Identifiant station,Nom station,Station en fonctionnement,Capacité de la station,Nombre bornettes libres,Nombre total vélos disponibles,Vélos mécaniques disponibles,Vélos électriques disponibles,Borne de paiement disponible,Retour vélib possible,Actualisation de la donnée,Coordonnées géographiques,Nom communes équipées,Code INSEE communes équipées,Densite de la Station,hour
16107,Benjamin Godard - Victor Hugo,OUI,31,29,2,0,2,OUI,OUI,2025-03-13 06:00:24+00:00,"48.865983, 2.275725",Paris,75056,0.06451612903225806,6
44015,Rouget de L'isle - Watteau,OUI,20,5,15,1,14,OUI,OUI,2025-03-13 06:00:54+00:00,"48.778192750803, 2.3963020229163",Vitry-sur-Seine,94081,0.75,6
40001,Hôpital Mondor,OUI,28,10,18,10,8,OUI,OUI,2025-03-13 05:59:46+00:00,"48.798922410229, 2.4537451531298",Créteil,94028,0.6428571428571429,6
9020,Toudouze - Clauzel,OUI,21,19,2,2,0,OUI,OUI,2025-03-13 05:53:08+00:00,"48.87929591733507, 2.3373600840568547",Paris,75056,0.09523809523809523,6
14014,Jourdan - Stade Charléty,OUI,60,49,11,4,7,OUI,OUI,2025-03-13 05:58:13+00:00,"48.819428333369, 2.3433353751898",Paris,75056,0.18333333333333332,6
14111,Cassini - Denfert-Rochereau,OUI,23,20,3,1,2,OUI,OUI,2025-03-13 05:58:01+00:00,"48.837525839067, 2.3360354080796",Paris,75056,0.13043478260869565,6
32017,Basilique,OUI,20,13,7,0,7,OUI,OUI,2025-03-13 05:56:40+00:00,"48.93626891059109, 2.3588666820200914",Saint-Denis,93066,0.35,6
8026,Messine - Place Du Pérou,OUI,12,11,1,1,0,OUI,OUI,2025-03-13 05:52:24+00:00,"48.875448033960744, 2.315508019010038",Paris,75056,0.08333333333333333,6
11104,Charonne - Robert et Sonia Delaunay,OUI,20,11,9,0,9,OUI,OUI,2025-03-13 05:51:19+00:00,"48.855907555969, 2.3925706744194",Paris,75056,0.45,6
7002,Vaneau - Sèvres,OUI,35,8,27,22,5,OUI,OUI,2025-03-13 06:00:51+00:00,"48.848563233059, 2.3204218259346",Paris,75056,0.7714285714285715,6
13007,Le Brun - Gobelins,OUI,46,9,37,26,11,OUI,OUI,2025-03-13 06:00:40+00:00,"48.835092787824, 2.3534681351338",Paris,75056,0.8043478260869565,6
5110,Lacépède - Monge,OUI,23,23,0,0,0,OUI,OUI,2025-03-13 05:55:05+00:00,"48.84389286531899, 2.3519663885235786",Paris,75056,0.0,6
6003,Saint-Sulpice,OUI,20,13,7,5,2,OUI,OUI,2025-03-13 06:00:53+00:00,"48.85165383178419, 2.3308077827095985",Paris,75056,0.35,6
6108,Saint-Romain - Cherche-Midi,OUI,15,13,2,1,1,OUI,OUI,2025-03-13 05:57:17+00:00,"48.84708159081946, 2.321374788880348",Paris,75056,0.13333333333333333,6
42016,Pierre et Marie Curie - Maurice Thorez,OUI,27,20,7,5,2,OUI,OUI,2025-03-13 06:00:14+00:00,"48.81580226360801, 2.376804985105991",Ivry-sur-Seine,94041,0.25925925925925924,6
33006,André Karman - République,OUI,30,21,9,3,6,OUI,OUI,2025-03-13 06:00:06+00:00,"48.91039875761846, 2.3851355910301213",Aubervilliers,93001,0.3,6
40011,Bas du Mont-Mesly,OUI,26,19,7,5,2,OUI,OUI,2025-03-13 06:00:47+00:00,"48.779035118572, 2.4609763908985",Créteil,94028,0.2692307692307692,6
25006,Place Nelson Mandela,OUI,22,19,3,3,0,OUI,OUI,2025-03-13 05:57:32+00:00,"48.862453313908, 2.1961666225454",Rueil-Malmaison,92063,0.13636363636363635,6
21010,Silly - Galliéni,OUI,25,11,14,13,1,OUI,OUI,2025-03-13 05:58:33+00:00,"48.835583838706, 2.2325500845909",Boulogne-Billancourt,92012,0.56,6
30002,Jean Rostand - Paul Vaillant Couturier,OUI,40,27,13,3,10,OUI,OUI,2025-03-13 06:00:21+00:00,"48.908168131015, 2.4530601033354",Bobigny,93008,0.325,6
32304,Charcot - Benfleet,OUI,28,27,1,0,1,NON,NON,2025-03-13 05:59:18+00:00,"48.878370277021, 2.440523876268",Romainville,93063,0.03571428571428571,6
5016,Thouin - Cardinal Lemoine,OUI,16,11,5,1,4,OUI,OUI,2025-03-13 05:52:40+00:00,"48.84504716661511, 2.3494647851273465",Paris,75056,0.3125,6
7003,Square Boucicaut,OUI,59,53,6,2,4,OUI,OUI,2025-03-13 05:57:00+00:00,"48.851296433665276, 2.325061820447445",Paris,75056,0.1016949152542373,6
6021,Beaux-Arts - Bonaparte,OUI,20,16,4,2,2,OUI,OUI,2025-03-13 05:57:46+00:00,"48.856451985396, 2.3348518833518",Paris,75056,0.2,6
17041,Guersant - Gouvion-Saint-Cyr,OUI,32,18,14,10,4,OUI,OUI,2025-03-13 05:59:23+00:00,"48.88287775178599, 2.287667370814871",Paris,75056,0.4375,6
15202,Bracion - Périphérique,OUI,30,19,11,6,5,OUI,OUI,2025-03-13 06:00:22+00:00,"48.826103771275, 2.3004549373748",Paris,75056,0.36666666666666664,6
11025,Froment - Bréguet,OUI,43,35,8,8,0,OUI,OUI,2025-03-13 05:58:59+00:00,"48.8570414504784, 2.37289470306807",Paris,75056,0.18604651162790697,6
12109,Mairie du 12ème,OUI,30,9,21,16,5,OUI,OUI,2025-03-13 06:00:22+00:00,"48.840855311763, 2.3875549435616",Paris,75056,0.7,6
15047,Morillons - Dantzig,OUI,51,33,18,7,11,OUI,OUI,2025-03-13 06:00:56+00:00,"48.83310149953933, 2.299380004405976",Paris,75056,0.35294117647058826,6
8050,Boétie - Ponthieu,OUI,44,32,12,2,10,OUI,OUI,2025-03-13 05:56:54+00:00,"48.871417284355, 2.3076787590981",Paris,75056,0.2727272727272727,6
17026,Jouffroy d'Abbans - Wagram,OUI,39,35,4,2,2,OUI,OUI,2025-03-13 05:59:28+00:00,"48.881973298352, 2.301132157445",Paris,75056,0.10256410256410256,6
14108,Le Brix et Mesmin - Jourdan,OUI,20,16,4,3,1,OUI,OUI,2025-03-13 05:59:03+00:00,"48.82234096593411, 2.327861653302471",Paris,75056,0.2,6
13101,Croulebarde - Corvisart,OUI,33,6,27,14,13,OUI,OUI,2025-03-13 06:00:48+00:00,"48.830981659316855, 2.3481646925210953",Paris,75056,0.8181818181818182,6
31024,Romainville - Vaillant-Couturier,OUI,36,31,5,0,5,OUI,OUI,2025-03-13 05:59:26+00:00,"48.86785, 2.446748",Montreuil,93048,0.1388888888888889,6
2022,Saint-Fiacre - Poissonière,OUI,33,29,4,1,3,OUI,OUI,2025-03-13 05:57:07+00:00,"48.870828911558, 2.3459213599563",Paris,75056,0.12121212121212122,6
17025,Chazelles - Courcelles,OUI,33,24,9,5,4,OUI,OUI,2025-03-13 05:59:27+00:00,"48.879406604954, 2.3034455627202988",Paris,75056,0.2727272727272727,6
17044,Porte de Saint-Ouen - Bessières,OUI,42,23,19,9,10,OUI,OUI,2025-03-13 05:57:08+00:00,"48.89792240854517, 2.32851451022192",Paris,75056,0.4523809523809524,6
20143,Ramponeau - Belleville,OUI,43,39,4,1,3,OUI,OUI,2025-03-13 05:56:11+00:00,"48.871031137596, 2.379056852114",Paris,75056,0.09302325581395349,6
19033,Cambrai - Benjamin Constant,OUI,41,39,2,1,1,OUI,OUI,2025-03-13 05:57:14+00:00,"48.89594736851349, 2.381133802246315",Paris,75056,0.04878048780487805,6
43002,Lagny - Victor Basch,OUI,23,7,16,4,12,OUI,OUI,2025-03-13 05:59:07+00:00,"48.84884147189881, 2.426325418925233",Vincennes,94080,0.6956521739130435,6
21326,Moulin de Pierre - Abbé Grégoire,OUI,20,18,2,0,2,OUI,OUI,2025-03-13 05:53:27+00:00,"48.822036188382, 2.2754641655975",Issy-les-Moulineaux,92040,0.1,6
17048,De Toqueville - Terrasse,OUI,30,17,13,12,1,OUI,OUI,2025-03-13 05:58:38+00:00,"48.882428, 2.314002",Paris,75056,0.43333333333333335,6
16138,Saint-Cloud - Hippodrome,OUI,30,24,6,3,3,OUI,OUI,2025-03-13 05:52:50+00:00,"48.85772148887421, 2.2549109905958176",Paris,75056,0.2,6
2017,Caire - Dussoubs,OUI,38,19,19,17,2,OUI,OUI,2025-03-13 05:59:03+00:00,"48.86785342111862, 2.349364310503006",Paris,75056,0.5,6
21216,Louis Lejeune - Barbès,OUI,24,16,8,4,4,OUI,OUI,2025-03-13 06:00:23+00:00,"48.81807418981508, 2.3267009854316716",Montrouge,92049,0.3333333333333333,6
9008,Tour d'Auvergne - Rodier,OUI,17,11,6,4,2,OUI,OUI,2025-03-13 05:58:53+00:00,"48.879161, 2.343698",Paris,75056,0.35294117647058826,6
15068,Général Martial Valin - Pont du Garigliano,OUI,16,7,9,4,5,OUI,OUI,2025-03-13 05:57:42+00:00,"48.83823094269141, 2.270506024360657",Paris,75056,0.5625,6
8048,Marceau - Chaillot,OUI,18,15,3,2,1,OUI,OUI,2025-03-13 05:51:16+00:00,"48.868834023334, 2.2986030816809",Paris,75056,0.16666666666666666,6
22207,Rond-point du Dr Albert Schweitzer,OUI,21,16,5,4,1,OUI,OUI,2025-03-13 05:57:52+00:00,"48.78980918988166, 2.3143940046429634",Bagneux,92007,0.23809523809523808,6
14013,Liard - Amiral Mouchez,OUI,26,19,7,3,4,OUI,OUI,2025-03-13 05:58:35+00:00,"48.8214169, 2.342167",Paris,75056,0.2692307692307692,6
92002,Théâtre des Amandiers - Palais des sports,OUI,23,11,12,6,6,OUI,OUI,2025-03-13 05:58:14+00:00,"48.892648526839, 2.2136941552162",Nanterre,92050,0.5217391304347826,6
13118,Regnault - Patay,OUI,63,22,41,32,9,OUI,OUI,2025-03-13 05:56:36+00:00,"48.82435782216384, 2.377065159380436",Paris,75056,0.6507936507936508,6
19027,Serrurier,OUI,18,15,3,0,3,OUI,OUI,2025-03-13 05:55:00+00:00,"48.880493403246, 2.398064173758",Paris,75056,0.16666666666666666,6
13030,Italie - Tolbiac,OUI,21,8,13,3,10,OUI,OUI,2025-03-13 06:00:35+00:00,"48.82557229464416, 2.3576171323657036",Paris,75056,0.6190476190476191,6
31028,Raspail Barbès,OUI,28,28,0,0,0,OUI,OUI,2025-03-13 05:58:59+00:00,"48.8529945, 2.4247387",Montreuil,93048,0.0,6
9002,Abbeville - Faubourg Poissonnière,OUI,14,11,3,3,0,OUI,OUI,2025-03-13 05:53:29+00:00,"48.879223, 2.349147",Paris,75056,0.21428571428571427,6
44017,Jules Guesde - Pont du Port à l'Anglais,OUI,26,0,26,21,5,OUI,OUI,2025-03-13 05:57:21+00:00,"48.79628807093802, 2.417212128639221",Vitry-sur-Seine,94081,1.0,6
48003,Youri Gagarine - Karl Marx,OUI,21,17,4,1,3,OUI,OUI,2025-03-13 05:56:44+00:00,"48.78448485079149, 2.35908430069685",Villejuif,94076,0.19047619047619047,6
9001,Bellefond - Poissonnière,OUI,15,7,8,7,1,OUI,OUI,2025-03-13 05:58:26+00:00,"48.87759897050706, 2.348463758826256",Paris,75056,0.5333333333333333,6
16118,Michel-Ange - Parent de Rosan,OUI,25,2,23,14,9,OUI,OUI,2025-03-13 05:55:00+00:00,"48.840579923690115, 2.2584119439125065",Paris,75056,0.92,6
10115,Granges aux Belles,OUI,27,15,12,7,5,OUI,OUI,2025-03-13 05:58:30+00:00,"48.8761373390584, 2.3680844979417",Paris,75056,0.4444444444444444,6
8103,Artois - Berri,OUI,22,21,1,0,1,OUI,OUI,2025-03-13 05:55:35+00:00,"48.87393521240818, 2.3064258322119713",Paris,75056,0.045454545454545456,6
10029,Dunkerque - Rocroy,OUI,23,22,1,0,1,OUI,OUI,2025-03-13 05:57:45+00:00,"48.880726, 2.351464",Paris,75056,0.043478260869565216,6
15112,Vigée-Lebrun - Anselme Payen,OUI,23,21,2,1,1,OUI,OUI,2025-03-13 05:58:18+00:00,"48.838683941628375, 2.3110422492027287",Paris,75056,0.08695652173913043,6
10161,Gare de l'Est - Faubourg-Saint-Martin,OUI,32,20,12,9,3,OUI,OUI,2025-03-13 06:00:58+00:00,"48.875642647477, 2.3594588041306",Paris,75056,0.375,6
18111,Félix Ziem - Armand Gauthier,OUI,21,10,11,4,7,OUI,OUI,2025-03-13 05:57:51+00:00,"48.88949630486821, 2.333393658804396",Paris,75056,0.5238095238095238,6
41303,Gare de Nogent-le-Perreux,OUI,30,14,16,12,4,OUI,OUI,2025-03-13 05:59:25+00:00,"48.83842553348809, 2.493693307042122",Nogent-sur-Marne,94052,0.5333333333333333,6
16110,Octave Feuillet - Albéric Magnard,OUI,21,19,2,1,1,OUI,OUI,2025-03-13 05:59:55+00:00,"48.86106902949534, 2.2730283066630363",Paris,75056,0.09523809523809523,6
12031,Gabriel Lamé,OUI,35,32,3,3,0,OUI,OUI,2025-03-13 05:56:35+00:00,"48.8351212784276, 2.385534569621086",Paris,75056,0.08571428571428572,6
43009,Place Jean-Spire-Lemaître,OUI,49,43,6,5,1,OUI,OUI,2025-03-13 06:00:32+00:00,"48.8468428626593, 2.452062070369721",Vincennes,94080,0.12244897959183673,6
1001,Quai de l'Horloge - Pont Neuf,OUI,16,8,8,8,0,OUI,OUI,2025-03-13 05:59:11+00:00,"48.857058739111, 2.3417982839439",Paris,75056,0.5,6
17032,Jean Oestreicher - Porte de Champerret,OUI,21,13,8,1,7,OUI,OUI,2025-03-13 05:59:56+00:00,"48.88655580065981, 2.288640439510346",Paris,75056,0.38095238095238093,6
5022,Boulangers - Cardinal Lemoine,OUI,18,13,5,2,3,OUI,OUI,2025-03-13 05:57:31+00:00,"48.8462904, 2.3521495",Paris,75056,0.2777777777777778,6
8016,Square Louis XVI,OUI,29,21,8,7,1,OUI,OUI,2025-03-13 05:52:47+00:00,"48.87320440102894, 2.323658830743138",Paris,75056,0.27586206896551724,6
9038,Douai - Bruxelles,OUI,26,26,0,0,0,OUI,OUI,2025-03-13 06:00:33+00:00,"48.88320784122797, 2.3308449949028507",Paris,75056,0.0,6
21328,Verger - Colonel Guichard,OUI,29,28,1,0,1,OUI,OUI,2025-03-13 05:59:07+00:00,"48.816376985087, 2.2670380088932",Issy-les-Moulineaux,92040,0.034482758620689655,6
17008,Porte Pouchet-Bessières,OUI,23,6,17,9,8,OUI,OUI,2025-03-13 05:55:34+00:00,"48.8978765, 2.3230632",Paris,75056,0.7391304347826086,6
13104,Gare d'Austerlitz - Quai Saint-Bernard,OUI,26,6,20,16,4,OUI,OUI,2025-03-13 05:59:51+00:00,"48.84369030864, 2.3657163977623",Paris,75056,0.7692307692307693,6
7018,Ségur - d'Estrées,OUI,19,14,5,3,2,OUI,OUI,2025-03-13 05:57:12+00:00,"48.851419978983, 2.3097044974566",Paris,75056,0.2631578947368421,6
17040,Pereire - Ternes,OUI,46,40,6,6,0,OUI,OUI,2025-03-13 06:01:01+00:00,"48.87973954830735, 2.288012132048607",Paris,75056,0.13043478260869565,6
5005,Gay Lussac - Saint-Jacques,OUI,24,23,1,0,1,OUI,OUI,2025-03-13 05:51:51+00:00,"48.844730256132, 2.3419239448664",Paris,75056,0.041666666666666664,6
8009,Gare Saint-Lazare - Isly,OUI,25,13,12,5,7,OUI,OUI,2025-03-13 05:59:13+00:00,"48.874777677621296, 2.326515804784655",Paris,75056,0.48,6
8053,Place Georges Guillaumin,OUI,26,23,3,0,3,OUI,OUI,2025-03-13 06:00:56+00:00,"48.874750203957, 2.301771435326",Paris,75056,0.11538461538461539,6
31103,Gare Rosny-Bois-Perrier,OUI,32,15,17,0,17,OUI,OUI,2025-03-13 05:56:13+00:00,"48.88115023337061, 2.480436824262142",Rosny-sous-Bois,93064,0.53125,6
19015,Thionville - Ourcq,OUI,21,21,0,0,0,OUI,OUI,2025-03-13 06:00:37+00:00,"48.88917613743794, 2.3833653330802917",Paris,75056,0.0,6
18203,Lamarck - Saint-Ouen,OUI,40,40,0,0,0,NON,NON,2025-03-13 05:55:19+00:00,"48.891334555236, 2.3272445342326",Paris,75056,0.0,6
9022,Rossini - Laffitte,OUI,33,30,3,1,2,OUI,OUI,2025-03-13 05:58:35+00:00,"48.87334627510507, 2.337980867701675",Paris,75056,0.09090909090909091,6
21323,Charlot - Stade Gabriel Voisin,OUI,31,8,23,21,2,OUI,OUI,2025-03-13 06:00:48+00:00,"48.827228120536, 2.268122527474",Issy-les-Moulineaux,92040,0.7419354838709677,6
26003,Argenteuil - Voltaire,OUI,16,9,7,2,5,OUI,OUI,2025-03-13 05:59:12+00:00,"48.91864865955558, 2.2814112156629562",Asnières-sur-Seine,92004,0.4375,6
9014,Faubourg Montmartre - La Fayette,OUI,34,21,13,10,3,OUI,OUI,2025-03-13 06:00:16+00:00,"48.875254549053, 2.3408536612988",Paris,75056,0.38235294117647056,6
19003,Quai de la Seine,OUI,23,15,8,2,6,OUI,OUI,2025-03-13 05:56:56+00:00,"48.884492238407525, 2.3703941702842717",Paris,75056,0.34782608695652173,6
9106,Boudreau - Auber,OUI,27,25,2,1,1,OUI,OUI,2025-03-13 06:00:25+00:00,"48.87219, 2.329423",Paris,75056,0.07407407407407407,6
10107,Gare du Nord - Hôpital Lariboisière,OUI,49,46,3,2,1,OUI,OUI,2025-03-13 05:56:17+00:00,"48.881949, 2.352339",Paris,75056,0.061224489795918366,6
19105,Ambroise Rendu - Porte Brunet,OUI,17,13,4,1,3,OUI,OUI,2025-03-13 05:53:17+00:00,"48.883667, 2.395733",Paris,75056,0.23529411764705882,6
26002,Redoute - Les Courtilles,OUI,37,5,32,15,17,OUI,OUI,2025-03-13 06:00:31+00:00,"48.929867194519, 2.2836696356535",Asnières-sur-Seine,92004,0.8648648648648649,6
31706,Château - République,OUI,25,16,9,2,7,OUI,OUI,2025-03-13 06:00:18+00:00,"48.862923800596, 2.4155035614967",Bagnolet,93006,0.36,6
17043,Belidor - Gouvion-Saint-Cyr,OUI,38,26,12,11,1,OUI,OUI,2025-03-13 05:59:48+00:00,"48.88022154052015, 2.2854680567979813",Paris,75056,0.3157894736842105,6
22409,Henri Barbusse - Stalingrad,OUI,16,11,5,1,4,OUI,OUI,2025-03-13 06:00:52+00:00,"48.814183748660554, 2.2872862592339516",Malakoff,92046,0.3125,6
16039,Exelmans - Versailles,OUI,48,7,41,33,8,OUI,OUI,2025-03-13 05:59:18+00:00,"48.84097491091973, 2.264390252530575",Paris,75056,0.8541666666666666,6
17004,Legendre - Clichy,OUI,39,24,15,10,5,OUI,OUI,2025-03-13 05:59:33+00:00,"48.88896161855884, 2.322528975094376",Paris,75056,0.38461538461538464,6
11023,Saint-Maur - Roquette,OUI,46,24,22,20,2,OUI,OUI,2025-03-13 05:58:24+00:00,"48.858688774062955, 2.383553994571467",Paris,75056,0.4782608695652174,6
12151,Gare de Lyon - Place Louis Armand,OUI,58,5,53,31,22,OUI,OUI,2025-03-13 05:55:15+00:00,"48.845515089794, 2.3726498446286",Paris,75056,0.9137931034482759,6
11002,Roquette - Thiéré,OUI,22,5,17,16,1,OUI,OUI,2025-03-13 06:00:52+00:00,"48.85507930579506, 2.3733686318721463",Paris,75056,0.7727272727272727,6
5020,Institut du Monde Arabe - Saint-Germain,OUI,40,13,27,24,3,OUI,OUI,2025-03-13 06:00:06+00:00,"48.849063299501, 2.3558086529374",Paris,75056,0.675,6
8034,Berri - Haussmann,OUI,34,31,3,2,1,OUI,OUI,2025-03-13 05:56:45+00:00,"48.874746047357135, 2.3082953318953514",Paris,75056,0.08823529411764706,6
92007,Pesaro - Préfecture,OUI,21,20,1,1,0,OUI,OUI,2025-03-13 05:58:35+00:00,"48.89577046284005, 2.223908342421055",Nanterre,92050,0.047619047619047616,6
5032,Panthéon - Valette,OUI,39,24,15,2,13,OUI,OUI,2025-03-13 05:56:34+00:00,"48.847020571652, 2.3464982619671",Paris,75056,0.38461538461538464,6
16026,Ranelagh - Mozart,OUI,7,5,2,0,2,OUI,OUI,2025-03-13 05:57:39+00:00,"48.8554439, 2.2704418",Paris,75056,0.2857142857142857,6
6006,Notre-Dame-des-Champs - Stanislas,OUI,19,12,7,2,5,OUI,OUI,2025-03-13 05:55:01+00:00,"48.84479928858768, 2.329337755887181",Paris,75056,0.3684210526315789,6
9028,Moncey - Blanche,OUI,17,16,1,0,1,OUI,OUI,2025-03-13 05:56:04+00:00,"48.88006587474148, 2.3310810327529907",Paris,75056,0.058823529411764705,6
8010,Liège - Moscou,OUI,16,13,3,2,1,OUI,OUI,2025-03-13 05:59:32+00:00,"48.8795431, 2.3264628",Paris,75056,0.1875,6
19026,Place de Rhin et Danube,OUI,14,14,0,0,0,OUI,OUI,2025-03-13 05:51:33+00:00,"48.88192765861766, 2.392586767673493",Paris,75056,0.0,6
31022,Mairie de Montreuil,OUI,51,43,8,5,3,OUI,OUI,2025-03-13 05:56:21+00:00,"48.86131452758348, 2.440614402294159",Montreuil,93048,0.1568627450980392,6
45003,11 Novembre 1918 - 8 Mai 1945,OUI,36,12,24,14,10,OUI,OUI,2025-03-13 05:54:49+00:00,"48.80889533774377, 2.5382421165704727",Champigny-sur-Marne,94017,0.6666666666666666,6
31009,Place Du Général De Gaulle,OUI,25,22,3,0,3,OUI,OUI,2025-03-13 05:56:04+00:00,"48.8687591, 2.4329931",Montreuil,93048,0.12,6
12111,Claude Decaen - Cannebière,OUI,25,14,11,4,7,OUI,OUI,2025-03-13 06:00:52+00:00,"48.83761417037952, 2.397253782195704",Paris,75056,0.44,6
41302,Charles de Gaulle - Beauté,OUI,48,42,6,0,6,OUI,OUI,2025-03-13 06:00:55+00:00,"48.83649602312711, 2.479562651149885",Nogent-sur-Marne,94052,0.125,6
11047,Amelot - Saint-Sébastien,OUI,29,8,21,19,2,OUI,OUI,2025-03-13 05:58:50+00:00,"48.861142162761, 2.3677996181077",Paris,75056,0.7241379310344828,6
14020,Cimetière de Montrouge,OUI,58,40,18,3,15,OUI,OUI,2025-03-13 06:01:04+00:00,"48.821466904768, 2.3215785772007",Paris,75056,0.3103448275862069,6
19043,Delphine Seyrig - Général Leclerc,OUI,52,45,7,2,5,OUI,OUI,2025-03-13 06:00:40+00:00,"48.893923963057865, 2.39790290594101",Pantin,93055,0.1346153846153846,6
33017,Anatole France - President Roosevelt,OUI,26,6,20,6,14,OUI,OUI,2025-03-13 05:59:53+00:00,"48.9155156, 2.3814103",Aubervilliers,93001,0.7692307692307693,6
18107,Chartres - La Charbonnière,OUI,34,31,3,1,2,OUI,OUI,2025-03-13 05:55:40+00:00,"48.8847601, 2.3534657",Paris,75056,0.08823529411764706,6
15042,Henry Farman,OUI,16,11,5,4,1,OUI,OUI,2025-03-13 05:52:02+00:00,"48.83372430280548, 2.2713854536414146",Paris,75056,0.3125,6
20042,Pyrénées - Emmery,OUI,39,33,6,0,6,OUI,OUI,2025-03-13 05:59:42+00:00,"48.872010281270974, 2.392039597034455",Paris,75056,0.15384615384615385,6
18011,Pajol - Place Herbert,OUI,37,15,22,10,12,OUI,OUI,2025-03-13 06:00:16+00:00,"48.8927825, 2.3635598",Paris,75056,0.5945945945945946,6
15067,Desaix - Edgar Faure,OUI,11,3,8,8,0,OUI,OUI,2025-03-13 05:55:39+00:00,"48.852804604940296, 2.293077029857222",Paris,75056,0.7272727272727273,6
33102,Gabriel Péri - Francisco Ferrer,OUI,17,15,2,1,1,OUI,OUI,2025-03-13 06:00:35+00:00,"48.88633710236977, 2.407338917255402",Le Pré-Saint-Gervais,93061,0.11764705882352941,6
17030,Pereire - Rennequin,OUI,22,3,19,13,6,OUI,OUI,2025-03-13 05:57:17+00:00,"48.88364782887555, 2.2952447086572647",Paris,75056,0.8636363636363636,6
21212,Marne - Germain Dardan,OUI,21,20,1,1,0,OUI,OUI,2025-03-13 05:51:05+00:00,"48.81217465201, 2.3035024699104",Montrouge,92049,0.047619047619047616,6
11027,Saint-Ambroise - Parmentier,OUI,36,10,26,23,3,OUI,OUI,2025-03-13 05:59:11+00:00,"48.862147844548, 2.3772348091006",Paris,75056,0.7222222222222222,6
19120,Carducci - Place Hannah Arendt,OUI,26,22,4,0,4,OUI,OUI,2025-03-13 05:59:58+00:00,"48.877436681515796, 2.3860743641853337",Paris,75056,0.15384615384615385,6
12128,Pyramide - Ecole du Breuil,OUI,32,24,8,2,6,OUI,OUI,2025-03-13 06:00:27+00:00,"48.82237977153955, 2.4586871266365056",Paris,75056,0.25,6
11113,Richard Lenoir - Republique,OUI,53,8,45,42,3,OUI,OUI,2025-03-13 06:01:02+00:00,"48.8667175, 2.3692541",Paris,75056,0.8490566037735849,6
46002,Rouget de Lisle,OUI,35,2,33,15,18,OUI,OUI,2025-03-13 05:53:44+00:00,"48.764615483395254, 2.4071189761161804",Choisy-le-Roi,94022,0.9428571428571428,6
15104,Hôpital Européen Georges Pompidou,OUI,63,30,33,24,9,OUI,OUI,2025-03-13 05:59:44+00:00,"48.837695319163, 2.2753742337227",Paris,75056,0.5238095238095238,6
10016,Récollets - Square Villemin,OUI,17,15,2,0,2,OUI,OUI,2025-03-13 06:00:58+00:00,"48.875034655883944, 2.359801238597928",Paris,75056,0.11764705882352941,6
14003,Schoelcher - Raspail,OUI,48,36,12,4,8,OUI,OUI,2025-03-13 05:53:45+00:00,"48.83681733526843, 2.3312794080411474",Paris,75056,0.25,6
42706,Roger Salengro - Fontainebleau,OUI,25,25,0,0,0,OUI,OUI,2025-03-13 05:58:00+00:00,"48.814548697325, 2.3611663654447",Le Kremlin-Bicêtre,94043,0.0,6
43008,Fontenay - Libération,OUI,22,15,7,5,2,OUI,OUI,2025-03-13 06:00:02+00:00,"48.847803063647, 2.4451419711113",Vincennes,94080,0.3181818181818182,6
44006,Concorde - Stalingrad,OUI,34,17,17,9,8,OUI,OUI,2025-03-13 05:58:15+00:00,"48.7985844, 2.3821302",Vitry-sur-Seine,94081,0.5,6
5018,Mutualité,OUI,36,17,19,16,3,OUI,OUI,2025-03-13 05:59:05+00:00,"48.848225572724, 2.3502873256803",Paris,75056,0.5277777777777778,6
18003,Cimetière de Montmartre,OUI,43,42,1,0,1,OUI,OUI,2025-03-13 05:59:24+00:00,"48.886472466142, 2.3328901827335",Paris,75056,0.023255813953488372,6
19101,Square Simon Bolivar,OUI,23,14,9,1,8,OUI,OUI,2025-03-13 06:01:04+00:00,"48.875089888322, 2.3826304078102",Paris,75056,0.391304347826087,6
19103,Manin - Carrières d'Amérique,OUI,17,6,11,5,6,OUI,OUI,2025-03-13 05:58:21+00:00,"48.88467214209463, 2.3919698596000676",Paris,75056,0.6470588235294118,6
12114,Victor Hugo - Jeanne Jugan,OUI,28,17,11,3,8,OUI,OUI,2025-03-13 06:00:19+00:00,"48.843949064031825, 2.415081394834419",Paris,75056,0.39285714285714285,6
14138,Porte de Vanves,OUI,30,10,20,15,5,OUI,OUI,2025-03-13 06:00:17+00:00,"48.828012849445, 2.3056878894567",Paris,75056,0.6666666666666666,6
21312,Lucie Aubrac - Fort,OUI,30,30,0,0,0,OUI,OUI,2025-03-13 06:01:05+00:00,"48.818144834008976, 2.271184623241425",Issy-les-Moulineaux,92040,0.0,6
46003,Conservatoire de Musique,OUI,24,1,23,18,5,OUI,OUI,2025-03-13 06:00:58+00:00,"48.77093586667601, 2.4034014344215398",Choisy-le-Roi,94022,0.9583333333333334,6
18028,Championnet - Vauvenargues,OUI,31,17,14,8,6,OUI,OUI,2025-03-13 05:59:19+00:00,"48.89401874744574, 2.3319872841238976",Paris,75056,0.45161290322580644,6
41209,Cimetière de Fontenay-sous-Bois,OUI,15,15,0,0,0,OUI,OUI,2025-03-13 05:57:45+00:00,"48.84706173362218, 2.4787822365760808",Fontenay-sous-Bois,94033,0.0,6
15054,Lecourbe - Jean Maridor,OUI,18,4,14,12,2,OUI,OUI,2025-03-13 05:59:11+00:00,"48.83796366147599, 2.2877392172813416",Paris,75056,0.7777777777777778,6
14008,Mouton Duvernet - Général Leclerc,OUI,27,21,6,1,5,OUI,OUI,2025-03-13 05:59:04+00:00,"48.831632518293, 2.3293121159077",Paris,75056,0.2222222222222222,6
15106,Grenelle - Violet,OUI,33,18,15,14,1,OUI,OUI,2025-03-13 06:00:30+00:00,"48.84993035512154, 2.294612042605877",Paris,75056,0.45454545454545453,6
13001,Port-Royal - Hôpital du Val-de-Grâce,OUI,18,9,9,4,5,OUI,OUI,2025-03-13 05:57:59+00:00,"48.837668272811, 2.3448138346607",Paris,75056,0.5,6
5124,Erasme - Ulm,OUI,22,19,3,0,3,OUI,OUI,2025-03-13 05:59:10+00:00,"48.84264375274712, 2.3445946723222733",Paris,75056,0.13636363636363635,6
8017,Rocher - Laborde,OUI,65,52,13,6,7,OUI,OUI,2025-03-13 06:00:17+00:00,"48.87590240712654, 2.322616316378116",Paris,75056,0.2,6
22406,Guy Môquet - Etienne Dolet,OUI,22,21,1,0,1,OUI,OUI,2025-03-13 05:56:04+00:00,"48.81527009991819, 2.298078276995073",Malakoff,92046,0.045454545454545456,6
14106,Marc Sangnier - Porte de Vanves,OUI,20,14,6,2,4,OUI,OUI,2025-03-13 05:59:51+00:00,"48.825218683556734, 2.3107116669416428",Paris,75056,0.3,6
31102,Boissière - Etienne Dolet,OUI,20,17,3,1,2,OUI,OUI,2025-03-13 05:54:47+00:00,"48.876111, 2.4677312",Montreuil,93048,0.15,6
18046,Etienne Jodelle - Saint Ouen,OUI,31,28,3,0,3,OUI,OUI,2025-03-13 06:00:04+00:00,"48.88794016394694, 2.326124420314341",Paris,75056,0.0967741935483871,6
2111,Chabanais - Petits Champs,OUI,29,21,8,3,5,OUI,OUI,2025-03-13 05:53:54+00:00,"48.86703740186721, 2.336716018617153",Paris,75056,0.27586206896551724,6
14012,Sibelle - Alésia,OUI,37,32,5,2,3,OUI,OUI,2025-03-13 06:00:57+00:00,"48.826701758539215, 2.3384983465075493",Paris,75056,0.13513513513513514,6
18022,Marcadet - Barbès,OUI,32,17,15,6,9,OUI,OUI,2025-03-13 05:59:12+00:00,"48.890451120965, 2.3490573929687",Paris,75056,0.46875,6
35010,Hoche - Jean Lolive,OUI,20,12,8,4,4,OUI,OUI,2025-03-13 05:59:01+00:00,"48.89110239200789, 2.402843534946442",Pantin,93055,0.4,6
8054,Bertie Albrecht - Hoche,OUI,32,27,5,1,4,OUI,OUI,2025-03-13 05:54:03+00:00,"48.87614039826388, 2.301303138307601",Paris,75056,0.15625,6
17203,Place de la Porte de Champeret,OUI,27,7,20,15,5,OUI,OUI,2025-03-13 05:59:04+00:00,"48.886062068226, 2.2917001576821",Paris,75056,0.7407407407407407,6
15109,Cevennes - Bergers,OUI,28,12,16,15,1,OUI,OUI,2025-03-13 05:57:54+00:00,"48.84240765130395, 2.281037718057633",Paris,75056,0.5714285714285714,6
42014,Place Marcel Cachin,OUI,31,5,26,20,6,OUI,OUI,2025-03-13 05:58:09+00:00,"48.81411442356866, 2.39090770483017",Ivry-sur-Seine,94041,0.8387096774193549,6
21209,Molière - République,OUI,30,23,7,4,3,OUI,OUI,2025-03-13 06:00:27+00:00,"48.81111581390707, 2.3145738624448158",Montrouge,92049,0.23333333333333334,6
14124,David Weill - Parc Montsouris,OUI,22,19,3,0,3,OUI,OUI,2025-03-13 06:01:01+00:00,"48.821092374256104, 2.333725690841675",Paris,75056,0.13636363636363635,6
21005,Hôtel de Ville de Boulogne Billancourt,OUI,25,12,13,8,5,OUI,OUI,2025-03-13 06:00:31+00:00,"48.83495885166784, 2.2416803240776066",Boulogne-Billancourt,92012,0.52,6
15133,Saint Lambert - Blomet,OUI,27,0,27,22,5,OUI,OUI,2025-03-13 06:00:58+00:00,"48.83659148147257, 2.2930556908249855",Paris,75056,1.0,6
10042,Enghien - Faubourg Poissonnière,OUI,32,15,17,15,2,OUI,OUI,2025-03-13 06:01:00+00:00,"48.872420063053, 2.3483952362828",Paris,75056,0.53125,6
44013,Edouard Tremblay - Julian Grimaux,OUI,30,22,8,2,6,OUI,OUI,2025-03-13 05:59:10+00:00,"48.781383825117, 2.3723508417606",Vitry-sur-Seine,94081,0.26666666666666666,6
4016,Lobau - Hôtel de Ville,OUI,60,20,40,35,5,OUI,OUI,2025-03-13 06:01:04+00:00,"48.8562118, 2.3532536",Paris,75056,0.6666666666666666,6
20131,Repos - Cimetière du Père Lachaise,OUI,33,27,6,6,0,OUI,OUI,2025-03-13 05:59:47+00:00,"48.859358523593, 2.3896131366845",Paris,75056,0.18181818181818182,6
8045,Place de la Reine Astrid,OUI,56,52,4,1,3,OUI,OUI,2025-03-13 06:00:56+00:00,"48.864920982538, 2.3025491823859",Paris,75056,0.07142857142857142,6
6025,Assas - Rennes,OUI,32,30,2,1,1,OUI,OUI,2025-03-13 05:53:58+00:00,"48.8492084999386, 2.32851454623001",Paris,75056,0.0625,6
15110,Place Robert Guillemard,OUI,22,10,12,10,2,OUI,OUI,2025-03-13 05:57:56+00:00,"48.836191728066666, 2.2811267160086417",Paris,75056,0.5454545454545454,6
15034,Lakanal - Commerce,OUI,48,4,44,39,5,OUI,OUI,2025-03-13 05:59:27+00:00,"48.84442462786544, 2.294059172272682",Paris,75056,0.9166666666666666,6
21006,Marcelin Berthelot,OUI,27,19,8,3,5,OUI,OUI,2025-03-13 05:59:58+00:00,"48.8415473058801, 2.233161628246308",Boulogne-Billancourt,92012,0.2962962962962963,6
48010,Karl Marx,OUI,16,3,13,4,9,OUI,OUI,2025-03-13 05:51:37+00:00,"48.784527937293184, 2.3646667979455587",Villejuif,94076,0.8125,6
42021,Raspail - Manufacture des Oeillets,OUI,30,5,25,22,3,OUI,OUI,2025-03-13 05:57:41+00:00,"48.8094458, 2.3903009",Ivry-sur-Seine,94041,0.8333333333333334,6
21015,Nationale - Place Jules Guesde,OUI,23,8,15,8,7,OUI,OUI,2025-03-13 05:59:43+00:00,"48.82753962462998, 2.2416052222251897",Boulogne-Billancourt,92012,0.6521739130434783,6
1119,Cossonnerie - Sébastopol,OUI,23,17,6,3,3,OUI,OUI,2025-03-13 06:00:40+00:00,"48.86132665908402, 2.349419631063938",Paris,75056,0.2608695652173913,6
44003,Gabriel Péri - Danielle Casanova,OUI,20,3,17,10,7,OUI,OUI,2025-03-13 06:00:27+00:00,"48.790114, 2.4025777",Vitry-sur-Seine,94081,0.85,6
35020,Marcelle - Thalie,OUI,20,19,1,0,1,OUI,OUI,2025-03-13 05:59:46+00:00,"48.8835462, 2.4137883",Pantin,93055,0.05,6
5028,Censier - Jardin des Plantes,OUI,28,6,22,19,3,OUI,OUI,2025-03-13 06:01:05+00:00,"48.84107178161383, 2.355475388467312",Paris,75056,0.7857142857142857,6
1020,Cambon - Rivoli,OUI,35,23,12,2,10,OUI,OUI,2025-03-13 05:59:25+00:00,"48.866143390992, 2.3251800647137",Paris,75056,0.34285714285714286,6
22203,Tertres - Fontaine,OUI,26,23,3,1,2,OUI,OUI,2025-03-13 05:57:52+00:00,"48.787553654715644, 2.306235730648041",Bagneux,92007,0.11538461538461539,6
25003,Henri Ste-Claire Déville - Paul Héroult,OUI,21,10,11,5,6,OUI,OUI,2025-03-13 06:00:31+00:00,"48.892663, 2.172411",Rueil-Malmaison,92063,0.5238095238095238,6
41202,Gare Rer de Fontenay sous Bois,OUI,57,46,11,4,7,OUI,OUI,2025-03-13 06:00:33+00:00,"48.8436279, 2.4630465",Fontenay-sous-Bois,94033,0.19298245614035087,6
20115,Louis Lumière - Porte de Bagnolet,OUI,20,18,2,0,2,OUI,OUI,2025-03-13 06:00:35+00:00,"48.86431136000005, 2.4105210229754443",Paris,75056,0.1,6
11039,Richard Lenoir - Jean-Pierre Timbaud,OUI,35,3,32,32,0,OUI,OUI,2025-03-13 06:00:35+00:00,"48.865804276686, 2.3693370749669",Paris,75056,0.9142857142857143,6
31003,Paris - Emile Zola,OUI,29,24,5,3,2,OUI,OUI,2025-03-13 05:59:14+00:00,"48.854898095789295, 2.4186685681343083",Montreuil,93048,0.1724137931034483,6
11026,Chemin Vert - Saint-Maur,OUI,44,23,21,20,1,OUI,OUI,2025-03-13 05:58:21+00:00,"48.86112461407359, 2.381299026310444",Paris,75056,0.4772727272727273,6
22402,Jean Jaurès - Salvador Allende,OUI,42,42,0,0,0,OUI,OUI,2025-03-13 05:58:49+00:00,"48.821475594736775, 2.3026576638221745",Malakoff,92046,0.0,6
32604,Square du Théâtre du Garde-Chasse,OUI,50,34,16,11,5,OUI,OUI,2025-03-13 06:00:28+00:00,"48.881287375060616, 2.420119643211365",Les Lilas,93045,0.32,6
9116,Victoire - Chaussée d'Antin,OUI,24,19,5,4,1,OUI,OUI,2025-03-13 05:56:55+00:00,"48.875065791004396, 2.3316738009452824",Paris,75056,0.20833333333333334,6
15021,Joseph Liouville - Croix Nivert,OUI,62,3,59,33,26,OUI,OUI,2025-03-13 05:59:22+00:00,"48.844835471244416, 2.297508493065834",Paris,75056,0.9516129032258065,6
11030,Oberkampf - République,OUI,21,12,9,7,2,OUI,OUI,2025-03-13 06:00:47+00:00,"48.86531608707, 2.37611478491",Paris,75056,0.42857142857142855,6
17105,Place Madeleine Daniélou,OUI,42,32,10,5,5,OUI,OUI,2025-03-13 05:58:33+00:00,"48.883498, 2.282015",Paris,75056,0.23809523809523808,6
17013,Legendre - Dulong,OUI,23,17,6,1,5,OUI,OUI,2025-03-13 05:58:47+00:00,"48.885325169402904, 2.316423766314984",Paris,75056,0.2608695652173913,6
9010,Rochechouart lamartine,OUI,24,14,10,10,0,OUI,OUI,2025-03-13 05:56:12+00:00,"48.876719895109, 2.344393021854",Paris,75056,0.4166666666666667,6
19024,Botzaris - Parc des Buttes Chaumont,OUI,20,17,3,0,3,OUI,OUI,2025-03-13 05:54:02+00:00,"48.877951, 2.381464",Paris,75056,0.15,6
16108,Sablons - Georges Mandel,OUI,38,36,2,1,1,OUI,OUI,2025-03-13 05:52:32+00:00,"48.863875, 2.28189",Paris,75056,0.05263157894736842,6
41601,Général De Gaulle - Alouette,OUI,23,12,11,3,8,OUI,OUI,2025-03-13 05:59:08+00:00,"48.839109, 2.4175664",Saint-Mandé,94067,0.4782608695652174,6
17125,Marie-Georges Picquart - Pereire,OUI,32,27,5,1,4,OUI,OUI,2025-03-13 05:58:26+00:00,"48.88863669349711, 2.3111706599593163",Paris,75056,0.15625,6
23006,Jules Guesde - Alsace,OUI,23,17,6,4,2,OUI,OUI,2025-03-13 06:00:41+00:00,"48.890566275506, 2.2950777411461",Levallois-Perret,92044,0.2608695652173913,6
16136,Théophile Gautier - François Millet,OUI,27,7,20,18,2,OUI,OUI,2025-03-13 06:00:32+00:00,"48.85034821320644, 2.273029983043671",Paris,75056,0.7407407407407407,6
15058,Place du Moulin de Javel,OUI,42,25,17,12,5,OUI,OUI,2025-03-13 05:57:42+00:00,"48.84021670922, 2.2716060653329",Paris,75056,0.40476190476190477,6
19032,Villette - Belleville,OUI,41,30,11,2,9,OUI,OUI,2025-03-13 05:59:45+00:00,"48.8726877314, 2.376461327076",Paris,75056,0.2682926829268293,6
18009,Jean-François Lépine - Stephenson,OUI,22,3,19,1,18,OUI,OUI,2025-03-13 05:58:53+00:00,"48.88611466796807, 2.356855627529275",Paris,75056,0.8636363636363636,6
21701,Larmeroux - Baudelaire,OUI,28,15,13,4,9,OUI,OUI,2025-03-13 06:00:43+00:00,"48.816939911292, 2.2809894804846",Vanves,92075,0.4642857142857143,6
11105,Parmentier - République,OUI,22,8,14,9,5,OUI,OUI,2025-03-13 05:57:50+00:00,"48.8644954, 2.3750124",Paris,75056,0.6363636363636364,6
16008,Galilée - Kléber,OUI,30,25,5,1,4,OUI,OUI,2025-03-13 05:51:28+00:00,"48.867411865714, 2.2907813801148",Paris,75056,0.16666666666666666,6
43005,Gare RER de Vincennes,OUI,47,0,47,13,34,OUI,OUI,2025-03-13 05:57:44+00:00,"48.847563015126106, 2.433383166790009",Vincennes,94080,1.0,6
11024,Mairie du 11ème,OUI,51,13,38,37,1,OUI,OUI,2025-03-13 05:58:34+00:00,"48.858925, 2.3789759",Paris,75056,0.7450980392156863,6
19022,Marché Secrétan,OUI,23,19,4,1,3,OUI,OUI,2025-03-13 05:57:52+00:00,"48.88125496379482, 2.373463287949562",Paris,75056,0.17391304347826086,6
22003,Beffroy,OUI,26,20,6,2,4,OUI,OUI,2025-03-13 05:59:57+00:00,"48.886591074488, 2.2613945603371",Neuilly-sur-Seine,92051,0.23076923076923078,6
21008,Victor Hugo - Galliéni,OUI,33,12,21,19,2,OUI,OUI,2025-03-13 05:58:44+00:00,"48.838020154411, 2.2460845112801",Boulogne-Billancourt,92012,0.6363636363636364,6
13050,Quai Panhard et Levassor,OUI,57,51,6,3,3,OUI,OUI,2025-03-13 05:56:15+00:00,"48.828374828097, 2.3842737458056",Paris,75056,0.10526315789473684,6
20134,Lieutenant Chauré - Etienne Marey,OUI,19,16,3,2,1,OUI,OUI,2025-03-13 05:58:41+00:00,"48.86746195408435, 2.405970990657807",Paris,75056,0.15789473684210525,6
22016,Charles de Gaulle - Sablonville,OUI,26,18,8,1,7,OUI,OUI,2025-03-13 05:58:12+00:00,"48.87991924860035, 2.2763770446181297",Neuilly-sur-Seine,92051,0.3076923076923077,6
24001,Arche - Léonard de Vinci,OUI,28,20,8,4,4,OUI,OUI,2025-03-13 06:00:42+00:00,"48.89790972494496, 2.2383723043644914",Courbevoie,92026,0.2857142857142857,6
14136,Auguste Cain - Jean Moulin,OUI,40,33,7,0,7,OUI,OUI,2025-03-13 05:59:58+00:00,"48.82577028927573, 2.3210415244102482",Paris,75056,0.175,6
10014,Marseille - Beaurepaire,OUI,48,13,35,31,4,OUI,OUI,2025-03-13 06:01:04+00:00,"48.871624306962985, 2.3639265082738348",Paris,75056,0.7291666666666666,6
32302,Chemin Vert - Fraternité,OUI,20,19,1,0,1,OUI,OUI,2025-03-13 05:56:26+00:00,"48.877141208359035, 2.4461565166711807",Romainville,93063,0.05,6
11035,Parmentier - Abel Rabaud,OUI,49,17,32,18,14,OUI,OUI,2025-03-13 05:59:40+00:00,"48.86921273836114, 2.371688821240712",Paris,75056,0.6530612244897959,6
42010,Mairie d'Ivry-sur-Seine,OUI,52,7,45,31,14,OUI,OUI,2025-03-13 05:58:30+00:00,"48.81057120969284, 2.3842826485633855",Ivry-sur-Seine,94041,0.8653846153846154,6
15046,Parc Georges Brassens - Brancion,OUI,28,12,16,3,13,OUI,OUI,2025-03-13 06:00:17+00:00,"48.83227829269761, 2.3022570088505745",Paris,75056,0.5714285714285714,6
46001,Place Paul Eluard,OUI,19,5,14,8,6,OUI,OUI,2025-03-13 05:54:40+00:00,"48.7672039733195, 2.4144977331161503",Choisy-le-Roi,94022,0.7368421052631579,6
16040,Exelmans - Michel-Ange,OUI,29,8,21,19,2,OUI,OUI,2025-03-13 06:00:41+00:00,"48.84309486651855, 2.2597770800669053",Paris,75056,0.7241379310344828,6
17028,Reims - Raymond Pitet,OUI,34,16,18,14,4,OUI,OUI,2025-03-13 05:54:38+00:00,"48.8888, 2.296319",Paris,75056,0.5294117647058824,6
22006,Pierret - Madrid,OUI,27,20,7,5,2,OUI,OUI,2025-03-13 05:55:42+00:00,"48.882976576876565, 2.260125767248034",Neuilly-sur-Seine,92051,0.25925925925925924,6
42302,Aristide Briand - Gare de Bagneux,OUI,20,17,3,0,3,OUI,OUI,2025-03-13 05:59:41+00:00,"48.79387269664978, 2.321148812770844",Cachan,94016,0.15,6
21301,Saint-Vincent - Verdun,OUI,33,0,33,22,11,OUI,OUI,2025-03-13 06:00:52+00:00,"48.819211549234495, 2.254007756710053",Issy-les-Moulineaux,92040,1.0,6
32003,Wilson - Métallurgie,OUI,28,18,10,3,7,OUI,OUI,2025-03-13 05:57:47+00:00,"48.909423010092326, 2.3584435880184174",Saint-Denis,93066,0.35714285714285715,6
19029,Seine - Flandre,OUI,19,12,7,5,2,OUI,OUI,2025-03-13 05:55:22+00:00,"48.886785741479684, 2.3746193200349808",Paris,75056,0.3684210526315789,6
21104,Madame de Sanzillon - Mozart,OUI,22,7,15,7,8,OUI,OUI,2025-03-13 06:00:01+00:00,"48.90379820774301, 2.3187401890754704",Clichy,92024,0.6818181818181818,6
9032,Mathurins - Auber,OUI,35,19,16,8,8,OUI,OUI,2025-03-13 06:00:01+00:00,"48.872988840744, 2.3294984212276",Paris,75056,0.45714285714285713,6
11042,Grand Prieuré - Crussol,OUI,45,5,40,38,2,OUI,OUI,2025-03-13 06:00:18+00:00,"48.864660627935, 2.3692265531829",Paris,75056,0.8888888888888888,6
19016,Hautpoul - Jean Jaurès,OUI,29,16,13,5,8,OUI,OUI,2025-03-13 05:56:50+00:00,"48.886393679436, 2.3865414544355",Paris,75056,0.4482758620689655,6
1013,Place du Palais Royal,OUI,65,42,23,22,1,OUI,OUI,2025-03-13 06:00:56+00:00,"48.862382970647, 2.3384822532535",Paris,75056,0.35384615384615387,6
32026,Leroy des Barres - Médiathèque,OUI,27,0,27,12,15,OUI,OUI,2025-03-13 06:00:12+00:00,"48.928253687082, 2.3681719727966",Saint-Denis,93066,1.0,6
8025,Miromesnil - La Boétie,OUI,32,22,10,3,7,OUI,OUI,2025-03-13 05:58:39+00:00,"48.873722412917, 2.3158480972052",Paris,75056,0.3125,6
9005,Square d'Anvers,OUI,31,26,5,0,5,OUI,OUI,2025-03-13 05:51:56+00:00,"48.882633484311, 2.3448844062122",Paris,75056,0.16129032258064516,6
7102,Mairie du 7ème,OUI,48,35,13,10,3,OUI,OUI,2025-03-13 05:56:23+00:00,"48.8577967, 2.3192664",Paris,75056,0.2708333333333333,6
20121,Boyer - Ménilmontant,OUI,18,17,1,0,1,OUI,OUI,2025-03-13 06:00:02+00:00,"48.868895162679, 2.3919824145635",Paris,75056,0.05555555555555555,6
13002,Arago - Glacière,OUI,26,5,21,18,3,OUI,OUI,2025-03-13 05:58:07+00:00,"48.83486054775774, 2.3445770524322067",Paris,75056,0.8076923076923077,6
42301,Gare Arcueil - Cachan,OUI,25,20,5,0,5,OUI,OUI,2025-03-13 05:54:46+00:00,"48.799824, 2.328171",Arcueil,94003,0.2,6
19013,Laumière - Petit,OUI,30,18,12,6,6,OUI,OUI,2025-03-13 06:01:05+00:00,"48.88467368538326, 2.380039058625698",Paris,75056,0.4,6
26013,Quai du docteur Dervaux,OUI,26,4,22,11,11,OUI,OUI,2025-03-13 06:00:49+00:00,"48.910482, 2.297998",Asnières-sur-Seine,92004,0.8461538461538461,6
42504,Gare RER de Gentilly,OUI,30,18,12,4,8,OUI,OUI,2025-03-13 05:59:38+00:00,"48.814280450380224, 2.3410347104072575",Gentilly,94037,0.4,6
42015,Place Jean Ferrat,OUI,23,18,5,1,4,OUI,OUI,2025-03-13 05:57:22+00:00,"48.8184945213025, 2.3744174838066106",Ivry-sur-Seine,94041,0.21739130434782608,6
20111,Villiers de l'Isle Adam - Pyrénées,OUI,20,16,4,0,4,OUI,OUI,2025-03-13 06:00:17+00:00,"48.867362, 2.396222",Paris,75056,0.2,6
31010,Stalingrad - Désiré Chevalier,OUI,41,37,4,0,4,OUI,OUI,2025-03-13 05:52:54+00:00,"48.85670169739857, 2.445072233676911",Montreuil,93048,0.0975609756097561,6
20043,Charonne - Avron,OUI,26,21,5,2,3,OUI,OUI,2025-03-13 05:51:58+00:00,"48.851602665222, 2.3984030470379",Paris,75056,0.19230769230769232,6
51004,Général Delambre - Prebuard,OUI,28,17,11,2,9,OUI,OUI,2025-03-13 05:52:00+00:00,"48.93870344444, 2.2234171606307",Argenteuil,95018,0.39285714285714285,6
32016,Place de la Porte de Paris,OUI,37,29,8,1,7,OUI,OUI,2025-03-13 05:58:36+00:00,"48.93009363207303, 2.3564037680625916",Saint-Denis,93066,0.21621621621621623,6
12009,Charenton - Diderot,OUI,18,7,11,9,2,OUI,OUI,2025-03-13 05:58:10+00:00,"48.846171461187, 2.3793068155646",Paris,75056,0.6111111111111112,6
15201,Place Amédée Gordini - Lefebvre,OUI,37,30,7,3,4,OUI,OUI,2025-03-13 05:52:52+00:00,"48.83061737745, 2.2920634208276",Paris,75056,0.1891891891891892,6
19125,Place de l'Édit de Nantes,OUI,25,12,13,4,9,OUI,OUI,2025-03-13 05:54:33+00:00,"48.88879, 2.3785",Paris,75056,0.52,6
19008,Flandre - Alphonse Karr,OUI,26,20,6,4,2,OUI,OUI,2025-03-13 05:58:40+00:00,"48.89465, 2.381868",Paris,75056,0.23076923076923078,6
14036,Boulard - Daguerre,OUI,43,43,0,0,0,OUI,OUI,2025-03-13 05:56:14+00:00,"48.83446472680611, 2.3293386027216907",Paris,75056,0.0,6
11004,Charonne - Faubourg Saint-Antoine,OUI,32,9,23,22,1,OUI,OUI,2025-03-13 05:59:39+00:00,"48.852191909696, 2.3740932717919",Paris,75056,0.71875,6
18201,Tristan Tzara -  Tchaïkovski,OUI,32,24,8,4,4,OUI,OUI,2025-03-13 05:54:05+00:00,"48.89490221746837, 2.3648490384221077",Paris,75056,0.25,6
19205,Simon Bolivar - Henri Turot,OUI,22,18,4,0,4,OUI,OUI,2025-03-13 06:00:30+00:00,"48.877475489801, 2.3739709492211",Paris,75056,0.18181818181818182,6
92008,Hôtel de Ville de Nanterre,OUI,35,17,18,11,7,OUI,OUI,2025-03-13 06:00:54+00:00,"48.892371898250424, 2.205548956990242",Nanterre,92050,0.5142857142857142,6
9021,Saint Georges - d'Aumale,OUI,22,17,5,2,3,OUI,OUI,2025-03-13 06:00:07+00:00,"48.87778639599673, 2.337429821491241",Paris,75056,0.22727272727272727,6
41402,Victor Hugo - Ecoles,OUI,23,7,16,8,8,OUI,OUI,2025-03-13 06:00:48+00:00,"48.80476007936134, 2.4180373930262093",Alfortville,94002,0.6956521739130435,6
23009,Anatole France - Louise Michel,OUI,47,29,18,15,3,OUI,OUI,2025-03-13 05:59:56+00:00,"48.88873214926474, 2.2881576418876652",Levallois-Perret,92044,0.3829787234042553,6
18012,Stephenson - Doudeauville,OUI,34,24,10,7,3,OUI,OUI,2025-03-13 05:56:30+00:00,"48.888537048944826, 2.3561610281467438",Paris,75056,0.29411764705882354,6
12027,Montgallet - Charenton,OUI,15,9,6,6,0,OUI,OUI,2025-03-13 06:00:58+00:00,"48.842647778701, 2.3861649278137",Paris,75056,0.4,6
5123,Saint-Germain - Thenard,OUI,29,23,6,4,2,OUI,OUI,2025-03-13 05:55:55+00:00,"48.850571, 2.3471015",Paris,75056,0.20689655172413793,6
42029,Stalingrad - Germaine Tailleferre,OUI,24,20,4,1,3,OUI,OUI,2025-03-13 05:58:33+00:00,"48.80257200481316, 2.3786691203713417",Ivry-sur-Seine,94041,0.16666666666666666,6
11036,Jules Ferry - Faubourg du Temple Paris,OUI,57,15,42,40,2,OUI,OUI,2025-03-13 06:00:23+00:00,"48.868397, 2.3678933",Paris,75056,0.7368421052631579,6
21313,Guynemer - Séverine,OUI,25,15,10,9,1,OUI,OUI,2025-03-13 06:00:57+00:00,"48.83091743371036, 2.2790706530213356",Issy-les-Moulineaux,92040,0.4,6
43003,Hôpital Bégin,OUI,26,26,0,0,0,NON,NON,2025-03-13 05:56:13+00:00,"48.84571672113, 2.4272462725639",Vincennes,94080,0.0,6
11007,Jean Macé - Faidherbe,OUI,59,32,27,16,11,OUI,OUI,2025-03-13 05:58:35+00:00,"48.85337548426, 2.3828620836139",Paris,75056,0.4576271186440678,6
8035,Bienfaisance - Place de Narvik,OUI,34,30,4,3,1,OUI,OUI,2025-03-13 05:57:04+00:00,"48.87660163459077, 2.3129771277308464",Paris,75056,0.11764705882352941,6
35018,Ancien Canal - Hélène Brion,OUI,23,18,5,0,5,OUI,OUI,2025-03-13 05:57:19+00:00,"48.89484799296163, 2.4188338592648506",Pantin,93055,0.21739130434782608,6
17102,Alfred Roll - Berthier,OUI,28,12,16,16,0,OUI,OUI,2025-03-13 06:00:23+00:00,"48.887808570529, 2.3000952981763",Paris,75056,0.5714285714285714,6
18110,Departement - Pajol,OUI,16,7,9,2,7,OUI,OUI,2025-03-13 05:59:45+00:00,"48.886674849730184, 2.3613611608743668",Paris,75056,0.5625,6
28001,Richard Wallace - Place du 8 Mai 1945,OUI,29,12,17,15,2,OUI,OUI,2025-03-13 05:59:47+00:00,"48.87866794788021, 2.2420343756675725",Puteaux,92062,0.5862068965517241,6
19005,Flandre - Riquet,OUI,19,12,7,5,2,OUI,OUI,2025-03-13 05:59:59+00:00,"48.888013281448, 2.3737595955229",Paris,75056,0.3684210526315789,6
26007,Square Gilbert Thomain,OUI,19,12,7,2,5,OUI,OUI,2025-03-13 05:59:27+00:00,"48.90717373809284, 2.2695400938391685",Asnières-sur-Seine,92004,0.3684210526315789,6
41606,Pasteur - Gambetta,OUI,18,9,9,1,8,OUI,OUI,2025-03-13 05:52:51+00:00,"48.84572797384512, 2.4236011505126953",Saint-Mandé,94067,0.5,6
16111,Faustin Hélie - Desbordes-Valmore,OUI,27,24,3,1,2,OUI,OUI,2025-03-13 06:00:21+00:00,"48.859403, 2.276522",Paris,75056,0.1111111111111111,6
17011,Fragonard - Porte de Clichy,OUI,54,17,37,32,5,OUI,OUI,2025-03-13 06:00:23+00:00,"48.894155633419, 2.3143893107772",Paris,75056,0.6851851851851852,6
15025,Dupleix - du Guesclin,OUI,46,5,41,37,4,OUI,OUI,2025-03-13 05:57:58+00:00,"48.85147910413369, 2.296709530055523",Paris,75056,0.8913043478260869,6
17045,Place des Ternes.,OUI,45,40,5,1,4,OUI,OUI,2025-03-13 06:00:28+00:00,"48.878438631226516, 2.297727763652802",Paris,75056,0.1111111111111111,6
10113,Parmentier - Hôpital Saint-Louis,OUI,38,27,11,9,2,OUI,OUI,2025-03-13 06:00:28+00:00,"48.871379874257, 2.3698963836667",Paris,75056,0.2894736842105263,6
33018,Edouard Poisson - Victor Hugo,OUI,26,6,20,7,13,OUI,OUI,2025-03-13 06:00:18+00:00,"48.91118557052621, 2.379864752692811",Aubervilliers,93001,0.7692307692307693,6
43402,Place de Verdun,OUI,40,19,21,17,4,OUI,OUI,2025-03-13 05:59:08+00:00,"48.8202823, 2.473775",Joinville-le-Pont,94042,0.525,6
6013,Jacques Callot - Mazarine,OUI,27,3,24,24,0,OUI,OUI,2025-03-13 06:00:38+00:00,"48.855280175332, 2.3375743255019",Paris,75056,0.8888888888888888,6
12013,Montgallet - Reuilly,OUI,14,1,13,8,5,OUI,OUI,2025-03-13 06:00:09+00:00,"48.844291, 2.3896481",Paris,75056,0.9285714285714286,6
8033,Commandant Rivière,OUI,40,31,9,3,6,OUI,OUI,2025-03-13 05:58:17+00:00,"48.872933, 2.309796",Paris,75056,0.225,6
21305,Place Jacques Madaule,OUI,24,4,20,19,1,OUI,OUI,2025-03-13 06:00:37+00:00,"48.823933787309, 2.2606918215752",Issy-les-Moulineaux,92040,0.8333333333333334,6
23001,Paul Vaillant Couturier - Chaptal,OUI,35,33,2,0,2,OUI,OUI,2025-03-13 05:56:17+00:00,"48.893479576183, 2.2775253653526",Levallois-Perret,92044,0.05714285714285714,6
11115,Montreuil - Gonnet,OUI,24,7,17,8,9,OUI,OUI,2025-03-13 06:01:00+00:00,"48.850500564921, 2.3890856287864",Paris,75056,0.7083333333333334,6
15010,Square Cambronne,OUI,59,18,41,38,3,OUI,OUI,2025-03-13 05:59:54+00:00,"48.84756654526, 2.3025691509247",Paris,75056,0.6949152542372882,6
7015,Varenne,OUI,44,33,11,7,4,OUI,OUI,2025-03-13 05:59:05+00:00,"48.857202661803, 2.3152771219611",Paris,75056,0.25,6
17037,Bayen - Pereire,OUI,21,6,15,5,10,OUI,OUI,2025-03-13 06:00:32+00:00,"48.881804409079656, 2.2921088710427284",Paris,75056,0.7142857142857143,6
33003,Bordier - Félix Faure,OUI,44,18,26,13,13,OUI,OUI,2025-03-13 05:59:57+00:00,"48.90390751882016, 2.3830059170722966",Aubervilliers,93001,0.5909090909090909,6
5021,Jussieu - Fossés Saint-Bernard,OUI,38,25,13,9,4,OUI,OUI,2025-03-13 05:59:23+00:00,"48.847185510023, 2.3534858599305",Paris,75056,0.34210526315789475,6
5106,Cujas - Saint-Michel,OUI,19,3,16,5,11,OUI,OUI,2025-03-13 05:52:25+00:00,"48.848191348584, 2.341831654854",Paris,75056,0.8421052631578947,6
12115,Porte de Vincennes,OUI,32,27,5,2,3,OUI,OUI,2025-03-13 05:59:26+00:00,"48.846454, 2.415514",Paris,75056,0.15625,6
22505,Mairie de La Garenne Colombes,OUI,22,8,14,14,0,OUI,OUI,2025-03-13 06:00:42+00:00,"48.90663823468682, 2.24679596722126",La Garenne-Colombes,92035,0.6363636363636364,6
16121,Jardin d'Acclimatation,OUI,30,28,2,1,1,OUI,OUI,2025-03-13 05:53:53+00:00,"48.878772242510465, 2.270772233605385",Paris,75056,0.06666666666666667,6
13045,Jean Colly - Tolbiac,OUI,34,27,7,5,2,OUI,OUI,2025-03-13 06:00:58+00:00,"48.827817291597846, 2.3705490678548813",Paris,75056,0.20588235294117646,6
41102,Gare de Laplace,OUI,43,31,12,7,5,OUI,OUI,2025-03-13 05:58:05+00:00,"48.80893199114179, 2.3349460959434514",Arcueil,94003,0.27906976744186046,6
19115,Porte de la Villette,OUI,26,15,11,4,7,OUI,OUI,2025-03-13 05:52:50+00:00,"48.89835196548483, 2.386150136590004",Paris,75056,0.4230769230769231,6
18141,Clignancourt - Sofia,OUI,19,16,3,0,3,OUI,OUI,2025-03-13 06:01:06+00:00,"48.88511992309783, 2.34719488842051",Paris,75056,0.15789473684210525,6
14034,Ouest - Château,OUI,23,23,0,0,0,OUI,OUI,2025-03-13 06:01:03+00:00,"48.83617286014242, 2.319392143923804",Paris,75056,0.0,6
16124,Route de Sèvres - Porte de Bagatelle,OUI,65,6,59,52,7,OUI,OUI,2025-03-13 06:00:59+00:00,"48.87525984132485, 2.249415814876557",Paris,75056,0.9076923076923077,6
32010,Place aux Étoiles,OUI,37,29,8,1,7,OUI,OUI,2025-03-13 05:56:16+00:00,"48.91835629408464, 2.3523425683379173",Saint-Denis,93066,0.21621621621621623,6
33009,Félix Faure - Sadi Carnot,OUI,33,25,8,4,4,OUI,OUI,2025-03-13 05:54:51+00:00,"48.90812110228388, 2.378623187541962",Aubervilliers,93001,0.24242424242424243,6
16018,Flandrin - Henri Martin,OUI,18,15,3,0,3,OUI,OUI,2025-03-13 05:59:14+00:00,"48.8643275, 2.2724174",Paris,75056,0.16666666666666666,6
25005,18 juin 1940 - Buzenval,OUI,25,11,14,5,9,OUI,OUI,2025-03-13 05:58:47+00:00,"48.868807, 2.185428",Rueil-Malmaison,92063,0.56,6
25008,Place du 8 Mai 1945,OUI,18,12,6,5,1,OUI,OUI,2025-03-13 05:59:11+00:00,"48.871552174017, 2.2025031970585",Rueil-Malmaison,92063,0.3333333333333333,6
12034,Pirogues de Bercy - Libourne,OUI,48,44,4,1,3,OUI,OUI,2025-03-13 05:55:20+00:00,"48.832308, 2.38637",Paris,75056,0.08333333333333333,6
24002,Gare de Courbevoie,OUI,32,21,11,8,3,OUI,OUI,2025-03-13 05:52:59+00:00,"48.8993867, 2.2506506",Courbevoie,92026,0.34375,6
15033,Place Violet,OUI,29,0,29,27,2,OUI,OUI,2025-03-13 05:59:32+00:00,"48.84487893836502, 2.2905756533145905",Paris,75056,1.0,6
33001,Victor Hugo - Magasins Généraux,OUI,34,32,2,1,1,OUI,OUI,2025-03-13 05:54:32+00:00,"48.903281401126755, 2.368072383105755",Aubervilliers,93001,0.058823529411764705,6
19044,Grands Moulins de Pantin,OUI,50,47,3,1,2,OUI,OUI,2025-03-13 06:00:39+00:00,"48.89738369720229, 2.3959985375404362",Paris,75056,0.06,6
16034,Porte d'Auteuil,OUI,32,30,2,0,2,OUI,OUI,2025-03-13 06:00:43+00:00,"48.8479394142243, 2.2608396783471107",Paris,75056,0.0625,6
41404,Carnot - Pâquerettes,OUI,24,3,21,18,3,OUI,OUI,2025-03-13 06:00:22+00:00,"48.79592939432515, 2.4261841177940373",Alfortville,94002,0.875,6
7009,Assemblée Nationale,OUI,72,58,14,9,5,OUI,OUI,2025-03-13 05:59:02+00:00,"48.861411014652, 2.3201214185208",Paris,75056,0.19444444444444445,6
8055,Courcelles - Place des Ternes,OUI,28,24,4,2,2,OUI,OUI,2025-03-13 06:00:28+00:00,"48.878199928923124, 2.2992860188665043",Paris,75056,0.14285714285714285,6
15122,Place Charles Vallin,OUI,27,15,12,9,3,OUI,OUI,2025-03-13 05:59:04+00:00,"48.835523812041, 2.3025986552238",Paris,75056,0.4444444444444444,6
21502,Verdun - Place Henri IV,OUI,26,12,14,11,3,OUI,OUI,2025-03-13 06:00:51+00:00,"48.870797375639214, 2.2277003154158592",Suresnes,92073,0.5384615384615384,6
20132,Réunion - Avron,OUI,26,23,3,2,1,OUI,OUI,2025-03-13 06:00:25+00:00,"48.852566752033766, 2.403928068708116",Paris,75056,0.11538461538461539,6
16129,Ceinture du Lac Inferieure - Saint-Cloud,OUI,41,39,2,0,2,OUI,OUI,2025-03-13 05:59:54+00:00,"48.86218070933143, 2.2617871686816216",Paris,75056,0.04878048780487805,6
42707,Place Jean-Baptiste Clément,OUI,24,18,6,1,5,OUI,OUI,2025-03-13 05:59:54+00:00,"48.81240466867336, 2.3617091774940495",Le Kremlin-Bicêtre,94043,0.25,6
35019,Anatole France - Jean Lolive,OUI,27,10,17,3,14,OUI,OUI,2025-03-13 05:58:13+00:00,"48.8949922, 2.4253764",Pantin,93055,0.6296296296296297,6
92003,Chanzy - Sud-Est,OUI,25,22,3,3,0,OUI,OUI,2025-03-13 06:00:18+00:00,"48.888912037698766, 2.195632159709931",Nanterre,92050,0.12,6
20113,Piat - Parc de Belleville,OUI,20,17,3,0,3,OUI,OUI,2025-03-13 05:59:56+00:00,"48.87195626635528, 2.384981390278095",Paris,75056,0.15,6
5119,Jussieu - Guy de la Brosse,OUI,40,35,5,2,3,OUI,OUI,2025-03-13 05:52:13+00:00,"48.845665, 2.355653",Paris,75056,0.125,6
20119,Square des Saint-Simoniens,OUI,25,25,0,0,0,OUI,OUI,2025-03-13 05:54:52+00:00,"48.8701796, 2.3967273",Paris,75056,0.0,6
35009,Jean Lolive - Parc Stalingrad,OUI,22,12,10,3,7,OUI,OUI,2025-03-13 05:55:53+00:00,"48.89206174403158, 2.4091735482215886",Pantin,93055,0.45454545454545453,6
31705,Champeaux - Gallieni,OUI,47,34,13,1,12,OUI,OUI,2025-03-13 05:49:57+00:00,"48.864459134684644, 2.4161778017878532",Bagnolet,93006,0.2765957446808511,6
19019,Petit - Manin,OUI,22,22,0,0,0,NON,NON,2025-03-13 05:53:06+00:00,"48.886506875343, 2.3938155401308",Paris,75056,0.0,6
6030,Assas - Vaugirard,OUI,34,27,7,1,6,OUI,OUI,2025-03-13 05:56:35+00:00,"48.848274111398, 2.3292413726449",Paris,75056,0.20588235294117646,6
27002,Parc Pierre Lagravère,OUI,30,12,18,7,11,OUI,OUI,2025-03-13 05:59:17+00:00,"48.92650488131725, 2.239069678491417",Colombes,92025,0.6,6
23802,Raymond Poincaré - Allée de la Marche,OUI,22,16,6,6,0,OUI,OUI,2025-03-13 05:54:25+00:00,"48.838634069623, 2.1724102640451",Garches,92033,0.2727272727272727,6
21109,Guichet - Jean Jaurès,OUI,23,11,12,7,5,OUI,OUI,2025-03-13 05:58:01+00:00,"48.905169868129036, 2.3023840785026555",Clichy,92024,0.5217391304347826,6
12126,Gravelle - Route du Bac,OUI,51,21,30,17,13,OUI,OUI,2025-03-13 05:59:41+00:00,"48.824407, 2.418455",Paris,75056,0.5882352941176471,6
23701,Parvis Robert Schuman - Roger Salengro,OUI,24,8,16,5,11,OUI,OUI,2025-03-13 05:55:47+00:00,"48.812657470558754, 2.1921751275658607",Chaville,92022,0.6666666666666666,6
20036,Ménilmontant - Pelleport,OUI,31,31,0,0,0,OUI,OUI,2025-03-13 06:00:05+00:00,"48.870682633845, 2.3989596023316",Paris,75056,0.0,6
17007,Navier - Epinettes,OUI,36,14,22,5,17,OUI,OUI,2025-03-13 05:59:37+00:00,"48.89587780769155, 2.3226776719093327",Paris,75056,0.6111111111111112,6
26001,Gare d'Asnières sur Seine,OUI,21,5,16,9,7,OUI,OUI,2025-03-13 05:59:01+00:00,"48.90636459217474, 2.2835066914558415",Asnières-sur-Seine,92004,0.7619047619047619,6
31012,Place Carnot,OUI,23,10,13,5,8,OUI,OUI,2025-03-13 05:59:06+00:00,"48.85593932186797, 2.441531717777252",Montreuil,93048,0.5652173913043478,6
92004,Nanterre - Université,OUI,19,7,12,7,5,OUI,OUI,2025-03-13 05:52:08+00:00,"48.901365, 2.212693",Nanterre,92050,0.631578947368421,6
12024,Gare de Bercy,OUI,35,14,21,18,3,OUI,OUI,2025-03-13 05:57:10+00:00,"48.839794573906, 2.3826066032052",Paris,75056,0.6,6
18020,Francoeur - Marcadet,OUI,19,13,6,0,6,OUI,OUI,2025-03-13 06:00:59+00:00,"48.89104123261663, 2.340014585442034",Paris,75056,0.3157894736842105,6
14104,Boyer-Barret - Raymond Losserand,OUI,22,22,0,0,0,OUI,OUI,2025-03-13 05:58:58+00:00,"48.83329880233322, 2.3173383995890617",Paris,75056,0.0,6
20136,Henri Chevreau - Couronnes,OUI,26,23,3,0,3,OUI,OUI,2025-03-13 05:59:27+00:00,"48.87033205312931, 2.388777695596218",Paris,75056,0.11538461538461539,6
41604,Lagny - Joffre,OUI,30,24,6,3,3,OUI,OUI,2025-03-13 05:55:43+00:00,"48.84930687084088, 2.417949736118317",Saint-Mandé,94067,0.2,6
43006,Vignerons - Minimes,OUI,29,22,7,4,3,OUI,OUI,2025-03-13 06:00:55+00:00,"48.841486, 2.430793",Vincennes,94080,0.2413793103448276,6
15017,Place Falguière,OUI,22,8,14,0,14,OUI,OUI,2025-03-13 05:58:42+00:00,"48.83629973941847, 2.3104464635252953",Paris,75056,0.6363636363636364,6
5002,Sommerard - Saint-Jacques,OUI,34,22,12,5,7,OUI,OUI,2025-03-13 05:54:56+00:00,"48.850310432924466, 2.345015835298588",Paris,75056,0.35294117647058826,6
15029,Emeriau - Place de Brazzaville,OUI,49,19,30,27,3,OUI,OUI,2025-03-13 06:00:39+00:00,"48.850785261674964, 2.2871585190296173",Paris,75056,0.6122448979591837,6
14018,Porte d'Orléans,OUI,45,41,4,2,2,OUI,OUI,2025-03-13 05:57:45+00:00,"48.8227639, 2.3249313",Paris,75056,0.08888888888888889,6
17018,Parc Monceau,OUI,18,18,0,0,0,OUI,OUI,2025-03-13 06:00:59+00:00,"48.881077914129, 2.3095492646098",Paris,75056,0.0,6
31702,Pierre et Marie Curie - Julien Grimau,OUI,18,15,3,0,3,OUI,OUI,2025-03-13 05:59:46+00:00,"48.870714014863225, 2.424097023904324",Bagnolet,93006,0.16666666666666666,6
18005,Tardieu - Chappe,OUI,16,16,0,0,0,OUI,OUI,2025-03-13 05:58:28+00:00,"48.884146759782, 2.341845408082",Paris,75056,0.0,6
42503,Vladimir Ilitch Lénine - Andrée Chedid,OUI,31,23,8,4,4,OUI,OUI,2025-03-13 05:59:40+00:00,"48.813240124373, 2.3319716067039",Gentilly,94037,0.25806451612903225,6
10005,Petites Ecuries - Faubourg Poissonnière,OUI,15,3,12,9,3,OUI,OUI,2025-03-13 06:00:55+00:00,"48.87397217237368, 2.348388757504776",Paris,75056,0.8,6
7014,Saint-François-Xavier,OUI,42,39,3,1,2,OUI,OUI,2025-03-13 05:59:21+00:00,"48.85154484769, 2.3146149516106",Paris,75056,0.07142857142857142,6
5026,Pascal - Claude Bernard,OUI,46,11,35,29,6,OUI,OUI,2025-03-13 05:59:20+00:00,"48.839061952159746, 2.3499782010912895",Paris,75056,0.7608695652173914,6
20040,Parc de Belleville - Julien Lacroix,OUI,26,19,7,4,3,OUI,OUI,2025-03-13 06:00:22+00:00,"48.8703459, 2.3842214",Paris,75056,0.2692307692307692,6
15028,Grenelle - Dr Finlay,OUI,70,23,47,44,3,OUI,OUI,2025-03-13 06:00:50+00:00,"48.851315406715976, 2.2919502854347233",Paris,75056,0.6714285714285714,6
17017,Gare de Pont-Cardinet,OUI,30,10,20,11,9,OUI,OUI,2025-03-13 05:56:53+00:00,"48.88713901475306, 2.314494143994255",Paris,75056,0.6666666666666666,6
8102,Lamennais - Washington,OUI,25,23,2,0,2,OUI,OUI,2025-03-13 06:00:18+00:00,"48.87352990026496, 2.303444892168045",Paris,75056,0.08,6
34002,Capitaine Glarner - Gabriel Péri,OUI,23,7,16,15,1,OUI,OUI,2025-03-13 05:59:14+00:00,"48.902449900418745, 2.3304807533425724",Saint-Ouen-sur-Seine,93070,0.6956521739130435,6
7004,Raspail - Varenne,OUI,17,11,6,4,2,OUI,OUI,2025-03-13 05:58:34+00:00,"48.853147816545, 2.3263905197382",Paris,75056,0.35294117647058826,6
13102,Pitié-Salpêtrière,OUI,50,37,13,9,4,OUI,OUI,2025-03-13 06:00:22+00:00,"48.83748810318667, 2.365213818848133",Paris,75056,0.26,6
21013,Pierre Grenier - Pont de Billancourt,OUI,21,7,14,13,1,OUI,OUI,2025-03-13 05:59:39+00:00,"48.8258020742942, 2.2487989068031315",Boulogne-Billancourt,92012,0.6666666666666666,6
11101,Charles Delescluze,OUI,48,6,42,40,2,OUI,OUI,2025-03-13 06:00:52+00:00,"48.85242200848887, 2.380632497370243",Paris,75056,0.875,6
21111,Professeur René Leriche - Général Leclerc,OUI,50,12,38,21,17,OUI,OUI,2025-03-13 05:58:31+00:00,"48.90782845483013, 2.307887971401215",Clichy,92024,0.76,6
15055,Vasco de Gama,OUI,53,14,39,37,2,OUI,OUI,2025-03-13 05:59:55+00:00,"48.83671783466264, 2.283664085650799",Paris,75056,0.7358490566037735,6
2010,Uzès - Montmartre,OUI,26,22,4,2,2,OUI,OUI,2025-03-13 05:56:15+00:00,"48.870790980240706, 2.3431010171771054",Paris,75056,0.15384615384615385,6
12011,Charenton - Place du Col Bourgoin,OUI,35,9,26,24,2,OUI,OUI,2025-03-13 06:00:04+00:00,"48.844867319554, 2.3825789350545",Paris,75056,0.7428571428571429,6
11114,Ledru-Rollin - Charonne,OUI,31,17,14,12,2,OUI,OUI,2025-03-13 06:01:04+00:00,"48.85345855607243, 2.3772463581947094",Paris,75056,0.45161290322580644,6
21308,Bara - Henri Farman,OUI,58,40,18,16,2,OUI,OUI,2025-03-13 05:58:35+00:00,"48.833218027457846, 2.2677567601203923",Issy-les-Moulineaux,92040,0.3103448275862069,6
5116,Place Valhubert,OUI,49,5,44,41,3,OUI,OUI,2025-03-13 05:58:00+00:00,"48.844182577315, 2.3640366643667",Paris,75056,0.8979591836734694,6
19037,Belleville - Porte des Lilas,OUI,29,26,3,1,2,OUI,OUI,2025-03-13 05:51:25+00:00,"48.87660391892763, 2.404769691129476",Paris,75056,0.10344827586206896,6
7006,Quai Voltaire,OUI,32,7,25,22,3,OUI,OUI,2025-03-13 05:59:22+00:00,"48.858942986179, 2.3314182047146",Paris,75056,0.78125,6
6018,Michelet - Assas,OUI,16,13,3,0,3,OUI,OUI,2025-03-13 05:59:16+00:00,"48.842741502832, 2.3350211977959",Paris,75056,0.1875,6
8012,Batignolles - Place de Clichy,OUI,46,37,9,2,7,OUI,OUI,2025-03-13 06:00:23+00:00,"48.883474535757, 2.326493114233",Paris,75056,0.1956521739130435,6
21019,Edouard Vaillant - Paul-Adolphe Souriau,OUI,26,8,18,14,4,OUI,OUI,2025-03-13 05:58:02+00:00,"48.834845858829, 2.2479459643364",Boulogne-Billancourt,92012,0.6923076923076923,6
10023,Gare de l'Est - Verdun,OUI,13,12,1,1,0,OUI,OUI,2025-03-13 06:00:58+00:00,"48.876156054271, 2.3609149083206",Paris,75056,0.07692307692307693,6
21105,Morice - Général Leclerc,OUI,25,3,22,20,2,OUI,OUI,2025-03-13 06:00:59+00:00,"48.90245471981591, 2.3128929734230046",Clichy,92024,0.88,6
13026,Place Jean Delay,OUI,34,16,18,9,9,OUI,OUI,2025-03-13 06:00:22+00:00,"48.823316, 2.354336",Paris,75056,0.5294117647058824,6
19109,Tanger - Place du Maroc,OUI,17,11,6,2,4,OUI,OUI,2025-03-13 05:52:52+00:00,"48.8862524447104, 2.3689296841621403",Paris,75056,0.35294117647058826,6
23002,Pont de Levallois-bécon,OUI,49,24,25,9,16,OUI,OUI,2025-03-13 06:00:18+00:00,"48.8984179, 2.2791311",Levallois-Perret,92044,0.5102040816326531,6
31019,Vincennes - Douy-Delcupe,OUI,37,31,6,4,2,OUI,OUI,2025-03-13 05:55:23+00:00,"48.85493692155721, 2.436049282550812",Montreuil,93048,0.16216216216216217,6
14139,Pierre Larousse - Raymond Losserand,OUI,29,10,19,7,12,OUI,OUI,2025-03-13 05:55:25+00:00,"48.83059564231877, 2.3119183257222176",Paris,75056,0.6551724137931034,6
17124,Porte de Saint-Ouen - Henri Huchard,OUI,26,13,13,4,9,OUI,OUI,2025-03-13 06:00:30+00:00,"48.898708366365064, 2.3295360803604126",Paris,75056,0.5,6
14130,Jonquoy - Didot,OUI,30,26,4,0,4,OUI,OUI,2025-03-13 06:00:42+00:00,"48.82890454823947, 2.31648076325655",Paris,75056,0.13333333333333333,6
44012,Génie - Mozart,OUI,18,12,6,2,4,OUI,OUI,2025-03-13 05:59:27+00:00,"48.794902381218904, 2.3734183609485626",Vitry-sur-Seine,94081,0.3333333333333333,6
10015,Lucien Sampaix - Récollets,OUI,41,32,9,8,1,OUI,OUI,2025-03-13 05:56:26+00:00,"48.874330377560476, 2.3621229082345963",Paris,75056,0.21951219512195122,6
17027,Place du Maréchal Juin - Péreire,OUI,44,30,14,12,2,OUI,OUI,2025-03-13 06:00:03+00:00,"48.885263, 2.298286",Paris,75056,0.3181818181818182,6
41207,Place du Général de Gaulle,OUI,28,22,6,1,5,OUI,OUI,2025-03-13 05:56:10+00:00,"48.8525288, 2.4877332",Fontenay-sous-Bois,94033,0.21428571428571427,6
31016,Lucie Aubrac - Franklin,OUI,35,30,5,2,3,OUI,OUI,2025-03-13 05:53:05+00:00,"48.86223916006812, 2.4435862898826604",Montreuil,93048,0.14285714285714285,6
12032,Porte Dorée,OUI,35,17,18,10,8,OUI,OUI,2025-03-13 06:00:29+00:00,"48.8354337, 2.4077132",Paris,75056,0.5142857142857142,6
22101,Gare Routière de Saint Cloud,OUI,29,17,12,7,5,OUI,OUI,2025-03-13 06:01:03+00:00,"48.84288183896324, 2.222245037555695",Saint-Cloud,92064,0.41379310344827586,6
6103,Mézières - Rennes,OUI,53,44,9,4,5,OUI,OUI,2025-03-13 05:55:27+00:00,"48.85023459321703, 2.3303819820284843",Paris,75056,0.16981132075471697,6
13043,Dunois - Clisson,OUI,51,38,13,9,4,OUI,OUI,2025-03-13 05:59:38+00:00,"48.832294, 2.3674523",Paris,75056,0.2549019607843137,6
15038,Place Adolphe Cherioux - Vaugirard,OUI,61,35,26,24,2,OUI,OUI,2025-03-13 06:00:47+00:00,"48.83959442800459, 2.3010657727718353",Paris,75056,0.4262295081967213,6
8051,Batignolles - Rome,OUI,12,3,9,3,6,OUI,OUI,2025-03-13 05:54:59+00:00,"48.881823370566806, 2.3202589899301524",Paris,75056,0.75,6
21032,Sèvres-Gallieni,OUI,25,14,11,6,5,OUI,OUI,2025-03-13 05:57:46+00:00,"48.837809408957, 2.2281519323587",Boulogne-Billancourt,92012,0.44,6
44102,Verdun - Adrien Damalix,OUI,26,3,23,8,15,OUI,OUI,2025-03-13 06:01:03+00:00,"48.8222334178559, 2.4215328320860863",Saint-Maurice,94069,0.8846153846153846,6
20021,Indre - Prairies,OUI,38,31,7,3,4,OUI,OUI,2025-03-13 06:00:37+00:00,"48.86254398506782, 2.403290458023548",Paris,75056,0.18421052631578946,6
16032,Eglise d'Auteuil,OUI,20,7,13,6,7,OUI,OUI,2025-03-13 05:55:57+00:00,"48.84749841771691, 2.26848387135299",Paris,75056,0.65,6
7005,Raspail - Bac,OUI,51,46,5,3,2,OUI,OUI,2025-03-13 05:57:55+00:00,"48.855628721101, 2.3256602883339",Paris,75056,0.09803921568627451,6
14122,Colonel Monteil - Brune,OUI,19,18,1,1,0,OUI,OUI,2025-03-13 05:53:49+00:00,"48.82650293311, 2.3092747998272",Paris,75056,0.05263157894736842,6
32014,Place du Cornillon - Stade de France,OUI,33,22,11,3,8,OUI,OUI,2025-03-13 05:54:57+00:00,"48.92540695835961, 2.3644426837563515",Saint-Denis,93066,0.3333333333333333,6
16123,Mahatma Gandhi,OUI,24,7,17,11,6,OUI,OUI,2025-03-13 05:56:50+00:00,"48.876356, 2.264205",Paris,75056,0.7083333333333334,6
18032,Porte de Clignancourt.,OUI,54,50,4,2,2,OUI,OUI,2025-03-13 05:51:46+00:00,"48.897488, 2.343996",Paris,75056,0.07407407407407407,6
31007,Paris - Désiré Préaux,OUI,44,41,3,1,2,OUI,OUI,2025-03-13 05:59:36+00:00,"48.85742876694898, 2.4323049187660217",Montreuil,93048,0.06818181818181818,6
51003,Hôtel de Ville d'Argenteuil,OUI,29,10,19,12,7,OUI,OUI,2025-03-13 05:58:29+00:00,"48.946504, 2.2496396",Argenteuil,95018,0.6551724137931034,6
41204,République - Danton,OUI,19,19,0,0,0,OUI,OUI,2025-03-13 05:58:35+00:00,"48.85249172181667, 2.462034523487091",Fontenay-sous-Bois,94033,0.0,6
13016,Primo Levi - Frigos,OUI,32,30,2,1,1,OUI,OUI,2025-03-13 05:52:43+00:00,"48.83094844846017, 2.37965351592796",Paris,75056,0.0625,6
18109,Pajol - Riquet,OUI,45,16,29,15,14,OUI,OUI,2025-03-13 05:59:57+00:00,"48.88960028134536, 2.3628534749150276",Paris,75056,0.6444444444444445,6
2009,Filles Saint-Thomas - Place de la Bourse,OUI,58,51,7,4,3,OUI,OUI,2025-03-13 05:58:54+00:00,"48.868899890853, 2.3397543845203",Paris,75056,0.1206896551724138,6
19038,Lassus - Delouvain,OUI,19,18,1,0,1,OUI,OUI,2025-03-13 05:58:11+00:00,"48.8755044846, 2.3890327325519",Paris,75056,0.05263157894736842,6
9115,Milton - Manuel,OUI,21,17,4,2,2,OUI,OUI,2025-03-13 05:53:37+00:00,"48.878249, 2.341181",Paris,75056,0.19047619047619047,6
35017,Toffier Decaux - Cartier Bresson,OUI,17,11,6,1,5,OUI,OUI,2025-03-13 06:00:06+00:00,"48.90165072551549, 2.4017545580863957",Pantin,93055,0.35294117647058826,6
19039,Edouard Pailleron - Simon Bolivar,OUI,23,15,8,3,5,OUI,OUI,2025-03-13 05:58:24+00:00,"48.87979886049996, 2.374839261174202",Paris,75056,0.34782608695652173,6
20118,Orteaux - Mouraud,OUI,24,15,9,4,5,OUI,OUI,2025-03-13 05:59:36+00:00,"48.85558642847872, 2.408762907764669",Paris,75056,0.375,6
21003,Jean Jaurès - Jean Baptiste Clément,OUI,39,1,38,18,20,OUI,OUI,2025-03-13 05:59:18+00:00,"48.84576261454011, 2.2369650006294255",Boulogne-Billancourt,92012,0.9743589743589743,6
9031,Provence - Chaussée d'Antin,OUI,25,19,6,5,1,OUI,OUI,2025-03-13 05:49:46+00:00,"48.87428447542072, 2.332976511564311",Paris,75056,0.24,6
22001,Château - Bineau,OUI,20,18,2,1,1,OUI,OUI,2025-03-13 05:58:34+00:00,"48.890404028589806, 2.270106375217438",Neuilly-sur-Seine,92051,0.1,6
9117,Bellefond - Maubeuge,OUI,28,22,6,5,1,OUI,OUI,2025-03-13 06:00:47+00:00,"48.878255397645, 2.3452642187476",Paris,75056,0.21428571428571427,6
18025,Mairie du 18ème,OUI,38,34,4,1,3,OUI,OUI,2025-03-13 06:00:48+00:00,"48.892939296937605, 2.3445510864257812",Paris,75056,0.10526315789473684,6
15035,Place Etienne Pernet,OUI,43,1,42,36,6,OUI,OUI,2025-03-13 06:00:57+00:00,"48.84243457133779, 2.2921819612383847",Paris,75056,0.9767441860465116,6
17122,Bridaine - Lamandé,OUI,28,24,4,1,3,OUI,OUI,2025-03-13 05:57:23+00:00,"48.8862074, 2.3206239",Paris,75056,0.14285714285714285,6
18049,Porte d'Aubervilliers,OUI,52,48,4,1,3,OUI,OUI,2025-03-13 05:57:49+00:00,"48.89859661942376, 2.3689722642302513",Paris,75056,0.07692307692307693,6
20027,Porte de Ménilmontant,OUI,14,13,1,0,1,OUI,OUI,2025-03-13 05:54:49+00:00,"48.8691543609174, 2.40932246879487",Paris,75056,0.07142857142857142,6
18113,Lepic - Armée d'Orient,OUI,24,23,1,0,1,OUI,OUI,2025-03-13 06:00:06+00:00,"48.887536403814, 2.3343077301979",Paris,75056,0.041666666666666664,6
9023,Laffitte - Italiens,OUI,29,20,9,3,6,OUI,OUI,2025-03-13 05:57:02+00:00,"48.871815737396, 2.3372015478451",Paris,75056,0.3103448275862069,6
31703,Sadi Carnot - François Mitterrand,OUI,26,26,0,0,0,OUI,OUI,2025-03-13 05:56:38+00:00,"48.87532687671517, 2.4241617321968083",Bagnolet,93006,0.0,6
15108,Lourmel - Marie Skobtsov,OUI,22,12,10,9,1,OUI,OUI,2025-03-13 06:01:03+00:00,"48.844974, 2.287283",Paris,75056,0.45454545454545453,6
35003,Gabrielle Josserand - Edouard Vaillant,OUI,24,9,15,9,6,OUI,OUI,2025-03-13 05:58:22+00:00,"48.90271566255436, 2.3933270573616032",Pantin,93055,0.625,6
19040,Belleville - Télégraphe,OUI,40,39,1,0,1,OUI,OUI,2025-03-13 06:00:53+00:00,"48.8756045, 2.3995549",Paris,75056,0.025,6
21014,Hameau Fleuri - Marché,OUI,21,17,4,2,2,OUI,OUI,2025-03-13 05:59:42+00:00,"48.831448892608314, 2.2412404417991643",Boulogne-Billancourt,92012,0.19047619047619047,6
17047,Courcelles - Pierre Demours,OUI,25,12,13,12,1,OUI,OUI,2025-03-13 06:00:20+00:00,"48.883769733273496, 2.29858466343129",Paris,75056,0.52,6
5121,Square René Viviani - Montebello,OUI,32,8,24,23,1,OUI,OUI,2025-03-13 06:00:28+00:00,"48.851904891406, 2.3478421568871",Paris,75056,0.75,6
6016,Danton - Serpente,OUI,21,13,8,7,1,OUI,OUI,2025-03-13 05:58:51+00:00,"48.852297362582, 2.3414132371545",Paris,75056,0.38095238095238093,6
47005,Ecole Vétérinaire,OUI,35,13,22,15,7,OUI,OUI,2025-03-13 06:00:20+00:00,"48.81488859822486, 2.4224362157778994",Maisons-Alfort,94046,0.6285714285714286,6
17046,Mac-Mahon - Brey,OUI,25,21,4,2,2,OUI,OUI,2025-03-13 05:57:01+00:00,"48.877532084130166, 2.294512536052928",Paris,75056,0.16,6
19127,Aubervilliers - Curial,OUI,23,21,2,0,2,OUI,OUI,2025-03-13 06:00:46+00:00,"48.89088305227546, 2.3688579350709915",Paris,75056,0.08695652173913043,6
17121,Square des Epinettes,OUI,20,8,12,6,6,OUI,OUI,2025-03-13 05:59:43+00:00,"48.89383909781389, 2.325953990221024",Paris,75056,0.6,6
47004,Stade Auguste Delaune,OUI,21,2,19,18,1,OUI,OUI,2025-03-13 06:01:03+00:00,"48.80896378683884, 2.4345204234123234",Maisons-Alfort,94046,0.9047619047619048,6
19009,Cité des Sciences et de l'Industrie,OUI,28,19,9,1,8,OUI,OUI,2025-03-13 05:59:36+00:00,"48.89659571178903, 2.384599149227142",Paris,75056,0.32142857142857145,6
18033,Belliard - Damrémont,OUI,34,19,15,14,1,OUI,OUI,2025-03-13 06:01:00+00:00,"48.89669238777841, 2.338023450388167",Paris,75056,0.4411764705882353,6
18029,Emile Blemont - Poteau,OUI,39,26,13,5,8,OUI,OUI,2025-03-13 06:00:26+00:00,"48.8943782, 2.3415122",Paris,75056,0.3333333333333333,6
11010,Boulets - Faubourg Saint-Antoine,OUI,42,22,20,7,13,OUI,OUI,2025-03-13 05:56:25+00:00,"48.849259262115, 2.3917546141943",Paris,75056,0.47619047619047616,6
21703,Square du Carrefour de l'Insurrection,OUI,20,15,5,3,2,OUI,OUI,2025-03-13 06:00:50+00:00,"48.820864559770676, 2.291113436222077",Vanves,92075,0.25,6
15002,Maine - Antoine Bourdelle,OUI,17,16,1,1,0,OUI,OUI,2025-03-13 05:56:50+00:00,"48.84308531746595, 2.320263946784738",Paris,75056,0.058823529411764705,6
16021,François Ponsard - La Muette,OUI,23,22,1,0,1,OUI,OUI,2025-03-13 05:53:43+00:00,"48.8583666, 2.2744515",Paris,75056,0.043478260869565216,6
21310,Kléber - Gouverneur Général Eboué,OUI,21,9,12,11,1,OUI,OUI,2025-03-13 05:59:50+00:00,"48.826885843069796, 2.2723413258790965",Issy-les-Moulineaux,92040,0.5714285714285714,6
20023,Pelleport - Belgrand,OUI,14,12,2,0,2,OUI,OUI,2025-03-13 05:51:43+00:00,"48.86500081847653, 2.403980836377493",Paris,75056,0.14285714285714285,6
23007,Président Wilson - Jean Jaures,OUI,24,19,5,5,0,OUI,OUI,2025-03-13 05:56:47+00:00,"48.89034054052266, 2.2920683026313786",Levallois-Perret,92044,0.20833333333333334,6
14002,Edgar Quinet - Raspail,OUI,44,19,25,18,7,OUI,OUI,2025-03-13 05:56:33+00:00,"48.83940266673835, 2.32971478253603",Paris,75056,0.5681818181818182,6
32015,Gare RER de Saint-Denis,OUI,37,26,11,9,2,OUI,OUI,2025-03-13 06:01:00+00:00,"48.93554324248177, 2.3471488058567047",Saint-Denis,93066,0.2972972972972973,6
10020,Chabrol - d'Hauteville,OUI,10,4,6,5,1,OUI,OUI,2025-03-13 05:59:32+00:00,"48.877018388033, 2.3513179644942",Paris,75056,0.6,6
16043,Place de Passy,OUI,12,7,5,3,2,OUI,OUI,2025-03-13 05:57:10+00:00,"48.85780291711202, 2.277500546942199",Paris,75056,0.4166666666666667,6
20116,Haies - Réunion,OUI,20,17,3,0,3,OUI,OUI,2025-03-13 06:00:22+00:00,"48.85386896766491, 2.402426162238911",Paris,75056,0.15,6
11041,Square Saint-Ambroise,OUI,40,5,35,32,3,OUI,OUI,2025-03-13 06:00:19+00:00,"48.860934, 2.375841",Paris,75056,0.875,6
42004,Westermeyer - Paul Vaillant-Couturier,OUI,27,0,27,20,7,OUI,OUI,2025-03-13 06:01:03+00:00,"48.819116181578764, 2.3966637253761296",Ivry-sur-Seine,94041,1.0,6
15031,Théâtre - Lourmel,OUI,51,26,25,25,0,OUI,OUI,2025-03-13 05:59:06+00:00,"48.8482070397636, 2.2898658737540245",Paris,75056,0.49019607843137253,6
6107,Place Alphonse Deville,OUI,22,22,0,0,0,OUI,OUI,2025-03-13 05:57:23+00:00,"48.850188262662, 2.3275961726904",Paris,75056,0.0,6
11006,Ledru-Rollin - Place du Père Chaillet,OUI,35,13,22,22,0,OUI,OUI,2025-03-13 05:58:56+00:00,"48.856433706943704, 2.379020587761426",Paris,75056,0.6285714285714286,6
16029,Maison de Radio - France,OUI,42,1,41,38,3,OUI,OUI,2025-03-13 06:00:47+00:00,"48.85132886434057, 2.277785539627075",Paris,75056,0.9761904761904762,6
16015,Bassano -  Iéna,OUI,15,11,4,1,3,OUI,OUI,2025-03-13 05:54:01+00:00,"48.868144510482075, 2.296149600985935",Paris,75056,0.26666666666666666,6
9017,Lallier - Trudaine,OUI,28,18,10,1,9,OUI,OUI,2025-03-13 05:56:59+00:00,"48.88109246617963, 2.3408224806189537",Paris,75056,0.35714285714285715,6
15070,Balard - Montagne de la Fage,OUI,35,8,27,23,4,OUI,OUI,2025-03-13 06:00:57+00:00,"48.83850740333351, 2.2782871127128606",Paris,75056,0.7714285714285715,6
7008,Villersexel - Saint-Germain,OUI,16,7,9,6,3,OUI,OUI,2025-03-13 06:00:06+00:00,"48.858297001218, 2.3237934708595",Paris,75056,0.5625,6
1120,Lavandieres Sainte Opportune - Rivoli,OUI,22,15,7,4,3,OUI,OUI,2025-03-13 06:01:04+00:00,"48.859279702476, 2.3466217517853",Paris,75056,0.3181818181818182,6
16112,Chernoviz - Raynouard,OUI,36,33,3,1,2,OUI,OUI,2025-03-13 05:54:50+00:00,"48.8569864146289, 2.282173218142987",Paris,75056,0.08333333333333333,6
14112,Méchain - Faubourg Saint-Jacques,OUI,15,11,4,2,2,OUI,OUI,2025-03-13 06:00:43+00:00,"48.83586772099485, 2.33798034198275",Paris,75056,0.26666666666666666,6
42703,Fontainebleau - Edmond Michelet,OUI,45,41,4,4,0,OUI,OUI,2025-03-13 05:56:28+00:00,"48.80956436844049, 2.3626908659935",Le Kremlin-Bicêtre,94043,0.08888888888888889,6
9026,Jean-Baptiste Pigalle - La Bruyere,OUI,17,17,0,0,0,OUI,OUI,2025-03-13 06:00:02+00:00,"48.87939826447722, 2.333709173337285",Paris,75056,0.0,6
14030,Pernety - Raymond Losserand,OUI,32,30,2,0,2,OUI,OUI,2025-03-13 05:52:29+00:00,"48.834254627953, 2.317609339387",Paris,75056,0.0625,6
21001,Transvaal - Charles de Gaulle,OUI,27,12,15,4,11,OUI,OUI,2025-03-13 06:00:45+00:00,"48.848280403628806, 2.2373420120857195",Boulogne-Billancourt,92012,0.5555555555555556,6
13046,Eugène Oudiné - Dessous Des Berges,OUI,44,29,15,12,3,OUI,OUI,2025-03-13 05:58:03+00:00,"48.8256423, 2.3750226",Paris,75056,0.3409090909090909,6
16122,Route de la Muette - Porte de Neuilly,OUI,49,41,8,7,1,OUI,OUI,2025-03-13 06:00:53+00:00,"48.8798926, 2.2587671",Paris,75056,0.16326530612244897,6
22102,Mont Valérien - Michel Salles,OUI,24,6,18,8,10,OUI,OUI,2025-03-13 05:56:26+00:00,"48.8561915, 2.2152966",Saint-Cloud,92064,0.75,6
20016,Pyrénées - Maraîchers,OUI,32,23,9,1,8,OUI,OUI,2025-03-13 06:00:57+00:00,"48.85714001395299, 2.4043509364128113",Paris,75056,0.28125,6
15003,Gare Montparnasse - Vaugirard,OUI,66,38,28,19,9,OUI,OUI,2025-03-13 05:58:07+00:00,"48.8418071798797, 2.31951002690117",Paris,75056,0.42424242424242425,6
10010,Place Jacques Bonsergent,OUI,32,2,30,25,5,OUI,OUI,2025-03-13 06:00:04+00:00,"48.870948218595, 2.3612049221992",Paris,75056,0.9375,6
4110,Neuve Saint-Pierre - Beautreillis,OUI,19,1,18,13,5,OUI,OUI,2025-03-13 05:59:05+00:00,"48.85355351439652, 2.3639122769236565",Paris,75056,0.9473684210526315,6
16027,Mozart - Jasmin,OUI,62,60,2,0,2,OUI,OUI,2025-03-13 05:59:49+00:00,"48.85286124871689, 2.268483570651513",Paris,75056,0.03225806451612903,6
10036,Aqueduc - Villette,OUI,22,11,11,6,5,OUI,OUI,2025-03-13 06:00:09+00:00,"48.883886063895, 2.367198803315",Paris,75056,0.5,6
8019,Naples - Rome,OUI,26,22,4,2,2,OUI,OUI,2025-03-13 05:54:03+00:00,"48.879960700846226, 2.321358695626259",Paris,75056,0.15384615384615385,6
23304,Mairie de Sceaux,OUI,33,31,2,1,1,OUI,OUI,2025-03-13 05:57:14+00:00,"48.778916905132, 2.2887361764861",Sceaux,92071,0.06060606060606061,6
18008,Square Léon,OUI,33,30,3,3,0,OUI,OUI,2025-03-13 05:58:42+00:00,"48.88667396788626, 2.353205569088459",Paris,75056,0.09090909090909091,6
6017,Sénat - Condé,OUI,32,26,6,3,3,OUI,OUI,2025-03-13 05:58:08+00:00,"48.84954227788459, 2.337939441204071",Paris,75056,0.1875,6
20201,Eugène Reisz - Davout,OUI,20,17,3,0,3,OUI,OUI,2025-03-13 05:51:17+00:00,"48.85631874632638, 2.410396970808506",Paris,75056,0.15,6
13103,Hôpital Pitié Salpêtrière,OUI,49,38,11,1,10,OUI,OUI,2025-03-13 05:57:30+00:00,"48.8377016, 2.3604946",Paris,75056,0.22448979591836735,6
6032,Sabot - Rennes,OUI,25,12,13,11,2,OUI,OUI,2025-03-13 05:55:13+00:00,"48.852575112948415, 2.331552766263485",Paris,75056,0.52,6
12161,Diderot - Reuilly,OUI,43,8,35,31,4,OUI,OUI,2025-03-13 05:58:42+00:00,"48.847208456061, 2.3861273378134",Paris,75056,0.813953488372093,6
17022,Pereire - Place de Wagram,OUI,45,43,2,2,0,OUI,OUI,2025-03-13 06:00:36+00:00,"48.887070607581215, 2.304111124531457",Paris,75056,0.044444444444444446,6
15107,Palais des Sports,OUI,21,3,18,14,4,OUI,OUI,2025-03-13 05:59:50+00:00,"48.833468517426, 2.2858720645308",Paris,75056,0.8571428571428571,6
7020,Champ de Mars - Cler,OUI,39,9,30,29,1,OUI,OUI,2025-03-13 06:00:19+00:00,"48.856691550115315, 2.306646779179573",Paris,75056,0.7692307692307693,6
9101,Cadet - La Fayette,OUI,18,11,7,7,0,OUI,OUI,2025-03-13 05:59:49+00:00,"48.875601632672, 2.3435704037547",Paris,75056,0.3888888888888889,6
18017,Caulaincourt - Place Constantin Pecqueur,OUI,43,19,24,11,13,OUI,OUI,2025-03-13 06:00:59+00:00,"48.889677905028, 2.3381787144261",Paris,75056,0.5581395348837209,6
23903,Stade Gaston Bouillant,OUI,29,14,15,3,12,OUI,OUI,2025-03-13 06:00:03+00:00,"48.939958667023, 2.3279571813836",Villeneuve-la-Garenne,92078,0.5172413793103449,6
19041,Belleville - Pyrénées,OUI,38,30,8,1,7,OUI,OUI,2025-03-13 05:59:29+00:00,"48.8741908, 2.3860039",Paris,75056,0.21052631578947367,6
31704,Jeanne Hornet - Girardot,OUI,28,27,1,0,1,OUI,OUI,2025-03-13 05:59:13+00:00,"48.873802681432146, 2.427820265293122",Bagnolet,93006,0.03571428571428571,6
11043,Place Pasdeloup,OUI,18,1,17,16,1,OUI,OUI,2025-03-13 05:59:21+00:00,"48.862654215631, 2.3670325062844",Paris,75056,0.9444444444444444,6
45001,Hôtel de Ville de Champigny sur Marne,OUI,21,2,19,8,11,OUI,OUI,2025-03-13 06:00:33+00:00,"48.813810628405, 2.5096759200096",Champigny-sur-Marne,94017,0.9047619047619048,6
1117,Pont Neuf - Rivoli,OUI,24,11,13,11,2,OUI,OUI,2025-03-13 05:57:23+00:00,"48.860089892617, 2.344057559967",Paris,75056,0.5416666666666666,6
31023,Place François Mitterand,OUI,34,31,3,3,0,OUI,OUI,2025-03-13 05:59:45+00:00,"48.86492782016328, 2.442958317697048",Montreuil,93048,0.08823529411764706,6
4010,Saint-Antoine Sévigné,OUI,27,7,20,18,2,OUI,OUI,2025-03-13 06:00:53+00:00,"48.8550222, 2.3612322",Paris,75056,0.7407407407407407,6
9118,Faubourg Poissonniere - Delta,OUI,36,29,7,3,4,OUI,OUI,2025-03-13 05:59:05+00:00,"48.882555807626765, 2.3497482016682625",Paris,75056,0.19444444444444445,6
13010,Place d'Italie - Vincent Auriol,OUI,39,7,32,13,19,OUI,OUI,2025-03-13 05:59:23+00:00,"48.831481874467, 2.3567550292319",Paris,75056,0.8205128205128205,6
19023,Manin - Simon Bolivar,OUI,24,12,12,0,12,OUI,OUI,2025-03-13 05:58:26+00:00,"48.876499654127, 2.3794073625991",Paris,75056,0.5,6
32603,Calmette,OUI,31,25,6,1,5,OUI,OUI,2025-03-13 06:00:41+00:00,"48.88104925098552, 2.424993216991425",Les Lilas,93045,0.1935483870967742,6
18137,Poissonniers - Nord,OUI,28,26,2,1,1,OUI,OUI,2025-03-13 05:59:15+00:00,"48.892511213520656, 2.3522228747606277",Paris,75056,0.07142857142857142,6
17201,Porte Maillot - Perreire,OUI,50,40,10,5,5,OUI,OUI,2025-03-13 05:58:44+00:00,"48.878021154637, 2.2842371277102",Paris,75056,0.2,6
8056,Beaujon - Wagram,OUI,28,24,4,0,4,OUI,OUI,2025-03-13 05:57:58+00:00,"48.875352455985, 2.2964416444302",Paris,75056,0.14285714285714285,6
21311,Parvis Corentin Celton,OUI,51,0,51,47,4,OUI,OUI,2025-03-13 06:00:42+00:00,"48.82747252522725, 2.2784319519996648",Issy-les-Moulineaux,92040,1.0,6
17116,Reims - Porte d'Asnières,OUI,26,23,3,1,2,OUI,OUI,2025-03-13 05:57:46+00:00,"48.891834448210986, 2.300144659954865",Paris,75056,0.11538461538461539,6
15059,Parc André Citroën,OUI,64,3,61,58,3,OUI,OUI,2025-03-13 06:00:43+00:00,"48.840639944296655, 2.2780618071556096",Paris,75056,0.953125,6
12041,Bois de Vincennes.,OUI,58,31,27,7,20,OUI,OUI,2025-03-13 06:00:31+00:00,"48.8338064, 2.4132221",Saint-Mandé,94067,0.46551724137931033,6
23403,Chateau,OUI,21,11,10,8,2,OUI,OUI,2025-03-13 05:56:24+00:00,"48.774661399959, 2.3135878035462",Bourg-la-Reine,92014,0.47619047619047616,6
7013,Duroc - Place de Breteuil,OUI,46,33,13,9,4,OUI,OUI,2025-03-13 06:00:02+00:00,"48.847460641142, 2.3126140236855",Paris,75056,0.2826086956521739,6
4013,Vieille du Temple - Francs Bourgeois,OUI,27,8,19,16,3,OUI,OUI,2025-03-13 05:57:38+00:00,"48.858256413365815, 2.35821794718504",Paris,75056,0.7037037037037037,6
21114,Gustave Eiffel - Parc des Impressionnistes,OUI,30,16,14,13,1,OUI,OUI,2025-03-13 05:54:52+00:00,"48.90390619651018, 2.2946908324956894",Clichy,92024,0.4666666666666667,6
21024,Billancourt - Général Leclerc,OUI,22,5,17,10,7,OUI,OUI,2025-03-13 05:56:27+00:00,"48.8322649, 2.2380413",Boulogne-Billancourt,92012,0.7727272727272727,6
32018,Franciade - Gabriel Péri,OUI,25,10,15,11,4,OUI,OUI,2025-03-13 05:59:57+00:00,"48.93261499331498, 2.355954498052597",Saint-Denis,93066,0.6,6
10163,Gare du Nord - Demarquay,OUI,29,14,15,4,11,OUI,OUI,2025-03-13 05:58:59+00:00,"48.881154, 2.358411",Paris,75056,0.5172413793103449,6
17016,Brochant - Square des Batignolles,OUI,31,15,16,6,10,OUI,OUI,2025-03-13 05:59:19+00:00,"48.88818698581028, 2.316861143151153",Paris,75056,0.5161290322580645,6
2001,Greneta - Sebastopol,OUI,32,22,10,10,0,OUI,OUI,2025-03-13 05:57:16+00:00,"48.865242333228, 2.3516669869423",Paris,75056,0.3125,6
18019,Square Raymond Souplex,OUI,50,40,10,4,6,OUI,OUI,2025-03-13 05:58:03+00:00,"48.89183721478911, 2.335426103165901",Paris,75056,0.2,6
20019,Place du Maquis du Vercors,OUI,30,28,2,0,2,OUI,OUI,2025-03-13 05:59:56+00:00,"48.877321579493575, 2.4083782732486725",Paris,75056,0.06666666666666667,6
11003,Keller - La Roquette,OUI,34,12,22,21,1,OUI,OUI,2025-03-13 05:58:09+00:00,"48.8555508, 2.3752778",Paris,75056,0.6470588235294118,6
7101,Raspail - Chomel,OUI,49,41,8,5,3,OUI,OUI,2025-03-13 05:58:01+00:00,"48.852233164303, 2.3266580700874",Paris,75056,0.16326530612244897,6
11034,Parmentier - Fontaine au Roi,OUI,42,13,29,21,8,OUI,OUI,2025-03-13 05:56:53+00:00,"48.86787670551736, 2.372705978671471",Paris,75056,0.6904761904761905,6
18138,Station Paris Basketball - Ney - Charles Hermite,OUI,19,10,9,5,4,OUI,OUI,2025-03-13 05:56:18+00:00,"48.898748039775, 2.3645754531026",Paris,75056,0.47368421052631576,6
19031,Manin - Crimée,OUI,21,13,8,1,7,OUI,OUI,2025-03-13 06:00:27+00:00,"48.8831217743719, 2.3863670602440834",Paris,75056,0.38095238095238093,6
13041,Porte d'Ivry,OUI,49,37,12,11,1,OUI,OUI,2025-03-13 06:00:55+00:00,"48.821768747596, 2.3688706755638",Paris,75056,0.24489795918367346,6
15061,Square Desnouettes,OUI,21,11,10,9,1,OUI,OUI,2025-03-13 05:55:31+00:00,"48.83476837934194, 2.284142297394666",Paris,75056,0.47619047619047616,6
7016,Surcouf - Université,OUI,56,20,36,33,3,OUI,OUI,2025-03-13 06:00:17+00:00,"48.861273016278, 2.3094535509142",Paris,75056,0.6428571428571429,6
11019,Charonne - Philippe-Auguste,OUI,31,13,18,11,7,OUI,OUI,2025-03-13 05:55:36+00:00,"48.855603162026, 2.39054639062",Paris,75056,0.5806451612903226,6
4011,Hôtel de Ville - Pont-Marie,OUI,31,6,25,19,6,OUI,OUI,2025-03-13 06:00:37+00:00,"48.853899645527, 2.3569472506642",Paris,75056,0.8064516129032258,6
23008,Hôtel de Ville de Levallois Perret,OUI,25,11,14,12,2,OUI,OUI,2025-03-13 06:00:19+00:00,"48.89314451997415, 2.2888818383216862",Levallois-Perret,92044,0.56,6
12108,Bercy.,OUI,64,44,20,15,5,OUI,OUI,2025-03-13 05:56:28+00:00,"48.839966914994, 2.3788625746965",Paris,75056,0.3125,6
8015,Roquépine - Malesherbes,OUI,50,40,10,6,4,OUI,OUI,2025-03-13 05:56:49+00:00,"48.87345073390807, 2.320404499769211",Paris,75056,0.2,6
14006,Saint-Jacques - Tombe Issoire,OUI,21,14,7,1,6,OUI,OUI,2025-03-13 05:59:17+00:00,"48.833206330538864, 2.3369108140468597",Paris,75056,0.3333333333333333,6
21108,Mairie de Clichy,OUI,44,37,7,5,2,OUI,OUI,2025-03-13 06:00:52+00:00,"48.903653634661, 2.3059353232384",Clichy,92024,0.1590909090909091,6
31013,Centenaire - Sorins,OUI,42,33,9,1,8,OUI,OUI,2025-03-13 05:59:44+00:00,"48.85853523359734, 2.4273508787155156",Montreuil,93048,0.21428571428571427,6
6014,Pont de Lodi - Dauphine,OUI,20,10,10,9,1,OUI,OUI,2025-03-13 05:57:25+00:00,"48.855296898603285, 2.339947307565249",Paris,75056,0.5,6
20202,Dupont de l'Eure - Gambetta,OUI,29,20,9,0,9,OUI,OUI,2025-03-13 06:00:47+00:00,"48.8679385, 2.4003649",Paris,75056,0.3103448275862069,6
47002,Les Juilliottes,OUI,21,7,14,11,3,OUI,OUI,2025-03-13 05:59:03+00:00,"48.8043072, 2.4437362",Maisons-Alfort,94046,0.6666666666666666,6
33005,République - Henri Barbusse,OUI,32,11,21,12,9,OUI,OUI,2025-03-13 06:00:59+00:00,"48.90661553626751, 2.389432489871979",Aubervilliers,93001,0.65625,6
9012,Rougemont - Poissonnière,OUI,30,23,7,7,0,OUI,OUI,2025-03-13 05:57:59+00:00,"48.871611569354755, 2.345873080193996",Paris,75056,0.23333333333333334,6
1016,Thérèse - Opéra,OUI,24,21,3,2,1,OUI,OUI,2025-03-13 05:58:10+00:00,"48.866483514509, 2.3344334212238",Paris,75056,0.125,6
15020,Mairie du 15ème,OUI,31,3,28,21,7,OUI,OUI,2025-03-13 06:00:46+00:00,"48.8417762, 2.2986539",Paris,75056,0.9032258064516129,6
20103,Le Vau - Maurice Bertaux,OUI,23,20,3,1,2,OUI,OUI,2025-03-13 06:00:38+00:00,"48.86803439043193, 2.411030612453627",Paris,75056,0.13043478260869565,6
41206,Place des Larris,OUI,34,25,9,2,7,OUI,OUI,2025-03-13 05:54:57+00:00,"48.8568363, 2.4780236",Fontenay-sous-Bois,94033,0.2647058823529412,6
2014,Daunou - Louis le Grand,OUI,31,21,10,2,8,OUI,OUI,2025-03-13 05:56:51+00:00,"48.869113, 2.332515",Paris,75056,0.3225806451612903,6
13113,Vistule - Choisy,OUI,33,11,22,10,12,OUI,OUI,2025-03-13 06:01:03+00:00,"48.82365543660611, 2.3615723848342896",Paris,75056,0.6666666666666666,6
3101,Porte Saint-Martin,OUI,31,15,16,14,2,OUI,OUI,2025-03-13 05:59:04+00:00,"48.86860172112996, 2.35570102930069",Paris,75056,0.5161290322580645,6
13114,Nationale - Marcel Duchamp,OUI,23,13,10,3,7,OUI,OUI,2025-03-13 06:00:38+00:00,"48.82463749337136, 2.3678014799952507",Paris,75056,0.43478260869565216,6
2101,Bachaumont - Montmartre,OUI,33,7,26,25,1,OUI,OUI,2025-03-13 05:59:38+00:00,"48.86617395079137, 2.3449775576591496",Paris,75056,0.7878787878787878,6
20017,Saint-Blaise - Mouraud,OUI,27,16,11,3,8,OUI,OUI,2025-03-13 06:00:51+00:00,"48.85696177597818, 2.40869477391243",Paris,75056,0.4074074074074074,6
8049,Georges V - François 1er,OUI,20,18,2,1,1,OUI,OUI,2025-03-13 06:01:06+00:00,"48.87034, 2.30082",Paris,75056,0.1,6
14116,Romain Rolland,OUI,25,22,3,0,3,OUI,OUI,2025-03-13 05:55:32+00:00,"48.820215229662765, 2.3234144234418346",Montrouge,92049,0.12,6
12154,Square Georges Melies,OUI,37,19,18,5,13,OUI,OUI,2025-03-13 06:01:05+00:00,"48.84070239213081, 2.409667745232582",Paris,75056,0.4864864864864865,6
31018,Gambetta - Michelet,OUI,30,26,4,0,4,OUI,OUI,2025-03-13 05:58:02+00:00,"48.85273792380526, 2.429966032505036",Montreuil,93048,0.13333333333333333,6
17104,Jardin Marguerite Long,OUI,21,16,5,4,1,OUI,OUI,2025-03-13 05:51:30+00:00,"48.8816985773914, 2.2836575657129288",Paris,75056,0.23809523809523808,6
2110,Jeûneurs - Mulhouse,OUI,27,22,5,3,2,OUI,OUI,2025-03-13 05:58:46+00:00,"48.868997, 2.346925",Paris,75056,0.18518518518518517,6
19030,Melun - Jean Jaurès,OUI,27,19,8,6,2,OUI,OUI,2025-03-13 05:58:07+00:00,"48.8837796723475, 2.376477420330048",Paris,75056,0.2962962962962963,6
7026,Place de Finlande,OUI,24,3,21,19,2,OUI,OUI,2025-03-13 05:58:08+00:00,"48.862408335967, 2.3113624379039",Paris,75056,0.875,6
35008,Place de l'Eglise - Pantin,OUI,28,22,6,3,3,OUI,OUI,2025-03-13 05:57:52+00:00,"48.892809461520265, 2.4124351143836975",Pantin,93055,0.21428571428571427,6
5019,Poissy - Saint-Germain,OUI,24,7,17,17,0,OUI,OUI,2025-03-13 06:00:50+00:00,"48.84969649427, 2.3529685288668",Paris,75056,0.7083333333333334,6
13022,Butte aux Cailles - Esperance,OUI,30,19,11,5,6,OUI,OUI,2025-03-13 05:55:07+00:00,"48.82758774190948, 2.3492151126265526",Paris,75056,0.36666666666666664,6
17033,Carnot - Général Lanrezac,OUI,29,26,3,0,3,OUI,OUI,2025-03-13 06:00:07+00:00,"48.875443870736, 2.2938242935036",Paris,75056,0.10344827586206896,6
11044,Square du Bataclan,OUI,17,4,13,12,1,OUI,OUI,2025-03-13 05:55:05+00:00,"48.8633762, 2.3711327",Paris,75056,0.7647058823529411,6
14007,Ferrus - Saint-Jacques,OUI,34,20,14,8,6,OUI,OUI,2025-03-13 06:00:22+00:00,"48.8313878, 2.3408563",Paris,75056,0.4117647058823529,6
21952,Place Tony de Graaff,OUI,42,7,35,24,11,OUI,OUI,2025-03-13 05:59:37+00:00,"48.8181645, 2.2458109",Meudon,92048,0.8333333333333334,6
10164,Claude Vellefaux - Sambre et Meuse,OUI,32,28,4,1,3,OUI,OUI,2025-03-13 05:57:32+00:00,"48.875022, 2.370478",Paris,75056,0.125,6
11110,Roquette - Folie Regnault,OUI,50,36,14,11,3,OUI,OUI,2025-03-13 05:57:37+00:00,"48.859246959155485, 2.386553623578705",Paris,75056,0.28,6
11107,Faidherbe - Dahomey,OUI,40,5,35,24,11,OUI,OUI,2025-03-13 05:59:10+00:00,"48.851358329771806, 2.383823134795429",Paris,75056,0.875,6
16031,Vignes - Boulainvilliers,OUI,20,15,5,0,5,OUI,OUI,2025-03-13 06:00:20+00:00,"48.856399483950504, 2.275240458548069",Paris,75056,0.25,6
9113,Bleue - Trévise,OUI,27,19,8,7,1,OUI,OUI,2025-03-13 05:58:13+00:00,"48.87578906564573, 2.347289621829987",Paris,75056,0.2962962962962963,6
17005,Brochant - Clichy,OUI,53,34,19,18,1,OUI,OUI,2025-03-13 06:00:08+00:00,"48.89032998912038, 2.319730559929781",Paris,75056,0.3584905660377358,6
4109,Mornay - Sully,OUI,13,4,9,4,5,OUI,OUI,2025-03-13 06:00:00+00:00,"48.84970399548416, 2.364460788667202",Paris,75056,0.6923076923076923,6
21017,Place Marcel Sembat,OUI,51,19,32,32,0,OUI,OUI,2025-03-13 06:00:16+00:00,"48.83328865030686, 2.2441747784614567",Boulogne-Billancourt,92012,0.6274509803921569,6
8105,François 1er - Lincoln,OUI,29,26,3,1,2,OUI,OUI,2025-03-13 05:56:18+00:00,"48.869517979344, 2.3024262188416",Paris,75056,0.10344827586206896,6
22012,Madeleine Michelis - Roule,OUI,24,13,11,6,5,OUI,OUI,2025-03-13 05:59:53+00:00,"48.88260431301364, 2.2773634269833565",Neuilly-sur-Seine,92051,0.4583333333333333,6
11048,Place Mireille Havet,OUI,42,1,41,36,5,OUI,OUI,2025-03-13 05:59:53+00:00,"48.850533, 2.383756",Paris,75056,0.9761904761904762,6
15009,Suffren - Pérignon,OUI,45,15,30,26,4,OUI,OUI,2025-03-13 06:00:14+00:00,"48.84717561492764, 2.307052147596786",Paris,75056,0.6666666666666666,6
22017,Charles de Gaulle - Louis Philippe,OUI,27,19,8,5,3,OUI,OUI,2025-03-13 06:00:58+00:00,"48.881742142181, 2.2710045335353",Neuilly-sur-Seine,92051,0.2962962962962963,6
23005,Gare de Clichy-Levallois,OUI,24,6,18,18,0,OUI,OUI,2025-03-13 06:00:51+00:00,"48.89679827481989, 2.2984680533409123",Levallois-Perret,92044,0.75,6
19021,Mairie du 19ème,OUI,24,14,10,3,7,OUI,OUI,2025-03-13 05:56:08+00:00,"48.88256264247959, 2.3812624812126164",Paris,75056,0.4166666666666667,6
21120,Docteur Calmette - Martre,OUI,30,18,12,7,5,OUI,OUI,2025-03-13 05:57:55+00:00,"48.898969358483, 2.3086513252383",Clichy,92024,0.4,6
21004,Jean Jaurès - Reine,OUI,31,6,25,25,0,OUI,OUI,2025-03-13 06:00:17+00:00,"48.84009622558849, 2.239872515201569",Boulogne-Billancourt,92012,0.8064516129032258,6
14125,Dareau - Broussais,OUI,22,15,7,1,6,OUI,OUI,2025-03-13 05:59:28+00:00,"48.8307758, 2.3361804",Paris,75056,0.3181818181818182,6
22002,Argenson - Château,OUI,24,15,9,4,5,OUI,OUI,2025-03-13 05:56:48+00:00,"48.888559314669514, 2.2642001509666447",Neuilly-sur-Seine,92051,0.375,6
13047,Boutroux - Porte de Vitry,OUI,49,24,25,21,4,OUI,OUI,2025-03-13 06:00:18+00:00,"48.822632, 2.377738",Paris,75056,0.5102040816326531,6
20045,Louis Ganne - Davout,OUI,30,28,2,0,2,OUI,OUI,2025-03-13 05:54:42+00:00,"48.86338720692607, 2.409725748002529",Paris,75056,0.06666666666666667,6
44103,Pont De Charenton,OUI,18,1,17,9,8,OUI,OUI,2025-03-13 05:58:34+00:00,"48.8179685, 2.4199531",Saint-Maurice,94069,0.9444444444444444,6
13019,Fernand Braudel - Vincent Auriol,OUI,36,30,6,2,4,OUI,OUI,2025-03-13 05:56:54+00:00,"48.83637852318147, 2.3723404482007027",Paris,75056,0.16666666666666666,6
20047,Cours de Vincennes - Davout,OUI,48,26,22,8,14,OUI,OUI,2025-03-13 05:53:36+00:00,"48.847238029966, 2.4107042336225",Paris,75056,0.4583333333333333,6
5030,Sorbonne - Ecoles,OUI,47,34,13,3,10,OUI,OUI,2025-03-13 05:55:56+00:00,"48.849686566191, 2.3434996604919",Paris,75056,0.2765957446808511,6
9013,Mairie du 9ème,OUI,23,16,7,7,0,OUI,OUI,2025-03-13 05:53:11+00:00,"48.873267137583, 2.3407534480528",Paris,75056,0.30434782608695654,6
16041,Versailles - Claude Terrasse,OUI,46,6,40,27,13,OUI,OUI,2025-03-13 06:00:36+00:00,"48.840219338074, 2.263834191153",Paris,75056,0.8695652173913043,6
21951,Place Centrale,OUI,22,20,2,0,2,OUI,OUI,2025-03-13 05:59:33+00:00,"48.78740167690531, 2.2278830409049992",Meudon,92048,0.09090909090909091,6
9015,Lamartine - Faubourg Montmartre,OUI,28,8,20,16,4,OUI,OUI,2025-03-13 06:00:05+00:00,"48.876613982891, 2.3397656902671",Paris,75056,0.7142857142857143,6
92005,Gare de Nanterre Ville,OUI,42,19,23,18,5,OUI,OUI,2025-03-13 05:59:57+00:00,"48.8950295, 2.1957932",Nanterre,92050,0.5476190476190477,6
8029,Place du Canada,OUI,56,51,5,3,2,OUI,OUI,2025-03-13 05:56:47+00:00,"48.865346269363, 2.3101937879648",Paris,75056,0.08928571428571429,6
10039,Sambre et Meuse - Villette,OUI,24,18,6,3,3,OUI,OUI,2025-03-13 05:58:51+00:00,"48.874405666217, 2.3738072379951",Paris,75056,0.25,6
12153,Terroirs de France - Lheureux,OUI,55,43,12,8,4,OUI,OUI,2025-03-13 06:00:14+00:00,"48.83212027074841, 2.388618104159832",Paris,75056,0.21818181818181817,6
19036,Hôpital Robert Debré,OUI,33,28,5,0,5,OUI,OUI,2025-03-13 05:54:26+00:00,"48.88005222200894, 2.4008650346327003",Paris,75056,0.15151515151515152,6
14127,Odessa - Départ,OUI,39,35,4,2,2,OUI,OUI,2025-03-13 05:59:38+00:00,"48.842885590081, 2.3244281485677",Paris,75056,0.10256410256410256,6
31101,Jules Guesde - Laennec,OUI,19,13,6,0,6,OUI,OUI,2025-03-13 05:52:54+00:00,"48.87628983900398, 2.5006942078471184",Rosny-sous-Bois,93064,0.3157894736842105,6
14016,René Coty - Parc Montsouris,OUI,54,50,4,3,1,OUI,OUI,2025-03-13 06:00:34+00:00,"48.82479134498032, 2.336124926805496",Paris,75056,0.07407407407407407,6
14113,Santé - Arago,OUI,37,27,10,7,3,OUI,OUI,2025-03-13 05:58:49+00:00,"48.83507657562064, 2.3415737262044938",Paris,75056,0.2702702702702703,6
12033,François Truffaut - Saint Emilion,OUI,66,56,10,6,4,OUI,OUI,2025-03-13 06:00:18+00:00,"48.83372354344807, 2.386601903271428",Paris,75056,0.15151515151515152,6
35015,Averroès - Aimé Césaire,OUI,18,12,6,5,1,OUI,OUI,2025-03-13 05:59:02+00:00,"48.91405323432864, 2.412636950612068",Pantin,93055,0.3333333333333333,6
12120,Lac Daumesnil - Saint-Maurice,OUI,49,32,17,15,2,OUI,OUI,2025-03-13 05:57:12+00:00,"48.82774555743318, 2.4183654785156246",Paris,75056,0.3469387755102041,6
15019,Paul Barruel - Vaugirard,OUI,36,23,13,10,3,OUI,OUI,2025-03-13 05:59:19+00:00,"48.84014918546239, 2.3044332861900334",Paris,75056,0.3611111111111111,6
18142,Jessaint - Marx Dormoy,OUI,30,23,7,3,4,OUI,OUI,2025-03-13 05:53:00+00:00,"48.88484543106364, 2.358930408954621",Paris,75056,0.23333333333333334,6
9036,Athènes - Clichy,OUI,18,15,3,1,2,OUI,OUI,2025-03-13 05:58:34+00:00,"48.878113787876, 2.32956021945824",Paris,75056,0.16666666666666666,6
18035,René Binet - Porte de Montmartre,OUI,36,28,8,2,6,OUI,OUI,2025-03-13 05:52:36+00:00,"48.89905109950848, 2.3365534096956253",Paris,75056,0.2222222222222222,6
15125,Parc Suzanne Lenglen,OUI,51,27,24,19,5,OUI,OUI,2025-03-13 06:00:27+00:00,"48.833250690537874, 2.2765403240919113",Paris,75056,0.47058823529411764,6
13110,Moulin de la Pointe,OUI,20,19,1,0,1,OUI,OUI,2025-03-13 05:55:05+00:00,"48.82092946051445, 2.3563179373741145",Paris,75056,0.05,6
10004,Metz - Faubourg Saint-Denis,OUI,44,25,19,16,3,OUI,OUI,2025-03-13 06:01:01+00:00,"48.870893, 2.353521",Paris,75056,0.4318181818181818,6
23105,Sèvres Rive Gauche,OUI,33,17,16,15,1,OUI,OUI,2025-03-13 06:00:37+00:00,"48.821443218278, 2.2150785306885",Sèvres,92072,0.48484848484848486,6
21118,Neuilly - Petit,OUI,15,0,15,6,9,OUI,OUI,2025-03-13 05:59:22+00:00,"48.898965361341254, 2.29627937078476",Clichy,92024,1.0,6
20117,Saint-Fargeau - Mortier,OUI,31,31,0,0,0,OUI,OUI,2025-03-13 05:59:11+00:00,"48.87266656122256, 2.407912909984589",Paris,75056,0.0,6
20039,Belleville - Couronnes,OUI,48,29,19,6,13,OUI,OUI,2025-03-13 05:59:09+00:00,"48.868831082877, 2.3809862136841",Paris,75056,0.3958333333333333,6
48009,République - Auguste Perret,OUI,30,29,1,1,0,OUI,OUI,2025-03-13 06:00:35+00:00,"48.78695280952244, 2.3518594354391094",Villejuif,94076,0.03333333333333333,6
21203,Place Jules Ferry,OUI,28,26,2,1,1,OUI,OUI,2025-03-13 05:53:38+00:00,"48.812107928414775, 2.325837314128876",Montrouge,92049,0.07142857142857142,6
21009,Le Corbusier - Jean Jaurès,OUI,45,42,3,0,3,OUI,OUI,2025-03-13 05:59:18+00:00,"48.83780830557548, 2.2408381104469304",Boulogne-Billancourt,92012,0.06666666666666667,6
21316,Cimetière d'Issy-les-Moulineaux,OUI,23,22,1,0,1,OUI,OUI,2025-03-13 05:58:52+00:00,"48.817699773925, 2.2609312087297",Issy-les-Moulineaux,92040,0.043478260869565216,6
31017,Jean Moulin - Paul Doumer,OUI,17,16,1,0,1,OUI,OUI,2025-03-13 06:00:38+00:00,"48.8622179854695, 2.45533436536789",Montreuil,93048,0.058823529411764705,6
19025,Botzaris - Crimée,OUI,20,10,10,2,8,OUI,OUI,2025-03-13 05:58:55+00:00,"48.87959698690176, 2.3887913337477067",Paris,75056,0.5,6
18114,Véron - Lepic,OUI,22,15,7,2,5,OUI,OUI,2025-03-13 05:56:26+00:00,"48.88526123395252, 2.334559857845307",Paris,75056,0.3181818181818182,6
21029,Cours de l'Ile Seguin - Parc Billancourt,OUI,28,14,14,6,8,OUI,OUI,2025-03-13 05:59:20+00:00,"48.82714055843935, 2.234234511852265",Boulogne-Billancourt,92012,0.5,6
4107,Beaumarchais - Pas de la Mule,OUI,17,5,12,11,1,OUI,OUI,2025-03-13 05:58:14+00:00,"48.855580507049, 2.3684333673431",Paris,75056,0.7058823529411765,6
16003,André Maurois - Joseph et Marie Hackin,OUI,27,15,12,9,3,OUI,OUI,2025-03-13 05:58:06+00:00,"48.8778983, 2.2789591",Paris,75056,0.4444444444444444,6
22403,Pierre Brossolette - Adolphe Pinard,OUI,23,14,9,4,5,OUI,OUI,2025-03-13 05:56:34+00:00,"48.821772279548, 2.3131558299065",Malakoff,92046,0.391304347826087,6
15072,Place Fernand Forest,OUI,29,0,29,21,8,OUI,OUI,2025-03-13 06:00:36+00:00,"48.849269143836, 2.281863167882",Paris,75056,1.0,6
42011,Quai Marcel Boyer - Victor Hugo,OUI,29,15,14,11,3,OUI,OUI,2025-03-13 06:00:30+00:00,"48.822556366667, 2.3920395970345",Ivry-sur-Seine,94041,0.4827586206896552,6
12006,Gare de Lyon - Van Gogh,OUI,41,27,14,11,3,OUI,OUI,2025-03-13 05:59:33+00:00,"48.843839785643, 2.3704450240357",Paris,75056,0.34146341463414637,6
22103,Senard - Charles Blum,OUI,24,21,3,2,1,OUI,OUI,2025-03-13 05:51:16+00:00,"48.857315824799, 2.221091687679291",Saint-Cloud,92064,0.125,6
16007,Longchamp - Place d'Iéna,OUI,25,23,2,0,2,OUI,OUI,2025-03-13 05:57:09+00:00,"48.864917233434, 2.2926748171449",Paris,75056,0.08,6
19113,Pré Saint-Gervais - Lilas,OUI,27,22,5,0,5,OUI,OUI,2025-03-13 06:00:08+00:00,"48.877870626988, 2.3959073424339",Paris,75056,0.18518518518518517,6
10110,Louis Blanc - Jemmapes,OUI,30,16,14,5,9,OUI,OUI,2025-03-13 06:00:16+00:00,"48.879330755297, 2.3684485629201",Paris,75056,0.4666666666666667,6
14128,Gergovie - Vercingétorix,OUI,29,28,1,0,1,OUI,OUI,2025-03-13 05:58:37+00:00,"48.83453413883994, 2.313154547426182",Paris,75056,0.034482758620689655,6
21115,Chancé Milly - Cimetière Communal Sud,OUI,32,7,25,24,1,OUI,OUI,2025-03-13 06:00:48+00:00,"48.89687189382465, 2.303922325372696",Clichy,92024,0.78125,6
31026,Demi-Lune - Aristide Briand,OUI,20,15,5,0,5,OUI,OUI,2025-03-13 05:57:35+00:00,"48.87626381919953, 2.4562818557024",Montreuil,93048,0.25,6
13048,Wurtz - Tolbiac,OUI,28,28,0,0,0,NON,NON,2025-03-13 05:59:00+00:00,"48.82631195621, 2.344585955143",Paris,75056,0.0,6
17001,Guy Môquet - Saint-Ouen,OUI,44,19,25,15,10,OUI,OUI,2025-03-13 05:59:16+00:00,"48.892777719023975, 2.3270335793495183",Paris,75056,0.5681818181818182,6
21702,Gare SNCF Vanves-Malakoff,OUI,49,46,3,1,2,OUI,OUI,2025-03-13 05:58:24+00:00,"48.819002163836444, 2.292150005103606",Vanves,92075,0.061224489795918366,6
12129,Bois de Vincennes - Porte Jaune,OUI,35,33,2,2,0,OUI,OUI,2025-03-13 06:00:24+00:00,"48.838751246689455, 2.4605489149689674",Paris,75056,0.05714285714285714,6
42304,Marc Sangnier - Division Leclerc,OUI,21,3,18,15,3,OUI,OUI,2025-03-13 06:00:32+00:00,"48.78599652305309, 2.329955510795116",Cachan,94016,0.8571428571428571,6
35004,Place du Président Salvador Allende,OUI,59,47,12,2,10,OUI,OUI,2025-03-13 05:58:45+00:00,"48.897307310356055, 2.40079153681279",Pantin,93055,0.2033898305084746,6
21030,Fessart - Château,OUI,20,1,19,19,0,OUI,OUI,2025-03-13 06:00:17+00:00,"48.84245, 2.23989",Boulogne-Billancourt,92012,0.95,6
31707,Edouard Vaillant - Galliéni,OUI,47,44,3,1,2,OUI,OUI,2025-03-13 05:59:55+00:00,"48.858462881661, 2.4147954583168",Bagnolet,93006,0.06382978723404255,6
15043,Brancion - Lefebvre,OUI,9,9,0,0,0,OUI,OUI,2025-03-13 05:54:55+00:00,"48.82900222785569, 2.301431038163409",Paris,75056,0.0,6
8011,Clapeyron - Moscou,OUI,14,9,5,4,1,OUI,OUI,2025-03-13 05:59:03+00:00,"48.88078819514121, 2.324815057218075",Paris,75056,0.35714285714285715,6
20009,Docteurs Déjérine - Pte de Montreuil,OUI,19,18,1,0,1,OUI,OUI,2025-03-13 05:58:57+00:00,"48.85398448133697, 2.41208288897222",Paris,75056,0.05263157894736842,6
13020,Paul Klee - Place Augusta Holmes,OUI,43,35,8,4,4,OUI,OUI,2025-03-13 05:56:36+00:00,"48.838946417408025, 2.3704235663952966",Paris,75056,0.18604651162790697,6
42305,Vanne - Saussaies,OUI,20,12,8,1,7,OUI,OUI,2025-03-13 05:58:33+00:00,"48.786404, 2.338848",Cachan,94016,0.4,6
19124,Alexander Fleming - Belvédère,OUI,31,18,13,4,9,OUI,OUI,2025-03-13 06:00:30+00:00,"48.88179064200294, 2.4030599377642674",Paris,75056,0.41935483870967744,6
11032,Jean-Pierre Timbaud - Vaucouleurs,OUI,43,17,26,19,7,OUI,OUI,2025-03-13 05:56:27+00:00,"48.867937, 2.377885",Paris,75056,0.6046511627906976,6
7010,Constantine - Université,OUI,60,46,14,12,2,OUI,OUI,2025-03-13 06:00:26+00:00,"48.860680473738, 2.3148481955842",Paris,75056,0.23333333333333334,6
21955,Vaugirard - Verrerie,OUI,24,2,22,18,4,OUI,OUI,2025-03-13 05:57:44+00:00,"48.820881336842, 2.2367222622987",Meudon,92048,0.9166666666666666,6
32021,Place du Front Populaire - George Sand,OUI,65,61,4,2,2,OUI,OUI,2025-03-13 05:59:56+00:00,"48.90680713698062, 2.364541214992642",Saint-Denis,93066,0.06153846153846154,6
16101,Malakoff - Place de la Porte Maillot,OUI,26,24,2,2,0,OUI,OUI,2025-03-13 05:58:54+00:00,"48.876733496638, 2.2834577411413",Paris,75056,0.07692307692307693,6
20203,Evariste Galois,OUI,20,19,1,0,1,OUI,OUI,2025-03-13 05:59:22+00:00,"48.873341356228, 2.4133544409574",Paris,75056,0.05,6
4003,Quai aux Fleurs - Pont Saint-Louis,OUI,17,5,12,11,1,OUI,OUI,2025-03-13 06:01:05+00:00,"48.852915956209, 2.3521957173944",Paris,75056,0.7058823529411765,6
7024,Rapp - Place du Général Gouraud,OUI,28,18,10,9,1,OUI,OUI,2025-03-13 06:00:58+00:00,"48.858102885107, 2.3004072904587",Paris,75056,0.35714285714285715,6
32301,Mairie de Romainville,OUI,17,16,1,0,1,OUI,OUI,2025-03-13 05:59:20+00:00,"48.885109, 2.435679",Romainville,93063,0.058823529411764705,6
20004,Commandant l'Herminier - Gallieni,OUI,17,11,6,3,3,OUI,OUI,2025-03-13 05:59:26+00:00,"48.847040552603, 2.4160453677177",Paris,75056,0.35294117647058826,6
21219,Amaury Duval - Gabriel Péri,OUI,36,31,5,2,3,OUI,OUI,2025-03-13 05:53:49+00:00,"48.81718759671675, 2.323841750621796",Montrouge,92049,0.1388888888888889,6
12150,Bastille - Quai de la Rapée,OUI,27,4,23,20,3,OUI,OUI,2025-03-13 06:00:34+00:00,"48.84682410855, 2.3669364675879",Paris,75056,0.8518518518518519,6
31025,Paul Signac - Aristide Briand,OUI,34,31,3,0,3,OUI,OUI,2025-03-13 06:00:34+00:00,"48.86950262156371, 2.4502260982990265",Montreuil,93048,0.08823529411764706,6
11031,Jacquard - Ternaux,OUI,39,9,30,26,4,OUI,OUI,2025-03-13 05:58:33+00:00,"48.8646605, 2.373162",Paris,75056,0.7692307692307693,6
5014,Jean Calvin - Tournefort,OUI,28,23,5,2,3,OUI,OUI,2025-03-13 06:00:49+00:00,"48.84158856925782, 2.348489575088024",Paris,75056,0.17857142857142858,6
12125,Pyramide - Parc Floral,OUI,49,44,5,1,4,OUI,OUI,2025-03-13 05:56:46+00:00,"48.837442, 2.440452",Paris,75056,0.10204081632653061,6
13033,Porte d'Italie,OUI,13,11,2,0,2,OUI,OUI,2025-03-13 05:59:22+00:00,"48.817161987718954, 2.360236309468746",Paris,75056,0.15384615384615385,6
13515,Auguste Blanqui - Glacière,OUI,58,49,9,6,3,OUI,OUI,2025-03-13 05:57:49+00:00,"48.831151602964, 2.343822196126",Paris,75056,0.15517241379310345,6
42701,Charles Gide - Fort de Bicêtre,OUI,29,5,24,4,20,OUI,OUI,2025-03-13 05:58:07+00:00,"48.8071937956922, 2.353984415531159",Le Kremlin-Bicêtre,94043,0.8275862068965517,6
9016,Choron - Martyrs,OUI,15,4,11,9,2,OUI,OUI,2025-03-13 05:59:44+00:00,"48.877851443503, 2.3396701365709",Paris,75056,0.7333333333333333,6
20122,Vitruve - Davout,OUI,23,20,3,1,2,OUI,OUI,2025-03-13 06:00:46+00:00,"48.86053161154489, 2.4091592812626543",Paris,75056,0.13043478260869565,6
10152,Gare du Nord - Place de Valenciennes,OUI,24,20,4,0,4,OUI,OUI,2025-03-13 06:00:59+00:00,"48.879089, 2.354235",Paris,75056,0.16666666666666666,6
16020,Place de la Porte de Passy,OUI,34,28,6,4,2,OUI,OUI,2025-03-13 06:00:04+00:00,"48.857341095470794, 2.2644165538827115",Paris,75056,0.17647058823529413,6
15131,Charles Lecocq - Lecourbe,OUI,29,6,23,20,3,OUI,OUI,2025-03-13 05:59:32+00:00,"48.84044, 2.294867",Paris,75056,0.7931034482758621,6
13126,Place Nationale - Château-des-Rentiers,OUI,17,9,8,6,2,OUI,OUI,2025-03-13 05:58:14+00:00,"48.829268, 2.365212",Paris,75056,0.47058823529411764,6
10037,Quai de Valmy,OUI,26,20,6,3,3,OUI,OUI,2025-03-13 06:00:33+00:00,"48.88126951579429, 2.368186041712761",Paris,75056,0.23076923076923078,6
14101,Gare Montparnasse - Edgar Quinet,OUI,33,21,12,10,2,OUI,OUI,2025-03-13 06:00:01+00:00,"48.841487851079, 2.3233232282801",Paris,75056,0.36363636363636365,6
13117,Stade Georges Carpentier,OUI,39,17,22,5,17,OUI,OUI,2025-03-13 05:58:02+00:00,"48.820482438381, 2.3668321967125",Paris,75056,0.5641025641025641,6
8020,Batignolles - Beudant,OUI,43,37,6,0,6,OUI,OUI,2025-03-13 05:52:37+00:00,"48.88216401466375, 2.319852970540523",Paris,75056,0.13953488372093023,6
13027,Mazagran - Pierre de Coubertin,OUI,15,14,1,1,0,OUI,OUI,2025-03-13 05:55:57+00:00,"48.816218640260445, 2.344226874411106",Paris,75056,0.06666666666666667,6
15023,La Motte-Picquet - Grenelle,OUI,31,5,26,25,1,OUI,OUI,2025-03-13 05:59:00+00:00,"48.84858321339195, 2.299347817897797",Paris,75056,0.8387096774193549,6
17029,Pierre Demours - Laugier,OUI,36,25,11,9,2,OUI,OUI,2025-03-13 05:59:33+00:00,"48.8813072, 2.294846",Paris,75056,0.3055555555555556,6
40009,Lycée Saint Exupéry - Juliette Savar,OUI,29,18,11,8,3,OUI,OUI,2025-03-13 06:01:05+00:00,"48.783021513972, 2.4637357216879",Créteil,94028,0.3793103448275862,6
11103,Pelée - Alphonse Baudin,OUI,34,1,33,30,3,OUI,OUI,2025-03-13 06:00:27+00:00,"48.8600265, 2.3710541",Paris,75056,0.9705882352941176,6
5034,Censier - Santeuil,OUI,63,37,26,25,1,OUI,OUI,2025-03-13 06:01:05+00:00,"48.840658921385234, 2.3537524044513702",Paris,75056,0.4126984126984127,6
14131,Jourdan - Monticelli,OUI,30,13,17,4,13,OUI,OUI,2025-03-13 05:56:56+00:00,"48.822032, 2.329095",Paris,75056,0.5666666666666667,6
10017,Gare de l'Est - Fidélité,OUI,14,7,7,6,1,OUI,OUI,2025-03-13 05:56:31+00:00,"48.874575, 2.356796",Paris,75056,0.5,6
17023,Porte d'Asnières,OUI,34,27,7,3,4,OUI,OUI,2025-03-13 05:58:55+00:00,"48.89035817610495, 2.3036286234855656",Paris,75056,0.20588235294117646,6
22013,Mairie de Neuilly sur Seine,OUI,30,17,13,12,1,OUI,OUI,2025-03-13 05:58:41+00:00,"48.88494728765838, 2.2677031159400944",Neuilly-sur-Seine,92051,0.43333333333333335,6
19108,Gaston Tessier - Rosa Parks RER,OUI,37,22,15,8,7,OUI,OUI,2025-03-13 05:58:30+00:00,"48.8963765, 2.3743692",Paris,75056,0.40540540540540543,6
16009,Saint-Didier - Raymond Poincaré,OUI,17,15,2,2,0,OUI,OUI,2025-03-13 05:59:58+00:00,"48.86642312020962, 2.285863497192411",Paris,75056,0.11764705882352941,6
42501,Raspail - Albert Schweitzer,OUI,27,8,19,17,2,OUI,OUI,2025-03-13 05:59:58+00:00,"48.81031545, 2.34395871",Gentilly,94037,0.7037037037037037,6
10153,Gare du Nord - Denain,OUI,20,13,7,1,6,OUI,OUI,2025-03-13 06:01:00+00:00,"48.879595787608, 2.3544725775719",Paris,75056,0.35,6
6008,Assas - Luxembourg,OUI,33,25,8,2,6,OUI,OUI,2025-03-13 05:55:29+00:00,"48.843734468779, 2.3334283818759",Paris,75056,0.24242424242424243,6
16014,Eylau - Trocadéro,OUI,22,20,2,1,1,OUI,OUI,2025-03-13 05:59:16+00:00,"48.863354122371, 2.2864209115505",Paris,75056,0.09090909090909091,6
42209,Place de l'Europe - Quai de Bercy,OUI,14,2,12,8,4,OUI,OUI,2025-03-13 05:57:56+00:00,"48.82529858840266, 2.3945679143071175",Charenton-le-Pont,94018,0.8571428571428571,6
21708,Marcel Yol - Jullien,OUI,29,0,29,6,23,OUI,OUI,2025-03-13 05:55:50+00:00,"48.82537611802588, 2.287235018058929",Vanves,92075,1.0,6
22206,Louis Pasteur - Albert Petit,OUI,30,30,0,0,0,OUI,OUI,2025-03-13 05:59:45+00:00,"48.796261, 2.317289",Bagneux,92007,0.0,6
41210,Hôtel de ville de Fontenay-sous-Bois,OUI,19,17,2,0,2,OUI,OUI,2025-03-13 05:59:06+00:00,"48.84949749106274, 2.4750164151191716",Fontenay-sous-Bois,94033,0.10526315789473684,6
15030,Emeriau - Beaugrenelle,OUI,70,14,56,54,2,OUI,OUI,2025-03-13 05:59:00+00:00,"48.84791249714942, 2.2843059897422795",Paris,75056,0.8,6
11109,Pierre Levée - Fontaine Timbaud,OUI,22,12,10,7,3,OUI,OUI,2025-03-13 05:59:12+00:00,"48.86632723374305, 2.3711163550615306",Paris,75056,0.45454545454545453,6
9114,Faubourg Poissonnière - Dunkerque,OUI,30,25,5,3,2,OUI,OUI,2025-03-13 05:59:05+00:00,"48.880883445404436, 2.349934279918671",Paris,75056,0.16666666666666666,6
15052,Convention - Vaugirard,OUI,45,11,34,25,9,OUI,OUI,2025-03-13 05:57:23+00:00,"48.83767682233156, 2.295586926020252",Paris,75056,0.7555555555555555,6
25001,Colmar - Victor Hugo,OUI,29,20,9,7,2,OUI,OUI,2025-03-13 05:56:42+00:00,"48.88652251096166, 2.173960916697979",Rueil-Malmaison,92063,0.3103448275862069,6
31021,Résistance - Hoche,OUI,28,28,0,0,0,OUI,OUI,2025-03-13 06:00:26+00:00,"48.864273423741956, 2.435784414410591",Montreuil,93048,0.0,6
35007,Benjamin Delessert - Jean Lolive,OUI,20,17,3,0,3,OUI,OUI,2025-03-13 05:56:25+00:00,"48.89392043619345, 2.417981922626496",Pantin,93055,0.15,6
44002,Paul Vaillant-Couturier - Gare RER,OUI,25,2,23,18,5,OUI,OUI,2025-03-13 06:00:06+00:00,"48.80108159069614, 2.402097210288048",Vitry-sur-Seine,94081,0.92,6
44101,Place Mongolfier,OUI,37,15,22,11,11,OUI,OUI,2025-03-13 05:59:25+00:00,"48.815160030060376, 2.4592879414558415",Saint-Maurice,94069,0.5945945945945946,6
16115,Raffet - Montmorency,OUI,39,36,3,1,2,OUI,OUI,2025-03-13 05:59:53+00:00,"48.85258670812, 2.2629252456151954",Paris,75056,0.07692307692307693,6
13032,Italie - Jardin Joan Miro,OUI,24,15,9,3,6,OUI,OUI,2025-03-13 05:59:08+00:00,"48.81990914045756, 2.3592948541045193",Paris,75056,0.375,6
15123,Commerce - Letellier,OUI,42,20,22,20,2,OUI,OUI,2025-03-13 05:59:14+00:00,"48.84797660373612, 2.2966245196598805",Paris,75056,0.5238095238095238,6
15064,Javel - André Citroën,OUI,44,7,37,34,3,OUI,OUI,2025-03-13 05:59:15+00:00,"48.846276485475, 2.2786368057132",Paris,75056,0.8409090909090909,6
13039,Ivry - Simone Weil,OUI,18,16,2,2,0,OUI,OUI,2025-03-13 05:56:08+00:00,"48.823283932030755, 2.3659095168113713",Paris,75056,0.1111111111111111,6
14010,Jean Moulin - Place Victor et Hélène Basch,OUI,37,34,3,0,3,OUI,OUI,2025-03-13 06:00:17+00:00,"48.82764910241, 2.3261967301369",Paris,75056,0.08108108108108109,6
21031,Cimetière de Boulogne-Billancourt,OUI,39,9,30,28,2,OUI,OUI,2025-03-13 06:00:30+00:00,"48.830764, 2.252024",Boulogne-Billancourt,92012,0.7692307692307693,6
22303,Lucien Lanternier - Le Luth,OUI,26,9,17,12,5,OUI,OUI,2025-03-13 06:00:16+00:00,"48.93159430558871, 2.2889783978462224",Gennevilliers,92036,0.6538461538461539,6
16024,Ranelagh - Maison de la Radio,OUI,20,3,17,11,6,OUI,OUI,2025-03-13 05:59:29+00:00,"48.85293603169479, 2.280449643731117",Paris,75056,0.85,6
6027,Blaise-Desgoffe - Vaugirard,OUI,31,11,20,4,16,OUI,OUI,2025-03-13 05:59:12+00:00,"48.846128877747, 2.3242672160268",Paris,75056,0.6451612903225806,6
17039,Place Saint-Ferdinand,OUI,38,34,4,2,2,OUI,OUI,2025-03-13 05:51:16+00:00,"48.87815529789739, 2.288518047864942",Paris,75056,0.10526315789473684,6
18007,Goutte d'or - Barbès,OUI,20,7,13,8,5,OUI,OUI,2025-03-13 05:57:01+00:00,"48.885124323627, 2.3496962338686",Paris,75056,0.65,6
22604,Hôtel de Ville de Fontenay-aux-Roses,OUI,32,31,1,1,0,OUI,OUI,2025-03-13 05:58:25+00:00,"48.790844603480856, 2.2871455930319455",Fontenay-aux-Roses,92032,0.03125,6
13044,Place Jeanne d'Arc,OUI,36,24,12,3,9,OUI,OUI,2025-03-13 06:00:43+00:00,"48.829575, 2.369126",Paris,75056,0.3333333333333333,6
8001,Petit Palais,OUI,42,35,7,4,3,OUI,OUI,2025-03-13 05:56:07+00:00,"48.8667692, 2.3157655",Paris,75056,0.16666666666666666,6
15022,Emile Zola - Fondary,OUI,39,5,34,33,1,OUI,OUI,2025-03-13 05:59:44+00:00,"48.847051143113745, 2.2953405976295476",Paris,75056,0.8717948717948718,6
13121,Bruneseau - Quai d'Ivry,OUI,46,3,43,38,5,OUI,OUI,2025-03-13 06:00:00+00:00,"48.824945637583, 2.3885661363602",Ivry-sur-Seine,94041,0.9347826086956522,6
8037,Monceau - Malesherbes,OUI,37,26,11,6,5,OUI,OUI,2025-03-13 05:58:15+00:00,"48.8795079, 2.3145456",Paris,75056,0.2972972972972973,6
21307,Victor Cresson - Telles de la Poterie,OUI,28,2,26,23,3,OUI,OUI,2025-03-13 06:01:02+00:00,"48.822698842979, 2.2686498274964",Issy-les-Moulineaux,92040,0.9285714285714286,6
11017,Charonne - Bureau,OUI,44,41,3,1,2,OUI,OUI,2025-03-13 05:53:41+00:00,"48.854176, 2.396093",Paris,75056,0.06818181818181818,6
10012,Vinaigriers - Magenta,OUI,24,9,15,13,2,OUI,OUI,2025-03-13 05:59:33+00:00,"48.8731167, 2.3593052",Paris,75056,0.625,6
21306,Place Lafayette,OUI,61,39,22,15,7,OUI,OUI,2025-03-13 05:55:11+00:00,"48.829654975522, 2.2638675570488",Issy-les-Moulineaux,92040,0.36065573770491804,6
21028,Pierre Lefaucheux - Traversière,OUI,34,15,19,18,1,OUI,OUI,2025-03-13 06:00:19+00:00,"48.82435208303827, 2.2417913004755974",Boulogne-Billancourt,92012,0.5588235294117647,6
1021,Halles - Bourdonnais,OUI,19,9,10,7,3,OUI,OUI,2025-03-13 06:00:30+00:00,"48.860448992575, 2.3460162431002",Paris,75056,0.5263157894736842,6
10018,Square Alban Satragne,OUI,28,24,4,3,1,OUI,OUI,2025-03-13 05:58:07+00:00,"48.875388227727, 2.3559567333359",Paris,75056,0.14285714285714285,6
33015,Charles Tillon - Cimetière Communal,OUI,26,1,25,7,18,OUI,OUI,2025-03-13 05:59:26+00:00,"48.91844023641836, 2.3935630917549138",Aubervilliers,93001,0.9615384615384616,6
20108,Jardin de l'Hospice Debrousse,OUI,23,20,3,1,2,OUI,OUI,2025-03-13 05:59:06+00:00,"48.861451061938, 2.40568600595",Paris,75056,0.13043478260869565,6
7017,La Motte-Picquet - La Tour Maubourg,OUI,39,19,20,19,1,OUI,OUI,2025-03-13 05:59:26+00:00,"48.856926701847, 2.3096215831203",Paris,75056,0.5128205128205128,6
13011,Hôpital - Campo-Formio,OUI,11,9,2,0,2,OUI,OUI,2025-03-13 05:56:30+00:00,"48.835405, 2.358218",Paris,75056,0.18181818181818182,6
41205,Maréchal Joffre - Verdun,OUI,20,20,0,0,0,OUI,OUI,2025-03-13 05:57:53+00:00,"48.85385, 2.470307",Fontenay-sous-Bois,94033,0.0,6
8549,George V - Christophe Colomb,OUI,22,17,5,0,5,OUI,OUI,2025-03-13 06:01:05+00:00,"48.87046, 2.30104",Paris,75056,0.22727272727272727,6
22015,Île de la Jatte,OUI,23,22,1,0,1,OUI,OUI,2025-03-13 05:53:59+00:00,"48.894036161302104, 2.2666339203715324",Neuilly-sur-Seine,92051,0.043478260869565216,6
23902,Gallieni - Lycée Charles Petitet,OUI,44,22,22,14,8,OUI,OUI,2025-03-13 05:59:21+00:00,"48.927640283627, 2.3308986340524",Villeneuve-la-Garenne,92078,0.5,6
44005,Place Saint-Just,OUI,19,6,13,8,5,OUI,OUI,2025-03-13 05:58:19+00:00,"48.790379518724265, 2.3895226791501045",Vitry-sur-Seine,94081,0.6842105263157895,6
20007,Buzenval - Avron,OUI,49,47,2,2,0,OUI,OUI,2025-03-13 06:00:52+00:00,"48.851617204999, 2.4015135973077",Paris,75056,0.04081632653061224,6
17119,Toqueville - Cardinet,OUI,31,26,5,4,1,OUI,OUI,2025-03-13 05:56:59+00:00,"48.88490187110713, 2.3109393194317818",Paris,75056,0.16129032258064516,6
17015,Place de Lévis,OUI,48,33,15,2,13,OUI,OUI,2025-03-13 05:59:06+00:00,"48.883546851533254, 2.3131933808326726",Paris,75056,0.3125,6
9004,Gérando - Rochechouart,OUI,21,13,8,1,7,OUI,OUI,2025-03-13 06:00:51+00:00,"48.88294340845, 2.3464846238494",Paris,75056,0.38095238095238093,6
22501,Théâtre de La Garenne,OUI,20,14,6,3,3,OUI,OUI,2025-03-13 05:59:47+00:00,"48.905658361454, 2.2345951981176",La Garenne-Colombes,92035,0.3,6
51002,Placette Grégoire Collas,OUI,25,14,11,5,6,OUI,OUI,2025-03-13 06:00:40+00:00,"48.94342014002797, 2.2487476095557213",Argenteuil,95018,0.44,6
42003,Place de l'Insurrection d'Août 1944,OUI,30,8,22,21,1,OUI,OUI,2025-03-13 06:00:45+00:00,"48.81477852751594, 2.398074567317963",Ivry-sur-Seine,94041,0.7333333333333333,6
33016,Fort d'Aubervilliers,OUI,20,7,13,11,2,OUI,OUI,2025-03-13 06:01:01+00:00,"48.91502382370325, 2.4035281687974925",Aubervilliers,93001,0.65,6
4001,Arcole - Notre-Dame,OUI,27,20,7,2,5,OUI,OUI,2025-03-13 05:58:29+00:00,"48.853883541328, 2.3493797332048",Paris,75056,0.25925925925925924,6
6012,Saint-Germain - Ciseaux,OUI,16,15,1,1,0,OUI,OUI,2025-03-13 06:00:10+00:00,"48.853305277595, 2.3344654618827",Paris,75056,0.0625,6
12043,Daumesnil - Hébrard,OUI,39,10,29,26,3,OUI,OUI,2025-03-13 06:00:54+00:00,"48.8429, 2.38474",Paris,75056,0.7435897435897436,6
13009,Auguste Blanqui - Corvisart,OUI,26,12,14,6,8,OUI,OUI,2025-03-13 05:56:17+00:00,"48.8300989, 2.3502726",Paris,75056,0.5384615384615384,6
23003,Président Wilson - Baudin,OUI,27,18,9,8,1,OUI,OUI,2025-03-13 06:00:56+00:00,"48.89826887103676, 2.2849336266517644",Levallois-Perret,92044,0.3333333333333333,6
27005,Gare du Stade,OUI,18,12,6,1,5,OUI,OUI,2025-03-13 05:53:21+00:00,"48.9312676, 2.2603778",Colombes,92025,0.3333333333333333,6
44007,Camille Groult - Guy Môquet,OUI,21,5,16,13,3,OUI,OUI,2025-03-13 06:00:58+00:00,"48.787482746521306, 2.3976725712418556",Vitry-sur-Seine,94081,0.7619047619047619,6
15071,Suffren - Champ de Mars,OUI,21,6,15,13,2,OUI,OUI,2025-03-13 05:58:30+00:00,"48.8547194, 2.2952168",Paris,75056,0.7142857142857143,6
4002,Marché aux fleurs,OUI,18,14,4,3,1,OUI,OUI,2025-03-13 06:00:45+00:00,"48.855258115391, 2.3473754525185",Paris,75056,0.2222222222222222,6
8201,Arsène Houssaye - Friedland,OUI,29,27,2,0,2,OUI,OUI,2025-03-13 05:52:24+00:00,"48.874510616163, 2.2994716674148",Paris,75056,0.06896551724137931,6
10105,Mazagran - Bonne Nouvelle,OUI,25,15,10,9,1,OUI,OUI,2025-03-13 06:00:37+00:00,"48.870047123655, 2.3511248454452",Paris,75056,0.4,6
17111,Lemercier - Cardinet,OUI,23,12,11,5,6,OUI,OUI,2025-03-13 05:59:44+00:00,"48.890097168851746, 2.317377626895905",Paris,75056,0.4782608695652174,6
17003,Jacques Kellner - Saint-Ouen,OUI,43,36,7,5,2,OUI,OUI,2025-03-13 05:55:05+00:00,"48.895809485802886, 2.327897409164145",Paris,75056,0.16279069767441862,6
21319,Esplanade du Foncet - Camille Desmoulins,OUI,27,4,23,19,4,OUI,OUI,2025-03-13 06:00:27+00:00,"48.827090233494964, 2.2606857866048813",Issy-les-Moulineaux,92040,0.8518518518518519,6
13109,Brillat-Savarin - Küss,OUI,19,7,12,6,6,OUI,OUI,2025-03-13 06:00:41+00:00,"48.822203, 2.350422",Paris,75056,0.631578947368421,6
9006,Dunkerque - Trudaine,OUI,16,11,5,0,5,OUI,OUI,2025-03-13 05:51:15+00:00,"48.88215166773376, 2.3463253676891327",Paris,75056,0.3125,6
21204,Estienne d'Orves - Henri Ginoux,OUI,31,26,5,1,4,OUI,OUI,2025-03-13 06:01:02+00:00,"48.815388220397274, 2.320886790760933",Montrouge,92049,0.16129032258064516,6
8116,Champs-Elysees - Bassano,OUI,25,25,0,0,0,NON,NON,2021-02-21 19:09:18+00:00,"48.871811807816, 2.300238981843",Paris,75056,0.0,19
43001,Paris - Laitières,OUI,22,16,6,1,5,OUI,OUI,2025-03-13 06:00:56+00:00,"48.84630274151258, 2.4207553267478947",Vincennes,94080,0.2727272727272727,6
5024,Place Monge,OUI,21,18,3,0,3,OUI,OUI,2025-03-13 05:56:59+00:00,"48.842761803051, 2.3524079471827",Paris,75056,0.14285714285714285,6
11021,Charonne - Pierre Bayle,OUI,23,12,11,5,6,OUI,OUI,2025-03-13 06:00:30+00:00,"48.858445054262, 2.3903981223891",Paris,75056,0.4782608695652174,6
12038,Picpus - Louis Braille,OUI,43,37,6,4,2,OUI,OUI,2025-03-13 05:56:28+00:00,"48.839988788912, 2.4005256685521",Paris,75056,0.13953488372093023,6
21217,Louis Rolland - République,OUI,26,13,13,4,9,OUI,OUI,2025-03-13 05:58:24+00:00,"48.81710889740748, 2.3193106434955717",Montrouge,92049,0.5,6
9011,Geoffroy - Marie,OUI,18,13,5,5,0,OUI,OUI,2025-03-13 05:57:10+00:00,"48.873781940593325, 2.344513876337893",Paris,75056,0.2777777777777778,6
16011,Victor Hugo - La Pompe,OUI,40,24,16,1,15,OUI,OUI,2025-03-13 06:00:23+00:00,"48.86795222470859, 2.28146318346262",Paris,75056,0.4,6
12028,Vivaldi - Antoine-Julien Hénard,OUI,27,14,13,8,5,OUI,OUI,2025-03-13 05:57:28+00:00,"48.841923663276546, 2.389728979467376",Paris,75056,0.48148148148148145,6
12007,Gare de Lyon - Chalon,OUI,45,25,20,13,7,OUI,OUI,2025-03-13 05:58:35+00:00,"48.845666194202, 2.3741452395916",Paris,75056,0.4444444444444444,6
9034,Godot de Mauroy - Madeleine,OUI,21,15,6,1,5,OUI,OUI,2025-03-13 05:59:32+00:00,"48.869789, 2.326347",Paris,75056,0.2857142857142857,6
47001,Place de la Gare,OUI,45,2,43,37,6,OUI,OUI,2025-03-13 06:00:40+00:00,"48.80253358011283, 2.4275037646293645",Maisons-Alfort,94046,0.9555555555555556,6
12035,Madagascar - Meuniers,OUI,32,15,17,17,0,OUI,OUI,2025-03-13 05:56:49+00:00,"48.83460464474706, 2.3970650508999825",Paris,75056,0.53125,6
10165,Gare de l'Est - Place du 11 Novembre 1918,OUI,39,30,9,8,1,OUI,OUI,2025-03-13 06:00:57+00:00,"48.876327, 2.3585464",Paris,75056,0.23076923076923078,6
10021,Marché Saint-Quentin,OUI,14,11,3,0,3,OUI,OUI,2025-03-13 05:57:39+00:00,"48.877356057652, 2.3545114456374",Paris,75056,0.21428571428571427,6
13128,Quai de la Gare - Pont de Bercy,OUI,29,8,21,17,4,OUI,OUI,2025-03-13 05:58:03+00:00,"48.83730787972, 2.3740861260598",Paris,75056,0.7241379310344828,6
41211,Louis Xavier de Ricard - Ancienne Mairie,OUI,34,30,4,2,2,OUI,OUI,2025-03-13 05:59:58+00:00,"48.84629899065091, 2.472420372068882",Fontenay-sous-Bois,94033,0.11764705882352941,6
92001,Mairie de quartier du Plateau - Mont-Valérien,OUI,20,7,13,4,9,OUI,OUI,2025-03-13 06:00:04+00:00,"48.8799933, 2.2072437",Nanterre,92050,0.65,6
21707,Square Etienne Jarousse,OUI,22,18,4,3,1,OUI,OUI,2025-03-13 05:58:13+00:00,"48.82485182597129, 2.2925933450460434",Vanves,92075,0.18181818181818182,6
43010,La Jarry - Place Diderot,OUI,25,14,11,6,5,OUI,OUI,2025-03-13 06:01:02+00:00,"48.849726940367326, 2.452013790607453",Vincennes,94080,0.44,6
4019,Cloître Saint-Merri - Renard,OUI,29,13,16,12,4,OUI,OUI,2025-03-13 06:01:01+00:00,"48.858835448898, 2.3518279194832",Paris,75056,0.5517241379310345,6
17107,Berthier - Place Stuart Merril,OUI,36,19,17,12,5,OUI,OUI,2025-03-13 05:59:38+00:00,"48.885927922355044, 2.2933450341224675",Paris,75056,0.4722222222222222,6
5001,Harpe - Saint-Germain,OUI,43,34,9,7,2,OUI,OUI,2025-03-13 05:59:29+00:00,"48.851518815017, 2.3436703160405",Paris,75056,0.20930232558139536,6
15057,Lucien Bossoutrot - Général Martial Vallin,OUI,38,18,20,10,10,OUI,OUI,2025-03-13 05:55:15+00:00,"48.836956046311, 2.2741072252393",Paris,75056,0.5263157894736842,6
15129,Hôpital Necker,OUI,39,29,10,7,3,OUI,OUI,2025-03-13 06:00:02+00:00,"48.846043490118454, 2.313245013356209",Paris,75056,0.2564102564102564,6
16002,Pergolèse - Malakoff,OUI,37,34,3,0,3,OUI,OUI,2025-03-13 05:59:58+00:00,"48.87521088779225, 2.2842781618237495",Paris,75056,0.08108108108108109,6
51001,Gare d'Argenteuil,OUI,37,18,19,3,16,OUI,OUI,2025-03-13 05:59:30+00:00,"48.947022436806705, 2.256898172199726",Argenteuil,95018,0.5135135135135135,6
15004,Vaugirard - Pasteur,OUI,21,3,18,17,1,OUI,OUI,2025-03-13 05:59:40+00:00,"48.84040868803496, 2.3154367133975033",Paris,75056,0.8571428571428571,6
6022,Marché Saint-Germain,OUI,18,13,5,5,0,OUI,OUI,2025-03-13 05:59:44+00:00,"48.85165625855281, 2.335500307381153",Paris,75056,0.2777777777777778,6
23010,Voltaire - Anatole France,OUI,25,21,4,1,3,OUI,OUI,2025-03-13 05:54:04+00:00,"48.891999360256904, 2.284262739121914",Levallois-Perret,92044,0.16,6
15006,Cherche-Midi - Hôpital Necker,OUI,37,37,0,0,0,OUI,OUI,2025-03-13 05:52:11+00:00,"48.84461063309956, 2.317914068698883",Paris,75056,0.0,6
19128,Quai de l'Oise - Aisne,OUI,28,14,14,3,11,OUI,OUI,2025-03-13 05:59:19+00:00,"48.8906231, 2.3833701",Paris,75056,0.5,6
15127,Place Charles Michels,OUI,35,17,18,15,3,OUI,OUI,2025-03-13 05:56:51+00:00,"48.846401, 2.28502",Paris,75056,0.5142857142857142,6
15005,Place Jacques et Thérèse Tréfouël,OUI,41,12,29,21,8,OUI,OUI,2025-03-13 06:00:16+00:00,"48.842726498317, 2.3125657439232",Paris,75056,0.7073170731707317,6
33103,Jean Jaurès - Jules Jacquemin,OUI,22,8,14,2,12,OUI,OUI,2025-03-13 05:58:33+00:00,"48.88433053604843, 2.4082902455152104",Le Pré-Saint-Gervais,93061,0.6363636363636364,6
18006,Square Louise Michel,OUI,35,31,4,0,4,OUI,OUI,2025-03-13 05:59:18+00:00,"48.884687354509, 2.3441386967897",Paris,75056,0.11428571428571428,6
14032,Mairie du 14ème,OUI,31,24,7,1,6,OUI,OUI,2025-03-13 05:58:00+00:00,"48.83254578123, 2.3254923149943",Paris,75056,0.22580645161290322,6
21401,Mairie de Clamart,OUI,31,28,3,1,2,OUI,OUI,2025-03-13 05:57:49+00:00,"48.800612, 2.262151",Clamart,92023,0.0967741935483871,6
14011,Place des Droits de l'Enfant,OUI,37,30,7,3,4,OUI,OUI,2025-03-13 06:00:57+00:00,"48.8274804, 2.3319217",Paris,75056,0.1891891891891892,6
9027,Douai - Pierre Fontaine,OUI,23,20,3,2,1,OUI,OUI,2025-03-13 05:59:56+00:00,"48.88229101148092, 2.33324121683836",Paris,75056,0.13043478260869565,6
6002,Saint-Benoît - Jacob,OUI,22,20,2,2,0,OUI,OUI,2025-03-13 05:55:24+00:00,"48.85545136013941, 2.3334722220897675",Paris,75056,0.09090909090909091,6
17108,Bessières - Porte de Clichy,OUI,29,15,14,10,4,OUI,OUI,2025-03-13 06:01:05+00:00,"48.89611762451474, 2.31790903955698",Paris,75056,0.4827586206896552,6
2013,Favart - Italiens,OUI,17,14,3,2,1,OUI,OUI,2025-03-13 05:57:43+00:00,"48.871446353921, 2.3382901058508",Paris,75056,0.17647058823529413,6
11033,Bréguet - Sabin,OUI,30,9,21,20,1,OUI,OUI,2025-03-13 05:59:26+00:00,"48.856931678257, 2.3706749462105",Paris,75056,0.7,6
4020,Place Edmond Michelet,OUI,23,18,5,5,0,OUI,OUI,2025-03-13 06:00:33+00:00,"48.860134890542, 2.3500636965036",Paris,75056,0.21739130434782608,6
10033,Gare du Nord - Saint-Vincent de Paul,OUI,24,16,8,3,5,OUI,OUI,2025-03-13 05:57:46+00:00,"48.880955741648, 2.3524305148385",Paris,75056,0.3333333333333333,6
23004,Paul Vaillant-Couturier - Victor Hugo,OUI,33,14,19,16,3,OUI,OUI,2025-03-13 05:59:04+00:00,"48.89819702263572, 2.293848017974069",Levallois-Perret,92044,0.5757575757575758,6
22408,Place du 14 Juillet,OUI,22,22,0,0,0,OUI,OUI,2025-03-13 05:57:54+00:00,"48.819266959525, 2.3011998832226",Malakoff,92046,0.0,6
20022,Porte de Bagnolet,OUI,32,31,1,1,0,OUI,OUI,2025-03-13 06:00:35+00:00,"48.864707139122984, 2.408344637349607",Paris,75056,0.03125,6
5012,Estrapade - Ulm,OUI,16,15,1,0,1,OUI,OUI,2025-03-13 05:58:34+00:00,"48.84512772828, 2.3454568170362",Paris,75056,0.0625,6
12036,Reuilly - Place Felix Eboue,OUI,40,35,5,0,5,OUI,OUI,2025-03-13 05:59:59+00:00,"48.84030274499962, 2.394630398715453",Paris,75056,0.125,6
15311,Quai du Président Roosevelt - Pont Aval,OUI,30,15,15,14,1,OUI,OUI,2025-03-13 05:58:35+00:00,"48.8343883676388, 2.2656820714473724",Paris,75056,0.5,6
14026,Plantes - Moulin Vert,OUI,44,44,0,0,0,OUI,OUI,2025-03-13 05:59:51+00:00,"48.83005755305626, 2.3232302069664006",Paris,75056,0.0,6
35006,Delizy - Louis Nadot,OUI,21,20,1,0,1,OUI,OUI,2025-03-13 05:51:08+00:00,"48.896212845581346, 2.4094578623771667",Pantin,93055,0.047619047619047616,6
8117,Place de la Madeleine - Royale,OUI,41,35,6,3,3,OUI,OUI,2025-03-13 05:59:33+00:00,"48.869228052648, 2.324421107769",Paris,75056,0.14634146341463414,6
12018,Saint-Mandé - Fabre d'Eglantine,OUI,33,23,10,6,4,OUI,OUI,2025-03-13 05:59:27+00:00,"48.8453579, 2.3965022",Paris,75056,0.30303030303030304,6
48004,Maxime Gorki - Louis Aragon,OUI,19,11,8,1,7,OUI,OUI,2025-03-13 05:58:20+00:00,"48.78909814728443, 2.368387877941132",Villejuif,94076,0.42105263157894735,6
44016,Balzac - Olympes de Gouges,OUI,28,10,18,8,10,OUI,OUI,2025-03-13 05:55:19+00:00,"48.77850332486751, 2.4006786569952965",Vitry-sur-Seine,94081,0.6428571428571429,6
14001,Edgar Quinet - Gaité,OUI,27,25,2,2,0,OUI,OUI,2025-03-13 06:00:01+00:00,"48.841160928966, 2.324595451355",Paris,75056,0.07407407407407407,6
15011,Cambronne - Villa Croix Nivert,OUI,62,26,36,35,1,OUI,OUI,2025-03-13 06:00:47+00:00,"48.845847561366, 2.3017574474216",Paris,75056,0.5806451612903226,6
18139,Poissonniers - Championnet,OUI,27,21,6,3,3,OUI,OUI,2025-03-13 06:00:21+00:00,"48.89543299733937, 2.3530178144574165",Paris,75056,0.2222222222222222,6
32601,Porte des Lilas - Faidherbe,OUI,39,24,15,6,9,OUI,OUI,2025-03-13 06:00:32+00:00,"48.87861855668978, 2.4120327830314636",Les Lilas,93045,0.38461538461538464,6
19110,Square Claude Bernard,OUI,28,23,5,3,2,OUI,OUI,2025-03-13 06:00:09+00:00,"48.89876016219984, 2.375325746834278",Paris,75056,0.17857142857142858,6
12026,Place Ginette Hamelin,OUI,50,27,23,20,3,OUI,OUI,2025-03-13 05:59:45+00:00,"48.837853, 2.382064",Paris,75056,0.46,6
16105,Crevaux - Bugeaud,OUI,31,26,5,2,3,OUI,OUI,2025-03-13 05:57:10+00:00,"48.87080942867, 2.2811490076919",Paris,75056,0.16129032258064516,6
10162,Alexandre Parodi - Quai de Valmy,OUI,23,16,7,4,3,OUI,OUI,2025-03-13 06:00:17+00:00,"48.879359419425, 2.3665961623192",Paris,75056,0.30434782608695654,6
3008,Perle - Vieille du Temple,OUI,35,22,13,13,0,OUI,OUI,2025-03-13 05:57:40+00:00,"48.8601346, 2.3611206",Paris,75056,0.37142857142857144,6
9024,Taitbout - La Fayette,OUI,51,45,6,3,3,OUI,OUI,2025-03-13 05:58:19+00:00,"48.8733298892, 2.3352625966072",Paris,75056,0.11764705882352941,6
6010,Chevreuse - Montparnasse,OUI,15,12,3,1,2,OUI,OUI,2025-03-13 06:00:06+00:00,"48.841739161231, 2.3315522167367",Paris,75056,0.2,6
9102,Londres - Place d'Estienne d'Orves,OUI,24,21,3,1,2,OUI,OUI,2025-03-13 05:57:19+00:00,"48.876693805756986, 2.3305362090468407",Paris,75056,0.125,6
45002,Roger Salengro - Général de Gaulle,OUI,27,7,20,5,15,OUI,OUI,2025-03-13 05:58:50+00:00,"48.820029010376956, 2.4846760556101803",Champigny-sur-Marne,94017,0.7407407407407407,6
18030,Joseph Dijon - Ornano,OUI,37,31,6,5,1,OUI,OUI,2025-03-13 05:56:32+00:00,"48.89374453351521, 2.3476678133010864",Paris,75056,0.16216216216216217,6
15128,Cadix - Hameau,OUI,36,10,26,17,9,OUI,OUI,2025-03-13 05:59:47+00:00,"48.8340107632249, 2.289516180753708",Paris,75056,0.7222222222222222,6
92006,Place Nelson Mandela,OUI,30,29,1,0,1,OUI,OUI,2025-03-13 05:55:24+00:00,"48.897874318180556, 2.2182820737361912",Nanterre,92050,0.03333333333333333,6
12037,Reuilly - Daumesnil,OUI,36,22,14,8,6,OUI,OUI,2025-03-13 05:57:58+00:00,"48.8395385, 2.3972516",Paris,75056,0.3888888888888889,6
31005,Square Denise Buisson,OUI,45,36,9,4,5,OUI,OUI,2025-03-13 05:56:42+00:00,"48.8562322730982, 2.426436245441437",Montreuil,93048,0.2,6
1007,Turbigo - Française,OUI,16,12,4,2,2,OUI,OUI,2025-03-13 05:56:26+00:00,"48.86358858111446, 2.3477794602513313",Paris,75056,0.25,6
21314,Chemin de Bretagne,OUI,28,8,20,14,6,OUI,OUI,2025-03-13 06:01:06+00:00,"48.824753068884, 2.2588385956052",Issy-les-Moulineaux,92040,0.7142857142857143,6
16013,Mairie du 16ème,OUI,35,32,3,1,2,OUI,OUI,2025-03-13 05:53:41+00:00,"48.863936848471994, 2.2765953093767166",Paris,75056,0.08571428571428572,6
12005,Crozatier - Faubourg Saint-Antoine,OUI,39,6,33,32,1,OUI,OUI,2025-03-13 05:58:52+00:00,"48.850440013405, 2.378901366211",Paris,75056,0.8461538461538461,6
20008,Pyrénées - Avron,OUI,31,31,0,0,0,OUI,OUI,2025-03-13 05:59:16+00:00,"48.853246898211985, 2.405871044529538",Paris,75056,0.0,6
13516,Glacière - Soeur Catherine Marie,OUI,40,22,18,15,3,OUI,OUI,2025-03-13 05:56:03+00:00,"48.829522989420596, 2.343570403754711",Paris,75056,0.45,6
18034,Leibniz - Jean Dollfus,OUI,32,24,8,5,3,OUI,OUI,2025-03-13 05:58:43+00:00,"48.896328348515986, 2.333390423834684",Paris,75056,0.25,6
12155,Rottembourg - Général Michel Bizot,OUI,43,6,37,32,5,OUI,OUI,2025-03-13 06:00:28+00:00,"48.83787825992554, 2.4044052511453633",Paris,75056,0.8604651162790697,6
20104,Louis Lumière.,OUI,22,18,4,0,4,OUI,OUI,2025-03-13 05:53:54+00:00,"48.86216198070008, 2.41112578185621",Paris,75056,0.18181818181818182,6
5115,Buffon - Jardin des Plantes,OUI,28,8,20,18,2,OUI,OUI,2025-03-13 05:56:44+00:00,"48.842668466104875, 2.3618587106466293",Paris,75056,0.7142857142857143,6
14135,Jourdan - Cité Universitaire,OUI,39,25,14,8,6,OUI,OUI,2025-03-13 06:01:04+00:00,"48.819897343156676, 2.3397007964124366",Paris,75056,0.358974358974359,6
44011,Lebrun - Colonel Fabien,OUI,27,23,4,2,2,OUI,OUI,2025-03-13 05:58:39+00:00,"48.78266870733145, 2.381317801773548",Vitry-sur-Seine,94081,0.14814814814814814,6
8110,Gare Saint-Lazare - Stockholm,OUI,31,20,11,3,8,OUI,OUI,2025-03-13 05:59:12+00:00,"48.877127316667654, 2.322417162358761",Paris,75056,0.3548387096774194,6
2108,Vivienne - Montmartre,OUI,37,28,9,3,6,OUI,OUI,2025-03-13 06:00:26+00:00,"48.871347597383, 2.3414588347077",Paris,75056,0.24324324324324326,6
20024,Gambetta - Père Lachaise,OUI,27,21,6,1,5,OUI,OUI,2025-03-13 05:52:00+00:00,"48.864295696165875, 2.398228667282044",Paris,75056,0.2222222222222222,6
12101,Charenton - Prague,OUI,28,3,25,21,4,OUI,OUI,2025-03-13 06:00:05+00:00,"48.848175129981, 2.3763584494312",Paris,75056,0.8928571428571429,6
12156,Niger - Soult,OUI,22,10,12,6,6,OUI,OUI,2025-03-13 06:00:04+00:00,"48.84369906369085, 2.410361237220498",Paris,75056,0.5454545454545454,6
8027,Mairie du 8ème,OUI,14,12,2,1,1,OUI,OUI,2025-03-13 05:57:51+00:00,"48.877932, 2.318264",Paris,75056,0.14285714285714285,6
18140,Porte de Clignancourt - Ney,OUI,39,28,11,3,8,OUI,OUI,2025-03-13 05:58:51+00:00,"48.899641123987095, 2.344321422278881",Paris,75056,0.28205128205128205,6
15039,Abbé Groult - Convention,OUI,17,7,10,6,4,OUI,OUI,2025-03-13 05:59:09+00:00,"48.83596927866069, 2.302064039509349",Paris,75056,0.5882352941176471,6
21315,Jules Guesdes - Général de Gaulle,OUI,24,9,15,4,11,OUI,OUI,2025-03-13 05:59:14+00:00,"48.81930581291959, 2.278934195637703",Issy-les-Moulineaux,92040,0.625,6
9009,Square Montholon,OUI,20,13,7,5,2,OUI,OUI,2025-03-13 05:58:24+00:00,"48.876620377545024, 2.3457641154527664",Paris,75056,0.35,6
23102,Hôtel de Ville de Sèvres,OUI,31,18,13,9,4,OUI,OUI,2025-03-13 05:58:22+00:00,"48.824363561289, 2.2131047397852",Sèvres,92072,0.41935483870967744,6
10034,Louis Blanc - La Chapelle,OUI,21,12,9,0,9,OUI,OUI,2025-03-13 06:00:02+00:00,"48.884008964514, 2.3599335551262",Paris,75056,0.42857142857142855,6
15036,Croix Nivert - Square Saint-Lambert,OUI,47,47,0,0,0,NON,NON,2025-03-03 09:03:43+00:00,"48.843051521591, 2.2952004522085",Paris,75056,0.0,9
6104,Herschel - Observatoire,OUI,36,29,7,3,4,OUI,OUI,2025-03-13 05:55:24+00:00,"48.84342376221923, 2.3376645147800446",Paris,75056,0.19444444444444445,6
21402,Place Aimé Césaire,OUI,27,25,2,0,2,OUI,OUI,2025-03-13 05:59:34+00:00,"48.783194713067815, 2.2429127991199493",Clamart,92023,0.07407407407407407,6
21309,Mairie d'Issy,OUI,40,25,15,6,9,OUI,OUI,2025-03-13 05:59:41+00:00,"48.823767792468, 2.2723111510277",Issy-les-Moulineaux,92040,0.375,6
41403,Gare RER - Malleret-Joinville,OUI,20,1,19,16,3,OUI,OUI,2025-03-13 05:59:13+00:00,"48.802936, 2.42531",Alfortville,94002,0.95,6
20034,Sorbier - Ménilmontant,OUI,23,21,2,0,2,OUI,OUI,2025-03-13 05:57:34+00:00,"48.868542395661, 2.3897721245885",Paris,75056,0.08695652173913043,6
13018,Bruant - Vincent Auriol,OUI,25,11,14,4,10,OUI,OUI,2025-03-13 05:59:42+00:00,"48.834848452929, 2.3668264996271",Paris,75056,0.56,6
13005,Cordelières - Arago,OUI,43,7,36,28,8,OUI,OUI,2025-03-13 06:01:05+00:00,"48.83548071896613, 2.348572461702221",Paris,75056,0.8372093023255814,6
21303,Jean Monnet - Iles,OUI,32,2,30,30,0,OUI,OUI,2025-03-13 06:01:03+00:00,"48.823393984057304, 2.2497073194874866",Issy-les-Moulineaux,92040,0.9375,6
19002,Centquatre,OUI,38,17,21,0,21,NON,NON,2025-03-13 05:58:38+00:00,"48.889333538455, 2.3707854375243",Paris,75056,0.5526315789473685,6
33014,Parc Eli Lotar,OUI,19,3,16,10,6,OUI,OUI,2025-03-13 05:57:44+00:00,"48.91844993053703, 2.3727085813879967",Aubervilliers,93001,0.8421052631578947,6
17019,Phalsbourg - Villiers,OUI,19,14,5,0,5,OUI,OUI,2025-03-13 06:00:26+00:00,"48.88242307900951, 2.3090453445911407",Paris,75056,0.2631578947368421,6
9007,Condorcet - Turgot,OUI,19,15,4,2,2,OUI,OUI,2025-03-13 05:57:46+00:00,"48.87985155789093, 2.345232367515564",Paris,75056,0.21052631578947367,6
19010,Emile Reynaud - Porte de la Villette,OUI,22,5,17,3,14,OUI,OUI,2025-03-13 05:59:37+00:00,"48.90098953630053, 2.3887022584676743",Paris,75056,0.7727272727272727,6
13052,Leredde - Tolbiac,OUI,44,33,11,8,3,OUI,OUI,2025-03-13 06:00:56+00:00,"48.82887629664, 2.3744382709265",Paris,75056,0.25,6
10009,Mairie du 10ème,OUI,18,3,15,14,1,OUI,OUI,2025-03-13 05:58:56+00:00,"48.872089449907, 2.3575825989246",Paris,75056,0.8333333333333334,6
17024,Villiers - Batignolles,OUI,22,17,5,3,2,OUI,OUI,2025-03-13 05:55:50+00:00,"48.88125253846116, 2.31653843075037",Paris,75056,0.22727272727272727,6
15132,Bargue -  Dutot,OUI,21,12,9,4,5,OUI,OUI,2025-03-13 05:59:01+00:00,"48.837884, 2.308876",Paris,75056,0.42857142857142855,6
20105,Benoît Frachon - République,OUI,28,25,3,2,1,OUI,OUI,2025-03-13 05:59:58+00:00,"48.85230729014318, 2.415605485439301",Paris,75056,0.10714285714285714,6
20006,Pyrénées - Plaine,OUI,12,2,10,3,7,OUI,OUI,2025-03-13 05:58:33+00:00,"48.85026702458, 2.4062821269035",Paris,75056,0.8333333333333334,6
41401,Marne - Charles de Gaulle,OUI,26,7,19,17,2,OUI,OUI,2025-03-13 05:59:19+00:00,"48.815071719544434, 2.4121668934822087",Alfortville,94002,0.7307692307692307,6
21953,Gare de Bellevue,OUI,20,15,5,1,4,OUI,OUI,2025-03-13 05:54:31+00:00,"48.8192404685572, 2.2295309230685234",Meudon,92048,0.25,6
14031,Didot - Place de Moro-Giafferi,OUI,19,17,2,1,1,OUI,OUI,2025-03-13 05:56:05+00:00,"48.8337, 2.3215",Paris,75056,0.10526315789473684,6
14137,Maurice d'Ocagne - General Maudhuy,OUI,29,19,10,5,5,OUI,OUI,2025-03-13 05:51:38+00:00,"48.82414282524159, 2.3158789426088333",Paris,75056,0.3448275862068966,6
20044,Davout - Volga,OUI,27,21,6,4,2,OUI,OUI,2025-03-13 06:00:57+00:00,"48.852919679957296, 2.410522909779111",Paris,75056,0.2222222222222222,6
14019,Sarrette - Général Leclerc,OUI,21,21,0,0,0,OUI,OUI,2025-03-13 06:00:54+00:00,"48.825030852925, 2.3264128693982",Paris,75056,0.0,6
16019,Porte de la Muette,OUI,34,30,4,3,1,OUI,OUI,2025-03-13 05:56:41+00:00,"48.86302317841182, 2.2687188170157406",Paris,75056,0.11764705882352941,6
3011,Turbigo - Réaumur,OUI,31,7,24,16,8,OUI,OUI,2025-03-13 06:01:01+00:00,"48.865574047531, 2.3564198613167",Paris,75056,0.7741935483870968,6
33012,Landy - Heurtault,OUI,29,15,14,4,10,OUI,OUI,2025-03-13 05:59:52+00:00,"48.915096534520316, 2.375951372087002",Aubervilliers,93001,0.4827586206896552,6
31709,Place de la Fraternité,OUI,22,12,10,0,10,OUI,OUI,2025-03-13 06:00:10+00:00,"48.85716405838368, 2.422847449779511",Montreuil,93048,0.45454545454545453,6
3102,Bourg l'Abbé - Saint-Martin,OUI,36,19,17,15,2,OUI,OUI,2025-03-13 06:00:18+00:00,"48.86393331949257, 2.352406270802021",Paris,75056,0.4722222222222222,6
21506,Maurice Payret-Dortail,OUI,22,19,3,1,2,OUI,OUI,2025-03-13 05:58:07+00:00,"48.87811957063342, 2.2233625128865246",Suresnes,92073,0.13636363636363635,6
10019,Paradis - Hauteville,OUI,31,14,17,10,7,OUI,OUI,2025-03-13 05:58:46+00:00,"48.874999954666755, 2.3522757401923404",Paris,75056,0.5483870967741935,6
3001,Beaumarchais - Saint-Gilles,OUI,44,23,21,19,2,OUI,OUI,2025-03-13 05:59:28+00:00,"48.8580378, 2.3679352",Paris,75056,0.4772727272727273,6
41203,Stalingrad - Rigollots,OUI,49,33,16,7,9,OUI,OUI,2025-03-13 05:56:47+00:00,"48.84997403844251, 2.45557576417923",Fontenay-sous-Bois,94033,0.32653061224489793,6
9037,Parme - Clichy,OUI,24,22,2,0,2,OUI,OUI,2025-03-13 05:57:03+00:00,"48.881266424227, 2.3281970934506",Paris,75056,0.08333333333333333,6
18039,Jardins d'Eole,OUI,18,13,5,2,3,OUI,OUI,2025-03-13 05:59:56+00:00,"48.8869703, 2.3668488",Paris,75056,0.2777777777777778,6
7021,Bosquet - Saint-Dominique,OUI,28,9,19,17,2,OUI,OUI,2025-03-13 06:00:04+00:00,"48.858651709526, 2.3037165802346",Paris,75056,0.6785714285714286,6
2015,Louis le Grand - Italiens,OUI,32,28,4,0,4,OUI,OUI,2025-03-13 05:55:06+00:00,"48.870508937204, 2.3340544619393",Paris,75056,0.125,6
10008,Cité Riverin - Château d'Eau,OUI,18,4,14,14,0,OUI,OUI,2025-03-13 05:59:47+00:00,"48.870702423554306, 2.358739863900845",Paris,75056,0.7777777777777778,6
21026,Sèvres - Général Leclerc,OUI,29,19,10,8,2,OUI,OUI,2025-03-13 06:00:09+00:00,"48.830121559055, 2.2314262390137",Boulogne-Billancourt,92012,0.3448275862068966,6
16012,Flandrin - Longchamp,OUI,40,27,13,7,6,OUI,OUI,2025-03-13 05:59:26+00:00,"48.86877849178477, 2.274354539176829",Paris,75056,0.325,6
20029,Frères Flavien - Porte des Lilas,OUI,23,14,9,4,5,OUI,OUI,2025-03-13 05:52:35+00:00,"48.8780992764359, 2.41104629853209",Paris,75056,0.391304347826087,6
16036,Porte Molitor,OUI,58,32,26,22,4,OUI,OUI,2025-03-13 05:59:47+00:00,"48.84524763511433, 2.2569015249609947",Paris,75056,0.4482758620689655,6
2003,Saint-Denis - Réaumur,OUI,31,18,13,13,0,OUI,OUI,2025-03-13 05:59:08+00:00,"48.8661116315789, 2.3507790675507594",Paris,75056,0.41935483870967744,6
42505,Charles Frérot - Albert Guilpin,OUI,29,13,16,9,7,OUI,OUI,2025-03-13 06:00:13+00:00,"48.8155839183714, 2.3505029082298283",Gentilly,94037,0.5517241379310345,6
22503,Joffre - Aigle,OUI,19,8,11,3,8,OUI,OUI,2025-03-13 05:56:12+00:00,"48.904033, 2.245096",La Garenne-Colombes,92035,0.5789473684210527,6
10032,Claude Vellefaux - Hôpital Saint-Louis,OUI,31,22,9,8,1,OUI,OUI,2025-03-13 06:00:12+00:00,"48.872859139003, 2.3700717069851",Paris,75056,0.2903225806451613,6
13017,Nationale - Vincent Auriol,OUI,33,27,6,1,5,OUI,OUI,2025-03-13 05:57:35+00:00,"48.83252708397293, 2.362354410392119",Paris,75056,0.18181818181818182,6
12015,Place de la Nation - Picpus,OUI,36,20,16,3,13,OUI,OUI,2025-03-13 06:01:02+00:00,"48.846821681548, 2.4001130461693",Paris,75056,0.4444444444444444,6
15111,Olivier de Serres - Leriche,OUI,24,13,11,4,7,OUI,OUI,2025-03-13 06:00:18+00:00,"48.83460221715206, 2.2957482933998112",Paris,75056,0.4583333333333333,6
26004,Gare RER les Grésillons,OUI,22,12,10,9,1,OUI,OUI,2025-03-13 06:01:04+00:00,"48.919898633572764, 2.31458459136273",Asnières-sur-Seine,92004,0.45454545454545453,6
12020,Cours de Vincennes - Soult,OUI,44,35,9,6,3,OUI,OUI,2025-03-13 05:59:10+00:00,"48.846918761569, 2.4105220288038",Paris,75056,0.20454545454545456,6
16042,Murat - Porte de Saint-Cloud,OUI,38,3,35,30,5,OUI,OUI,2025-03-13 06:00:05+00:00,"48.83750862621299, 2.2577651962637906",Paris,75056,0.9210526315789473,6
2021,Cléry - Montmartre,OUI,58,51,7,3,4,OUI,OUI,2025-03-13 06:00:50+00:00,"48.867458, 2.3445211",Paris,75056,0.1206896551724138,6
1006,Grande Truanderie - Saint-Denis,OUI,29,20,9,8,1,OUI,OUI,2025-03-13 05:55:59+00:00,"48.8626302, 2.3498075",Paris,75056,0.3103448275862069,6
4014,Blancs-Manteaux - Archives,OUI,28,7,21,20,1,OUI,OUI,2025-03-13 05:59:46+00:00,"48.85941800703, 2.3559471219778",Paris,75056,0.75,6
15001,Gare Montparnasse - Arrivée,OUI,41,32,9,2,7,OUI,OUI,2025-03-13 06:00:03+00:00,"48.843827994315, 2.3225811123848",Paris,75056,0.21951219512195122,6
19012,Lally-Tollendal - Armand Carrel,OUI,27,15,12,4,8,OUI,OUI,2025-03-13 06:00:19+00:00,"48.88270066221072, 2.374717555940151",Paris,75056,0.4444444444444444,6
15008,Sèvres - Lecourbe,OUI,60,48,12,7,5,OUI,OUI,2025-03-13 06:00:27+00:00,"48.8447677, 2.3110086",Paris,75056,0.2,6
31001,Lagny - Auguste Blanqui,OUI,26,17,9,5,4,OUI,OUI,2025-03-13 06:00:40+00:00,"48.84922568052601, 2.4218603968620305",Montreuil,93048,0.34615384615384615,6
22201,Henri Ravera - Gabriel Péri,OUI,27,20,7,0,7,OUI,OUI,2025-03-13 05:54:29+00:00,"48.79722273833844, 2.302115857601166",Bagneux,92007,0.25925925925925924,6
21507,Gardenat-Lapostol - Velettes,OUI,20,13,7,1,6,OUI,OUI,2025-03-13 06:01:00+00:00,"48.87387, 2.224185",Suresnes,92073,0.35,6
11112,Jules Vallès - Charonne,OUI,23,5,18,16,2,OUI,OUI,2025-03-13 05:58:53+00:00,"48.854284379935, 2.3847674578428",Paris,75056,0.782608695652174,6
22306,Place du 17 Octobre,OUI,16,13,3,2,1,OUI,OUI,2025-03-13 05:55:36+00:00,"48.91962690034779, 2.2978286134199792",Gennevilliers,92036,0.1875,6
5007,Ecoles - Carmes,OUI,32,26,6,3,3,OUI,OUI,2025-03-13 05:55:22+00:00,"48.848904447989405, 2.3473486304283147",Paris,75056,0.1875,6
14023,Adolphe Pinard - Victor Hugo,OUI,51,49,2,1,1,OUI,OUI,2025-03-13 06:00:27+00:00,"48.8236825874564, 2.3077843710780144",Malakoff,92046,0.0392156862745098,6
4006,Bourdon - Pont Morland,OUI,49,27,22,22,0,OUI,OUI,2025-03-13 06:00:34+00:00,"48.8478103, 2.3659356",Paris,75056,0.4489795918367347,6
22502,Kléber - National,OUI,20,16,4,1,3,OUI,OUI,2025-03-13 05:55:15+00:00,"48.906333898712234, 2.2393910586833954",La Garenne-Colombes,92035,0.2,6
18202,Diane Arbus,OUI,37,29,8,2,6,OUI,OUI,2025-03-13 06:00:52+00:00,"48.898800717199, 2.3524022474885",Paris,75056,0.21621621621621623,6
4015,Mairie du 4ème,OUI,39,26,13,12,1,OUI,OUI,2025-03-13 05:59:09+00:00,"48.855949910497, 2.3563823103905",Paris,75056,0.3333333333333333,6
5015,Epée de Bois - Mouffetard,OUI,62,58,4,3,1,OUI,OUI,2025-03-13 06:00:49+00:00,"48.841508690388835, 2.350066713988781",Paris,75056,0.06451612903225806,6
3003,Fille du Calvaire - Turenne,OUI,26,10,16,14,2,OUI,OUI,2025-03-13 05:59:43+00:00,"48.86210505412563, 2.3649600148200993",Paris,75056,0.6153846153846154,6
44014,Camille Risch - Paul Armangot,OUI,25,13,12,4,8,OUI,OUI,2025-03-13 06:00:22+00:00,"48.774703, 2.373685",Vitry-sur-Seine,94081,0.48,6
21110,Parc Roger Salengro,OUI,30,6,24,21,3,OUI,OUI,2025-03-13 05:59:03+00:00,"48.905303858642, 2.31055945158",Clichy,92024,0.8,6
47003,Charentonneau - Maisons Alfort,OUI,20,8,12,7,5,OUI,OUI,2025-03-13 05:56:59+00:00,"48.809932980484355, 2.443288456496946",Maisons-Alfort,94046,0.6,6
6031,Pierre Sarrazin - Saint-Michel,OUI,31,18,13,12,1,OUI,OUI,2025-03-13 06:00:02+00:00,"48.850908146398, 2.342130728066",Paris,75056,0.41935483870967744,6
18004,Place des Abbesses,OUI,11,7,4,1,3,OUI,OUI,2025-03-13 05:59:26+00:00,"48.884542726149725, 2.3386867716908455",Paris,75056,0.36363636363636365,6
4012,Tiron - Rivoli,OUI,27,3,24,21,3,OUI,OUI,2025-03-13 05:59:16+00:00,"48.855692253233, 2.3579058051109",Paris,75056,0.8888888888888888,6
7012,Cité Vaneau,OUI,24,18,6,5,1,OUI,OUI,2025-03-13 06:00:56+00:00,"48.8542210666207, 2.319614924490452",Paris,75056,0.25,6
21215,Verdier - Jean Jaurès,OUI,32,28,4,3,1,OUI,OUI,2025-03-13 05:53:58+00:00,"48.81614048711214, 2.3123561963438988",Montrouge,92049,0.125,6
20001,Place de la Nation - Charonne,OUI,33,26,7,2,5,OUI,OUI,2025-03-13 05:59:41+00:00,"48.848364667777, 2.3997623859813",Paris,75056,0.21212121212121213,6
41208,Alouettes - Maréchal de Lattre de Tassigny,OUI,21,16,5,1,4,OUI,OUI,2025-03-13 05:59:53+00:00,"48.85511009293948, 2.4930700287222862",Fontenay-sous-Bois,94033,0.23809523809523808,6
12019,Gare de Reuilly - Picpus,OUI,26,18,8,3,5,OUI,OUI,2025-03-13 06:00:33+00:00,"48.84267354116789, 2.3972943797707558",Paris,75056,0.3076923076923077,6
42704,Mairie du Kremlin-Bicêtre,OUI,25,19,6,0,6,OUI,OUI,2025-03-13 05:58:19+00:00,"48.81191981537702, 2.3570189997553825",Le Kremlin-Bicêtre,94043,0.24,6
3010,Beaubourg - Michel-le-Comte,OUI,15,7,8,6,2,OUI,OUI,2025-03-13 05:44:37+00:00,"48.862534941806, 2.3543103039265",Paris,75056,0.5333333333333333,6
4017,Place de l'Hôtel de Ville,OUI,13,6,7,7,0,OUI,OUI,2025-03-13 05:56:05+00:00,"48.8573314, 2.351458",Paris,75056,0.5384615384615384,6
16102,Pergolèse - Marbeau,OUI,26,23,3,3,0,OUI,OUI,2025-03-13 06:00:34+00:00,"48.873568706869, 2.2815125225299",Paris,75056,0.11538461538461539,6
26006,Bas - Gabriel Péri,OUI,30,3,27,19,8,OUI,OUI,2025-03-13 05:58:25+00:00,"48.91585580539625, 2.2948095202445984",Asnières-sur-Seine,92004,0.9,6
4021,Centre Georges Pompidou,OUI,24,22,2,0,2,OUI,OUI,2025-03-13 05:54:14+00:00,"48.861419, 2.352581",Paris,75056,0.08333333333333333,6
42026,Barbès - Monique Maunoury,OUI,40,27,13,7,6,OUI,OUI,2025-03-13 05:58:20+00:00,"48.81552718820216, 2.3687169334905405",Ivry-sur-Seine,94041,0.325,6
19201,Petit - Georges Thill,OUI,23,11,12,3,9,OUI,OUI,2025-03-13 05:59:50+00:00,"48.88603131999171, 2.3895753175020222",Paris,75056,0.5217391304347826,6
2012,Choiseul - Quatre Septembre,OUI,44,37,7,2,5,OUI,OUI,2025-03-13 05:53:50+00:00,"48.8699355331869, 2.3359975218772893",Paris,75056,0.1590909090909091,6
22301,Chausson - Gabriel Péri,OUI,20,5,15,14,1,OUI,OUI,2025-03-13 06:00:41+00:00,"48.921891003481115, 2.2952306270599365",Gennevilliers,92036,0.75,6
12163,Hippodrome Paris-Vincennes,OUI,42,41,1,1,0,OUI,OUI,2025-03-13 06:00:59+00:00,"48.82048387758518, 2.446271181106568",Paris,75056,0.023809523809523808,6
41405,Place de l'Europe - Alfortville,OUI,24,4,20,17,3,OUI,OUI,2025-03-13 05:58:10+00:00,"48.78913702405837, 2.4284800887107854",Alfortville,94002,0.8333333333333334,6
35012,Candale - Mehul,OUI,25,16,9,0,9,OUI,OUI,2025-03-13 06:00:25+00:00,"48.8893935006175, 2.414379715919495",Pantin,93055,0.36,6
8028,Arsène Houssaye - Champs-Elysées,OUI,28,24,4,2,2,OUI,OUI,2025-03-13 05:55:40+00:00,"48.873409276267, 2.2977904602885",Paris,75056,0.14285714285714285,6
21505,Édouard Vaillant - Place Jean Jaurès,OUI,21,16,5,2,3,OUI,OUI,2025-03-13 06:00:14+00:00,"48.86265537999924, 2.2089037319128613",Suresnes,92073,0.23809523809523808,6
10011,Bourse du Travail,OUI,15,0,15,13,2,OUI,OUI,2025-03-13 06:01:01+00:00,"48.868976638826, 2.3623438552022",Paris,75056,1.0,6
2016,Aboukir - Alexandrie,OUI,20,9,11,11,0,OUI,OUI,2025-03-13 05:57:08+00:00,"48.86868344444473, 2.3502043269474897",Paris,75056,0.55,6
10027,Dunkerque - Alsace,OUI,20,8,12,3,9,OUI,OUI,2025-03-13 06:00:28+00:00,"48.879355, 2.358379",Paris,75056,0.6,6
16044,Porte de Saint Cloud - Parc des Princes,OUI,32,13,19,16,3,OUI,OUI,2025-03-13 06:00:52+00:00,"48.838662757066, 2.2525164484978",Paris,75056,0.59375,6
10006,Petites Ecuries - Faubourg Saint-Denis,OUI,25,20,5,3,2,OUI,OUI,2025-03-13 05:56:09+00:00,"48.87287120589831, 2.3542150855064397",Paris,75056,0.2,6
44001,Quai Jules Guesde - Saint-Simon,OUI,30,0,30,26,4,OUI,OUI,2025-03-13 06:00:00+00:00,"48.80391487219, 2.4089661620274",Vitry-sur-Seine,94081,1.0,6
22401,Charles de Gaulle - Plateau de Vanves,OUI,32,32,0,0,0,OUI,OUI,2025-03-13 05:58:52+00:00,"48.82233088973263, 2.298571803412886",Malakoff,92046,0.0,6
5004,Saint-Jacques - Val de Grâce,OUI,19,16,3,2,1,OUI,OUI,2025-03-13 05:56:44+00:00,"48.8417514, 2.3413893",Paris,75056,0.15789473684210525,6
12002,Lacuée - Lyon,OUI,15,3,12,4,8,OUI,OUI,2025-03-13 06:01:02+00:00,"48.849268481958, 2.3704585433006",Paris,75056,0.8,6
10041,Gare du Nord - La Chapelle,OUI,18,13,5,3,2,OUI,OUI,2025-03-13 05:59:08+00:00,"48.884178287286, 2.3561057075858",Paris,75056,0.2777777777777778,6
4103,Archives - Rivoli,OUI,19,12,7,3,4,OUI,OUI,2025-03-13 05:55:43+00:00,"48.857346707443, 2.3539767041802",Paris,75056,0.3684210526315789,6
32019,Place du 8 mai 1945.,OUI,28,21,7,3,4,OUI,OUI,2025-03-13 05:56:55+00:00,"48.938882272105, 2.3566243797541",Saint-Denis,93066,0.25,6
14103,Maine - Liancourt,OUI,25,24,1,0,1,OUI,OUI,2025-03-13 05:59:44+00:00,"48.835064363954, 2.323731449974",Paris,75056,0.04,6
9039,Chaussée d'Antin - Haussmann,OUI,22,16,6,3,3,OUI,OUI,2025-03-13 06:00:34+00:00,"48.87243, 2.33359",Paris,75056,0.2727272727272727,6
19129,Solitaires - Place des Fêtes,OUI,29,29,0,0,0,NON,NON,2025-02-23 09:26:05+00:00,"48.876601, 2.391769",Paris,75056,0.0,9
22506,Gare des Vallées,OUI,18,11,7,5,2,OUI,OUI,2025-03-13 06:00:11+00:00,"48.913179, 2.257726",La Garenne-Colombes,92035,0.3888888888888889,6
32013,Saint-Denis - Université,OUI,19,16,3,1,2,OUI,OUI,2025-03-13 05:59:35+00:00,"48.94563430946964, 2.3638297989964485",Saint-Denis,93066,0.15789473684210525,6
1026,Place du Lieutenant Henri Karcher,OUI,29,22,7,6,1,OUI,OUI,2025-03-13 06:00:39+00:00,"48.863490871724466, 2.3400671035051346",Paris,75056,0.2413793103448276,6
1102,Française - Etienne Marcel,OUI,35,17,18,18,0,OUI,OUI,2025-03-13 06:00:52+00:00,"48.864053304653766, 2.347587011754513",Paris,75056,0.5142857142857142,6
1116,Ventadour - Opéra,OUI,25,15,10,7,3,OUI,OUI,2025-03-13 05:59:28+00:00,"48.866810653323, 2.3343884482519",Paris,75056,0.4,6
24006,Adolphe Lalyre - Armand Silvestre,OUI,39,24,15,3,12,OUI,OUI,2025-03-13 05:59:59+00:00,"48.90406266961591, 2.273416221141815",Courbevoie,92026,0.38461538461538464,6
32024,Port - Confluence,OUI,23,13,10,5,5,OUI,OUI,2025-03-13 05:59:54+00:00,"48.936093926526, 2.3436167797955",Saint-Denis,93066,0.43478260869565216,6
3009,Temple - Haudriettes,OUI,19,10,9,8,1,OUI,OUI,2025-03-13 06:00:27+00:00,"48.861636880212, 2.3566960206458",Paris,75056,0.47368421052631576,6
1017,Saint-Honoré - 29 juillet,OUI,18,16,2,2,0,OUI,OUI,2025-03-13 05:53:11+00:00,"48.86557114282421, 2.330567417577153",Paris,75056,0.1111111111111111,6
14132,Bézout - Général Leclerc,OUI,28,28,0,0,0,OUI,OUI,2025-03-13 05:55:06+00:00,"48.82884804502439, 2.3285973072052",Paris,75056,0.0,6
15040,Saint-Amand - Labrouste,OUI,34,26,8,3,5,OUI,OUI,2025-03-13 06:00:10+00:00,"48.834097274832295, 2.3087677359581",Paris,75056,0.23529411764705882,6
2005,Montmartre - Etienne Marcel,OUI,15,5,10,8,2,OUI,OUI,2025-03-13 05:57:42+00:00,"48.86502194581, 2.3450684401448",Paris,75056,0.6666666666666666,6
23107,Gare de Sèvres - Ville d'Avray,OUI,22,16,6,4,2,OUI,OUI,2025-03-13 05:57:28+00:00,"48.826262366227, 2.2001516849313",Sèvres,92072,0.2727272727272727,6
3012,Square Emile - Chautemps,OUI,25,8,17,11,6,OUI,OUI,2025-03-13 05:58:44+00:00,"48.867433724231, 2.3536357283592",Paris,75056,0.68,6
6201,Saint Pères - Saint Germain,OUI,22,8,14,8,6,OUI,OUI,2025-03-13 06:00:44+00:00,"48.853729675265, 2.3300181032703",Paris,75056,0.6363636363636364,6
23702,Hôtel de Ville de Chaville,OUI,20,17,3,0,3,OUI,OUI,2025-03-13 05:54:15+00:00,"48.80887149094033, 2.188134044408798",Chaville,92022,0.15,6
6026,Saint-Placide - Cherche Midi,OUI,66,64,2,2,0,OUI,OUI,2025-03-13 05:54:11+00:00,"48.8490535919234, 2.325317971408367",Paris,75056,0.030303030303030304,6
14022,Didot - Mariniers,OUI,35,35,0,0,0,OUI,OUI,2025-03-13 05:51:41+00:00,"48.82650543613106, 2.313136198271666",Paris,75056,0.0,6
22601,Marx Dormoy - Château Sainte-Barbe,OUI,21,17,4,1,3,OUI,OUI,2025-03-13 05:59:58+00:00,"48.791782341055324, 2.297856844961643",Fontenay-aux-Roses,92032,0.19047619047619047,6
2002,Etienne Marcel - Montorgueil,OUI,24,12,12,11,1,OUI,OUI,2025-03-13 05:59:00+00:00,"48.86450567259199, 2.3461959511041637",Paris,75056,0.5,6
42018,Amédée Huon - Fort d'Ivry,OUI,30,24,6,1,5,OUI,OUI,2025-03-13 05:57:59+00:00,"48.805131376899986, 2.388489693403244",Ivry-sur-Seine,94041,0.2,6
3006,Mairie du 3ème,OUI,24,2,22,18,4,OUI,OUI,2025-03-13 06:00:18+00:00,"48.86446178139141, 2.361762821674347",Paris,75056,0.9166666666666666,6
12164,Stade Pershing,OUI,26,26,0,0,0,NON,NON,2025-02-26 05:58:32+00:00,"48.829107826857, 2.4583535268903",Paris,75056,0.0,6
48008,Guy Môquet - Parvis Georges Marchais,OUI,30,28,2,0,2,OUI,OUI,2025-03-13 05:58:32+00:00,"48.79518840095975, 2.35943466424942",Villejuif,94076,0.06666666666666667,6
19111,Cesaria Evora - Rosa Parks,OUI,35,30,5,3,2,OUI,OUI,2025-03-13 05:58:24+00:00,"48.89717672825043, 2.3745173960924144",Paris,75056,0.14285714285714285,6
3007,Archives - Pastourelle,OUI,26,12,14,11,3,OUI,OUI,2025-03-13 05:59:40+00:00,"48.8623615, 2.3595041",Paris,75056,0.5384615384615384,6
9111,Victoire - Laffitte,OUI,19,13,6,5,1,OUI,OUI,2025-03-13 05:58:17+00:00,"48.87514373494672, 2.338118505144376",Paris,75056,0.3157894736842105,6
28005,Jean Jaurès - Paul Lafargue,OUI,25,21,4,3,1,OUI,OUI,2025-03-13 06:01:02+00:00,"48.884933177666, 2.2484488785267",Puteaux,92062,0.16,6
5122,Saint-Michel - Luxembourg,OUI,27,17,10,6,4,OUI,OUI,2025-03-13 06:00:22+00:00,"48.84501507626, 2.3394941166043",Paris,75056,0.37037037037037035,6
35005,Quai de l'Aisne - Général Leclerc,OUI,26,24,2,0,2,OUI,OUI,2025-03-13 05:56:59+00:00,"48.895713, 2.400571",Pantin,93055,0.07692307692307693,6
13125,Gare d'Austerlitz - Pont Charles de Gaulle,OUI,55,32,23,12,11,OUI,OUI,2025-03-13 06:00:20+00:00,"48.842319830109, 2.3670300096273",Paris,75056,0.41818181818181815,6
18112,Arthur Ranc - Hôpital Bichat,OUI,24,24,0,0,0,OUI,OUI,2025-03-13 06:00:55+00:00,"48.8978712500682, 2.333521842956543",Paris,75056,0.0,6
8036,Lisbonne - Monceau,OUI,46,37,9,5,4,OUI,OUI,2025-03-13 05:56:28+00:00,"48.877455676814, 2.3096942214195",Paris,75056,0.1956521739130435,6
16139,Suresnes - Muette à Neuilly,OUI,26,20,6,3,3,OUI,OUI,2025-03-13 05:53:08+00:00,"48.868570404348, 2.266000919044",Paris,75056,0.23076923076923078,6
48005,Eugène Varlin - Place de la Paix,OUI,23,17,6,1,5,OUI,OUI,2025-03-13 06:00:27+00:00,"48.792862, 2.363093",Villejuif,94076,0.2608695652173913,6
6007,Bréa - Raspail,OUI,22,20,2,2,0,OUI,OUI,2025-03-13 05:57:38+00:00,"48.842738478258, 2.3297942217634",Paris,75056,0.09090909090909091,6
14133,Froidevaux - Boulard,OUI,34,32,2,1,1,OUI,OUI,2025-03-13 05:56:14+00:00,"48.835147319625, 2.3294411972165",Paris,75056,0.058823529411764705,6
42028,Verdun - Carnot,OUI,28,21,7,3,4,OUI,OUI,2025-03-13 05:55:02+00:00,"48.808439376064946, 2.373795211315155",Ivry-sur-Seine,94041,0.25,6
21706,Jean Bleuzen - Square du 11 Novembre,OUI,45,31,14,12,2,OUI,OUI,2025-03-13 06:00:34+00:00,"48.8232579, 2.2965213",Vanves,92075,0.3111111111111111,6
22603,Place de la Division Leclerc,OUI,33,33,0,0,0,OUI,OUI,2025-03-13 05:56:48+00:00,"48.793824988636516, 2.2731140430551027",Fontenay-aux-Roses,92032,0.0,6
1014,Rivoli - Musée du Louvre,OUI,20,14,6,1,5,OUI,OUI,2025-03-13 05:57:44+00:00,"48.86364636851945, 2.33409583568573",Paris,75056,0.3,6
21119,Belfort - Victor Hugo,OUI,21,6,15,13,2,OUI,OUI,2025-03-13 05:58:43+00:00,"48.9018492, 2.3172724",Clichy,92024,0.7142857142857143,6
42211,Séminaire de Conflans - Liberté,OUI,25,5,20,3,17,OUI,OUI,2025-03-13 06:00:03+00:00,"48.823194, 2.404179",Charenton-le-Pont,94018,0.8,6
16010,Belles Feuilles - Place de Mexico,OUI,22,17,5,2,3,OUI,OUI,2025-03-13 05:56:07+00:00,"48.865804746474, 2.2829206287861",Paris,75056,0.22727272727272727,6
3002,Saint-Gilles - Turenne,OUI,15,5,10,9,1,OUI,OUI,2025-03-13 05:59:58+00:00,"48.858158956779, 2.3647149920992",Paris,75056,0.6666666666666666,6
16201,Porte Dauphine,OUI,60,58,2,1,1,OUI,OUI,2025-03-13 05:52:22+00:00,"48.871139344351, 2.2749781616017",Paris,75056,0.03333333333333333,6
21509,Gardenat Lapostol - Franklin Roosevelt,OUI,24,20,4,2,2,OUI,OUI,2025-03-13 05:53:08+00:00,"48.871839, 2.222505",Suresnes,92073,0.16666666666666666,6
23042,André Theuriet - Blagis,OUI,30,20,10,3,7,OUI,OUI,2025-03-13 05:53:16+00:00,"48.77977325745441, 2.3130525648593903",Bourg-la-Reine,92014,0.3333333333333333,6
13054,Pau Casals - Neuve Tolbiac,OUI,53,49,4,2,2,OUI,OUI,2025-03-13 05:57:35+00:00,"48.8311602, 2.3774395",Paris,75056,0.07547169811320754,6
27006,Victor Hugo - Gare,OUI,20,15,5,4,1,OUI,OUI,2025-03-13 05:54:20+00:00,"48.923133952658, 2.2600970417261",Colombes,92025,0.25,6
1012,Jean-Jacques Rousseau - Deux Ecus,OUI,21,9,12,11,1,OUI,OUI,2025-03-13 05:51:49+00:00,"48.86297805972131, 2.3414635285735126",Paris,75056,0.5714285714285714,6
1008,Les Halles - Saint-Eustache,OUI,32,32,0,0,0,OUI,OUI,2025-03-13 05:59:31+00:00,"48.86362695901683, 2.342623919248581",Paris,75056,0.0,6
2004,Square Pierre Lazareff,OUI,17,9,8,8,0,OUI,OUI,2025-03-13 05:56:22+00:00,"48.867141720746, 2.3483933508396",Paris,75056,0.47058823529411764,6
2006,Place des Victoires,OUI,23,20,3,2,1,OUI,OUI,2025-03-13 05:57:38+00:00,"48.8660354, 2.3420333",Paris,75056,0.13043478260869565,6
19130,Place Paul Delouvrier,OUI,26,19,7,4,3,OUI,OUI,2025-03-13 05:54:45+00:00,"48.89197621431365, 2.3851288855075836",Paris,75056,0.2692307692307692,6
44004,Place de l'Eglise - Vitry-sur-Seine,OUI,28,3,25,21,4,OUI,OUI,2025-03-13 05:59:23+00:00,"48.791922819921815, 2.395057752728462",Vitry-sur-Seine,94081,0.8928571428571429,6
4018,Saint-Bon - Rivoli,OUI,14,7,7,3,4,OUI,OUI,2025-03-13 05:58:19+00:00,"48.857999643315, 2.3502172809763",Paris,75056,0.5,6
1024,Coquillière - Louvre,OUI,17,15,2,2,0,OUI,OUI,2025-03-13 06:00:03+00:00,"48.863795909662, 2.3425736278296",Paris,75056,0.11764705882352941,6
4007,Place de la Bastille - Bourdon,OUI,33,9,24,18,6,OUI,OUI,2025-03-13 06:00:35+00:00,"48.852364355271, 2.3681089282036",Paris,75056,0.7272727272727273,6
2102,Saint-Marc - Feydeau,OUI,36,33,3,1,2,OUI,OUI,2025-03-13 05:57:57+00:00,"48.870326843044, 2.3418715826353",Paris,75056,0.08333333333333333,6
4009,Village Saint-Paul,OUI,24,2,22,17,5,OUI,OUI,2025-03-13 05:59:28+00:00,"48.852639866625, 2.3607301712036",Paris,75056,0.9166666666666666,6
42210,Victor Hugo - Paul Eluard,OUI,30,3,27,25,2,OUI,OUI,2025-03-13 05:58:43+00:00,"48.819602554907, 2.4114319673051",Charenton-le-Pont,94018,0.9,6
4101,Bastille - Beaumarchais,OUI,20,2,18,15,3,OUI,OUI,2025-03-13 05:59:55+00:00,"48.853833463852, 2.3685702681541",Paris,75056,0.9,6
34013,Blanqui - Docteur Bauer,OUI,21,9,12,4,8,OUI,OUI,2025-03-13 05:58:46+00:00,"48.907735489085, 2.3407192814591",Saint-Ouen-sur-Seine,93070,0.5714285714285714,6
33020,Waldeck Rochet - Germaine Tillon,OUI,30,26,4,1,3,OUI,OUI,2025-03-13 05:58:13+00:00,"48.91105960199651, 2.3676301538944244",Aubervilliers,93001,0.13333333333333333,6
23104,Quai de Sèvres - Manufacture Nationale,OUI,26,19,7,5,2,OUI,OUI,2025-03-13 06:00:51+00:00,"48.828688, 2.22499",Sèvres,92072,0.2692307692307692,6
1025,Oratoire - Rivoli,OUI,17,8,9,9,0,OUI,OUI,2025-03-13 06:00:02+00:00,"48.861342760889, 2.3400047421455",Paris,75056,0.5294117647058824,6
21011,Silly - Louis Blériot,OUI,23,7,16,10,6,OUI,OUI,2025-03-13 05:59:56+00:00,"48.83219045374266, 2.2340199351310734",Boulogne-Billancourt,92012,0.6956521739130435,6
1018,Alger - Rivoli,OUI,14,7,7,4,3,OUI,OUI,2025-03-13 06:00:51+00:00,"48.864773553495, 2.3294493936128",Paris,75056,0.5,6
20140,Paganini - Davout,OUI,21,13,8,2,6,OUI,OUI,2025-03-13 05:58:43+00:00,"48.85135, 2.412021",Paris,75056,0.38095238095238093,6
2008,Mairie du 2ème,OUI,28,24,4,2,2,OUI,OUI,2025-03-13 05:53:21+00:00,"48.8672190355135, 2.3404625437747044",Paris,75056,0.14285714285714285,6
48012,Stalingrad - Henri Luisette,OUI,26,25,1,0,1,OUI,OUI,2025-03-13 05:56:48+00:00,"48.78363092456589, 2.366935946761926",Villejuif,94076,0.038461538461538464,6
23101,Grande Rue - Europe,OUI,25,12,13,5,8,OUI,OUI,2025-03-13 06:00:51+00:00,"48.8218104687602, 2.205879874527455",Sèvres,92072,0.52,6
15018,Dutot - Place Alleray,OUI,56,40,16,12,4,OUI,OUI,2025-03-13 05:54:07+00:00,"48.836826091766, 2.3071701095578",Paris,75056,0.2857142857142857,6
18015,Custine - Ramey,OUI,40,38,2,1,1,OUI,OUI,2025-03-13 05:57:34+00:00,"48.888735896947, 2.3469526693225",Paris,75056,0.05,6
10166,Strasbourg - Saint-Denis,OUI,15,10,5,4,1,OUI,OUI,2025-03-13 05:57:49+00:00,"48.869601642433, 2.3542908579111",Paris,75056,0.3333333333333333,6
17106,Berthier - Porte de Clichy,OUI,24,15,9,5,4,OUI,OUI,2025-03-13 05:55:29+00:00,"48.894222687781, 2.3125872006816",Paris,75056,0.375,6
17202,Mariotte - Batignolles,OUI,18,17,1,0,1,OUI,OUI,2025-03-13 05:57:55+00:00,"48.884571659595, 2.321469503475",Paris,75056,0.05555555555555555,6
1023,Saint-Honoré - Musée du Louvre,OUI,21,16,5,1,4,OUI,OUI,2025-03-13 05:59:52+00:00,"48.863443132848, 2.3348781846405",Paris,75056,0.23809523809523808,6
8202,Londres - Europe,OUI,27,24,3,1,2,OUI,OUI,2025-03-13 05:56:04+00:00,"48.878618556803, 2.3248164693922",Paris,75056,0.1111111111111111,6
19202,Marseillaise - Grenade,OUI,43,37,6,1,5,OUI,OUI,2025-03-13 05:58:47+00:00,"48.889371092747, 2.3979396821544",Paris,75056,0.13953488372093023,6
12202,Charenton - Wattignies,OUI,40,15,25,25,0,OUI,OUI,2025-03-13 05:59:58+00:00,"48.836919119234, 2.3916775206425",Paris,75056,0.625,6
14201,Decrès - Alésia,OUI,29,23,6,1,5,OUI,OUI,2025-03-13 06:00:20+00:00,"48.832200060759, 2.3139070151575",Paris,75056,0.20689655172413793,6
10202,Bichat - Grange aux Belles,OUI,29,22,7,7,0,OUI,OUI,2025-03-13 06:00:22+00:00,"48.873688, 2.365015",Paris,75056,0.2413793103448276,6
5003,Le Goff - Gay-Lussac,OUI,34,27,7,3,4,OUI,OUI,2025-03-13 05:52:55+00:00,"48.846102400979, 2.3412207886577",Paris,75056,0.20588235294117646,6
27001,Square Victor Basch,OUI,19,0,19,9,10,OUI,OUI,2025-03-13 05:58:24+00:00,"48.914304862261, 2.2289156913757",Colombes,92025,1.0,6
51008,Martyrs de Châteaubriant - Jean Grandel,OUI,38,28,10,1,9,OUI,OUI,2025-03-13 05:52:55+00:00,"48.951432, 2.211214",Argenteuil,95018,0.2631578947368421,6
17021,Jouffroy d'Abbans - Villiers,OUI,33,20,13,6,7,OUI,OUI,2025-03-13 05:59:30+00:00,"48.884215547037, 2.3056533560157",Paris,75056,0.3939393939393939,6
18135,Ney - Porte de Montmartre,OUI,23,20,3,1,2,OUI,OUI,2025-03-13 05:56:43+00:00,"48.897918, 2.3364872",Paris,75056,0.13043478260869565,6
34011,Clef des Champs - Albert Dhalenne,OUI,26,4,22,7,15,OUI,OUI,2025-03-13 06:00:12+00:00,"48.914938, 2.330665",Saint-Ouen-sur-Seine,93070,0.8461538461538461,6
31020,Résistance - Parmentier,OUI,31,23,8,7,1,OUI,OUI,2025-03-13 05:51:52+00:00,"48.85965138131299, 2.436705082654953",Montreuil,93048,0.25806451612903225,6
21704,Place du Maréchal de Lattre de Tassigny,OUI,27,1,26,19,7,OUI,OUI,2025-03-13 05:55:19+00:00,"48.821707715257055, 2.2853431485432423",Vanves,92075,0.9629629629629629,6
12166,Parc Floral du Bel Air,OUI,23,16,7,2,5,OUI,OUI,2025-03-13 06:00:58+00:00,"48.839285711865735, 2.438560165464878",Paris,75056,0.30434782608695654,6
13015,Chevaleret - Louise Weiss,OUI,35,29,6,6,0,OUI,OUI,2025-03-13 06:00:34+00:00,"48.832586513351, 2.37121138812",Paris,75056,0.17142857142857143,6
12113,Cardinal Lavigerie,OUI,46,2,44,36,8,OUI,OUI,2025-03-13 06:00:34+00:00,"48.832934193699835, 2.402636749399156",Paris,75056,0.9565217391304348,6
12123,Château de Vincennes,OUI,50,32,18,8,10,OUI,OUI,2025-03-13 06:00:57+00:00,"48.84423193255657, 2.439209537709179",Paris,75056,0.36,6
42019,Lampes,OUI,42,8,34,34,0,OUI,OUI,2025-03-13 06:00:54+00:00,"48.81152481985875, 2.4017931148409843",Ivry-sur-Seine,94041,0.8095238095238095,6
13024,Bobillot - Tolbiac,OUI,33,12,21,18,3,OUI,OUI,2025-03-13 05:53:49+00:00,"48.8255961335041, 2.350204177200794",Paris,75056,0.6363636363636364,6
24004,Paix - Verdun,OUI,30,24,6,5,1,OUI,OUI,2025-03-13 06:01:06+00:00,"48.900504, 2.261173",Courbevoie,92026,0.2,6
32020,Jules Guesdes - Carnot,OUI,14,12,2,1,1,OUI,OUI,2025-03-13 05:52:03+00:00,"48.93828169931872, 2.3508992046117783",Saint-Denis,93066,0.14285714285714285,6
24005,Edith Cavell - Volta,OUI,32,22,10,3,7,OUI,OUI,2025-03-13 06:01:03+00:00,"48.901616564286975, 2.269354350864887",Courbevoie,92026,0.3125,6
1015,Place André Malraux,OUI,17,9,8,6,2,OUI,OUI,2025-03-13 05:56:26+00:00,"48.863925158727, 2.3356226831675",Paris,75056,0.47058823529411764,6
31104,Mairie de Rosny-sous-Bois,OUI,26,10,16,10,6,OUI,OUI,2025-03-13 06:00:20+00:00,"48.871256519012, 2.4865807592869",Rosny-sous-Bois,93064,0.6153846153846154,6
9019,Victor Massé - Jean-Baptiste Pigalle,OUI,18,15,3,0,3,OUI,OUI,2025-03-13 05:55:29+00:00,"48.8811043724, 2.3366955667734",Paris,75056,0.16666666666666666,6
13116,Place du Docteur Yersin,OUI,50,48,2,0,2,OUI,OUI,2025-03-13 05:57:37+00:00,"48.82010494991975, 2.3725583776831627",Paris,75056,0.04,6
19046,Porte de Pantin.,OUI,31,26,5,1,4,OUI,OUI,2025-03-13 06:01:03+00:00,"48.889199725577, 2.3950181901455",Paris,75056,0.16129032258064516,6
11111,Léon Frot - Charonne,OUI,17,8,9,7,2,OUI,OUI,2025-03-13 06:00:14+00:00,"48.854963800335234, 2.387217085372007",Paris,75056,0.5294117647058824,6
2020,Danielle Casanova - Opéra,OUI,20,15,5,3,2,OUI,OUI,2025-03-13 06:00:23+00:00,"48.867643242297, 2.3333894088864",Paris,75056,0.25,6
48006,Maxime Gorki - Paul Vaillant-Couturier,OUI,19,16,3,0,3,OUI,OUI,2025-03-13 05:57:14+00:00,"48.79673508795443, 2.3683342337608337",Villejuif,94076,0.15789473684210525,6
15012,Cambronne - Mademoiselle,OUI,62,25,37,31,6,OUI,OUI,2025-03-13 05:59:14+00:00,"48.843277330035214, 2.30230766886348",Paris,75056,0.5967741935483871,6
10201,Magenta - Chabrol,OUI,21,14,7,5,2,OUI,OUI,2025-03-13 05:56:49+00:00,"48.876495350882, 2.3560990020633",Paris,75056,0.3333333333333333,6
18016,Francoeur - Caulaincourt,OUI,33,31,2,0,2,OUI,OUI,2025-03-13 05:54:03+00:00,"48.8899944409612, 2.342529706656933",Paris,75056,0.06060606060606061,6
6029,Vaugirard - Monsieur le Prince,OUI,24,3,21,8,13,OUI,OUI,2025-03-13 05:56:57+00:00,"48.848951441614, 2.3411329463124",Paris,75056,0.875,6
19117,Euryale Dehaynin - Loire,OUI,29,25,4,1,3,OUI,OUI,2025-03-13 06:00:18+00:00,"48.886248917304805, 2.3774591088294987",Paris,75056,0.13793103448275862,6
12016,Saint-Mande - Picpus,OUI,34,22,12,7,5,OUI,OUI,2025-03-13 06:00:45+00:00,"48.845127728278, 2.4015686296482",Paris,75056,0.35294117647058826,6
21022,Dôme - République,OUI,23,10,13,11,2,OUI,OUI,2025-03-13 06:00:34+00:00,"48.832681, 2.250257",Boulogne-Billancourt,92012,0.5652173913043478,6
23301,Les Blagis,OUI,24,9,15,11,4,OUI,OUI,2025-03-13 06:00:16+00:00,"48.785205, 2.302526",Sceaux,92071,0.625,6
15041,Franquet - Labrouste,OUI,37,23,14,12,2,OUI,OUI,2025-03-13 06:00:10+00:00,"48.83287705011431, 2.306762784719467",Paris,75056,0.3783783783783784,6
44008,Youri Gagarine - Commune de Paris,OUI,32,3,29,11,18,OUI,OUI,2025-03-13 05:57:34+00:00,"48.782427463041, 2.3939734697342",Vitry-sur-Seine,94081,0.90625,6
11022,Roquette - Auguste Laurent,OUI,15,4,11,9,2,OUI,OUI,2025-03-13 05:57:07+00:00,"48.858001906023354, 2.381797702650783",Paris,75056,0.7333333333333333,6
23303,Gare de Robinson,OUI,29,26,3,1,2,OUI,OUI,2025-03-13 06:01:02+00:00,"48.7799259211605, 2.281828634440899",Sceaux,92071,0.10344827586206896,6
41103,Place de la vache noire,OUI,22,20,2,0,2,OUI,OUI,2025-03-13 05:57:11+00:00,"48.81040517059777, 2.327060401439667",Arcueil,94003,0.09090909090909091,6
20010,Sorbier - Gasnier-Guy,OUI,33,33,0,0,0,OUI,OUI,2025-03-13 05:58:34+00:00,"48.865217631011, 2.3936596512794",Paris,75056,0.0,6
41602,Place Charles Digeon,OUI,29,25,4,4,0,OUI,OUI,2025-03-13 05:59:23+00:00,"48.84354203133597, 2.418427169322968",Saint-Mandé,94067,0.13793103448275862,6
42022,Gare RER - Maurice Grandcoing,OUI,36,4,32,32,0,OUI,OUI,2025-03-13 06:01:05+00:00,"48.813881, 2.392429",Ivry-sur-Seine,94041,0.8888888888888888,6
14004,Port Royal - Hôpital Cochin,OUI,22,20,2,0,2,OUI,OUI,2025-03-13 06:00:39+00:00,"48.838608030238, 2.3406994164846",Paris,75056,0.09090909090909091,6
26012,Jardin Modèle - Pierre Boudou,OUI,15,9,6,3,3,OUI,OUI,2025-03-13 06:01:03+00:00,"48.914866710946, 2.3057010525935",Asnières-sur-Seine,92004,0.4,6
14027,Gergovie - Alésia,OUI,54,51,3,1,2,OUI,OUI,2025-03-13 05:58:33+00:00,"48.83088717455243, 2.318882101207347",Paris,75056,0.05555555555555555,6
20048,Bagnolet - Place Saint-Blaise,OUI,27,22,5,1,4,OUI,OUI,2025-03-13 05:58:11+00:00,"48.85973, 2.40334",Paris,75056,0.18518518518518517,6
30003,Moscou - Edouard Vaillant,OUI,29,19,10,3,7,OUI,OUI,2025-03-13 06:00:45+00:00,"48.90755810177, 2.4689837335263",Bobigny,93008,0.3448275862068966,6
45004,République - Louis Loucheur,OUI,37,3,34,5,29,OUI,OUI,2025-03-13 05:59:59+00:00,"48.823549261189, 2.5101865455508",Champigny-sur-Marne,94017,0.918918918918919,6
35013,Guillaume Tell - Parc Henri Barbusse,OUI,20,13,7,1,6,OUI,OUI,2025-03-13 05:57:15+00:00,"48.88958925894009, 2.4198862910270695",Pantin,93055,0.35,6
23202,Henri Barbusse - Gabriel Péri,OUI,14,10,4,1,3,OUI,OUI,2025-03-13 05:59:56+00:00,"48.801773795836, 2.2874166362216",Châtillon,92020,0.2857142857142857,6
12008,Hector Malot - Daumesnil,OUI,53,8,45,44,1,OUI,OUI,2025-03-13 06:00:09+00:00,"48.84693552991762, 2.3770876228809357",Paris,75056,0.8490566037735849,6
13049,Vincent Auriol - Louise Weiss,OUI,22,19,3,2,1,OUI,OUI,2025-03-13 05:55:52+00:00,"48.834001935501, 2.3703888058662",Paris,75056,0.13636363636363635,6
12102,Bercy - Traversiére,OUI,29,21,8,8,0,OUI,OUI,2025-03-13 06:00:25+00:00,"48.846192642574, 2.3703800886869",Paris,75056,0.27586206896551724,6
6015,André Mazet - Saint-André des Arts,OUI,55,13,42,41,1,OUI,OUI,2025-03-13 05:59:58+00:00,"48.85375581057431, 2.3390958085656166",Paris,75056,0.7636363636363637,6
15050,Dominique Pado - Croix Nivert,OUI,22,9,13,12,1,OUI,OUI,2025-03-13 05:55:53+00:00,"48.83648798164934, 2.2897250577807426",Paris,75056,0.5909090909090909,6
32605,Mairie,OUI,19,16,3,0,3,OUI,OUI,2025-03-13 06:00:03+00:00,"48.87914304162, 2.4163350908311",Les Lilas,93045,0.15789473684210525,6
43004,Montreuil - République,OUI,22,15,7,2,5,OUI,OUI,2025-03-13 05:57:16+00:00,"48.85026349463687, 2.4345204234123234",Vincennes,94080,0.3181818181818182,6
32011,Stade de France - Francis de Pressensé,OUI,43,25,18,3,15,OUI,OUI,2025-03-13 06:00:18+00:00,"48.919141953558, 2.3620655760169",Saint-Denis,93066,0.4186046511627907,6
14009,Tombe Issoire - René Coty,OUI,34,26,8,3,5,OUI,OUI,2025-03-13 05:59:46+00:00,"48.830512876709, 2.3343613743782",Paris,75056,0.23529411764705882,6
17020,Jouffroy d'Abbans - Malesherbes,OUI,26,10,16,5,11,OUI,OUI,2025-03-13 06:00:50+00:00,"48.8850134, 2.3070717",Paris,75056,0.6153846153846154,6
17117,Pereire - Saussure,OUI,32,17,15,14,1,OUI,OUI,2025-03-13 06:00:31+00:00,"48.888229075478, 2.3101296275854",Paris,75056,0.46875,6
23206,Béranger - Félix Faure,OUI,26,15,11,0,11,OUI,OUI,2025-03-13 05:59:44+00:00,"48.80404828621485, 2.2848263373723436",Châtillon,92020,0.4230769230769231,6
16017,Siam - La Pompe,OUI,16,12,4,0,4,OUI,OUI,2025-03-13 05:59:22+00:00,"48.861720329027264, 2.275346568555312",Paris,75056,0.25,6
8040,Pierre Charron - Champs-Elysées,OUI,30,25,5,2,3,OUI,OUI,2025-03-13 05:54:00+00:00,"48.870103359864, 2.3043501377106",Paris,75056,0.16666666666666666,6
18021,Marcadet - Ramey,OUI,21,16,5,4,1,OUI,OUI,2025-03-13 06:00:59+00:00,"48.890875, 2.3449019",Paris,75056,0.23809523809523808,6
42030,Stéphanie Bouvard - Gambetta,OUI,30,8,22,20,2,OUI,OUI,2025-03-13 06:00:21+00:00,"48.814548138856, 2.4024386957288",Ivry-sur-Seine,94041,0.7333333333333333,6
16116,George Sand - Jean de La Fontaine,OUI,29,5,24,20,4,OUI,OUI,2025-03-13 05:53:13+00:00,"48.84986918764119, 2.268257387525699",Paris,75056,0.8275862068965517,6
8018,Saint-Augustin,OUI,29,26,3,3,0,OUI,OUI,2025-03-13 05:53:31+00:00,"48.8762009747008, 2.319786250591278",Paris,75056,0.10344827586206896,6
12022,Sahel - Général Michel Bizot,OUI,30,15,15,12,3,OUI,OUI,2025-03-13 05:58:57+00:00,"48.840872964793355, 2.4044444784522057",Paris,75056,0.5,6
31105,Lavoisier - Missak Manouchian,OUI,13,2,11,2,9,OUI,OUI,2025-03-13 06:00:58+00:00,"48.86286468896063, 2.495676465332508",Rosny-sous-Bois,93064,0.8461538461538461,6
20142,Mûriers - Père Lachaise,OUI,19,18,1,0,1,OUI,OUI,2025-03-13 06:01:04+00:00,"48.864130509668044, 2.39164982067019",Paris,75056,0.05263157894736842,6
22701,Général Leclerc - République,OUI,28,4,24,18,6,OUI,OUI,2025-03-13 05:58:42+00:00,"48.915885074177, 2.2682306702811",Bois-Colombes,92009,0.8571428571428571,6
48001,Chastenet de Géry - Marcel Paul,OUI,25,18,7,1,6,OUI,OUI,2025-03-13 06:00:41+00:00,"48.800123, 2.3567359",Villejuif,94076,0.28,6
17110,Legendre - Nollet,OUI,29,22,7,2,5,OUI,OUI,2025-03-13 05:59:19+00:00,"48.887742186754224, 2.320293079881375",Paris,75056,0.2413793103448276,6
24101,Place Charles de Gaulle,OUI,24,21,3,1,2,OUI,OUI,2025-03-13 05:59:55+00:00,"48.826073335699, 2.1894485725692",Ville-d'Avray,92077,0.125,6
14035,Maine - Jean Zay,OUI,45,31,14,5,9,OUI,OUI,2025-03-13 06:00:55+00:00,"48.837925263898, 2.3225428909063",Paris,75056,0.3111111111111111,6
21329,Gare - Aristide Briand,OUI,28,10,18,13,5,OUI,OUI,2025-03-13 06:00:41+00:00,"48.821410564722, 2.2555950104387",Issy-les-Moulineaux,92040,0.6428571428571429,6
8046,Marceau - Président Wilson,OUI,29,27,2,1,1,OUI,OUI,2025-03-13 05:57:35+00:00,"48.8652359, 2.3002513",Paris,75056,0.06896551724137931,6
19121,Belleville -  Pré Saint-Gervais,OUI,21,20,1,0,1,OUI,OUI,2025-03-13 05:54:45+00:00,"48.875565910073, 2.3930460959673",Paris,75056,0.047619047619047616,6
21218,Gabriel Péri - Place de la Libération,OUI,17,13,4,0,4,OUI,OUI,2025-03-13 05:59:15+00:00,"48.819828421929, 2.3117361743705",Montrouge,92049,0.23529411764705882,6
25007,Bons Raisins - Voltaire,OUI,24,20,4,1,3,OUI,OUI,2025-03-13 05:56:57+00:00,"48.87282451461399, 2.1947155570850896",Rueil-Malmaison,92063,0.16666666666666666,6
18101,Championnet.,OUI,21,9,12,4,8,OUI,OUI,2025-03-13 05:58:00+00:00,"48.8953643, 2.3498166",Paris,75056,0.5714285714285714,6
19114,Manin - Secrétan,OUI,20,9,11,1,10,OUI,OUI,2025-03-13 06:00:18+00:00,"48.8791665, 2.3787959",Paris,75056,0.55,6
6028,Quatre Vents - Carrefour de l'Odéon,OUI,37,25,12,12,0,OUI,OUI,2025-03-13 05:59:45+00:00,"48.851751374458864, 2.338161695134053",Paris,75056,0.32432432432432434,6
21002,Place Denfert-Rochereau,OUI,20,0,20,11,9,OUI,OUI,2025-03-13 05:59:09+00:00,"48.843252536286684, 2.245987951755524",Boulogne-Billancourt,92012,1.0,6
20005,Reynaldo Hahn - Lagny,OUI,19,17,2,1,1,OUI,OUI,2025-03-13 05:55:00+00:00,"48.849266043601794, 2.412330328844772",Paris,75056,0.10526315789473684,6
23041,Général Leclerc - Bièvre,OUI,24,20,4,2,2,OUI,OUI,2025-03-13 05:57:29+00:00,"48.782414428747316, 2.3166695237159733",Bourg-la-Reine,92014,0.16666666666666666,6
11016,Philippe-Auguste,OUI,48,31,17,4,13,OUI,OUI,2025-03-13 05:55:51+00:00,"48.851853488265, 2.3932945355773",Paris,75056,0.3541666666666667,6
42024,Danielle Casanova - Ledru-Rollin,OUI,28,5,23,19,4,OUI,OUI,2025-03-13 05:59:04+00:00,"48.815783497876815, 2.383259721100331",Ivry-sur-Seine,94041,0.8214285714285714,6
15120,Colonel Pierre Avia,OUI,29,19,10,9,1,OUI,OUI,2025-03-13 05:56:22+00:00,"48.8296843300915, 2.275342586850291",Paris,75056,0.3448275862068966,6
5027,Gobelins - Port-Royal,OUI,39,4,35,31,4,OUI,OUI,2025-03-13 06:00:09+00:00,"48.837135900263, 2.3515201359987",Paris,75056,0.8974358974358975,6
16023,Passy - Place du Costa Rica,OUI,30,19,11,3,8,OUI,OUI,2025-03-13 06:00:16+00:00,"48.8584893, 2.2839655",Paris,75056,0.36666666666666664,6
15203,Porte de Versailles,OUI,25,16,9,7,2,OUI,OUI,2025-03-13 05:58:57+00:00,"48.832324016657, 2.2875617349045",Paris,75056,0.36,6
24007,Jean-Baptiste Charcot - Sainte-Geneviève,OUI,21,15,6,2,4,OUI,OUI,2025-03-13 05:58:20+00:00,"48.90310883721567, 2.278892956674099",Courbevoie,92026,0.2857142857142857,6
15053,Lecourbe - Convention,OUI,46,15,31,20,11,OUI,OUI,2025-03-13 06:00:51+00:00,"48.83923319241899, 2.2915197908878326",Paris,75056,0.6739130434782609,6
15114,Pasteur - Cotentin,OUI,33,26,7,2,5,OUI,OUI,2025-03-13 05:58:01+00:00,"48.8389284, 2.316356",Paris,75056,0.21212121212121213,6
20003,Pyrénées - Cours de Vincennes,OUI,19,0,19,3,16,OUI,OUI,2025-03-13 05:53:33+00:00,"48.847796779935, 2.4061721563339",Paris,75056,1.0,6
11028,Guillaume Bertrand - République,OUI,38,14,24,10,14,OUI,OUI,2025-03-13 06:00:21+00:00,"48.863825174341, 2.380906377155",Paris,75056,0.631578947368421,6
10003,Hauteville - Bonne Nouvelle,OUI,17,13,4,2,2,OUI,OUI,2025-03-13 06:00:24+00:00,"48.87077436024, 2.3496496368327",Paris,75056,0.23529411764705882,6
21027,Fief - République,OUI,24,15,9,4,5,OUI,OUI,2025-03-13 05:58:04+00:00,"48.83170888166024, 2.255771979689598",Boulogne-Billancourt,92012,0.375,6
13028,Gouthière - Poterne des Peupliers,OUI,32,27,5,4,1,OUI,OUI,2025-03-13 05:57:39+00:00,"48.820507, 2.351342",Paris,75056,0.15625,6
15044,Dantzig - Lefebvre,OUI,33,29,4,0,4,OUI,OUI,2025-03-13 05:54:16+00:00,"48.83013921586756, 2.295934036374092",Paris,75056,0.12121212121212122,6
15069,Félix Faure - Convention,OUI,44,7,37,32,5,OUI,OUI,2025-03-13 05:59:04+00:00,"48.841249336041, 2.2883866008495",Paris,75056,0.8409090909090909,6
15113,Arsonval - Falguière,OUI,24,20,4,4,0,OUI,OUI,2025-03-13 05:57:39+00:00,"48.84040040365445, 2.313117867297474",Paris,75056,0.16666666666666666,6
20012,Buzenval - Vignoles,OUI,17,9,8,4,4,OUI,OUI,2025-03-13 05:54:35+00:00,"48.853858171688, 2.4000040814281",Paris,75056,0.47058823529411764,6
19001,Crimée - Ourcq,OUI,55,42,13,10,3,OUI,OUI,2025-03-13 05:58:25+00:00,"48.894104140316, 2.3729460884673",Paris,75056,0.23636363636363636,6
42303,Place Eustache Deschamps,OUI,20,6,14,7,7,OUI,OUI,2025-03-13 06:00:40+00:00,"48.793855, 2.336637",Cachan,94016,0.7,6
13023,Bobillot - Moulin des Prés,OUI,28,19,9,4,5,OUI,OUI,2025-03-13 05:56:38+00:00,"48.828657346203, 2.353020646317",Paris,75056,0.32142857142857145,6
48002,LCL Campus - Place Oscar Niemeyer,OUI,37,33,4,2,2,OUI,OUI,2025-03-13 05:52:13+00:00,"48.805342480621576, 2.363983690738678",Villejuif,94076,0.10810810810810811,6
12040,Porte de Charenton,OUI,66,46,20,8,12,OUI,OUI,2025-03-13 06:00:12+00:00,"48.831240105856, 2.3989107459784",Paris,75056,0.30303030303030304,6
41605,Général De Gaulle - Vivien,OUI,21,7,14,4,10,OUI,OUI,2025-03-13 05:58:24+00:00,"48.83607420090204, 2.4189166724681854",Saint-Mandé,94067,0.6666666666666666,6
21007,Rond-Point Rhin et Danube,OUI,53,44,9,1,8,OUI,OUI,2025-03-13 05:56:08+00:00,"48.840452820991764, 2.2280225157737736",Boulogne-Billancourt,92012,0.16981132075471697,6
20020,Pyrénées - Charles Renouvier,OUI,28,25,3,0,3,OUI,OUI,2025-03-13 05:54:13+00:00,"48.86095933229224, 2.400421852042113",Paris,75056,0.10714285714285714,6
19007,Flandre - Ourcq,OUI,29,24,5,2,3,OUI,OUI,2025-03-13 05:58:06+00:00,"48.89260159189023, 2.3790915682911873",Paris,75056,0.1724137931034483,6
13120,Pierre Joseph Desault,OUI,18,1,17,17,0,OUI,OUI,2025-03-13 05:59:35+00:00,"48.82110230800372, 2.378775402903557",Paris,75056,0.9444444444444444,6
11018,Saint-Maur - République,OUI,37,14,23,11,12,OUI,OUI,2025-03-13 06:00:29+00:00,"48.864185861455, 2.3783174157143",Paris,75056,0.6216216216216216,6
15024,Suffren - La Motte-Piquet,OUI,22,2,20,16,4,OUI,OUI,2025-03-13 06:00:50+00:00,"48.850881230919, 2.3012199997902",Paris,75056,0.9090909090909091,6
21107,Bertrand Sincholle - Henri Barbusse,OUI,18,10,8,8,0,OUI,OUI,2025-03-13 06:00:44+00:00,"48.89925982394349, 2.3042294383049016",Clichy,92024,0.4444444444444444,6
12119,Dom-Pérignon - Gravelle,OUI,47,11,36,29,7,OUI,OUI,2025-03-13 06:00:06+00:00,"48.825481574435, 2.409880310297",Paris,75056,0.7659574468085106,6
22007,Commandant Charcot - Bretteville,OUI,32,4,28,15,13,OUI,OUI,2025-03-13 05:56:39+00:00,"48.87530570765423, 2.2558460757136345",Neuilly-sur-Seine,92051,0.875,6
13006,Duméril - Jeanne d'Arc,OUI,39,15,24,22,2,OUI,OUI,2025-03-13 06:00:41+00:00,"48.838151608087, 2.3571084495564",Paris,75056,0.6153846153846154,6
12039,Général Michel Bizot - Claude Decaen,OUI,35,10,25,19,6,OUI,OUI,2025-03-13 06:00:47+00:00,"48.83481262982544, 2.400927788127704",Paris,75056,0.7142857142857143,6
43007,Hôtel de Ville de Vincennes,OUI,26,24,2,2,0,OUI,OUI,2025-03-13 05:51:27+00:00,"48.84827609706963, 2.4398955702781677",Vincennes,94080,0.07692307692307693,6
13037,Ivry - Baudricourt,OUI,19,6,13,6,7,OUI,OUI,2025-03-13 05:53:44+00:00,"48.824695995415006, 2.363106073577468",Paris,75056,0.6842105263157895,6
16025,Jean de la Fontaine - Boulainvilliers,OUI,66,16,50,38,12,OUI,OUI,2025-03-13 06:01:02+00:00,"48.85264791461651, 2.2758664190769196",Paris,75056,0.7575757575757576,6
5031,Lacépède - Linné,OUI,52,41,11,8,3,OUI,OUI,2025-03-13 06:01:06+00:00,"48.8437035476636, 2.354651279747486",Paris,75056,0.21153846153846154,6
13036,Olympiades,OUI,36,23,13,4,9,OUI,OUI,2025-03-13 06:00:58+00:00,"48.826764665199, 2.3650860786438",Paris,75056,0.3611111111111111,6
14025,Jacquier - Didot,OUI,30,27,3,1,2,OUI,OUI,2025-03-13 05:58:45+00:00,"48.82953336292279, 2.318179272115231",Paris,75056,0.1,6
20013,Alexandre Dumas - Place de la Réunion,OUI,44,42,2,0,2,OUI,OUI,2025-03-13 05:59:37+00:00,"48.85533710742046, 2.3997703687646292",Paris,75056,0.045454545454545456,6
6009,Guynemer - Jardin du Luxembourg,OUI,34,22,12,9,3,OUI,OUI,2025-03-13 05:59:09+00:00,"48.8466127, 2.3325478",Paris,75056,0.35294117647058826,6
5033,Saint-Séverin - Saint-Michel,OUI,30,8,22,20,2,OUI,OUI,2025-03-13 05:59:50+00:00,"48.852731305488, 2.3440927639604",Paris,75056,0.7333333333333333,6
20033,Etienne Dolet - Place Maurice Chevalier,OUI,45,22,23,9,14,OUI,OUI,2025-03-13 05:59:33+00:00,"48.86798303359366, 2.3851405311143026",Paris,75056,0.5111111111111111,6
15045,Porte de la Plaine,OUI,35,25,10,7,3,OUI,OUI,2025-03-13 05:58:51+00:00,"48.82805169605981, 2.2924277186393742",Paris,75056,0.2857142857142857,6
17050,Batignolles - Abel Truchet,OUI,26,25,1,0,1,OUI,OUI,2025-03-13 05:54:34+00:00,"48.883103904582, 2.3238347490884",Paris,75056,0.038461538461538464,6
25004,Marcel Pourtout - Édouard Manet,OUI,24,0,24,19,5,OUI,OUI,2025-03-13 05:58:27+00:00,"48.87555620763429, 2.1655967831611638",Rueil-Malmaison,92063,1.0,6
1201,Perrault - Place du Louvre,OUI,27,16,11,11,0,OUI,OUI,2025-03-13 06:00:29+00:00,"48.860273568996, 2.3412468419093",Paris,75056,0.4074074074074074,6
15027,Duhamel - André Gide,OUI,20,13,7,1,6,OUI,OUI,2025-03-13 06:00:48+00:00,"48.8365662244334, 2.312707121097412",Paris,75056,0.35,6
51007,Résistance - Romain Rolland,OUI,28,20,8,0,8,OUI,OUI,2025-03-13 05:54:18+00:00,"48.950873482371, 2.2310190077797",Argenteuil,95018,0.2857142857142857,6
21023,Ancienne Mairie - André Morizet,OUI,25,13,12,7,5,OUI,OUI,2025-03-13 05:59:01+00:00,"48.838311, 2.234077",Boulogne-Billancourt,92012,0.48,6
11040,Temple - Jean-Pierre Timbaud,OUI,32,16,16,15,1,OUI,OUI,2025-03-13 06:00:52+00:00,"48.86446597201, 2.3660597205162",Paris,75056,0.5,6
42205,Place Aristide Briand,OUI,35,10,25,15,10,OUI,OUI,2025-03-13 05:53:37+00:00,"48.82189236575831, 2.413003742694855",Charenton-le-Pont,94018,0.7142857142857143,6
11038,Temple - Charlot,OUI,41,10,31,30,1,OUI,OUI,2025-03-13 06:00:53+00:00,"48.865709343796, 2.3652737250724",Paris,75056,0.7560975609756098,6
31701,Mairie de Bagnolet,OUI,28,16,12,2,10,OUI,OUI,2025-03-13 05:56:35+00:00,"48.868421318555, 2.4179587885737",Bagnolet,93006,0.42857142857142855,6
21511,Marcel Monge - Marcel Dassault,OUI,46,17,29,27,2,OUI,OUI,2025-03-13 06:00:20+00:00,"48.86096384533371, 2.2246733296048142",Suresnes,92073,0.6304347826086957,6
22404,Pierre Brossolette - 12 Février 1934,OUI,24,19,5,2,3,OUI,OUI,2025-03-13 06:00:59+00:00,"48.8176962416867, 2.3076123744249344",Malakoff,92046,0.20833333333333334,6
8003,Galilée - Vernet,OUI,47,42,5,0,5,OUI,OUI,2025-03-13 05:56:15+00:00,"48.871715878697, 2.2985444962978",Paris,75056,0.10638297872340426,6
20032,Square des Amandiers,OUI,25,24,1,1,0,OUI,OUI,2025-03-13 05:59:55+00:00,"48.86615630668046, 2.3891324177384377",Paris,75056,0.04,6
22703,Place Jean Mermoz,OUI,27,14,13,4,9,OUI,OUI,2025-03-13 05:57:38+00:00,"48.9220937, 2.2718348",Bois-Colombes,92009,0.48148148148148145,6
20014,Charonne - Alexandre Dumas,OUI,34,27,7,2,5,OUI,OUI,2025-03-13 06:00:40+00:00,"48.856077415056, 2.3948693275452",Paris,75056,0.20588235294117646,6
24010,Charles de Gaulle - Rue de l'Alma,OUI,27,11,16,6,10,OUI,OUI,2025-03-13 05:59:30+00:00,"48.896620592993, 2.252313240191",Courbevoie,92026,0.5925925925925926,6
30004,Jean Jaurès - Place de la Libération,OUI,28,5,23,10,13,OUI,OUI,2025-03-13 05:58:39+00:00,"48.90617751921, 2.4391458057475",Bobigny,93008,0.8214285714285714,6
25009,Place des Arts - Jean Mermoz,OUI,20,1,19,12,7,OUI,OUI,2025-03-13 06:01:04+00:00,"48.880391139734, 2.1832160452221",Rueil-Malmaison,92063,0.95,6
20110,Gambetta - Tourelles,OUI,20,18,2,0,2,OUI,OUI,2025-03-13 06:00:02+00:00,"48.875337902264, 2.4059921130538",Paris,75056,0.1,6
26010,Louis Armand - Bernard Palissy,OUI,15,5,10,8,2,OUI,OUI,2025-03-13 05:57:58+00:00,"48.916974, 2.313384",Asnières-sur-Seine,92004,0.6666666666666666,6
14005,René Coty - Place Denfert-Rochereau,OUI,36,4,32,10,22,OUI,OUI,2025-03-13 05:54:23+00:00,"48.833056477316, 2.3329411447048",Paris,75056,0.8888888888888888,6
20030,Ménilmontant - Père Lachaise,OUI,40,28,12,0,12,OUI,OUI,2025-03-13 05:59:33+00:00,"48.863287291502, 2.3869940266013",Paris,75056,0.3,6
8007,Rome - Provence,OUI,29,10,19,18,1,OUI,OUI,2025-03-13 05:57:47+00:00,"48.874230055580306, 2.325570111724113",Paris,75056,0.6551724137931034,6
16140,Hippodrome de Longchamp,OUI,25,2,23,21,2,OUI,OUI,2025-03-13 05:59:13+00:00,"48.86413226532, 2.239905372262",Paris,75056,0.92,6
17006,Guy Môquet - Compoint,OUI,34,14,20,16,4,OUI,OUI,2025-03-13 05:53:35+00:00,"48.89213559044868, 2.32321947813034",Paris,75056,0.5882352941176471,6
20035,Pyrénées - Ménilmontant,OUI,25,21,4,0,4,OUI,OUI,2025-03-13 05:59:59+00:00,"48.8693268535238, 2.395084574818611",Paris,75056,0.16,6
21207,Verdier - République,OUI,29,21,8,5,3,OUI,OUI,2025-03-13 05:56:36+00:00,"48.815403766277, 2.31739372015",Montrouge,92049,0.27586206896551724,6
15032,Félix Faure - Lourmel,OUI,54,12,42,37,5,OUI,OUI,2025-03-13 06:00:23+00:00,"48.83868901709515, 2.2818081825971603",Paris,75056,0.7777777777777778,6
12122,Bois de Vincennes - Polygone,OUI,50,45,5,3,2,OUI,OUI,2025-03-13 05:57:11+00:00,"48.83544491617421, 2.431421081436563",Paris,75056,0.1,6
20037,Gambetta - Saint Fargeau,OUI,24,23,1,0,1,OUI,OUI,2025-03-13 05:53:44+00:00,"48.871244610447015, 2.4039056897163396",Paris,75056,0.041666666666666664,6
16033,Marché d'Auteuil,OUI,31,15,16,14,2,OUI,OUI,2025-03-13 05:59:52+00:00,"48.84842761367387, 2.265253821160005",Paris,75056,0.5161290322580645,6
19045,Macdonald - Césaria Evora,OUI,65,54,11,2,9,OUI,OUI,2025-03-13 06:00:18+00:00,"48.89883, 2.37933",Paris,75056,0.16923076923076924,6
21205,Arthur Auger - Jean Jaurès,OUI,23,16,7,2,5,OUI,OUI,2025-03-13 05:59:16+00:00,"48.813736445585235, 2.3069277405738835",Montrouge,92049,0.30434782608695654,6
13053,Chevaleret - Tolbiac,OUI,21,10,11,4,7,OUI,OUI,2025-03-13 06:00:21+00:00,"48.82941, 2.375934",Paris,75056,0.5238095238095238,6
6004,Regard - Rennes,OUI,46,41,5,2,3,OUI,OUI,2025-03-13 05:58:09+00:00,"48.847385404956, 2.3268555477262",Paris,75056,0.10869565217391304,6
48011,Epi d'Or - Chevilly,OUI,20,14,6,1,5,OUI,OUI,2025-03-13 06:00:07+00:00,"48.781109786782, 2.3549050362061",Villejuif,94076,0.3,6
11029,Ménilmontant - Oberkampf,OUI,39,31,8,2,6,OUI,OUI,2025-03-13 05:55:55+00:00,"48.866617658681, 2.3830134404158",Paris,75056,0.20512820512820512,6
19014,Lorraine - Jean Jaurès,OUI,19,14,5,2,3,OUI,OUI,2025-03-13 05:59:43+00:00,"48.8863865, 2.3825772",Paris,75056,0.2631578947368421,6
41212,Nungesser - Santé,OUI,22,21,1,0,1,OUI,OUI,2025-03-13 06:00:30+00:00,"48.852335, 2.448967",Fontenay-sous-Bois,94033,0.045454545454545456,6
15014,Volontaires - Vaugirard,OUI,33,17,16,13,3,OUI,OUI,2025-03-13 05:59:55+00:00,"48.84132050184004, 2.30808901725357",Paris,75056,0.48484848484848486,6
41304,Port - Maurice Chevalier,OUI,29,4,25,23,2,OUI,OUI,2025-03-13 05:59:31+00:00,"48.832474421632, 2.490257616467",Nogent-sur-Marne,94052,0.8620689655172413,6
13055,M.- A. Lagroua Weill-Hallé -  F. Dolto,OUI,58,50,8,4,4,OUI,OUI,2025-03-13 05:57:29+00:00,"48.828595283857425, 2.380220606266108",Paris,75056,0.13793103448275862,6
10151,Gare du Nord - Faubourg Saint-Denis,OUI,28,17,11,5,6,OUI,OUI,2025-03-13 05:59:43+00:00,"48.879612765504, 2.3568402975798",Paris,75056,0.39285714285714285,6
22014,Victor Hugo - Bineau,OUI,25,14,11,3,8,OUI,OUI,2025-03-13 05:59:59+00:00,"48.88758225888669, 2.2783890366554265",Neuilly-sur-Seine,92051,0.44,6
7007,Musée d'Orsay,OUI,64,31,33,30,3,OUI,OUI,2025-03-13 05:59:03+00:00,"48.859726157909, 2.3258604481816",Paris,75056,0.515625,6
25002,Hôtel de Ville de Rueil-Malmaison,OUI,19,7,12,12,0,OUI,OUI,2025-03-13 05:59:41+00:00,"48.878194, 2.181724",Rueil-Malmaison,92063,0.631578947368421,6
26011,Ménil - Argenteuil,OUI,17,3,14,9,5,OUI,OUI,2025-03-13 05:59:10+00:00,"48.925901818305, 2.2741496502338",Asnières-sur-Seine,92004,0.8235294117647058,6
6005,Montparnasse -  Square Ozanam,OUI,49,24,25,20,5,OUI,OUI,2025-03-13 05:51:53+00:00,"48.843310567822, 2.3265242949128",Paris,75056,0.5102040816326531,6
22208,Stalingrad - Barbara,OUI,19,18,1,0,1,OUI,OUI,2025-03-13 05:58:18+00:00,"48.809223658808, 2.3175904558822",Bagneux,92007,0.05263157894736842,6
16022,Jean Bologne - Passy,OUI,19,17,2,1,1,OUI,OUI,2025-03-13 05:57:42+00:00,"48.857566889784465, 2.280027395306772",Paris,75056,0.10526315789473684,6
45005,Stalingrad - Général de Gaulle,OUI,26,9,17,5,12,OUI,OUI,2025-03-13 06:00:05+00:00,"48.823450589614, 2.4965062363218",Champigny-sur-Marne,94017,0.6538461538461539,6
20011,Pyrénées - Dagorno,OUI,20,18,2,0,2,OUI,OUI,2025-03-13 05:57:56+00:00,"48.855425770695085, 2.4051643162965775",Paris,75056,0.1,6
18045,Pierre Ginier - Clichy,OUI,15,13,2,0,2,OUI,OUI,2025-03-13 05:55:37+00:00,"48.8867667, 2.326228",Paris,75056,0.13333333333333333,6
10025,Jemmapes - Ecluses Saint-Martin,OUI,14,4,10,3,7,OUI,OUI,2025-03-13 05:59:53+00:00,"48.87748519186726, 2.3660067468881607",Paris,75056,0.7142857142857143,6
20106,Mairie du 20ème,OUI,27,24,3,0,3,OUI,OUI,2025-03-13 05:54:38+00:00,"48.865302324275, 2.3990669846535",Paris,75056,0.1111111111111111,6
22305,Jean Jaurès - Place du Dr Roux,OUI,34,20,14,6,8,OUI,OUI,2025-03-13 05:59:55+00:00,"48.927567032796, 2.2947337017374",Gennevilliers,92036,0.4117647058823529,6
6020,Place Saint-André des Arts,OUI,33,21,12,10,2,OUI,OUI,2025-03-13 05:59:52+00:00,"48.852886173881, 2.3426544293761",Paris,75056,0.36363636363636365,6
21954,Val-Fleury,OUI,22,16,6,1,5,OUI,OUI,2025-03-13 05:54:51+00:00,"48.807671407991, 2.2407217696309",Meudon,92048,0.2727272727272727,6
21016,Point du Jour - Jean Jaurès,OUI,39,15,24,21,3,OUI,OUI,2025-03-13 05:59:04+00:00,"48.828753141436465, 2.245911467014621",Boulogne-Billancourt,92012,0.6153846153846154,6
11201,Faubourg St-Antoine - Place de la Nation,OUI,16,2,14,3,11,OUI,OUI,2025-03-13 05:52:57+00:00,"48.8487726, 2.393606",Paris,75056,0.875,6
5105,Geoffroy-Saint-Hilaire - Saint-Marcel,OUI,17,4,13,11,2,OUI,OUI,2025-03-13 05:59:21+00:00,"48.83907826424974, 2.356877340669728",Paris,75056,0.7647058823529411,6
22602,Place Henri Dunant - Gare RER,OUI,30,23,7,2,5,OUI,OUI,2025-03-13 05:54:11+00:00,"48.788093281931, 2.2909234046643",Fontenay-aux-Roses,92032,0.23333333333333334,6
19123,Metz - Marne,OUI,30,27,3,0,3,OUI,OUI,2025-03-13 05:52:40+00:00,"48.891163, 2.3865705",Paris,75056,0.1,6
23205,Parc des Pierrettes,OUI,22,15,7,0,7,OUI,OUI,2025-03-13 05:56:27+00:00,"48.7973062, 2.2909969",Châtillon,92020,0.3181818181818182,6
12017,Saint-Mandé - Docteur Arnold Netter,OUI,36,10,26,19,7,OUI,OUI,2025-03-13 06:01:05+00:00,"48.84462585769668, 2.404946386814118",Paris,75056,0.7222222222222222,6
25010,Maréchal Leclerc de Hauteclocque - Marché Buzenval,OUI,30,22,8,5,3,OUI,OUI,2025-03-13 05:51:28+00:00,"48.858446, 2.192077",Rueil-Malmaison,92063,0.26666666666666666,6
42027,Verdun - Pierre et Marie Curie,OUI,26,23,3,0,3,OUI,OUI,2025-03-13 05:56:59+00:00,"48.812822398263286, 2.3707106709480286",Ivry-sur-Seine,94041,0.11538461538461539,6
12001,Bastille - Biscornet,OUI,58,19,39,37,2,OUI,OUI,2025-03-13 06:00:10+00:00,"48.851355779579, 2.369220033288",Paris,75056,0.6724137931034483,6
16104,Paul Valery - Victor Hugo,OUI,33,32,1,0,1,OUI,OUI,2025-03-13 05:55:12+00:00,"48.87137406080164, 2.2887128591537476",Paris,75056,0.030303030303030304,6
22018,Charles de Gaulle - Les Sablons,OUI,35,31,4,1,3,OUI,OUI,2025-03-13 05:56:56+00:00,"48.880987514929, 2.2715748726513",Neuilly-sur-Seine,92051,0.11428571428571428,6
30005,Convention - Campus de Bobigny,OUI,29,21,8,1,7,OUI,OUI,2025-03-13 05:59:35+00:00,"48.914920058264, 2.4172238067445",Bobigny,93008,0.27586206896551724,6
11001,Richard Lenoir - Place de la Bastille,OUI,46,21,25,20,5,OUI,OUI,2025-03-13 05:59:55+00:00,"48.8538327, 2.3697222",Paris,75056,0.5434782608695652,6
21327,Jean Bouin - Gouverneur Général Eboué,OUI,31,9,22,22,0,OUI,OUI,2025-03-13 05:58:30+00:00,"48.824792734266, 2.2651904328524",Issy-les-Moulineaux,92040,0.7096774193548387,6
13013,Saint-Marcel - Hôpital,OUI,20,19,1,0,1,OUI,OUI,2025-03-13 06:00:11+00:00,"48.839504424583, 2.3609894170229",Paris,75056,0.05,6
19018,Cité de la Musique,OUI,54,30,24,11,13,OUI,OUI,2025-03-13 06:00:17+00:00,"48.888796556487, 2.3925811931922",Paris,75056,0.4444444444444444,6
8044,Alfred de Vigny - Place du Général Brocard,OUI,32,27,5,2,3,OUI,OUI,2025-03-13 06:00:56+00:00,"48.87836138361425, 2.305254448220567",Paris,75056,0.15625,6
17126,Hélène et François Missoffe - Emile Borel,OUI,28,19,9,8,1,OUI,OUI,2025-03-13 05:56:28+00:00,"48.89990653843488, 2.321543991674844",Paris,75056,0.32142857142857145,6
21510,Fontaine du Tertre - Calvaire,OUI,22,21,1,0,1,OUI,OUI,2025-03-13 05:59:48+00:00,"48.8702539, 2.2187778",Suresnes,92073,0.045454545454545456,6
34005,Adrien Lesesne - Docteur Bauer,OUI,29,12,17,4,13,OUI,OUI,2025-03-13 06:00:59+00:00,"48.90263867304635, 2.348248063431511",Saint-Ouen-sur-Seine,93070,0.5862068965517241,6
17036,Place Tristan Bernard,OUI,28,18,10,5,5,OUI,OUI,2025-03-13 05:58:37+00:00,"48.8794936, 2.2915423",Paris,75056,0.35714285714285715,6
17127,Porte de Clichy - Place des Nations Unies,OUI,36,8,28,27,1,OUI,OUI,2025-03-13 06:00:48+00:00,"48.896737263309504, 2.310542999196392",Paris,75056,0.7777777777777778,6
13008,Place d'Italie - Soeur Rosalie,OUI,51,33,18,5,13,OUI,OUI,2025-03-13 05:56:38+00:00,"48.831908520394, 2.3546943448098",Paris,75056,0.35294117647058826,6
26008,Henri Barbusse - Bourguignons,OUI,33,13,20,5,15,OUI,OUI,2025-03-13 06:00:14+00:00,"48.91301722799713, 2.2734212270774417",Asnières-sur-Seine,92004,0.6060606060606061,6
21033,Sèvres - Maréchal Juin,OUI,17,5,12,11,1,OUI,OUI,2025-03-13 06:00:21+00:00,"48.8324305, 2.2292812",Boulogne-Billancourt,92012,0.7058823529411765,6
26009,Marceau Delorme - Pierre Brossolette,OUI,26,6,20,13,7,OUI,OUI,2025-03-13 06:00:51+00:00,"48.91206062860357, 2.295897423568745",Asnières-sur-Seine,92004,0.7692307692307693,6
21112,Claude Debussy - Marc Bloch,OUI,52,41,11,9,2,OUI,OUI,2025-03-13 06:00:07+00:00,"48.910388180512, 2.3117771744728",Clichy,92024,0.21153846153846154,6
34008,Garibaldi - Gabriel Péri,OUI,29,24,5,3,2,OUI,OUI,2025-03-13 05:59:24+00:00,"48.905741911394, 2.3316044208059",Saint-Ouen-sur-Seine,93070,0.1724137931034483,6
41101,Paul Doumer - Stalingrad,OUI,24,17,7,5,2,OUI,OUI,2025-03-13 05:57:54+00:00,"48.806518992199, 2.3368880152702",Arcueil,94003,0.2916666666666667,6
34012,Bateliers - Quai de Seine,OUI,24,14,10,3,7,OUI,OUI,2025-03-13 05:58:52+00:00,"48.915817585516, 2.3239533298594",Saint-Ouen-sur-Seine,93070,0.4166666666666667,6
3201,Payenne - Square George Caïn,OUI,23,11,12,8,4,OUI,OUI,2025-03-13 06:00:57+00:00,"48.8578329, 2.3622643",Paris,75056,0.5217391304347826,6
31301,Gare RER,OUI,25,15,10,3,7,OUI,OUI,2025-03-13 05:58:35+00:00,"48.896280181078, 2.4581568985227",Noisy-le-Sec,93053,0.4,6
23106,Pavé des Gardes - Charles Vaillant,OUI,20,11,9,9,0,OUI,OUI,2025-03-13 05:59:15+00:00,"48.81168551728, 2.2111820107205",Sèvres,92072,0.45,6
21514,Place de la Paix - Abbé Saint-Pierre,OUI,24,17,7,5,2,OUI,OUI,2025-03-13 05:54:29+00:00,"48.86462724459225, 2.2047570338469806",Suresnes,92073,0.2916666666666667,6
21508,Georges Pompidou - Verdun,OUI,24,2,22,11,11,OUI,OUI,2025-03-13 06:01:02+00:00,"48.875481, 2.232443",Suresnes,92073,0.9166666666666666,6
31303,Simone Signoret - Paris,OUI,26,16,10,5,5,OUI,OUI,2025-03-13 05:55:59+00:00,"48.903600624712865, 2.465406596265139",Noisy-le-Sec,93053,0.38461538461538464,6
22302,Gare RER - Général de Gaulle,OUI,38,25,13,9,4,OUI,OUI,2025-03-13 05:57:26+00:00,"48.933548439566, 2.3064726536317",Gennevilliers,92036,0.34210526315789475,6
5107,Pontoise - La Tournelle,OUI,22,4,18,17,1,OUI,OUI,2025-03-13 05:58:08+00:00,"48.850458009188, 2.3524542754922",Paris,75056,0.8181818181818182,6
9029,Saint-Lazare - Place d'Estienne d'Orves,OUI,39,35,4,2,2,OUI,OUI,2025-03-13 05:59:23+00:00,"48.8768345, 2.3329067",Paris,75056,0.10256410256410256,6
17010,Jonquière - Docteur Paul Brousse,OUI,38,12,26,22,4,OUI,OUI,2025-03-13 05:58:49+00:00,"48.894799816683985, 2.318705212173216",Paris,75056,0.6842105263157895,6
34009,Dora Maar - Nadia Guendouz,OUI,27,6,21,13,8,OUI,OUI,2025-03-13 05:59:59+00:00,"48.905452421305, 2.3220406472683",Saint-Ouen-sur-Seine,93070,0.7777777777777778,6
18024,Clignancourt - Ordener,OUI,34,28,6,3,3,OUI,OUI,2025-03-13 05:53:23+00:00,"48.891457726153774, 2.348636478060487",Paris,75056,0.17647058823529413,6
8031,Jean Mermoz - Champs-Elysées,OUI,44,40,4,0,4,OUI,OUI,2025-03-13 05:56:26+00:00,"48.869689856852, 2.3107324540615",Paris,75056,0.09090909090909091,6
13205,Choisy - Pointe d'Ivry,OUI,24,13,11,9,2,OUI,OUI,2025-03-13 06:00:51+00:00,"48.822154170359, 2.3633708034878",Paris,75056,0.4583333333333333,6
22209,Verdun - Henri Barbusse,OUI,23,19,4,0,4,OUI,OUI,2025-03-13 05:55:30+00:00,"48.802056061754, 2.3159965061736",Bagneux,92007,0.17391304347826086,6
31201,Suzanne Masson,OUI,33,1,32,12,20,OUI,OUI,2025-03-13 05:59:42+00:00,"48.923306888013, 2.3847292397611",La Courneuve,93027,0.9696969696969697,6
35021,Cartier Bresson - Denis Papin,OUI,31,23,8,3,5,OUI,OUI,2025-03-13 06:00:26+00:00,"48.902616, 2.397814",Pantin,93055,0.25806451612903225,6
14110,Abbé Carton - Plantes,OUI,25,19,6,1,5,OUI,OUI,2025-03-13 05:59:45+00:00,"48.827673823166, 2.3209181427956",Paris,75056,0.24,6
18134,Ney - Porte de Clignancourt,OUI,23,21,2,0,2,OUI,OUI,2025-03-13 05:59:11+00:00,"48.8978867, 2.3458001",Paris,75056,0.08695652173913043,6
18018,Carpeaux - Place Jacques Froment,OUI,17,5,12,3,9,OUI,OUI,2025-03-13 05:59:22+00:00,"48.8906542, 2.3309428",Paris,75056,0.7058823529411765,6
13203,Square de Choisy - Eastman,OUI,23,19,4,2,2,OUI,OUI,2025-03-13 05:59:18+00:00,"48.828543456283, 2.3583075090494",Paris,75056,0.17391304347826086,6
32305,Saint-Germain - Verdun,OUI,29,20,9,0,9,OUI,OUI,2025-03-13 05:59:10+00:00,"48.882877330093, 2.4331868384644",Romainville,93063,0.3103448275862069,6
47007,Liberté - Vert-de-Maisons,OUI,20,3,17,13,4,OUI,OUI,2025-03-13 05:56:40+00:00,"48.790147809608, 2.4328628182411",Maisons-Alfort,94046,0.85,6
22507,Châteaudun - Place de la Liberté,OUI,25,18,7,3,4,OUI,OUI,2025-03-13 05:57:36+00:00,"48.90970830301211, 2.2454486480600626",La Garenne-Colombes,92035,0.28,6
13202,Place Farhat Hached,OUI,28,14,14,5,9,OUI,OUI,2025-03-13 05:59:16+00:00,"48.825487045602, 2.3816306985827",Paris,75056,0.5,6
12106,Gare de Lyon - Roland Barthes,OUI,68,35,33,25,8,OUI,OUI,2025-03-13 06:00:06+00:00,"48.84395729494058, 2.3790882155299187",Paris,75056,0.4852941176470588,6
21501,Pont de Suresnes,OUI,17,10,7,3,4,OUI,OUI,2025-03-13 05:59:53+00:00,"48.867415092322, 2.2258946679617",Suresnes,92073,0.4117647058823529,6
32023,Guy Môquet - Jean Moulin,OUI,28,5,23,11,12,OUI,OUI,2025-03-13 06:00:55+00:00,"48.940931521020836, 2.363948999931771",Saint-Denis,93066,0.8214285714285714,6
19204,Rampal - Belleville,OUI,19,16,3,0,3,OUI,OUI,2025-03-13 05:59:55+00:00,"48.873114661405, 2.3798409114805",Paris,75056,0.15789473684210525,6
23201,Avenir,OUI,42,35,7,1,6,OUI,OUI,2025-03-13 05:59:10+00:00,"48.8103438, 2.3003776",Châtillon,92020,0.16666666666666666,6
5201,Saint-Jacques - Soufflot,OUI,16,10,6,4,2,OUI,OUI,2025-03-13 06:00:04+00:00,"48.846280383395, 2.3430785379567",Paris,75056,0.375,6
12165,Champs de Manoeuvre - Cartoucherie,OUI,32,25,7,5,2,OUI,OUI,2025-03-13 05:56:29+00:00,"48.835261, 2.447974",Paris,75056,0.21875,6
18042,Place Pigalle,OUI,20,18,2,0,2,OUI,OUI,2025-03-13 05:58:17+00:00,"48.8827555, 2.3361566",Paris,75056,0.1,6
21320,Président Roosevelt - Rouget de Lisle,OUI,40,30,10,7,3,OUI,OUI,2025-03-13 06:00:02+00:00,"48.83047518749, 2.2616135525345",Issy-les-Moulineaux,92040,0.25,6
11037,Faubourg Du Temple - Republique,OUI,38,0,38,32,6,OUI,OUI,2025-03-13 06:00:21+00:00,"48.867872484749, 2.3648982158072",Paris,75056,1.0,6
23203,Division Leclerc - Kléber,OUI,25,8,17,5,12,OUI,OUI,2025-03-13 05:57:06+00:00,"48.798666226364, 2.2833752789972",Châtillon,92020,0.68,6
18041,Rochechouart - Martyrs,OUI,16,12,4,0,4,OUI,OUI,2025-03-13 06:01:04+00:00,"48.882193779572, 2.3405495658517",Paris,75056,0.25,6
9035,Gare Saint-Lazare - Place de Budapest,OUI,43,31,12,3,9,OUI,OUI,2025-03-13 05:58:08+00:00,"48.877753, 2.327339",Paris,75056,0.27906976744186046,6
8039,Colisée - Champs-Elysées,OUI,15,9,6,0,6,OUI,OUI,2025-03-13 05:58:42+00:00,"48.870475399387, 2.3076190799475",Paris,75056,0.4,6
23204,Roland Garros - Jean Bouin,OUI,27,19,8,3,5,OUI,OUI,2025-03-13 05:59:35+00:00,"48.809460857173, 2.2853198638301",Châtillon,92020,0.2962962962962963,6
11102,Alexandre Dumas - Voltaire,OUI,58,21,37,22,15,OUI,OUI,2025-03-13 05:57:50+00:00,"48.852888670365, 2.3891476408096",Paris,75056,0.6379310344827587,6
10026,Gare de l'Est - Chateau Landon,OUI,52,45,7,5,2,OUI,OUI,2025-03-13 06:00:49+00:00,"48.879305, 2.362424",Paris,75056,0.1346153846153846,6
16103,Traktir - Foch,OUI,20,16,4,1,3,OUI,OUI,2025-03-13 05:59:08+00:00,"48.872755334614, 2.2915497802487",Paris,75056,0.2,6
18023,Ordener - Poissonniers,OUI,35,27,8,1,7,OUI,OUI,2025-03-13 05:58:21+00:00,"48.891213890844654, 2.351288666219873",Paris,75056,0.22857142857142856,6
21213,Vanne - Général de Gaulle,OUI,25,17,8,2,6,OUI,OUI,2025-03-13 06:00:52+00:00,"48.815007, 2.328318",Montrouge,92049,0.32,6
18026,Ruisseau - Ordener,OUI,31,29,2,1,1,OUI,OUI,2025-03-13 05:53:00+00:00,"48.89299462568024, 2.340144887566567",Paris,75056,0.06451612903225806,6
35001,Jean Jaurès - Ouvrières Pivéreuses,OUI,21,13,8,2,6,OUI,OUI,2025-03-13 05:59:43+00:00,"48.910423437526, 2.3995766043663",Pantin,93055,0.38095238095238093,6
16006,Lauriston - Copernic,OUI,19,19,0,0,0,OUI,OUI,2025-03-13 05:57:55+00:00,"48.86926, 2.289918",Paris,75056,0.0,6
11011,Richard Lenoir - Voltaire,OUI,22,5,17,13,4,OUI,OUI,2025-03-13 05:59:30+00:00,"48.86164273878, 2.3727491497993",Paris,75056,0.7727272727272727,6
8008,Joseph Sansboeuf - Saint Lazare,OUI,31,25,6,4,2,OUI,OUI,2025-03-13 06:00:17+00:00,"48.875315630653, 2.3229019716382",Paris,75056,0.1935483870967742,6
11012,Montreuil - Voltaire,OUI,33,23,10,2,8,OUI,OUI,2025-03-13 06:01:04+00:00,"48.850507011842, 2.3930755582745",Paris,75056,0.30303030303030304,6
31202,Gabriel Péri - Jules Ferry,OUI,28,8,20,16,4,OUI,OUI,2025-03-13 06:00:18+00:00,"48.926182814311, 2.3912295762525",La Courneuve,93027,0.7142857142857143,6
7109,Place Joffre - Frédéric le Play,OUI,37,28,9,7,2,OUI,OUI,2025-03-13 05:55:41+00:00,"48.853754486938, 2.3044242337346",Paris,75056,0.24324324324324326,6
7201,Place De Fontenoy - Saxe,OUI,18,13,5,2,3,OUI,OUI,2025-03-13 06:00:50+00:00,"48.850270554523, 2.3069813815839",Paris,75056,0.2777777777777778,6
7025,Octave Gréard - Tour Eiffel,OUI,32,18,14,10,4,OUI,OUI,2025-03-13 06:00:29+00:00,"48.856502977696, 2.2931787543289",Paris,75056,0.4375,6
15013,Volontaires - Lecourbe,OUI,28,5,23,17,6,OUI,OUI,2025-03-13 06:00:42+00:00,"48.84351378799, 2.3065522313118",Paris,75056,0.8214285714285714,6
40007,Préfecture de Créteil,OUI,27,5,22,14,8,OUI,OUI,2025-03-13 06:00:20+00:00,"48.783680285918, 2.4544713672215",Créteil,94028,0.8148148148148148,6
40012,Stade de la Habette,OUI,16,14,2,0,2,OUI,OUI,2025-03-13 05:58:44+00:00,"48.774397033806, 2.4668785263921",Créteil,94028,0.125,6
13204,Tolbiac - Boussingault,OUI,39,29,10,9,1,OUI,OUI,2025-03-13 06:00:29+00:00,"48.826177754027, 2.3420378552202",Paris,75056,0.2564102564102564,6
12107,Diderot - Pierre Bourdan,OUI,21,10,11,6,5,OUI,OUI,2025-03-13 06:00:02+00:00,"48.847648620797, 2.3902582749724",Paris,75056,0.5238095238095238,6
13035,Choisy - Tolbiac,OUI,20,17,3,0,3,OUI,OUI,2025-03-13 05:57:54+00:00,"48.82591155587, 2.3602393269539",Paris,75056,0.15,6
16005,Raymond Poincaré - Place Victor Hugo,OUI,22,21,1,1,0,OUI,OUI,2025-03-13 05:55:05+00:00,"48.87030612437, 2.2850745414202",Paris,75056,0.045454545454545456,6
15062,Convention - Lourmel,OUI,35,9,26,26,0,OUI,OUI,2025-03-13 06:01:02+00:00,"48.842055041656, 2.2859910875559",Paris,75056,0.7428571428571429,6
12201,Dugommier,OUI,52,15,37,31,6,OUI,OUI,2025-03-13 06:00:39+00:00,"48.838811048815, 2.3896577954292",Paris,75056,0.7115384615384616,6
10114,Granges aux Belles - Hôpital Saint-Louis,OUI,60,41,19,13,6,OUI,OUI,2025-03-13 05:57:31+00:00,"48.874794994841, 2.366669436985",Paris,75056,0.31666666666666665,6
12105,Bercy - Villot,OUI,32,4,28,16,12,OUI,OUI,2025-03-13 05:58:17+00:00,"48.841795009027, 2.3767850184816",Paris,75056,0.875,6
13051,Halle Freyssinet - Parvis Alan Turing,OUI,23,21,2,2,0,OUI,OUI,2025-03-13 05:53:37+00:00,"48.832846814471, 2.3711421713233",Paris,75056,0.08695652173913043,6
40003,Centre Hospitalier Intercommunal de Créteil,OUI,17,15,2,1,1,OUI,OUI,2025-03-13 05:56:39+00:00,"48.797078298909, 2.463801423807",Créteil,94028,0.11764705882352941,6
8038,François 1er - Montaigne,OUI,52,45,7,7,0,OUI,OUI,2025-03-13 05:57:50+00:00,"48.866887649978, 2.3066755757207",Paris,75056,0.1346153846153846,6
23801,Place de la Gare,OUI,20,12,8,3,5,OUI,OUI,2025-03-13 05:51:15+00:00,"48.838513582184, 2.1866139007512",Garches,92033,0.4,6
11014,Place de la Nation - Taillebourg,OUI,46,1,45,21,24,OUI,OUI,2025-03-13 06:00:38+00:00,"48.8488408, 2.3973043",Paris,75056,0.9782608695652174,6
40004,Créteil Village,OUI,25,4,21,7,14,OUI,OUI,2025-03-13 06:00:27+00:00,"48.79122395576, 2.4642198533952",Créteil,94028,0.84,6
35002,Jean Jaurès - Presles,OUI,31,27,4,1,3,OUI,OUI,2025-03-13 05:57:13+00:00,"48.907134414988, 2.3960057280531",Pantin,93055,0.12903225806451613,6
23703,Gare de Chaville Rive Gauche,OUI,18,16,2,1,1,OUI,OUI,2025-03-13 05:56:43+00:00,"48.805160304345, 2.188277207315",Chaville,92022,0.1111111111111111,6
11020,Belfort - Voltaire,OUI,38,3,35,30,5,OUI,OUI,2025-03-13 06:00:21+00:00,"48.8563358, 2.3829901",Paris,75056,0.9210526315789473,6
18044,Clichy - Douai,OUI,32,31,1,0,1,OUI,OUI,2025-03-13 06:00:24+00:00,"48.883687771522, 2.328063700029",Paris,75056,0.03125,6
51005,Yves Farges - Route d'Enghien,OUI,33,16,17,6,11,OUI,OUI,2025-03-13 05:57:55+00:00,"48.95756799268, 2.2834496977978",Argenteuil,95018,0.5151515151515151,6
12157,Fabre d'Eglantine - Place de la Nation,OUI,66,47,19,8,11,OUI,OUI,2025-03-13 06:00:34+00:00,"48.8471116, 2.3956204",Paris,75056,0.2878787878787879,6
3004,Place de la République - Temple,OUI,16,0,16,14,2,OUI,OUI,2025-03-13 05:55:14+00:00,"48.867211201859, 2.3635464370545",Paris,75056,1.0,6
20137,Borrégo - Gambetta,OUI,25,24,1,0,1,OUI,OUI,2025-03-13 05:58:29+00:00,"48.87330497045532, 2.4014145880937576",Paris,75056,0.04,6
11046,Place de la République - Voltaire,OUI,16,3,13,10,3,OUI,OUI,2025-03-13 05:59:00+00:00,"48.866830968942, 2.3654810339212",Paris,75056,0.8125,6
10013,Alibert - Jemmapes,OUI,56,28,28,25,3,OUI,OUI,2025-03-13 06:00:05+00:00,"48.871044051984, 2.3661044619878",Paris,75056,0.5,6
11009,Boulets - Voltaire,OUI,22,9,13,12,1,OUI,OUI,2025-03-13 05:52:35+00:00,"48.85218705621, 2.3890301585197",Paris,75056,0.5909090909090909,6
15103,Cauchy - Cévennes,OUI,50,6,44,43,1,OUI,OUI,2025-03-13 06:00:59+00:00,"48.843372571022, 2.2751328349113",Paris,75056,0.88,6
15060,Place de la Montagne du Goulet,OUI,21,4,17,15,2,OUI,OUI,2025-03-13 06:00:17+00:00,"48.8443415, 2.2773844",Paris,75056,0.8095238095238095,6
41301,Bois de Vincennes - Gare,OUI,50,32,18,14,4,OUI,OUI,2025-03-13 05:54:55+00:00,"48.836022242887, 2.470833995083",Nogent-sur-Marne,94052,0.36,6
7111,Ecole Militaire - Place Joffre,OUI,23,18,5,2,3,OUI,OUI,2025-03-13 06:00:49+00:00,"48.852060203583, 2.3017993569374",Paris,75056,0.21739130434782608,6
18043,Clichy - Place Blanche,OUI,18,14,4,2,2,OUI,OUI,2025-03-13 05:59:55+00:00,"48.883601088297, 2.3332237824798",Paris,75056,0.2222222222222222,6
15105,Fédération - Suffren,OUI,24,2,22,21,1,OUI,OUI,2025-03-13 05:59:38+00:00,"48.852828153442, 2.2978776320815",Paris,75056,0.9166666666666666,6
1003,Saint-Denis - Rivoli,OUI,42,25,17,16,1,OUI,OUI,2025-03-13 06:01:00+00:00,"48.859059340842, 2.3476943001151",Paris,75056,0.40476190476190477,6
18205,Mauroy - Cheminots,OUI,30,13,17,3,14,OUI,OUI,2025-03-13 05:54:51+00:00,"48.897715198403, 2.357895075822",Paris,75056,0.5666666666666667,6
34014,Michelet - Dr Bauer,OUI,29,17,12,3,9,OUI,OUI,2025-03-13 05:46:54+00:00,"48.906125424194, 2.3440374449846",Saint-Ouen-sur-Seine,93070,0.41379310344827586,6
8057,Hoche - Tilsitt,OUI,31,29,2,1,1,OUI,OUI,2025-03-13 05:57:30+00:00,"48.874836457837, 2.2971323132515",Paris,75056,0.06451612903225806,6
32012,Carrefour Pleyel,OUI,65,47,18,5,13,OUI,OUI,2025-03-13 05:58:22+00:00,"48.92034156960326, 2.3438543826341625",Saint-Denis,93066,0.27692307692307694,6
7023,Bourdonnais - Tour Eiffel,OUI,54,26,28,21,7,OUI,OUI,2025-03-13 06:00:56+00:00,"48.860897797941, 2.295599598447",Paris,75056,0.5185185185185185,6
21404,Jean Jaurès - Gare de Clamart,OUI,20,11,9,0,9,OUI,OUI,2025-03-13 05:56:06+00:00,"48.81321981219, 2.2716768079163",Clamart,92023,0.45,6
9025,Taitbout - Châteaudun,OUI,53,41,12,12,0,OUI,OUI,2025-03-13 05:57:18+00:00,"48.876383969379, 2.3353566779335",Paris,75056,0.22641509433962265,6
17123,Mstislav Rostropovitch - Berthier,OUI,18,17,1,1,0,OUI,OUI,2025-03-13 05:52:58+00:00,"48.892120821173975, 2.309234105050564",Paris,75056,0.05555555555555555,6
4108,Quai de Béthune - Pont de la Tournelle,OUI,25,5,20,20,0,OUI,OUI,2025-03-13 05:59:03+00:00,"48.85097433194, 2.3563072085381",Paris,75056,0.8,6
6001,Institut de France,OUI,17,11,6,5,1,OUI,OUI,2025-03-13 06:00:29+00:00,"48.857615678565, 2.3358313530377",Paris,75056,0.35294117647058826,6
40010,Haut du Mont-Mesly,OUI,21,16,5,2,3,OUI,OUI,2025-03-13 06:00:44+00:00,"48.780191921646, 2.4685737495183",Créteil,94028,0.23809523809523808,6
1002,Victoria - Place du Chatelet,OUI,19,15,4,1,3,OUI,OUI,2025-03-13 05:57:02+00:00,"48.857992591527, 2.3469167947769",Paris,75056,0.21052631578947367,6
40013,Hôtel de Ville de Créteil,OUI,36,19,17,13,4,OUI,OUI,2025-03-13 05:59:55+00:00,"48.77699496201, 2.4552552404284",Créteil,94028,0.4722222222222222,6
17038,Grande Armée - Brunel,OUI,60,53,7,2,5,OUI,OUI,2025-03-13 06:00:33+00:00,"48.876116, 2.288124",Paris,75056,0.11666666666666667,6
40014,Créteil Pointe du Lac,OUI,28,3,25,9,16,OUI,OUI,2025-03-13 06:00:57+00:00,"48.769807356177, 2.4623027310281",Créteil,94028,0.8928571428571429,6
8052,Balzac - Champs Elysées,OUI,29,26,3,1,2,OUI,OUI,2025-03-13 05:58:45+00:00,"48.872699639621, 2.3001953959465",Paris,75056,0.10344827586206896,6
23011,Bineau - Louise Michel,OUI,26,25,1,0,1,OUI,OUI,2025-03-13 06:00:39+00:00,"48.88666162207, 2.2843274474144",Levallois-Perret,92044,0.038461538461538464,6
12010,Daumesnil - Picpus,OUI,22,6,16,8,8,OUI,OUI,2025-03-13 06:00:23+00:00,"48.8374688, 2.401765",Paris,75056,0.7272727272727273,6
26005,Hôtel de Ville d'Asnières sur Seine,OUI,25,18,7,5,2,OUI,OUI,2025-03-13 05:58:33+00:00,"48.90999330025577, 2.288238108158112",Asnières-sur-Seine,92004,0.28,6
13123,BNF - Bibliothèque Nationale de France,OUI,43,38,5,4,1,OUI,OUI,2025-03-13 06:01:00+00:00,"48.8350268238, 2.3760157451034",Paris,75056,0.11627906976744186,6
40008,Créteil Pompadour,OUI,44,14,30,12,18,OUI,OUI,2025-03-13 06:00:54+00:00,"48.773011623355, 2.435166164893",Créteil,94028,0.6818181818181818,6
40002,Bleuets - Bordières,OUI,21,16,5,2,3,OUI,OUI,2025-03-13 05:57:43+00:00,"48.802117531472, 2.4543687905029",Créteil,94028,0.23809523809523808,6
14021,Place de la Porte de Châtillon,OUI,59,53,6,3,3,OUI,OUI,2025-03-13 05:56:52+00:00,"48.8242469, 2.3186306",Paris,75056,0.1016949152542373,6
15056,Place Balard,OUI,24,4,20,15,5,OUI,OUI,2025-03-13 05:57:59+00:00,"48.836395736424, 2.2784192115068",Paris,75056,0.8333333333333334,6
13106,Bobillot - Paulin Mery,OUI,22,2,20,1,19,OUI,OUI,2025-03-13 06:00:00+00:00,"48.829899841747, 2.3543356766749",Paris,75056,0.9090909090909091,6
21021,Enfants du Paradis - Peupliers,OUI,42,26,16,12,4,OUI,OUI,2025-03-13 06:00:36+00:00,"48.833122686454, 2.2571459412575",Boulogne-Billancourt,92012,0.38095238095238093,6
40015,Iles de Loisirs de Créteil,OUI,24,4,20,10,10,OUI,OUI,2025-03-13 06:01:00+00:00,"48.780258200618, 2.4455094301232",Créteil,94028,0.8333333333333334,6
10031,Louis Blanc - Aqueduc,OUI,36,21,15,7,8,OUI,OUI,2025-03-13 06:00:20+00:00,"48.882030182599, 2.363561578095",Paris,75056,0.4166666666666667,6
32004,Wilson - Landy,OUI,39,20,19,11,8,OUI,OUI,2025-03-13 06:00:22+00:00,"48.91516726221354, 2.357633225619793",Saint-Denis,93066,0.48717948717948717,6
35014,Charles de Gaulle - Jean Lolive,OUI,26,19,7,2,5,OUI,OUI,2025-03-13 05:59:23+00:00,"48.8932644350857, 2.4126765131950383",Pantin,93055,0.2692307692307692,6
31708,Noisy le Sec - Jean-Baptiste Clément,OUI,19,18,1,0,1,OUI,OUI,2025-03-13 05:58:52+00:00,"48.874515389637, 2.4152836203575",Bagnolet,93006,0.05263157894736842,6
15026,Bir Hakeim,OUI,31,15,16,12,4,OUI,OUI,2025-03-13 05:59:14+00:00,"48.853844054334, 2.289705348222",Paris,75056,0.5161290322580645,6
1022,Danielle Casanova - Place Vendôme,OUI,37,25,12,5,7,OUI,OUI,2025-03-13 05:55:20+00:00,"48.868266498223, 2.3304839059711",Paris,75056,0.32432432432432434,6
19203,Pailleron - Bouret,OUI,26,5,21,4,17,OUI,OUI,2025-03-13 05:56:20+00:00,"48.880516995482, 2.3763902374411",Paris,75056,0.8076923076923077,6
27004,Gare de la Garenne-Colombes,OUI,27,15,12,4,8,OUI,OUI,2025-03-13 05:56:24+00:00,"48.909752, 2.239145",Colombes,92025,0.4444444444444444,6
4104,Sebastopol - Rambuteau,OUI,15,4,11,9,2,OUI,OUI,2025-03-13 06:00:42+00:00,"48.86181809267, 2.3501381278038",Paris,75056,0.7333333333333333,6
32001,Proudhon - Président Wilson,OUI,30,15,15,4,11,OUI,OUI,2025-03-13 06:00:32+00:00,"48.906442763495, 2.3584905266762",Saint-Denis,93066,0.5,6
33019,Madeleine Vionnet,OUI,28,12,16,5,11,OUI,OUI,2025-03-13 05:57:47+00:00,"48.902519074064, 2.3740895837545",Aubervilliers,93001,0.5714285714285714,6
21302,Aristide Briand - Place de la Résistance,OUI,45,3,42,38,4,OUI,OUI,2025-03-13 06:01:00+00:00,"48.82124248401006, 2.2511002421379094",Issy-les-Moulineaux,92040,0.9333333333333333,6
8002,Gare Saint-Lazare - Cour du Havre,OUI,41,8,33,18,15,OUI,OUI,2025-03-13 06:00:05+00:00,"48.875674400851, 2.3265598341823",Paris,75056,0.8048780487804879,6
12127,Tremblay - Lac des Minimes,OUI,46,40,6,0,6,OUI,OUI,2025-03-13 05:59:40+00:00,"48.834131261494, 2.4547516554594",Paris,75056,0.13043478260869565,6
9104,Caumartin - Provence,OUI,22,15,7,3,4,OUI,OUI,2025-03-13 05:58:35+00:00,"48.874422773426545, 2.3284685611724854",Paris,75056,0.3181818181818182,6
8004,Malesherbes - Place de la Madeleine,OUI,79,62,17,8,9,OUI,OUI,2025-03-13 05:49:58+00:00,"48.870406028483, 2.323243509808",Paris,75056,0.21518987341772153,6
9020,Toudouze - Clauzel,OUI,21,19,2,2,0,OUI,OUI,2025-03-13 06:52:38+00:00,"48.87929591733507, 2.3373600840568547",Paris,75056,0.09523809523809523,7
16107,Benjamin Godard - Victor Hugo,OUI,31,29,2,0,2,OUI,OUI,2025-03-13 06:59:56+00:00,"48.865983, 2.275725",Paris,75056,0.06451612903225806,7
11104,Charonne - Robert et Sonia Delaunay,OUI,20,10,10,0,10,OUI,OUI,2025-03-13 06:57:21+00:00,"48.855907555969, 2.3925706744194",Paris,75056,0.5,7
40001,Hôpital Mondor,OUI,28,10,18,10,8,OUI,OUI,2025-03-13 06:59:55+00:00,"48.798922410229, 2.4537451531298",Créteil,94028,0.6428571428571429,7
8026,Messine - Place Du Pérou,OUI,12,9,3,3,0,OUI,OUI,2025-03-13 06:51:45+00:00,"48.875448033960744, 2.315508019010038",Paris,75056,0.25,7
44015,Rouget de L'isle - Watteau,OUI,20,5,15,1,14,OUI,OUI,2025-03-13 07:01:04+00:00,"48.778192750803, 2.3963020229163",Vitry-sur-Seine,94081,0.75,7
7002,Vaneau - Sèvres,OUI,35,7,28,22,6,OUI,OUI,2025-03-13 07:00:59+00:00,"48.848563233059, 2.3204218259346",Paris,75056,0.8,7
14111,Cassini - Denfert-Rochereau,OUI,23,22,1,0,1,OUI,OUI,2025-03-13 06:58:25+00:00,"48.837525839067, 2.3360354080796",Paris,75056,0.043478260869565216,7
33006,André Karman - République,OUI,30,22,8,3,5,OUI,OUI,2025-03-13 07:00:15+00:00,"48.91039875761846, 2.3851355910301213",Aubervilliers,93001,0.26666666666666666,7
14014,Jourdan - Stade Charléty,OUI,60,47,13,4,9,OUI,OUI,2025-03-13 06:58:22+00:00,"48.819428333369, 2.3433353751898",Paris,75056,0.21666666666666667,7
40011,Bas du Mont-Mesly,OUI,26,19,7,5,2,OUI,OUI,2025-03-13 07:00:56+00:00,"48.779035118572, 2.4609763908985",Créteil,94028,0.2692307692307692,7
32017,Basilique,OUI,20,12,8,0,8,OUI,OUI,2025-03-13 06:56:50+00:00,"48.93626891059109, 2.3588666820200914",Saint-Denis,93066,0.4,7
21010,Silly - Galliéni,OUI,25,10,15,13,2,OUI,OUI,2025-03-13 07:00:44+00:00,"48.835583838706, 2.2325500845909",Boulogne-Billancourt,92012,0.6,7
13007,Le Brun - Gobelins,OUI,46,6,40,26,14,OUI,OUI,2025-03-13 07:00:48+00:00,"48.835092787824, 2.3534681351338",Paris,75056,0.8695652173913043,7
7003,Square Boucicaut,OUI,59,52,7,3,4,OUI,OUI,2025-03-13 07:00:38+00:00,"48.851296433665276, 2.325061820447445",Paris,75056,0.11864406779661017,7
6003,Saint-Sulpice,OUI,21,14,7,5,2,OUI,OUI,2025-03-13 06:57:43+00:00,"48.85165383178419, 2.3308077827095985",Paris,75056,0.3333333333333333,7
15047,Morillons - Dantzig,OUI,51,33,18,7,11,OUI,OUI,2025-03-13 06:57:59+00:00,"48.83310149953933, 2.299380004405976",Paris,75056,0.35294117647058826,7
5110,Lacépède - Monge,OUI,23,23,0,0,0,OUI,OUI,2025-03-13 06:55:27+00:00,"48.84389286531899, 2.3519663885235786",Paris,75056,0.0,7
17026,Jouffroy d'Abbans - Wagram,OUI,39,35,4,2,2,OUI,OUI,2025-03-13 06:59:54+00:00,"48.881973298352, 2.301132157445",Paris,75056,0.10256410256410256,7
6108,Saint-Romain - Cherche-Midi,OUI,15,13,2,1,1,OUI,OUI,2025-03-13 06:57:44+00:00,"48.84708159081946, 2.321374788880348",Paris,75056,0.13333333333333333,7
6021,Beaux-Arts - Bonaparte,OUI,20,17,3,2,1,OUI,OUI,2025-03-13 06:58:10+00:00,"48.856451985396, 2.3348518833518",Paris,75056,0.15,7
42016,Pierre et Marie Curie - Maurice Thorez,OUI,27,22,5,3,2,OUI,OUI,2025-03-13 07:00:53+00:00,"48.81580226360801, 2.376804985105991",Ivry-sur-Seine,94041,0.18518518518518517,7
15202,Bracion - Périphérique,OUI,30,21,9,5,4,OUI,OUI,2025-03-13 07:00:44+00:00,"48.826103771275, 2.3004549373748",Paris,75056,0.3,7
25006,Place Nelson Mandela,OUI,22,19,3,3,0,OUI,OUI,2025-03-13 06:57:54+00:00,"48.862453313908, 2.1961666225454",Rueil-Malmaison,92063,0.13636363636363635,7
12109,Mairie du 12ème,OUI,30,9,21,15,6,OUI,OUI,2025-03-13 07:00:37+00:00,"48.840855311763, 2.3875549435616",Paris,75056,0.7,7
30002,Jean Rostand - Paul Vaillant Couturier,OUI,40,27,13,3,10,OUI,OUI,2025-03-13 07:00:32+00:00,"48.908168131015, 2.4530601033354",Bobigny,93008,0.325,7
14108,Le Brix et Mesmin - Jourdan,OUI,20,15,5,3,2,OUI,OUI,2025-03-13 07:00:06+00:00,"48.82234096593411, 2.327861653302471",Paris,75056,0.25,7
32304,Charcot - Benfleet,OUI,28,27,1,0,1,NON,NON,2025-03-13 06:59:48+00:00,"48.878370277021, 2.440523876268",Romainville,93063,0.03571428571428571,7
31024,Romainville - Vaillant-Couturier,OUI,36,31,5,0,5,OUI,OUI,2025-03-13 06:59:49+00:00,"48.86785, 2.446748",Montreuil,93048,0.1388888888888889,7
17041,Guersant - Gouvion-Saint-Cyr,OUI,32,18,14,10,4,OUI,OUI,2025-03-13 06:56:06+00:00,"48.88287775178599, 2.287667370814871",Paris,75056,0.4375,7
17044,Porte de Saint-Ouen - Bessières,OUI,42,23,19,9,10,OUI,OUI,2025-03-13 06:58:41+00:00,"48.89792240854517, 2.32851451022192",Paris,75056,0.4523809523809524,7
5016,Thouin - Cardinal Lemoine,OUI,16,14,2,1,1,OUI,OUI,2025-03-13 06:59:20+00:00,"48.84504716661511, 2.3494647851273465",Paris,75056,0.125,7
19033,Cambrai - Benjamin Constant,OUI,41,38,3,1,2,OUI,OUI,2025-03-13 06:57:39+00:00,"48.89594736851349, 2.381133802246315",Paris,75056,0.07317073170731707,7
11025,Froment - Bréguet,OUI,43,37,6,6,0,OUI,OUI,2025-03-13 06:58:29+00:00,"48.8570414504784, 2.37289470306807",Paris,75056,0.13953488372093023,7
17025,Chazelles - Courcelles,OUI,33,23,10,5,5,OUI,OUI,2025-03-13 06:59:51+00:00,"48.879406604954, 2.3034455627202988",Paris,75056,0.30303030303030304,7
8050,Boétie - Ponthieu,OUI,44,30,14,3,11,OUI,OUI,2025-03-13 06:57:07+00:00,"48.871417284355, 2.3076787590981",Paris,75056,0.3181818181818182,7
21326,Moulin de Pierre - Abbé Grégoire,OUI,20,18,2,0,2,OUI,OUI,2025-03-13 06:53:55+00:00,"48.822036188382, 2.2754641655975",Issy-les-Moulineaux,92040,0.1,7
13101,Croulebarde - Corvisart,OUI,33,3,30,15,15,OUI,OUI,2025-03-13 07:01:05+00:00,"48.830981659316855, 2.3481646925210953",Paris,75056,0.9090909090909091,7
20143,Ramponeau - Belleville,OUI,43,40,3,1,2,OUI,OUI,2025-03-13 06:58:10+00:00,"48.871031137596, 2.379056852114",Paris,75056,0.06976744186046512,7
2022,Saint-Fiacre - Poissonière,OUI,33,27,6,1,5,OUI,OUI,2025-03-13 06:56:21+00:00,"48.870828911558, 2.3459213599563",Paris,75056,0.18181818181818182,7
43002,Lagny - Victor Basch,OUI,23,6,17,6,11,OUI,OUI,2025-03-13 06:59:13+00:00,"48.84884147189881, 2.426325418925233",Vincennes,94080,0.7391304347826086,7
21216,Louis Lejeune - Barbès,OUI,24,17,7,3,4,OUI,OUI,2025-03-13 07:00:01+00:00,"48.81807418981508, 2.3267009854316716",Montrouge,92049,0.2916666666666667,7
16138,Saint-Cloud - Hippodrome,OUI,30,24,6,3,3,OUI,OUI,2025-03-13 06:53:21+00:00,"48.85772148887421, 2.2549109905958176",Paris,75056,0.2,7
15068,Général Martial Valin - Pont du Garigliano,OUI,16,8,8,4,4,OUI,OUI,2025-03-13 06:57:29+00:00,"48.83823094269141, 2.270506024360657",Paris,75056,0.5,7
31028,Raspail Barbès,OUI,28,28,0,0,0,OUI,OUI,2025-03-13 06:59:24+00:00,"48.8529945, 2.4247387",Montreuil,93048,0.0,7
22207,Rond-point du Dr Albert Schweitzer,OUI,21,17,4,4,0,OUI,OUI,2025-03-13 06:57:13+00:00,"48.78980918988166, 2.3143940046429634",Bagneux,92007,0.19047619047619047,7
17048,De Toqueville - Terrasse,OUI,30,17,13,12,1,OUI,OUI,2025-03-13 06:58:47+00:00,"48.882428, 2.314002",Paris,75056,0.43333333333333335,7
92002,Théâtre des Amandiers - Palais des sports,OUI,23,11,12,6,6,OUI,OUI,2025-03-13 06:58:39+00:00,"48.892648526839, 2.2136941552162",Nanterre,92050,0.5217391304347826,7
19027,Serrurier,OUI,18,14,4,0,4,OUI,OUI,2025-03-13 06:56:53+00:00,"48.880493403246, 2.398064173758",Paris,75056,0.2222222222222222,7
16118,Michel-Ange - Parent de Rosan,OUI,25,5,20,13,7,OUI,OUI,2025-03-13 07:01:03+00:00,"48.840579923690115, 2.2584119439125065",Paris,75056,0.8,7
44017,Jules Guesde - Pont du Port à l'Anglais,OUI,26,0,26,21,5,OUI,OUI,2025-03-13 06:57:43+00:00,"48.79628807093802, 2.417212128639221",Vitry-sur-Seine,94081,1.0,7
8103,Artois - Berri,OUI,22,20,2,0,2,OUI,OUI,2025-03-13 06:55:59+00:00,"48.87393521240818, 2.3064258322119713",Paris,75056,0.09090909090909091,7
2017,Caire - Dussoubs,OUI,38,19,19,17,2,OUI,OUI,2025-03-13 06:54:28+00:00,"48.86785342111862, 2.349364310503006",Paris,75056,0.5,7
14013,Liard - Amiral Mouchez,OUI,26,22,4,3,1,OUI,OUI,2025-03-13 07:01:03+00:00,"48.8214169, 2.342167",Paris,75056,0.15384615384615385,7
9008,Tour d'Auvergne - Rodier,OUI,17,11,6,4,2,OUI,OUI,2025-03-13 06:59:18+00:00,"48.879161, 2.343698",Paris,75056,0.35294117647058826,7
13118,Regnault - Patay,OUI,63,24,39,32,7,OUI,OUI,2025-03-13 06:57:35+00:00,"48.82435782216384, 2.377065159380436",Paris,75056,0.6190476190476191,7
8048,Marceau - Chaillot,OUI,18,15,3,1,2,OUI,OUI,2025-03-13 06:51:39+00:00,"48.868834023334, 2.2986030816809",Paris,75056,0.16666666666666666,7
13030,Italie - Tolbiac,OUI,21,9,12,3,9,OUI,OUI,2025-03-13 07:00:59+00:00,"48.82557229464416, 2.3576171323657036",Paris,75056,0.5714285714285714,7
15112,Vigée-Lebrun - Anselme Payen,OUI,23,22,1,0,1,OUI,OUI,2025-03-13 06:58:45+00:00,"48.838683941628375, 2.3110422492027287",Paris,75056,0.043478260869565216,7
48003,Youri Gagarine - Karl Marx,OUI,21,17,4,2,2,OUI,OUI,2025-03-13 06:57:57+00:00,"48.78448485079149, 2.35908430069685",Villejuif,94076,0.19047619047619047,7
18111,Félix Ziem - Armand Gauthier,OUI,21,15,6,4,2,OUI,OUI,2025-03-13 07:00:29+00:00,"48.88949630486821, 2.333393658804396",Paris,75056,0.2857142857142857,7
16110,Octave Feuillet - Albéric Magnard,OUI,21,19,2,0,2,OUI,OUI,2025-03-13 07:00:36+00:00,"48.86106902949534, 2.2730283066630363",Paris,75056,0.09523809523809523,7
9002,Abbeville - Faubourg Poissonnière,OUI,14,10,4,2,2,OUI,OUI,2025-03-13 07:00:50+00:00,"48.879223, 2.349147",Paris,75056,0.2857142857142857,7
43009,Place Jean-Spire-Lemaître,OUI,49,45,4,3,1,OUI,OUI,2025-03-13 07:00:57+00:00,"48.8468428626593, 2.452062070369721",Vincennes,94080,0.08163265306122448,7
9001,Bellefond - Poissonnière,OUI,15,8,7,6,1,OUI,OUI,2025-03-13 06:59:54+00:00,"48.87759897050706, 2.348463758826256",Paris,75056,0.4666666666666667,7
17032,Jean Oestreicher - Porte de Champerret,OUI,21,12,9,2,7,OUI,OUI,2025-03-13 07:00:17+00:00,"48.88655580065981, 2.288640439510346",Paris,75056,0.42857142857142855,7
8016,Square Louis XVI,OUI,29,21,8,6,2,OUI,OUI,2025-03-13 07:00:44+00:00,"48.87320440102894, 2.323658830743138",Paris,75056,0.27586206896551724,7
41303,Gare de Nogent-le-Perreux,OUI,30,14,16,12,4,OUI,OUI,2025-03-13 06:58:30+00:00,"48.83842553348809, 2.493693307042122",Nogent-sur-Marne,94052,0.5333333333333333,7
10115,Granges aux Belles,OUI,27,15,12,7,5,OUI,OUI,2025-03-13 06:58:55+00:00,"48.8761373390584, 2.3680844979417",Paris,75056,0.4444444444444444,7
5022,Boulangers - Cardinal Lemoine,OUI,18,14,4,1,3,OUI,OUI,2025-03-13 07:00:59+00:00,"48.8462904, 2.3521495",Paris,75056,0.2222222222222222,7
10029,Dunkerque - Rocroy,OUI,23,21,2,0,2,OUI,OUI,2025-03-13 06:57:53+00:00,"48.880726, 2.351464",Paris,75056,0.08695652173913043,7
21328,Verger - Colonel Guichard,OUI,29,26,3,0,3,OUI,OUI,2025-03-13 06:59:35+00:00,"48.816376985087, 2.2670380088932",Issy-les-Moulineaux,92040,0.10344827586206896,7
10161,Gare de l'Est - Faubourg-Saint-Martin,OUI,32,21,11,8,3,OUI,OUI,2025-03-13 06:59:13+00:00,"48.875642647477, 2.3594588041306",Paris,75056,0.34375,7
17040,Pereire - Ternes,OUI,47,42,5,5,0,OUI,OUI,2025-03-13 06:55:28+00:00,"48.87973954830735, 2.288012132048607",Paris,75056,0.10638297872340426,7
12031,Gabriel Lamé,OUI,35,31,4,4,0,OUI,OUI,2025-03-13 06:56:49+00:00,"48.8351212784276, 2.385534569621086",Paris,75056,0.11428571428571428,7
17008,Porte Pouchet-Bessières,OUI,23,5,18,10,8,OUI,OUI,2025-03-13 06:59:36+00:00,"48.8978765, 2.3230632",Paris,75056,0.782608695652174,7
1001,Quai de l'Horloge - Pont Neuf,OUI,16,7,9,9,0,OUI,OUI,2025-03-13 06:59:35+00:00,"48.857058739111, 2.3417982839439",Paris,75056,0.5625,7
18203,Lamarck - Saint-Ouen,OUI,40,40,0,0,0,NON,NON,2025-03-13 06:55:43+00:00,"48.891334555236, 2.3272445342326",Paris,75056,0.0,7
13104,Gare d'Austerlitz - Quai Saint-Bernard,OUI,26,6,20,16,4,OUI,OUI,2025-03-13 06:58:30+00:00,"48.84369030864, 2.3657163977623",Paris,75056,0.7692307692307693,7
8053,Place Georges Guillaumin,OUI,26,24,2,0,2,OUI,OUI,2025-03-13 07:01:05+00:00,"48.874750203957, 2.301771435326",Paris,75056,0.07692307692307693,7
9038,Douai - Bruxelles,OUI,26,25,1,1,0,OUI,OUI,2025-03-13 07:00:29+00:00,"48.88320784122797, 2.3308449949028507",Paris,75056,0.038461538461538464,7
9014,Faubourg Montmartre - La Fayette,OUI,34,20,14,12,2,OUI,OUI,2025-03-13 07:00:16+00:00,"48.875254549053, 2.3408536612988",Paris,75056,0.4117647058823529,7
8009,Gare Saint-Lazare - Isly,OUI,25,11,14,6,8,OUI,OUI,2025-03-13 07:00:10+00:00,"48.874777677621296, 2.326515804784655",Paris,75056,0.56,7
9106,Boudreau - Auber,OUI,27,24,3,1,2,OUI,OUI,2025-03-13 07:00:48+00:00,"48.87219, 2.329423",Paris,75056,0.1111111111111111,7
31103,Gare Rosny-Bois-Perrier,OUI,32,14,18,0,18,OUI,OUI,2025-03-13 07:00:45+00:00,"48.88115023337061, 2.480436824262142",Rosny-sous-Bois,93064,0.5625,7
31706,Château - République,OUI,25,16,9,2,7,OUI,OUI,2025-03-13 07:00:27+00:00,"48.862923800596, 2.4155035614967",Bagnolet,93006,0.36,7
7018,Ségur - d'Estrées,OUI,19,12,7,4,3,OUI,OUI,2025-03-13 06:58:59+00:00,"48.851419978983, 2.3097044974566",Paris,75056,0.3684210526315789,7
19015,Thionville - Ourcq,OUI,21,21,0,0,0,OUI,OUI,2025-03-13 06:54:59+00:00,"48.88917613743794, 2.3833653330802917",Paris,75056,0.0,7
5005,Gay Lussac - Saint-Jacques,OUI,24,19,5,0,5,OUI,OUI,2025-03-13 06:59:28+00:00,"48.844730256132, 2.3419239448664",Paris,75056,0.20833333333333334,7
19003,Quai de la Seine,OUI,23,14,9,2,7,OUI,OUI,2025-03-13 07:00:38+00:00,"48.884492238407525, 2.3703941702842717",Paris,75056,0.391304347826087,7
21323,Charlot - Stade Gabriel Voisin,OUI,31,8,23,21,2,OUI,OUI,2025-03-13 07:00:55+00:00,"48.827228120536, 2.268122527474",Issy-les-Moulineaux,92040,0.7419354838709677,7
5020,Institut du Monde Arabe - Saint-Germain,OUI,40,12,28,24,4,OUI,OUI,2025-03-13 07:00:14+00:00,"48.849063299501, 2.3558086529374",Paris,75056,0.7,7
19105,Ambroise Rendu - Porte Brunet,OUI,17,14,3,1,2,OUI,OUI,2025-03-13 06:54:52+00:00,"48.883667, 2.395733",Paris,75056,0.17647058823529413,7
10107,Gare du Nord - Hôpital Lariboisière,OUI,49,45,4,2,2,OUI,OUI,2025-03-13 06:56:43+00:00,"48.881949, 2.352339",Paris,75056,0.08163265306122448,7
22409,Henri Barbusse - Stalingrad,OUI,16,11,5,1,4,OUI,OUI,2025-03-13 06:54:13+00:00,"48.814183748660554, 2.2872862592339516",Malakoff,92046,0.3125,7
17043,Belidor - Gouvion-Saint-Cyr,OUI,38,27,11,11,0,OUI,OUI,2025-03-13 06:59:40+00:00,"48.88022154052015, 2.2854680567979813",Paris,75056,0.2894736842105263,7
9022,Rossini - Laffitte,OUI,33,29,4,2,2,OUI,OUI,2025-03-13 07:01:02+00:00,"48.87334627510507, 2.337980867701675",Paris,75056,0.12121212121212122,7
16039,Exelmans - Versailles,OUI,48,10,38,31,7,OUI,OUI,2025-03-13 07:00:32+00:00,"48.84097491091973, 2.264390252530575",Paris,75056,0.7916666666666666,7
26003,Argenteuil - Voltaire,OUI,16,12,4,1,3,OUI,OUI,2025-03-13 06:59:30+00:00,"48.91864865955558, 2.2814112156629562",Asnières-sur-Seine,92004,0.25,7
11023,Saint-Maur - Roquette,OUI,46,25,21,20,1,OUI,OUI,2025-03-13 06:58:48+00:00,"48.858688774062955, 2.383553994571467",Paris,75056,0.45652173913043476,7
17004,Legendre - Clichy,OUI,38,23,15,10,5,OUI,OUI,2025-03-13 07:01:04+00:00,"48.88896161855884, 2.322528975094376",Paris,75056,0.39473684210526316,7
8034,Berri - Haussmann,OUI,34,32,2,1,1,OUI,OUI,2025-03-13 06:59:54+00:00,"48.874746047357135, 2.3082953318953514",Paris,75056,0.058823529411764705,7
12151,Gare de Lyon - Place Louis Armand,OUI,58,5,53,31,22,OUI,OUI,2025-03-13 07:00:50+00:00,"48.845515089794, 2.3726498446286",Paris,75056,0.9137931034482759,7
18107,Chartres - La Charbonnière,OUI,34,31,3,1,2,OUI,OUI,2025-03-13 06:56:04+00:00,"48.8847601, 2.3534657",Paris,75056,0.08823529411764706,7
92007,Pesaro - Préfecture,OUI,21,20,1,1,0,OUI,OUI,2025-03-13 06:59:34+00:00,"48.89577046284005, 2.223908342421055",Nanterre,92050,0.047619047619047616,7
20042,Pyrénées - Emmery,OUI,39,33,6,0,6,OUI,OUI,2025-03-13 07:01:03+00:00,"48.872010281270974, 2.392039597034455",Paris,75056,0.15384615384615385,7
16026,Ranelagh - Mozart,OUI,7,7,0,0,0,OUI,OUI,2025-03-13 06:58:03+00:00,"48.8554439, 2.2704418",Paris,75056,0.0,7
15067,Desaix - Edgar Faure,OUI,11,3,8,8,0,OUI,OUI,2025-03-13 06:56:02+00:00,"48.852804604940296, 2.293077029857222",Paris,75056,0.7272727272727273,7
9028,Moncey - Blanche,OUI,17,16,1,0,1,OUI,OUI,2025-03-13 06:56:28+00:00,"48.88006587474148, 2.3310810327529907",Paris,75056,0.058823529411764705,7
6006,Notre-Dame-des-Champs - Stanislas,OUI,19,14,5,1,4,OUI,OUI,2025-03-13 07:01:04+00:00,"48.84479928858768, 2.329337755887181",Paris,75056,0.2631578947368421,7
26002,Redoute - Les Courtilles,OUI,37,5,32,15,17,OUI,OUI,2025-03-13 07:00:41+00:00,"48.929867194519, 2.2836696356535",Asnières-sur-Seine,92004,0.8648648648648649,7
11027,Saint-Ambroise - Parmentier,OUI,36,8,28,23,5,OUI,OUI,2025-03-13 06:59:49+00:00,"48.862147844548, 2.3772348091006",Paris,75056,0.7777777777777778,7
19026,Place de Rhin et Danube,OUI,14,12,2,0,2,OUI,OUI,2025-03-13 06:58:57+00:00,"48.88192765861766, 2.392586767673493",Paris,75056,0.14285714285714285,7
12128,Pyramide - Ecole du Breuil,OUI,32,24,8,2,6,OUI,OUI,2025-03-13 07:00:50+00:00,"48.82237977153955, 2.4586871266365056",Paris,75056,0.25,7
45003,11 Novembre 1918 - 8 Mai 1945,OUI,36,12,24,14,10,OUI,OUI,2025-03-13 06:55:00+00:00,"48.80889533774377, 2.5382421165704727",Champigny-sur-Marne,94017,0.6666666666666666,7
8010,Liège - Moscou,OUI,16,13,3,2,1,OUI,OUI,2025-03-13 06:59:41+00:00,"48.8795431, 2.3264628",Paris,75056,0.1875,7
11002,Roquette - Thiéré,OUI,22,3,19,18,1,OUI,OUI,2025-03-13 07:01:01+00:00,"48.85507930579506, 2.3733686318721463",Paris,75056,0.8636363636363636,7
31022,Mairie de Montreuil,OUI,51,42,9,5,4,OUI,OUI,2025-03-13 06:57:31+00:00,"48.86131452758348, 2.440614402294159",Montreuil,93048,0.17647058823529413,7
12111,Claude Decaen - Cannebière,OUI,25,17,8,2,6,OUI,OUI,2025-03-13 07:00:43+00:00,"48.83761417037952, 2.397253782195704",Paris,75056,0.32,7
31009,Place Du Général De Gaulle,OUI,25,23,2,0,2,OUI,OUI,2025-03-13 06:59:05+00:00,"48.8687591, 2.4329931",Montreuil,93048,0.08,7
11047,Amelot - Saint-Sébastien,OUI,29,9,20,19,1,OUI,OUI,2025-03-13 06:58:51+00:00,"48.861142162761, 2.3677996181077",Paris,75056,0.6896551724137931,7
15042,Henry Farman,OUI,16,10,6,4,2,OUI,OUI,2025-03-13 07:00:18+00:00,"48.83372430280548, 2.2713854536414146",Paris,75056,0.375,7
19043,Delphine Seyrig - Général Leclerc,OUI,52,43,9,2,7,OUI,OUI,2025-03-13 07:00:50+00:00,"48.893923963057865, 2.39790290594101",Pantin,93055,0.17307692307692307,7
33102,Gabriel Péri - Francisco Ferrer,OUI,17,16,1,0,1,OUI,OUI,2025-03-13 07:01:06+00:00,"48.88633710236977, 2.407338917255402",Le Pré-Saint-Gervais,93061,0.058823529411764705,7
5032,Panthéon - Valette,OUI,39,20,19,1,18,OUI,OUI,2025-03-13 06:59:13+00:00,"48.847020571652, 2.3464982619671",Paris,75056,0.48717948717948717,7
42706,Roger Salengro - Fontainebleau,OUI,25,25,0,0,0,OUI,OUI,2025-03-13 07:00:43+00:00,"48.814548697325, 2.3611663654447",Le Kremlin-Bicêtre,94043,0.0,7
17030,Pereire - Rennequin,OUI,21,3,18,13,5,OUI,OUI,2025-03-13 06:58:48+00:00,"48.88364782887555, 2.2952447086572647",Paris,75056,0.8571428571428571,7
19120,Carducci - Place Hannah Arendt,OUI,27,25,2,0,2,OUI,OUI,2025-03-13 06:59:05+00:00,"48.877436681515796, 2.3860743641853337",Paris,75056,0.07407407407407407,7
46002,Rouget de Lisle,OUI,35,3,32,15,17,OUI,OUI,2025-03-13 06:50:12+00:00,"48.764615483395254, 2.4071189761161804",Choisy-le-Roi,94022,0.9142857142857143,7
18003,Cimetière de Montmartre,OUI,43,42,1,0,1,OUI,OUI,2025-03-13 06:51:49+00:00,"48.886472466142, 2.3328901827335",Paris,75056,0.023255813953488372,7
10016,Récollets - Square Villemin,OUI,17,14,3,1,2,OUI,OUI,2025-03-13 06:59:13+00:00,"48.875034655883944, 2.359801238597928",Paris,75056,0.17647058823529413,7
14003,Schoelcher - Raspail,OUI,48,38,10,3,7,OUI,OUI,2025-03-13 07:01:03+00:00,"48.83681733526843, 2.3312794080411474",Paris,75056,0.20833333333333334,7
41302,Charles de Gaulle - Beauté,OUI,48,42,6,0,6,OUI,OUI,2025-03-13 07:01:05+00:00,"48.83649602312711, 2.479562651149885",Nogent-sur-Marne,94052,0.125,7
5018,Mutualité,OUI,36,16,20,16,4,OUI,OUI,2025-03-13 06:59:11+00:00,"48.848225572724, 2.3502873256803",Paris,75056,0.5555555555555556,7
14020,Cimetière de Montrouge,OUI,58,41,17,3,14,OUI,OUI,2025-03-13 06:58:49+00:00,"48.821466904768, 2.3215785772007",Paris,75056,0.29310344827586204,7
19101,Square Simon Bolivar,OUI,23,15,8,1,7,OUI,OUI,2025-03-13 07:00:59+00:00,"48.875089888322, 2.3826304078102",Paris,75056,0.34782608695652173,7
33017,Anatole France - President Roosevelt,OUI,26,5,21,6,15,OUI,OUI,2025-03-13 07:00:03+00:00,"48.9155156, 2.3814103",Aubervilliers,93001,0.8076923076923077,7
14138,Porte de Vanves,OUI,30,12,18,15,3,OUI,OUI,2025-03-13 07:00:40+00:00,"48.828012849445, 2.3056878894567",Paris,75056,0.6,7
18011,Pajol - Place Herbert,OUI,37,18,19,8,11,OUI,OUI,2025-03-13 07:00:26+00:00,"48.8927825, 2.3635598",Paris,75056,0.5135135135135135,7
12114,Victor Hugo - Jeanne Jugan,OUI,28,18,10,3,7,OUI,OUI,2025-03-13 07:00:28+00:00,"48.843949064031825, 2.415081394834419",Paris,75056,0.35714285714285715,7
21212,Marne - Germain Dardan,OUI,21,20,1,1,0,OUI,OUI,2025-03-13 06:58:34+00:00,"48.81217465201, 2.3035024699104",Montrouge,92049,0.047619047619047616,7
46003,Conservatoire de Musique,OUI,24,1,23,18,5,OUI,OUI,2025-03-13 07:00:34+00:00,"48.77093586667601, 2.4034014344215398",Choisy-le-Roi,94022,0.9583333333333334,7
44006,Concorde - Stalingrad,OUI,34,19,15,8,7,OUI,OUI,2025-03-13 06:58:25+00:00,"48.7985844, 2.3821302",Vitry-sur-Seine,94081,0.4411764705882353,7
41209,Cimetière de Fontenay-sous-Bois,OUI,15,15,0,0,0,OUI,OUI,2025-03-13 06:47:59+00:00,"48.84706173362218, 2.4787822365760808",Fontenay-sous-Bois,94033,0.0,7
11113,Richard Lenoir - Republique,OUI,53,8,45,41,4,OUI,OUI,2025-03-13 07:00:32+00:00,"48.8667175, 2.3692541",Paris,75056,0.8490566037735849,7
14008,Mouton Duvernet - Général Leclerc,OUI,27,23,4,0,4,OUI,OUI,2025-03-13 07:00:03+00:00,"48.831632518293, 2.3293121159077",Paris,75056,0.14814814814814814,7
15104,Hôpital Européen Georges Pompidou,OUI,63,29,34,27,7,OUI,OUI,2025-03-13 07:00:09+00:00,"48.837695319163, 2.2753742337227",Paris,75056,0.5396825396825397,7
18028,Championnet - Vauvenargues,OUI,31,21,10,7,3,OUI,OUI,2025-03-13 06:58:19+00:00,"48.89401874744574, 2.3319872841238976",Paris,75056,0.3225806451612903,7
43008,Fontenay - Libération,OUI,22,13,9,5,4,OUI,OUI,2025-03-13 07:00:58+00:00,"48.847803063647, 2.4451419711113",Vincennes,94080,0.4090909090909091,7
8017,Rocher - Laborde,OUI,65,49,16,8,8,OUI,OUI,2025-03-13 07:00:43+00:00,"48.87590240712654, 2.322616316378116",Paris,75056,0.24615384615384617,7
19103,Manin - Carrières d'Amérique,OUI,17,8,9,5,4,OUI,OUI,2025-03-13 06:58:33+00:00,"48.88467214209463, 2.3919698596000676",Paris,75056,0.5294117647058824,7
15106,Grenelle - Violet,OUI,33,19,14,13,1,OUI,OUI,2025-03-13 07:00:41+00:00,"48.84993035512154, 2.294612042605877",Paris,75056,0.42424242424242425,7
21312,Lucie Aubrac - Fort,OUI,30,30,0,0,0,OUI,OUI,2025-03-13 06:51:29+00:00,"48.818144834008976, 2.271184623241425",Issy-les-Moulineaux,92040,0.0,7
5124,Erasme - Ulm,OUI,22,17,5,2,3,OUI,OUI,2025-03-13 06:59:21+00:00,"48.84264375274712, 2.3445946723222733",Paris,75056,0.22727272727272727,7
13001,Port-Royal - Hôpital du Val-de-Grâce,OUI,18,7,11,5,6,OUI,OUI,2025-03-13 07:00:44+00:00,"48.837668272811, 2.3448138346607",Paris,75056,0.6111111111111112,7
22406,Guy Môquet - Etienne Dolet,OUI,22,21,1,0,1,OUI,OUI,2025-03-13 06:56:28+00:00,"48.81527009991819, 2.298078276995073",Malakoff,92046,0.045454545454545456,7
15054,Lecourbe - Jean Maridor,OUI,18,5,13,12,1,OUI,OUI,2025-03-13 06:59:39+00:00,"48.83796366147599, 2.2877392172813416",Paris,75056,0.7222222222222222,7
2111,Chabanais - Petits Champs,OUI,29,22,7,3,4,OUI,OUI,2025-03-13 07:00:10+00:00,"48.86703740186721, 2.336716018617153",Paris,75056,0.2413793103448276,7
14106,Marc Sangnier - Porte de Vanves,OUI,20,12,8,2,6,OUI,OUI,2025-03-13 07:00:43+00:00,"48.825218683556734, 2.3107116669416428",Paris,75056,0.4,7
18022,Marcadet - Barbès,OUI,32,18,14,5,9,OUI,OUI,2025-03-13 07:00:21+00:00,"48.890451120965, 2.3490573929687",Paris,75056,0.4375,7
18046,Etienne Jodelle - Saint Ouen,OUI,31,26,5,0,5,OUI,OUI,2025-03-13 07:00:28+00:00,"48.88794016394694, 2.326124420314341",Paris,75056,0.16129032258064516,7
15109,Cevennes - Bergers,OUI,28,13,15,14,1,OUI,OUI,2025-03-13 07:00:24+00:00,"48.84240765130395, 2.281037718057633",Paris,75056,0.5357142857142857,7
31102,Boissière - Etienne Dolet,OUI,20,17,3,1,2,OUI,OUI,2025-03-13 06:55:12+00:00,"48.876111, 2.4677312",Montreuil,93048,0.15,7
21209,Molière - République,OUI,30,26,4,3,1,OUI,OUI,2025-03-13 07:00:39+00:00,"48.81111581390707, 2.3145738624448158",Montrouge,92049,0.13333333333333333,7
8054,Bertie Albrecht - Hoche,OUI,32,27,5,1,4,OUI,OUI,2025-03-13 06:57:05+00:00,"48.87614039826388, 2.301303138307601",Paris,75056,0.15625,7
35010,Hoche - Jean Lolive,OUI,20,10,10,6,4,OUI,OUI,2025-03-13 07:01:06+00:00,"48.89110239200789, 2.402843534946442",Pantin,93055,0.5,7
14012,Sibelle - Alésia,OUI,37,33,4,2,2,OUI,OUI,2025-03-13 07:00:51+00:00,"48.826701758539215, 2.3384983465075493",Paris,75056,0.10810810810810811,7
10042,Enghien - Faubourg Poissonnière,OUI,32,16,16,14,2,OUI,OUI,2025-03-13 07:00:26+00:00,"48.872420063053, 2.3483952362828",Paris,75056,0.5,7
21005,Hôtel de Ville de Boulogne Billancourt,OUI,25,12,13,7,6,OUI,OUI,2025-03-13 07:00:57+00:00,"48.83495885166784, 2.2416803240776066",Boulogne-Billancourt,92012,0.52,7
17203,Place de la Porte de Champeret,OUI,27,4,23,17,6,OUI,OUI,2025-03-13 07:00:13+00:00,"48.886062068226, 2.2917001576821",Paris,75056,0.8518518518518519,7
8045,Place de la Reine Astrid,OUI,56,53,3,1,2,OUI,OUI,2025-03-13 06:57:06+00:00,"48.864920982538, 2.3025491823859",Paris,75056,0.05357142857142857,7
42014,Place Marcel Cachin,OUI,31,6,25,20,5,OUI,OUI,2025-03-13 06:58:17+00:00,"48.81411442356866, 2.39090770483017",Ivry-sur-Seine,94041,0.8064516129032258,7
15110,Place Robert Guillemard,OUI,22,10,12,11,1,OUI,OUI,2025-03-13 06:58:05+00:00,"48.836191728066666, 2.2811267160086417",Paris,75056,0.5454545454545454,7
4016,Lobau - Hôtel de Ville,OUI,60,22,38,34,4,OUI,OUI,2025-03-13 06:58:43+00:00,"48.8562118, 2.3532536",Paris,75056,0.6333333333333333,7
14124,David Weill - Parc Montsouris,OUI,22,16,6,1,5,OUI,OUI,2025-03-13 06:55:54+00:00,"48.821092374256104, 2.333725690841675",Paris,75056,0.2727272727272727,7
20131,Repos - Cimetière du Père Lachaise,OUI,33,26,7,6,1,OUI,OUI,2025-03-13 07:00:11+00:00,"48.859358523593, 2.3896131366845",Paris,75056,0.21212121212121213,7
15133,Saint Lambert - Blomet,OUI,27,1,26,22,4,OUI,OUI,2025-03-13 06:58:32+00:00,"48.83659148147257, 2.2930556908249855",Paris,75056,0.9629629629629629,7
5028,Censier - Jardin des Plantes,OUI,28,6,22,19,3,OUI,OUI,2025-03-13 07:00:49+00:00,"48.84107178161383, 2.355475388467312",Paris,75056,0.7857142857142857,7
21006,Marcelin Berthelot,OUI,27,19,8,3,5,OUI,OUI,2025-03-13 06:59:41+00:00,"48.8415473058801, 2.233161628246308",Boulogne-Billancourt,92012,0.2962962962962963,7
48010,Karl Marx,OUI,16,3,13,4,9,OUI,OUI,2025-03-13 06:52:00+00:00,"48.784527937293184, 2.3646667979455587",Villejuif,94076,0.8125,7
44013,Edouard Tremblay - Julian Grimaux,OUI,30,21,9,2,7,OUI,OUI,2025-03-13 06:54:23+00:00,"48.781383825117, 2.3723508417606",Vitry-sur-Seine,94081,0.3,7
35020,Marcelle - Thalie,OUI,20,19,1,0,1,OUI,OUI,2025-03-13 06:59:56+00:00,"48.8835462, 2.4137883",Pantin,93055,0.05,7
6025,Assas - Rennes,OUI,32,30,2,1,1,OUI,OUI,2025-03-13 07:00:14+00:00,"48.8492084999386, 2.32851454623001",Paris,75056,0.0625,7
1020,Cambon - Rivoli,OUI,35,23,12,2,10,OUI,OUI,2025-03-13 06:59:35+00:00,"48.866143390992, 2.3251800647137",Paris,75056,0.34285714285714286,7
21015,Nationale - Place Jules Guesde,OUI,23,7,16,11,5,OUI,OUI,2025-03-13 07:00:27+00:00,"48.82753962462998, 2.2416052222251897",Boulogne-Billancourt,92012,0.6956521739130435,7
20115,Louis Lumière - Porte de Bagnolet,OUI,20,17,3,1,2,OUI,OUI,2025-03-13 06:59:35+00:00,"48.86431136000005, 2.4105210229754443",Paris,75056,0.15,7
44003,Gabriel Péri - Danielle Casanova,OUI,20,3,17,10,7,OUI,OUI,2025-03-13 07:00:40+00:00,"48.790114, 2.4025777",Vitry-sur-Seine,94081,0.85,7
31003,Paris - Emile Zola,OUI,29,24,5,3,2,OUI,OUI,2025-03-13 07:00:58+00:00,"48.854898095789295, 2.4186685681343083",Montreuil,93048,0.1724137931034483,7
15034,Lakanal - Commerce,OUI,48,1,47,42,5,OUI,OUI,2025-03-13 06:59:55+00:00,"48.84442462786544, 2.294059172272682",Paris,75056,0.9791666666666666,7
22402,Jean Jaurès - Salvador Allende,OUI,42,42,0,0,0,OUI,OUI,2025-03-13 06:58:18+00:00,"48.821475594736775, 2.3026576638221745",Malakoff,92046,0.0,7
22203,Tertres - Fontaine,OUI,26,23,3,1,2,OUI,OUI,2025-03-13 06:58:19+00:00,"48.787553654715644, 2.306235730648041",Bagneux,92007,0.11538461538461539,7
11030,Oberkampf - République,OUI,21,12,9,8,1,OUI,OUI,2025-03-13 07:00:56+00:00,"48.86531608707, 2.37611478491",Paris,75056,0.42857142857142855,7
41202,Gare Rer de Fontenay sous Bois,OUI,57,45,12,4,8,OUI,OUI,2025-03-13 06:59:07+00:00,"48.8436279, 2.4630465",Fontenay-sous-Bois,94033,0.21052631578947367,7
17013,Legendre - Dulong,OUI,23,19,4,1,3,OUI,OUI,2025-03-13 06:57:15+00:00,"48.885325169402904, 2.316423766314984",Paris,75056,0.17391304347826086,7
42021,Raspail - Manufacture des Oeillets,OUI,30,6,24,22,2,OUI,OUI,2025-03-13 06:57:49+00:00,"48.8094458, 2.3903009",Ivry-sur-Seine,94041,0.8,7
41601,Général De Gaulle - Alouette,OUI,23,18,5,3,2,OUI,OUI,2025-03-13 07:00:14+00:00,"48.839109, 2.4175664",Saint-Mandé,94067,0.21739130434782608,7
1119,Cossonnerie - Sébastopol,OUI,23,15,8,3,5,OUI,OUI,2025-03-13 06:55:04+00:00,"48.86132665908402, 2.349419631063938",Paris,75056,0.34782608695652173,7
15021,Joseph Liouville - Croix Nivert,OUI,62,5,57,32,25,OUI,OUI,2025-03-13 06:59:25+00:00,"48.844835471244416, 2.297508493065834",Paris,75056,0.9193548387096774,7
25003,Henri Ste-Claire Déville - Paul Héroult,OUI,21,10,11,5,6,OUI,OUI,2025-03-13 07:00:38+00:00,"48.892663, 2.172411",Rueil-Malmaison,92063,0.5238095238095238,7
18009,Jean-François Lépine - Stephenson,OUI,22,4,18,2,16,OUI,OUI,2025-03-13 06:56:33+00:00,"48.88611466796807, 2.356855627529275",Paris,75056,0.8181818181818182,7
9116,Victoire - Chaussée d'Antin,OUI,24,18,6,5,1,OUI,OUI,2025-03-13 06:57:17+00:00,"48.875065791004396, 2.3316738009452824",Paris,75056,0.25,7
11105,Parmentier - République,OUI,22,8,14,9,5,OUI,OUI,2025-03-13 06:58:14+00:00,"48.8644954, 2.3750124",Paris,75056,0.6363636363636364,7
11039,Richard Lenoir - Jean-Pierre Timbaud,OUI,35,3,32,32,0,OUI,OUI,2025-03-13 07:00:44+00:00,"48.865804276686, 2.3693370749669",Paris,75056,0.9142857142857143,7
16136,Théophile Gautier - François Millet,OUI,27,6,21,18,3,OUI,OUI,2025-03-13 07:00:41+00:00,"48.85034821320644, 2.273029983043671",Paris,75056,0.7777777777777778,7
11026,Chemin Vert - Saint-Maur,OUI,44,28,16,15,1,OUI,OUI,2025-03-13 06:59:54+00:00,"48.86112461407359, 2.381299026310444",Paris,75056,0.36363636363636365,7
19032,Villette - Belleville,OUI,41,33,8,1,7,OUI,OUI,2025-03-13 07:00:45+00:00,"48.8726877314, 2.376461327076",Paris,75056,0.1951219512195122,7
32604,Square du Théâtre du Garde-Chasse,OUI,50,34,16,11,5,OUI,OUI,2025-03-13 07:00:52+00:00,"48.881287375060616, 2.420119643211365",Les Lilas,93045,0.32,7
16008,Galilée - Kléber,OUI,30,18,12,4,8,OUI,OUI,2025-03-13 06:59:48+00:00,"48.867411865714, 2.2907813801148",Paris,75056,0.4,7
19024,Botzaris - Parc des Buttes Chaumont,OUI,20,17,3,0,3,OUI,OUI,2025-03-13 06:54:11+00:00,"48.877951, 2.381464",Paris,75056,0.15,7
11024,Mairie du 11ème,OUI,50,14,36,35,1,OUI,OUI,2025-03-13 07:00:50+00:00,"48.858925, 2.3789759",Paris,75056,0.72,7
23006,Jules Guesde - Alsace,OUI,23,18,5,4,1,OUI,OUI,2025-03-13 07:00:51+00:00,"48.890566275506, 2.2950777411461",Levallois-Perret,92044,0.21739130434782608,7
13050,Quai Panhard et Levassor,OUI,57,50,7,4,3,OUI,OUI,2025-03-13 06:56:39+00:00,"48.828374828097, 2.3842737458056",Paris,75056,0.12280701754385964,7
17105,Place Madeleine Daniélou,OUI,42,21,21,10,11,OUI,OUI,2025-03-13 07:01:05+00:00,"48.883498, 2.282015",Paris,75056,0.5,7
9010,Rochechouart lamartine,OUI,24,14,10,10,0,OUI,OUI,2025-03-13 06:56:31+00:00,"48.876719895109, 2.344393021854",Paris,75056,0.4166666666666667,7
21008,Victor Hugo - Galliéni,OUI,33,13,20,18,2,OUI,OUI,2025-03-13 07:00:51+00:00,"48.838020154411, 2.2460845112801",Boulogne-Billancourt,92012,0.6060606060606061,7
16108,Sablons - Georges Mandel,OUI,38,35,3,1,2,OUI,OUI,2025-03-13 06:52:47+00:00,"48.863875, 2.28189",Paris,75056,0.07894736842105263,7
42010,Mairie d'Ivry-sur-Seine,OUI,52,8,44,31,13,OUI,OUI,2025-03-13 07:01:04+00:00,"48.81057120969284, 2.3842826485633855",Ivry-sur-Seine,94041,0.8461538461538461,7
17125,Marie-Georges Picquart - Pereire,OUI,32,26,6,2,4,OUI,OUI,2025-03-13 06:59:51+00:00,"48.88863669349711, 2.3111706599593163",Paris,75056,0.1875,7
46001,Place Paul Eluard,OUI,19,5,14,8,6,OUI,OUI,2025-03-13 06:55:03+00:00,"48.7672039733195, 2.4144977331161503",Choisy-le-Roi,94022,0.7368421052631579,7
43005,Gare RER de Vincennes,OUI,47,1,46,12,34,OUI,OUI,2025-03-13 07:00:17+00:00,"48.847563015126106, 2.433383166790009",Vincennes,94080,0.9787234042553191,7
16040,Exelmans - Michel-Ange,OUI,29,7,22,19,3,OUI,OUI,2025-03-13 07:01:05+00:00,"48.84309486651855, 2.2597770800669053",Paris,75056,0.7586206896551724,7
19022,Marché Secrétan,OUI,23,20,3,0,3,OUI,OUI,2025-03-13 06:58:33+00:00,"48.88125496379482, 2.373463287949562",Paris,75056,0.13043478260869565,7
21301,Saint-Vincent - Verdun,OUI,33,0,33,22,11,OUI,OUI,2025-03-13 07:00:58+00:00,"48.819211549234495, 2.254007756710053",Issy-les-Moulineaux,92040,1.0,7
21701,Larmeroux - Baudelaire,OUI,28,16,12,3,9,OUI,OUI,2025-03-13 06:57:01+00:00,"48.816939911292, 2.2809894804846",Vanves,92075,0.42857142857142855,7
42302,Aristide Briand - Gare de Bagneux,OUI,20,17,3,0,3,OUI,OUI,2025-03-13 07:00:14+00:00,"48.79387269664978, 2.321148812770844",Cachan,94016,0.15,7
22003,Beffroy,OUI,26,21,5,1,4,OUI,OUI,2025-03-13 07:00:19+00:00,"48.886591074488, 2.2613945603371",Neuilly-sur-Seine,92051,0.19230769230769232,7
9032,Mathurins - Auber,OUI,35,16,19,10,9,OUI,OUI,2025-03-13 07:00:15+00:00,"48.872988840744, 2.3294984212276",Paris,75056,0.5428571428571428,7
20134,Lieutenant Chauré - Etienne Marey,OUI,19,17,2,1,1,OUI,OUI,2025-03-13 07:00:34+00:00,"48.86746195408435, 2.405970990657807",Paris,75056,0.10526315789473684,7
19016,Hautpoul - Jean Jaurès,OUI,29,18,11,5,6,OUI,OUI,2025-03-13 06:55:35+00:00,"48.886393679436, 2.3865414544355",Paris,75056,0.3793103448275862,7
24001,Arche - Léonard de Vinci,OUI,28,21,7,4,3,OUI,OUI,2025-03-13 07:00:12+00:00,"48.89790972494496, 2.2383723043644914",Courbevoie,92026,0.25,7
32026,Leroy des Barres - Médiathèque,OUI,27,0,27,11,16,OUI,OUI,2025-03-13 07:00:21+00:00,"48.928253687082, 2.3681719727966",Saint-Denis,93066,1.0,7
22016,Charles de Gaulle - Sablonville,OUI,26,18,8,1,7,OUI,OUI,2025-03-13 06:58:22+00:00,"48.87991924860035, 2.2763770446181297",Neuilly-sur-Seine,92051,0.3076923076923077,7
9005,Square d'Anvers,OUI,31,26,5,0,5,OUI,OUI,2025-03-13 06:55:58+00:00,"48.882633484311, 2.3448844062122",Paris,75056,0.16129032258064516,7
14136,Auguste Cain - Jean Moulin,OUI,40,35,5,0,5,OUI,OUI,2025-03-13 07:00:08+00:00,"48.82577028927573, 2.3210415244102482",Paris,75056,0.125,7
7102,Mairie du 7ème,OUI,48,34,14,10,4,OUI,OUI,2025-03-13 06:59:49+00:00,"48.8577967, 2.3192664",Paris,75056,0.2916666666666667,7
32302,Chemin Vert - Fraternité,OUI,20,19,1,0,1,OUI,OUI,2025-03-13 06:56:53+00:00,"48.877141208359035, 2.4461565166711807",Romainville,93063,0.05,7
13002,Arago - Glacière,OUI,26,3,23,18,5,OUI,OUI,2025-03-13 07:00:45+00:00,"48.83486054775774, 2.3445770524322067",Paris,75056,0.8846153846153846,7
10014,Marseille - Beaurepaire,OUI,48,11,37,30,7,OUI,OUI,2025-03-13 07:01:04+00:00,"48.871624306962985, 2.3639265082738348",Paris,75056,0.7708333333333334,7
20121,Boyer - Ménilmontant,OUI,18,17,1,0,1,OUI,OUI,2025-03-13 07:00:26+00:00,"48.868895162679, 2.3919824145635",Paris,75056,0.05555555555555555,7
11035,Parmentier - Abel Rabaud,OUI,49,19,30,17,13,OUI,OUI,2025-03-13 07:00:05+00:00,"48.86921273836114, 2.371688821240712",Paris,75056,0.6122448979591837,7
42301,Gare Arcueil - Cachan,OUI,25,22,3,0,3,OUI,OUI,2025-03-13 06:55:27+00:00,"48.799824, 2.328171",Arcueil,94003,0.12,7
15046,Parc Georges Brassens - Brancion,OUI,28,16,12,3,9,OUI,OUI,2025-03-13 07:00:27+00:00,"48.83227829269761, 2.3022570088505745",Paris,75056,0.42857142857142855,7
20111,Villiers de l'Isle Adam - Pyrénées,OUI,20,17,3,0,3,OUI,OUI,2025-03-13 07:00:40+00:00,"48.867362, 2.396222",Paris,75056,0.15,7
22006,Pierret - Madrid,OUI,27,20,7,4,3,OUI,OUI,2025-03-13 07:01:06+00:00,"48.882976576876565, 2.260125767248034",Neuilly-sur-Seine,92051,0.25925925925925924,7
20043,Charonne - Avron,OUI,26,23,3,2,1,OUI,OUI,2025-03-13 07:00:04+00:00,"48.851602665222, 2.3984030470379",Paris,75056,0.11538461538461539,7
17028,Reims - Raymond Pitet,OUI,34,15,19,14,5,OUI,OUI,2025-03-13 06:55:01+00:00,"48.8888, 2.296319",Paris,75056,0.5588235294117647,7
42015,Place Jean Ferrat,OUI,23,19,4,2,2,OUI,OUI,2025-03-13 06:57:43+00:00,"48.8184945213025, 2.3744174838066106",Ivry-sur-Seine,94041,0.17391304347826086,7
19029,Seine - Flandre,OUI,19,13,6,5,1,OUI,OUI,2025-03-13 06:59:30+00:00,"48.886785741479684, 2.3746193200349808",Paris,75056,0.3157894736842105,7
32016,Place de la Porte de Paris,OUI,37,30,7,0,7,OUI,OUI,2025-03-13 06:59:02+00:00,"48.93009363207303, 2.3564037680625916",Saint-Denis,93066,0.1891891891891892,7
32003,Wilson - Métallurgie,OUI,28,19,9,3,6,OUI,OUI,2025-03-13 06:58:10+00:00,"48.909423010092326, 2.3584435880184174",Saint-Denis,93066,0.32142857142857145,7
15201,Place Amédée Gordini - Lefebvre,OUI,37,28,9,4,5,OUI,OUI,2025-03-13 07:00:34+00:00,"48.83061737745, 2.2920634208276",Paris,75056,0.24324324324324326,7
21104,Madame de Sanzillon - Mozart,OUI,22,5,17,9,8,OUI,OUI,2025-03-13 07:00:25+00:00,"48.90379820774301, 2.3187401890754704",Clichy,92024,0.7727272727272727,7
41402,Victor Hugo - Ecoles,OUI,23,8,15,8,7,OUI,OUI,2025-03-13 06:58:36+00:00,"48.80476007936134, 2.4180373930262093",Alfortville,94002,0.6521739130434783,7
11042,Grand Prieuré - Crussol,OUI,46,4,42,40,2,OUI,OUI,2025-03-13 07:00:42+00:00,"48.864660627935, 2.3692265531829",Paris,75056,0.9130434782608695,7
12009,Charenton - Diderot,OUI,18,8,10,9,1,OUI,OUI,2025-03-13 06:56:54+00:00,"48.846171461187, 2.3793068155646",Paris,75056,0.5555555555555556,7
1013,Place du Palais Royal,OUI,65,41,24,22,2,OUI,OUI,2025-03-13 07:01:05+00:00,"48.862382970647, 2.3384822532535",Paris,75056,0.36923076923076925,7
19125,Place de l'Édit de Nantes,OUI,26,11,15,4,11,OUI,OUI,2025-03-13 07:00:39+00:00,"48.88879, 2.3785",Paris,75056,0.5769230769230769,7
8025,Miromesnil - La Boétie,OUI,32,19,13,4,9,OUI,OUI,2025-03-13 07:00:44+00:00,"48.873722412917, 2.3158480972052",Paris,75056,0.40625,7
19205,Simon Bolivar - Henri Turot,OUI,22,18,4,0,4,OUI,OUI,2025-03-13 06:54:30+00:00,"48.877475489801, 2.3739709492211",Paris,75056,0.18181818181818182,7
11036,Jules Ferry - Faubourg du Temple Paris,OUI,57,14,43,40,3,OUI,OUI,2025-03-13 07:01:00+00:00,"48.868397, 2.3678933",Paris,75056,0.7543859649122807,7
19013,Laumière - Petit,OUI,30,19,11,6,5,OUI,OUI,2025-03-13 07:00:25+00:00,"48.88467368538326, 2.380039058625698",Paris,75056,0.36666666666666664,7
43003,Hôpital Bégin,OUI,26,26,0,0,0,NON,NON,2025-03-13 06:56:36+00:00,"48.84571672113, 2.4272462725639",Vincennes,94080,0.0,7
42504,Gare RER de Gentilly,OUI,30,21,9,3,6,OUI,OUI,2025-03-13 07:00:33+00:00,"48.814280450380224, 2.3410347104072575",Gentilly,94037,0.3,7
12027,Montgallet - Charenton,OUI,15,10,5,5,0,OUI,OUI,2025-03-13 06:59:34+00:00,"48.842647778701, 2.3861649278137",Paris,75056,0.3333333333333333,7
26013,Quai du docteur Dervaux,OUI,26,5,21,10,11,OUI,OUI,2025-03-13 07:00:58+00:00,"48.910482, 2.297998",Asnières-sur-Seine,92004,0.8076923076923077,7
42029,Stalingrad - Germaine Tailleferre,OUI,24,20,4,1,3,OUI,OUI,2025-03-13 06:58:56+00:00,"48.80257200481316, 2.3786691203713417",Ivry-sur-Seine,94041,0.16666666666666666,7
31010,Stalingrad - Désiré Chevalier,OUI,41,34,7,0,7,OUI,OUI,2025-03-13 06:59:09+00:00,"48.85670169739857, 2.445072233676911",Montreuil,93048,0.17073170731707318,7
21313,Guynemer - Séverine,OUI,25,13,12,11,1,OUI,OUI,2025-03-13 06:58:45+00:00,"48.83091743371036, 2.2790706530213356",Issy-les-Moulineaux,92040,0.48,7
19008,Flandre - Alphonse Karr,OUI,26,21,5,3,2,OUI,OUI,2025-03-13 07:00:23+00:00,"48.89465, 2.381868",Paris,75056,0.19230769230769232,7
17102,Alfred Roll - Berthier,OUI,28,12,16,16,0,OUI,OUI,2025-03-13 07:00:47+00:00,"48.887808570529, 2.3000952981763",Paris,75056,0.5714285714285714,7
11004,Charonne - Faubourg Saint-Antoine,OUI,32,11,21,21,0,OUI,OUI,2025-03-13 07:00:28+00:00,"48.852191909696, 2.3740932717919",Paris,75056,0.65625,7
26007,Square Gilbert Thomain,OUI,19,12,7,2,5,OUI,OUI,2025-03-13 06:59:54+00:00,"48.90717373809284, 2.2695400938391685",Asnières-sur-Seine,92004,0.3684210526315789,7
18201,Tristan Tzara -  Tchaïkovski,OUI,32,24,8,4,4,OUI,OUI,2025-03-13 06:55:11+00:00,"48.89490221746837, 2.3648490384221077",Paris,75056,0.25,7
35018,Ancien Canal - Hélène Brion,OUI,23,18,5,0,5,OUI,OUI,2025-03-13 06:57:30+00:00,"48.89484799296163, 2.4188338592648506",Pantin,93055,0.21739130434782608,7
92008,Hôtel de Ville de Nanterre,OUI,35,14,21,12,9,OUI,OUI,2025-03-13 07:01:00+00:00,"48.892371898250424, 2.205548956990242",Nanterre,92050,0.6,7
19005,Flandre - Riquet,OUI,19,13,6,5,1,OUI,OUI,2025-03-13 07:00:23+00:00,"48.888013281448, 2.3737595955229",Paris,75056,0.3157894736842105,7
51004,Général Delambre - Prebuard,OUI,28,17,11,2,9,OUI,OUI,2025-03-13 06:48:02+00:00,"48.93870344444, 2.2234171606307",Argenteuil,95018,0.39285714285714285,7
10113,Parmentier - Hôpital Saint-Louis,OUI,38,28,10,8,2,OUI,OUI,2025-03-13 07:00:39+00:00,"48.871379874257, 2.3698963836667",Paris,75056,0.2631578947368421,7
18012,Stephenson - Doudeauville,OUI,34,27,7,6,1,OUI,OUI,2025-03-13 07:01:04+00:00,"48.888537048944826, 2.3561610281467438",Paris,75056,0.20588235294117646,7
41606,Pasteur - Gambetta,OUI,18,9,9,2,7,OUI,OUI,2025-03-13 06:58:24+00:00,"48.84572797384512, 2.4236011505126953",Saint-Mandé,94067,0.5,7
14036,Boulard - Daguerre,OUI,43,43,0,0,0,OUI,OUI,2025-03-13 06:56:07+00:00,"48.83446472680611, 2.3293386027216907",Paris,75056,0.0,7
7015,Varenne,OUI,44,33,11,7,4,OUI,OUI,2025-03-13 06:59:27+00:00,"48.857202661803, 2.3152771219611",Paris,75056,0.25,7
5123,Saint-Germain - Thenard,OUI,29,23,6,4,2,OUI,OUI,2025-03-13 06:55:33+00:00,"48.850571, 2.3471015",Paris,75056,0.20689655172413793,7
5021,Jussieu - Fossés Saint-Bernard,OUI,38,24,14,9,5,OUI,OUI,2025-03-13 07:00:27+00:00,"48.847185510023, 2.3534858599305",Paris,75056,0.3684210526315789,7
9021,Saint Georges - d'Aumale,OUI,22,18,4,2,2,OUI,OUI,2025-03-13 07:00:16+00:00,"48.87778639599673, 2.337429821491241",Paris,75056,0.18181818181818182,7
23001,Paul Vaillant Couturier - Chaptal,OUI,35,32,3,0,3,OUI,OUI,2025-03-13 06:58:19+00:00,"48.893479576183, 2.2775253653526",Levallois-Perret,92044,0.08571428571428572,7
23009,Anatole France - Louise Michel,OUI,47,32,15,13,2,OUI,OUI,2025-03-13 07:00:27+00:00,"48.88873214926474, 2.2881576418876652",Levallois-Perret,92044,0.3191489361702128,7
17037,Bayen - Pereire,OUI,21,7,14,5,9,OUI,OUI,2025-03-13 07:01:04+00:00,"48.881804409079656, 2.2921088710427284",Paris,75056,0.6666666666666666,7
8035,Bienfaisance - Place de Narvik,OUI,34,30,4,2,2,OUI,OUI,2025-03-13 07:00:38+00:00,"48.87660163459077, 2.3129771277308464",Paris,75056,0.11764705882352941,7
18141,Clignancourt - Sofia,OUI,19,17,2,0,2,OUI,OUI,2025-03-13 06:59:02+00:00,"48.88511992309783, 2.34719488842051",Paris,75056,0.10526315789473684,7
28001,Richard Wallace - Place du 8 Mai 1945,OUI,29,11,18,16,2,OUI,OUI,2025-03-13 07:00:09+00:00,"48.87866794788021, 2.2420343756675725",Puteaux,92062,0.6206896551724138,7
16124,Route de Sèvres - Porte de Bagatelle,OUI,65,6,59,52,7,OUI,OUI,2025-03-13 07:00:47+00:00,"48.87525984132485, 2.249415814876557",Paris,75056,0.9076923076923077,7
16111,Faustin Hélie - Desbordes-Valmore,OUI,27,23,4,1,3,OUI,OUI,2025-03-13 07:00:57+00:00,"48.859403, 2.276522",Paris,75056,0.14814814814814814,7
33003,Bordier - Félix Faure,OUI,44,19,25,13,12,OUI,OUI,2025-03-13 07:00:10+00:00,"48.90390751882016, 2.3830059170722966",Aubervilliers,93001,0.5681818181818182,7
11007,Jean Macé - Faidherbe,OUI,59,31,28,16,12,OUI,OUI,2025-03-13 06:58:42+00:00,"48.85337548426, 2.3828620836139",Paris,75056,0.4745762711864407,7
5106,Cujas - Saint-Michel,OUI,19,3,16,6,10,OUI,OUI,2025-03-13 07:00:35+00:00,"48.848191348584, 2.341831654854",Paris,75056,0.8421052631578947,7
15025,Dupleix - du Guesclin,OUI,46,5,41,37,4,OUI,OUI,2025-03-13 06:58:07+00:00,"48.85147910413369, 2.296709530055523",Paris,75056,0.8913043478260869,7
25005,18 juin 1940 - Buzenval,OUI,25,11,14,5,9,OUI,OUI,2025-03-13 06:58:06+00:00,"48.868807, 2.185428",Rueil-Malmaison,92063,0.56,7
18110,Departement - Pajol,OUI,17,8,9,2,7,OUI,OUI,2025-03-13 06:59:55+00:00,"48.886674849730184, 2.3613611608743668",Paris,75056,0.5294117647058824,7
13045,Jean Colly - Tolbiac,OUI,34,29,5,3,2,OUI,OUI,2025-03-13 06:59:58+00:00,"48.827817291597846, 2.3705490678548813",Paris,75056,0.14705882352941177,7
17011,Fragonard - Porte de Clichy,OUI,54,18,36,32,4,OUI,OUI,2025-03-13 07:01:02+00:00,"48.894155633419, 2.3143893107772",Paris,75056,0.6666666666666666,7
19115,Porte de la Villette,OUI,26,15,11,4,7,OUI,OUI,2025-03-13 06:53:12+00:00,"48.89835196548483, 2.386150136590004",Paris,75056,0.4230769230769231,7
17045,Place des Ternes.,OUI,45,40,5,1,4,OUI,OUI,2025-03-13 07:00:41+00:00,"48.878438631226516, 2.297727763652802",Paris,75056,0.1111111111111111,7
14034,Ouest - Château,OUI,23,23,0,0,0,OUI,OUI,2025-03-13 06:59:14+00:00,"48.83617286014242, 2.319392143923804",Paris,75056,0.0,7
43402,Place de Verdun,OUI,40,19,21,17,4,OUI,OUI,2025-03-13 06:59:16+00:00,"48.8202823, 2.473775",Joinville-le-Pont,94042,0.525,7
15033,Place Violet,OUI,29,0,29,27,2,OUI,OUI,2025-03-13 07:00:15+00:00,"48.84487893836502, 2.2905756533145905",Paris,75056,1.0,7
33018,Edouard Poisson - Victor Hugo,OUI,26,5,21,7,14,OUI,OUI,2025-03-13 07:00:41+00:00,"48.91118557052621, 2.379864752692811",Aubervilliers,93001,0.8076923076923077,7
25008,Place du 8 Mai 1945,OUI,18,12,6,5,1,OUI,OUI,2025-03-13 06:59:21+00:00,"48.871552174017, 2.2025031970585",Rueil-Malmaison,92063,0.3333333333333333,7
12013,Montgallet - Reuilly,OUI,14,4,10,5,5,OUI,OUI,2025-03-13 07:00:22+00:00,"48.844291, 2.3896481",Paris,75056,0.7142857142857143,7
24002,Gare de Courbevoie,OUI,32,22,10,8,2,OUI,OUI,2025-03-13 06:56:22+00:00,"48.8993867, 2.2506506",Courbevoie,92026,0.3125,7
21305,Place Jacques Madaule,OUI,24,5,19,18,1,OUI,OUI,2025-03-13 07:00:47+00:00,"48.823933787309, 2.2606918215752",Issy-les-Moulineaux,92040,0.7916666666666666,7
33001,Victor Hugo - Magasins Généraux,OUI,34,32,2,1,1,OUI,OUI,2025-03-13 06:54:56+00:00,"48.903281401126755, 2.368072383105755",Aubervilliers,93001,0.058823529411764705,7
11115,Montreuil - Gonnet,OUI,24,7,17,8,9,OUI,OUI,2025-03-13 07:00:14+00:00,"48.850500564921, 2.3890856287864",Paris,75056,0.7083333333333334,7
41404,Carnot - Pâquerettes,OUI,24,3,21,18,3,OUI,OUI,2025-03-13 07:00:31+00:00,"48.79592939432515, 2.4261841177940373",Alfortville,94002,0.875,7
6013,Jacques Callot - Mazarine,OUI,27,2,25,24,1,OUI,OUI,2025-03-13 07:00:46+00:00,"48.855280175332, 2.3375743255019",Paris,75056,0.9259259259259259,7
5119,Jussieu - Guy de la Brosse,OUI,40,36,4,2,2,OUI,OUI,2025-03-13 06:52:53+00:00,"48.845665, 2.355653",Paris,75056,0.1,7
12115,Porte de Vincennes,OUI,32,27,5,2,3,OUI,OUI,2025-03-13 06:59:35+00:00,"48.846454, 2.415514",Paris,75056,0.15625,7
8055,Courcelles - Place des Ternes,OUI,28,24,4,2,2,OUI,OUI,2025-03-13 07:00:38+00:00,"48.878199928923124, 2.2992860188665043",Paris,75056,0.14285714285714285,7
8033,Commandant Rivière,OUI,40,30,10,3,7,OUI,OUI,2025-03-13 07:00:04+00:00,"48.872933, 2.309796",Paris,75056,0.25,7
21109,Guichet - Jean Jaurès,OUI,23,12,11,6,5,OUI,OUI,2025-03-13 06:59:23+00:00,"48.905169868129036, 2.3023840785026555",Clichy,92024,0.4782608695652174,7
16121,Jardin d'Acclimatation,OUI,30,29,1,1,0,OUI,OUI,2025-03-13 06:54:16+00:00,"48.878772242510465, 2.270772233605385",Paris,75056,0.03333333333333333,7
31012,Place Carnot,OUI,23,15,8,5,3,OUI,OUI,2025-03-13 07:00:12+00:00,"48.85593932186797, 2.441531717777252",Montreuil,93048,0.34782608695652173,7
15010,Square Cambronne,OUI,59,18,41,37,4,OUI,OUI,2025-03-13 07:00:43+00:00,"48.84756654526, 2.3025691509247",Paris,75056,0.6949152542372882,7
12024,Gare de Bercy,OUI,34,14,20,17,3,OUI,OUI,2025-03-13 06:58:57+00:00,"48.839794573906, 2.3826066032052",Paris,75056,0.5882352941176471,7
41102,Gare de Laplace,OUI,43,31,12,7,5,OUI,OUI,2025-03-13 06:58:14+00:00,"48.80893199114179, 2.3349460959434514",Arcueil,94003,0.27906976744186046,7
35019,Anatole France - Jean Lolive,OUI,27,10,17,3,14,OUI,OUI,2025-03-13 06:58:20+00:00,"48.8949922, 2.4253764",Pantin,93055,0.6296296296296297,7
33009,Félix Faure - Sadi Carnot,OUI,33,26,7,4,3,OUI,OUI,2025-03-13 06:56:11+00:00,"48.90812110228388, 2.378623187541962",Aubervilliers,93001,0.21212121212121213,7
14104,Boyer-Barret - Raymond Losserand,OUI,22,22,0,0,0,OUI,OUI,2025-03-13 06:59:21+00:00,"48.83329880233322, 2.3173383995890617",Paris,75056,0.0,7
22505,Mairie de La Garenne Colombes,OUI,22,9,13,13,0,OUI,OUI,2025-03-13 07:01:04+00:00,"48.90663823468682, 2.24679596722126",La Garenne-Colombes,92035,0.5909090909090909,7
31705,Champeaux - Gallieni,OUI,47,34,13,1,12,OUI,OUI,2025-03-13 06:52:50+00:00,"48.864459134684644, 2.4161778017878532",Bagnolet,93006,0.2765957446808511,7
32010,Place aux Étoiles,OUI,37,28,9,2,7,OUI,OUI,2025-03-13 06:59:36+00:00,"48.91835629408464, 2.3523425683379173",Saint-Denis,93066,0.24324324324324326,7
23802,Raymond Poincaré - Allée de la Marche,OUI,22,16,6,6,0,OUI,OUI,2025-03-13 06:55:07+00:00,"48.838634069623, 2.1724102640451",Garches,92033,0.2727272727272727,7
16018,Flandrin - Henri Martin,OUI,18,15,3,1,2,OUI,OUI,2025-03-13 06:58:34+00:00,"48.8643275, 2.2724174",Paris,75056,0.16666666666666666,7
20036,Ménilmontant - Pelleport,OUI,31,31,0,0,0,OUI,OUI,2025-03-13 07:00:30+00:00,"48.870682633845, 2.3989596023316",Paris,75056,0.0,7
12034,Pirogues de Bercy - Libourne,OUI,48,44,4,1,3,OUI,OUI,2025-03-13 06:55:35+00:00,"48.832308, 2.38637",Paris,75056,0.08333333333333333,7
15017,Place Falguière,OUI,22,10,12,0,12,OUI,OUI,2025-03-13 06:59:06+00:00,"48.83629973941847, 2.3104464635252953",Paris,75056,0.5454545454545454,7
19044,Grands Moulins de Pantin,OUI,50,47,3,1,2,OUI,OUI,2025-03-13 07:00:48+00:00,"48.89738369720229, 2.3959985375404362",Paris,75056,0.06,7
15029,Emeriau - Place de Brazzaville,OUI,49,19,30,28,2,OUI,OUI,2025-03-13 07:00:30+00:00,"48.850785261674964, 2.2871585190296173",Paris,75056,0.6122448979591837,7
16034,Porte d'Auteuil,OUI,32,30,2,0,2,OUI,OUI,2025-03-13 07:01:05+00:00,"48.8479394142243, 2.2608396783471107",Paris,75056,0.0625,7
10005,Petites Ecuries - Faubourg Poissonnière,OUI,15,3,12,9,3,OUI,OUI,2025-03-13 07:01:03+00:00,"48.87397217237368, 2.348388757504776",Paris,75056,0.8,7
7009,Assemblée Nationale,OUI,72,59,13,9,4,OUI,OUI,2025-03-13 06:59:11+00:00,"48.861411014652, 2.3201214185208",Paris,75056,0.18055555555555555,7
18020,Francoeur - Marcadet,OUI,19,15,4,0,4,OUI,OUI,2025-03-13 07:00:43+00:00,"48.89104123261663, 2.340014585442034",Paris,75056,0.21052631578947367,7
20132,Réunion - Avron,OUI,26,22,4,3,1,OUI,OUI,2025-03-13 07:00:52+00:00,"48.852566752033766, 2.403928068708116",Paris,75056,0.15384615384615385,7
20136,Henri Chevreau - Couronnes,OUI,26,22,4,1,3,OUI,OUI,2025-03-13 07:00:59+00:00,"48.87033205312931, 2.388777695596218",Paris,75056,0.15384615384615385,7
15122,Place Charles Vallin,OUI,26,18,8,7,1,OUI,OUI,2025-03-13 07:00:27+00:00,"48.835523812041, 2.3025986552238",Paris,75056,0.3076923076923077,7
31702,Pierre et Marie Curie - Julien Grimau,OUI,18,15,3,0,3,OUI,OUI,2025-03-13 06:57:34+00:00,"48.870714014863225, 2.424097023904324",Bagnolet,93006,0.16666666666666666,7
42707,Place Jean-Baptiste Clément,OUI,24,17,7,2,5,OUI,OUI,2025-03-13 06:59:51+00:00,"48.81240466867336, 2.3617091774940495",Le Kremlin-Bicêtre,94043,0.2916666666666667,7
7004,Raspail - Varenne,OUI,17,6,11,5,6,OUI,OUI,2025-03-13 06:58:57+00:00,"48.853147816545, 2.3263905197382",Paris,75056,0.6470588235294118,7
92003,Chanzy - Sud-Est,OUI,25,24,1,1,0,OUI,OUI,2025-03-13 06:56:40+00:00,"48.888912037698766, 2.195632159709931",Nanterre,92050,0.04,7
21013,Pierre Grenier - Pont de Billancourt,OUI,21,7,14,13,1,OUI,OUI,2025-03-13 06:59:50+00:00,"48.8258020742942, 2.2487989068031315",Boulogne-Billancourt,92012,0.6666666666666666,7
35009,Jean Lolive - Parc Stalingrad,OUI,22,13,9,3,6,OUI,OUI,2025-03-13 06:57:37+00:00,"48.89206174403158, 2.4091735482215886",Pantin,93055,0.4090909090909091,7
2010,Uzès - Montmartre,OUI,26,22,4,3,1,OUI,OUI,2025-03-13 07:00:27+00:00,"48.870790980240706, 2.3431010171771054",Paris,75056,0.15384615384615385,7
19019,Petit - Manin,OUI,22,22,0,0,0,NON,NON,2025-03-13 06:53:30+00:00,"48.886506875343, 2.3938155401308",Paris,75056,0.0,7
11114,Ledru-Rollin - Charonne,OUI,31,17,14,12,2,OUI,OUI,2025-03-13 07:00:31+00:00,"48.85345855607243, 2.3772463581947094",Paris,75056,0.45161290322580644,7
27002,Parc Pierre Lagravère,OUI,30,12,18,7,11,OUI,OUI,2025-03-13 06:59:27+00:00,"48.92650488131725, 2.239069678491417",Colombes,92025,0.6,7
5116,Place Valhubert,OUI,49,5,44,42,2,OUI,OUI,2025-03-13 06:59:18+00:00,"48.844182577315, 2.3640366643667",Paris,75056,0.8979591836734694,7
23701,Parvis Robert Schuman - Roger Salengro,OUI,24,9,15,5,10,OUI,OUI,2025-03-13 07:01:05+00:00,"48.812657470558754, 2.1921751275658607",Chaville,92022,0.625,7
7006,Quai Voltaire,OUI,32,9,23,20,3,OUI,OUI,2025-03-13 07:00:05+00:00,"48.858942986179, 2.3314182047146",Paris,75056,0.71875,7
17007,Navier - Epinettes,OUI,36,18,18,4,14,OUI,OUI,2025-03-13 07:00:04+00:00,"48.89587780769155, 2.3226776719093327",Paris,75056,0.5,7
17017,Gare de Pont-Cardinet,OUI,31,8,23,13,10,OUI,OUI,2025-03-13 06:59:29+00:00,"48.88713901475306, 2.314494143994255",Paris,75056,0.7419354838709677,7
21502,Verdun - Place Henri IV,OUI,26,12,14,10,4,OUI,OUI,2025-03-13 06:58:47+00:00,"48.870797375639214, 2.2277003154158592",Suresnes,92073,0.5384615384615384,7
10023,Gare de l'Est - Verdun,OUI,13,12,1,1,0,OUI,OUI,2025-03-13 06:56:56+00:00,"48.876156054271, 2.3609149083206",Paris,75056,0.07692307692307693,7
16129,Ceinture du Lac Inferieure - Saint-Cloud,OUI,41,39,2,0,2,OUI,OUI,2025-03-13 07:00:22+00:00,"48.86218070933143, 2.2617871686816216",Paris,75056,0.04878048780487805,7
34002,Capitaine Glarner - Gabriel Péri,OUI,23,9,14,13,1,OUI,OUI,2025-03-13 07:00:13+00:00,"48.902449900418745, 2.3304807533425724",Saint-Ouen-sur-Seine,93070,0.6086956521739131,7
20113,Piat - Parc de Belleville,OUI,20,18,2,0,2,OUI,OUI,2025-03-13 06:59:43+00:00,"48.87195626635528, 2.384981390278095",Paris,75056,0.1,7
13026,Place Jean Delay,OUI,34,20,14,7,7,OUI,OUI,2025-03-13 07:00:30+00:00,"48.823316, 2.354336",Paris,75056,0.4117647058823529,7
20119,Square des Saint-Simoniens,OUI,25,25,0,0,0,OUI,OUI,2025-03-13 06:55:43+00:00,"48.8701796, 2.3967273",Paris,75056,0.0,7
23002,Pont de Levallois-bécon,OUI,49,20,29,11,18,OUI,OUI,2025-03-13 07:00:44+00:00,"48.8984179, 2.2791311",Levallois-Perret,92044,0.5918367346938775,7
6030,Assas - Vaugirard,OUI,34,24,10,1,9,OUI,OUI,2025-03-13 07:00:30+00:00,"48.848274111398, 2.3292413726449",Paris,75056,0.29411764705882354,7
13102,Pitié-Salpêtrière,OUI,50,36,14,9,5,OUI,OUI,2025-03-13 06:59:45+00:00,"48.83748810318667, 2.365213818848133",Paris,75056,0.28,7
12126,Gravelle - Route du Bac,OUI,51,22,29,17,12,OUI,OUI,2025-03-13 06:59:50+00:00,"48.824407, 2.418455",Paris,75056,0.5686274509803921,7
14130,Jonquoy - Didot,OUI,30,26,4,0,4,OUI,OUI,2025-03-13 06:57:56+00:00,"48.82890454823947, 2.31648076325655",Paris,75056,0.13333333333333333,7
41604,Lagny - Joffre,OUI,30,24,6,3,3,OUI,OUI,2025-03-13 06:58:20+00:00,"48.84930687084088, 2.417949736118317",Saint-Mandé,94067,0.2,7
10015,Lucien Sampaix - Récollets,OUI,41,31,10,8,2,OUI,OUI,2025-03-13 07:00:15+00:00,"48.874330377560476, 2.3621229082345963",Paris,75056,0.24390243902439024,7
17018,Parc Monceau,OUI,18,17,1,0,1,OUI,OUI,2025-03-13 06:51:19+00:00,"48.881077914129, 2.3095492646098",Paris,75056,0.05555555555555555,7
12032,Porte Dorée,OUI,35,16,19,10,9,OUI,OUI,2025-03-13 06:58:19+00:00,"48.8354337, 2.4077132",Paris,75056,0.5428571428571428,7
18005,Tardieu - Chappe,OUI,16,16,0,0,0,OUI,OUI,2025-03-13 06:54:24+00:00,"48.884146759782, 2.341845408082",Paris,75056,0.0,7
19037,Belleville - Porte des Lilas,OUI,29,26,3,1,2,OUI,OUI,2025-03-13 06:51:49+00:00,"48.87660391892763, 2.404769691129476",Paris,75056,0.10344827586206896,7
26001,Gare d'Asnières sur Seine,OUI,21,3,18,10,8,OUI,OUI,2025-03-13 06:59:15+00:00,"48.90636459217474, 2.2835066914558415",Asnières-sur-Seine,92004,0.8571428571428571,7
6103,Mézières - Rennes,OUI,53,47,6,3,3,OUI,OUI,2025-03-13 07:00:43+00:00,"48.85023459321703, 2.3303819820284843",Paris,75056,0.11320754716981132,7
92004,Nanterre - Université,OUI,19,7,12,8,4,OUI,OUI,2025-03-13 07:00:09+00:00,"48.901365, 2.212693",Nanterre,92050,0.631578947368421,7
15038,Place Adolphe Cherioux - Vaugirard,OUI,61,39,22,19,3,OUI,OUI,2025-03-13 07:00:48+00:00,"48.83959442800459, 2.3010657727718353",Paris,75056,0.36065573770491804,7
5026,Pascal - Claude Bernard,OUI,46,12,34,29,5,OUI,OUI,2025-03-13 07:00:12+00:00,"48.839061952159746, 2.3499782010912895",Paris,75056,0.7391304347826086,7
20021,Indre - Prairies,OUI,38,32,6,2,4,OUI,OUI,2025-03-13 07:01:01+00:00,"48.86254398506782, 2.403290458023548",Paris,75056,0.15789473684210525,7
43006,Vignerons - Minimes,OUI,29,22,7,4,3,OUI,OUI,2025-03-13 07:00:54+00:00,"48.841486, 2.430793",Vincennes,94080,0.2413793103448276,7
21019,Edouard Vaillant - Paul-Adolphe Souriau,OUI,26,8,18,14,4,OUI,OUI,2025-03-13 06:56:40+00:00,"48.834845858829, 2.2479459643364",Boulogne-Billancourt,92012,0.6923076923076923,7
5002,Sommerard - Saint-Jacques,OUI,34,20,14,7,7,OUI,OUI,2025-03-13 06:59:51+00:00,"48.850310432924466, 2.345015835298588",Paris,75056,0.4117647058823529,7
21105,Morice - Général Leclerc,OUI,25,4,21,18,3,OUI,OUI,2025-03-13 07:01:03+00:00,"48.90245471981591, 2.3128929734230046",Clichy,92024,0.84,7
15028,Grenelle - Dr Finlay,OUI,70,22,48,45,3,OUI,OUI,2025-03-13 07:01:04+00:00,"48.851315406715976, 2.2919502854347233",Paris,75056,0.6857142857142857,7
31019,Vincennes - Douy-Delcupe,OUI,37,31,6,4,2,OUI,OUI,2025-03-13 06:55:32+00:00,"48.85493692155721, 2.436049282550812",Montreuil,93048,0.16216216216216217,7
8102,Lamennais - Washington,OUI,25,23,2,0,2,OUI,OUI,2025-03-13 06:59:41+00:00,"48.87352990026496, 2.303444892168045",Paris,75056,0.08,7
17124,Porte de Saint-Ouen - Henri Huchard,OUI,26,14,12,4,8,OUI,OUI,2025-03-13 07:00:32+00:00,"48.898708366365064, 2.3295360803604126",Paris,75056,0.46153846153846156,7
14018,Porte d'Orléans,OUI,45,37,8,2,6,OUI,OUI,2025-03-13 07:00:46+00:00,"48.8227639, 2.3249313",Paris,75056,0.17777777777777778,7
31016,Lucie Aubrac - Franklin,OUI,35,28,7,2,5,OUI,OUI,2025-03-13 07:00:37+00:00,"48.86223916006812, 2.4435862898826604",Montreuil,93048,0.2,7
42503,Vladimir Ilitch Lénine - Andrée Chedid,OUI,31,27,4,4,0,OUI,OUI,2025-03-13 07:00:58+00:00,"48.813240124373, 2.3319716067039",Gentilly,94037,0.12903225806451613,7
22101,Gare Routière de Saint Cloud,OUI,29,15,14,8,6,OUI,OUI,2025-03-13 07:01:03+00:00,"48.84288183896324, 2.222245037555695",Saint-Cloud,92064,0.4827586206896552,7
21111,Professeur René Leriche - Général Leclerc,OUI,50,10,40,23,17,OUI,OUI,2025-03-13 06:56:42+00:00,"48.90782845483013, 2.307887971401215",Clichy,92024,0.8,7
8051,Batignolles - Rome,OUI,12,2,10,3,7,OUI,OUI,2025-03-13 07:00:59+00:00,"48.881823370566806, 2.3202589899301524",Paris,75056,0.8333333333333334,7
7014,Saint-François-Xavier,OUI,42,27,15,4,11,OUI,OUI,2025-03-13 07:01:03+00:00,"48.85154484769, 2.3146149516106",Paris,75056,0.35714285714285715,7
9115,Milton - Manuel,OUI,21,18,3,2,1,OUI,OUI,2025-03-13 06:55:23+00:00,"48.878249, 2.341181",Paris,75056,0.14285714285714285,7
8012,Batignolles - Place de Clichy,OUI,46,39,7,2,5,OUI,OUI,2025-03-13 06:51:01+00:00,"48.883474535757, 2.326493114233",Paris,75056,0.15217391304347827,7
19039,Edouard Pailleron - Simon Bolivar,OUI,23,15,8,3,5,OUI,OUI,2025-03-13 06:58:34+00:00,"48.87979886049996, 2.374839261174202",Paris,75056,0.34782608695652173,7
20040,Parc de Belleville - Julien Lacroix,OUI,26,19,7,4,3,OUI,OUI,2025-03-13 07:00:31+00:00,"48.8703459, 2.3842214",Paris,75056,0.2692307692307692,7
16032,Eglise d'Auteuil,OUI,20,10,10,7,3,OUI,OUI,2025-03-13 07:00:18+00:00,"48.84749841771691, 2.26848387135299",Paris,75056,0.5,7
14139,Pierre Larousse - Raymond Losserand,OUI,29,16,13,5,8,OUI,OUI,2025-03-13 07:00:57+00:00,"48.83059564231877, 2.3119183257222176",Paris,75056,0.4482758620689655,7
22001,Château - Bineau,OUI,20,19,1,0,1,OUI,OUI,2025-03-13 06:59:04+00:00,"48.890404028589806, 2.270106375217438",Neuilly-sur-Seine,92051,0.05,7
11101,Charles Delescluze,OUI,48,7,41,41,0,OUI,OUI,2025-03-13 06:56:52+00:00,"48.85242200848887, 2.380632497370243",Paris,75056,0.8541666666666666,7
18025,Mairie du 18ème,OUI,38,35,3,1,2,OUI,OUI,2025-03-13 06:59:51+00:00,"48.892939296937605, 2.3445510864257812",Paris,75056,0.07894736842105263,7
15055,Vasco de Gama,OUI,53,11,42,38,4,OUI,OUI,2025-03-13 07:00:49+00:00,"48.83671783466264, 2.283664085650799",Paris,75056,0.7924528301886793,7
17122,Bridaine - Lamandé,OUI,28,25,3,0,3,OUI,OUI,2025-03-13 07:00:10+00:00,"48.8862074, 2.3206239",Paris,75056,0.10714285714285714,7
41207,Place du Général de Gaulle,OUI,28,21,7,1,6,OUI,OUI,2025-03-13 06:56:20+00:00,"48.8525288, 2.4877332",Fontenay-sous-Bois,94033,0.25,7
20027,Porte de Ménilmontant,OUI,14,13,1,0,1,OUI,OUI,2025-03-13 06:55:15+00:00,"48.8691543609174, 2.40932246879487",Paris,75056,0.07142857142857142,7
12011,Charenton - Place du Col Bourgoin,OUI,35,12,23,22,1,OUI,OUI,2025-03-13 07:01:02+00:00,"48.844867319554, 2.3825789350545",Paris,75056,0.6571428571428571,7
9023,Laffitte - Italiens,OUI,29,20,9,3,6,OUI,OUI,2025-03-13 06:57:10+00:00,"48.871815737396, 2.3372015478451",Paris,75056,0.3103448275862069,7
21308,Bara - Henri Farman,OUI,58,40,18,16,2,OUI,OUI,2025-03-13 06:58:45+00:00,"48.833218027457846, 2.2677567601203923",Issy-les-Moulineaux,92040,0.3103448275862069,7
14122,Colonel Monteil - Brune,OUI,19,18,1,1,0,OUI,OUI,2025-03-13 06:55:03+00:00,"48.82650293311, 2.3092747998272",Paris,75056,0.05263157894736842,7
21032,Sèvres-Gallieni,OUI,25,12,13,6,7,OUI,OUI,2025-03-13 06:55:13+00:00,"48.837809408957, 2.2281519323587",Boulogne-Billancourt,92012,0.52,7
31007,Paris - Désiré Préaux,OUI,44,39,5,1,4,OUI,OUI,2025-03-13 06:59:46+00:00,"48.85742876694898, 2.4323049187660217",Montreuil,93048,0.11363636363636363,7
7005,Raspail - Bac,OUI,51,41,10,5,5,OUI,OUI,2025-03-13 06:58:03+00:00,"48.855628721101, 2.3256602883339",Paris,75056,0.19607843137254902,7
15108,Lourmel - Marie Skobtsov,OUI,22,12,10,8,2,OUI,OUI,2025-03-13 06:59:52+00:00,"48.844974, 2.287283",Paris,75056,0.45454545454545453,7
6018,Michelet - Assas,OUI,16,9,7,1,6,OUI,OUI,2025-03-13 06:58:49+00:00,"48.842741502832, 2.3350211977959",Paris,75056,0.4375,7
19040,Belleville - Télégraphe,OUI,40,39,1,0,1,OUI,OUI,2025-03-13 06:55:23+00:00,"48.8756045, 2.3995549",Paris,75056,0.025,7
19109,Tanger - Place du Maroc,OUI,17,10,7,3,4,OUI,OUI,2025-03-13 06:59:03+00:00,"48.8862524447104, 2.3689296841621403",Paris,75056,0.4117647058823529,7
6016,Danton - Serpente,OUI,21,8,13,9,4,OUI,OUI,2025-03-13 06:59:20+00:00,"48.852297362582, 2.3414132371545",Paris,75056,0.6190476190476191,7
32014,Place du Cornillon - Stade de France,OUI,33,24,9,4,5,OUI,OUI,2025-03-13 07:00:29+00:00,"48.92540695835961, 2.3644426837563515",Saint-Denis,93066,0.2727272727272727,7
17121,Square des Epinettes,OUI,20,9,11,6,5,OUI,OUI,2025-03-13 07:01:02+00:00,"48.89383909781389, 2.325953990221024",Paris,75056,0.55,7
18032,Porte de Clignancourt.,OUI,54,49,5,3,2,OUI,OUI,2025-03-13 06:52:31+00:00,"48.897488, 2.343996",Paris,75056,0.09259259259259259,7
19009,Cité des Sciences et de l'Industrie,OUI,28,20,8,1,7,OUI,OUI,2025-03-13 06:59:38+00:00,"48.89659571178903, 2.384599149227142",Paris,75056,0.2857142857142857,7
44012,Génie - Mozart,OUI,18,12,6,2,4,OUI,OUI,2025-03-13 06:59:50+00:00,"48.794902381218904, 2.3734183609485626",Vitry-sur-Seine,94081,0.3333333333333333,7
18109,Pajol - Riquet,OUI,45,19,26,14,12,OUI,OUI,2025-03-13 07:00:10+00:00,"48.88960028134536, 2.3628534749150276",Paris,75056,0.5777777777777777,7
17027,Place du Maréchal Juin - Péreire,OUI,44,31,13,12,1,OUI,OUI,2025-03-13 07:00:11+00:00,"48.885263, 2.298286",Paris,75056,0.29545454545454547,7
18029,Emile Blemont - Poteau,OUI,39,31,8,2,6,OUI,OUI,2025-03-13 07:00:36+00:00,"48.8943782, 2.3415122",Paris,75056,0.20512820512820512,7
51003,Hôtel de Ville d'Argenteuil,OUI,29,10,19,12,7,OUI,OUI,2025-03-13 06:58:53+00:00,"48.946504, 2.2496396",Argenteuil,95018,0.6551724137931034,7
35017,Toffier Decaux - Cartier Bresson,OUI,17,12,5,1,4,OUI,OUI,2025-03-13 07:01:01+00:00,"48.90165072551549, 2.4017545580863957",Pantin,93055,0.29411764705882354,7
13016,Primo Levi - Frigos,OUI,32,30,2,1,1,OUI,OUI,2025-03-13 06:57:41+00:00,"48.83094844846017, 2.37965351592796",Paris,75056,0.0625,7
16021,François Ponsard - La Muette,OUI,23,22,1,0,1,OUI,OUI,2025-03-13 06:59:58+00:00,"48.8583666, 2.2744515",Paris,75056,0.043478260869565216,7
13043,Dunois - Clisson,OUI,51,40,11,9,2,OUI,OUI,2025-03-13 07:00:54+00:00,"48.832294, 2.3674523",Paris,75056,0.21568627450980393,7
15035,Place Etienne Pernet,OUI,42,4,38,35,3,OUI,OUI,2025-03-13 07:00:15+00:00,"48.84243457133779, 2.2921819612383847",Paris,75056,0.9047619047619048,7
2009,Filles Saint-Thomas - Place de la Bourse,OUI,58,50,8,4,4,OUI,OUI,2025-03-13 06:59:07+00:00,"48.868899890853, 2.3397543845203",Paris,75056,0.13793103448275862,7
18049,Porte d'Aubervilliers,OUI,52,47,5,2,3,OUI,OUI,2025-03-13 07:01:02+00:00,"48.89859661942376, 2.3689722642302513",Paris,75056,0.09615384615384616,7
44102,Verdun - Adrien Damalix,OUI,26,9,17,7,10,OUI,OUI,2025-03-13 07:00:13+00:00,"48.8222334178559, 2.4215328320860863",Saint-Maurice,94069,0.6538461538461539,7
10020,Chabrol - d'Hauteville,OUI,10,2,8,6,2,OUI,OUI,2025-03-13 06:59:42+00:00,"48.877018388033, 2.3513179644942",Paris,75056,0.8,7
21003,Jean Jaurès - Jean Baptiste Clément,OUI,39,1,38,20,18,OUI,OUI,2025-03-13 07:01:05+00:00,"48.84576261454011, 2.2369650006294255",Boulogne-Billancourt,92012,0.9743589743589743,7
11041,Square Saint-Ambroise,OUI,40,7,33,30,3,OUI,OUI,2025-03-13 07:00:28+00:00,"48.860934, 2.375841",Paris,75056,0.825,7
16123,Mahatma Gandhi,OUI,24,7,17,11,6,OUI,OUI,2025-03-13 06:56:59+00:00,"48.876356, 2.264205",Paris,75056,0.7083333333333334,7
31703,Sadi Carnot - François Mitterrand,OUI,26,26,0,0,0,OUI,OUI,2025-03-13 07:00:41+00:00,"48.87532687671517, 2.4241617321968083",Bagnolet,93006,0.0,7
17047,Courcelles - Pierre Demours,OUI,25,12,13,12,1,OUI,OUI,2025-03-13 07:00:29+00:00,"48.883769733273496, 2.29858466343129",Paris,75056,0.52,7
15031,Théâtre - Lourmel,OUI,51,29,22,22,0,OUI,OUI,2025-03-13 06:56:52+00:00,"48.8482070397636, 2.2898658737540245",Paris,75056,0.43137254901960786,7
41204,République - Danton,OUI,19,19,0,0,0,OUI,OUI,2025-03-13 06:59:12+00:00,"48.85249172181667, 2.462034523487091",Fontenay-sous-Bois,94033,0.0,7
21014,Hameau Fleuri - Marché,OUI,21,15,6,2,4,OUI,OUI,2025-03-13 07:00:35+00:00,"48.831448892608314, 2.2412404417991643",Boulogne-Billancourt,92012,0.2857142857142857,7
17046,Mac-Mahon - Brey,OUI,25,20,5,1,4,OUI,OUI,2025-03-13 06:59:29+00:00,"48.877532084130166, 2.294512536052928",Paris,75056,0.2,7
11006,Ledru-Rollin - Place du Père Chaillet,OUI,35,12,23,22,1,OUI,OUI,2025-03-13 06:59:32+00:00,"48.856433706943704, 2.379020587761426",Paris,75056,0.6571428571428571,7
19038,Lassus - Delouvain,OUI,19,15,4,0,4,OUI,OUI,2025-03-13 07:01:05+00:00,"48.8755044846, 2.3890327325519",Paris,75056,0.21052631578947367,7
47005,Ecole Vétérinaire,OUI,35,13,22,16,6,OUI,OUI,2025-03-13 07:00:29+00:00,"48.81488859822486, 2.4224362157778994",Maisons-Alfort,94046,0.6285714285714286,7
21703,Square du Carrefour de l'Insurrection,OUI,20,18,2,1,1,OUI,OUI,2025-03-13 07:00:30+00:00,"48.820864559770676, 2.291113436222077",Vanves,92075,0.1,7
16015,Bassano -  Iéna,OUI,15,10,5,1,4,OUI,OUI,2025-03-13 07:00:44+00:00,"48.868144510482075, 2.296149600985935",Paris,75056,0.3333333333333333,7
20118,Orteaux - Mouraud,OUI,24,15,9,4,5,OUI,OUI,2025-03-13 06:59:59+00:00,"48.85558642847872, 2.408762907764669",Paris,75056,0.375,7
15070,Balard - Montagne de la Fage,OUI,35,8,27,24,3,OUI,OUI,2025-03-13 06:58:58+00:00,"48.83850740333351, 2.2782871127128606",Paris,75056,0.7714285714285715,7
9031,Provence - Chaussée d'Antin,OUI,25,20,5,4,1,OUI,OUI,2025-03-13 07:00:30+00:00,"48.87428447542072, 2.332976511564311",Paris,75056,0.2,7
21001,Transvaal - Charles de Gaulle,OUI,27,13,14,3,11,OUI,OUI,2025-03-13 06:57:58+00:00,"48.848280403628806, 2.2373420120857195",Boulogne-Billancourt,92012,0.5185185185185185,7
9117,Bellefond - Maubeuge,OUI,28,23,5,5,0,OUI,OUI,2025-03-13 07:00:48+00:00,"48.878255397645, 2.3452642187476",Paris,75056,0.17857142857142858,7
15002,Maine - Antoine Bourdelle,OUI,17,16,1,1,0,OUI,OUI,2025-03-13 06:59:11+00:00,"48.84308531746595, 2.320263946784738",Paris,75056,0.058823529411764705,7
20023,Pelleport - Belgrand,OUI,14,12,2,0,2,OUI,OUI,2025-03-13 06:55:09+00:00,"48.86500081847653, 2.403980836377493",Paris,75056,0.14285714285714285,7
23007,Président Wilson - Jean Jaures,OUI,24,18,6,5,1,OUI,OUI,2025-03-13 06:57:32+00:00,"48.89034054052266, 2.2920683026313786",Levallois-Perret,92044,0.25,7
14002,Edgar Quinet - Raspail,OUI,44,18,26,17,9,OUI,OUI,2025-03-13 07:00:47+00:00,"48.83940266673835, 2.32971478253603",Paris,75056,0.5909090909090909,7
32015,Gare RER de Saint-Denis,OUI,37,25,12,9,3,OUI,OUI,2025-03-13 06:59:07+00:00,"48.93554324248177, 2.3471488058567047",Saint-Denis,93066,0.32432432432432434,7
18113,Lepic - Armée d'Orient,OUI,24,23,1,0,1,OUI,OUI,2025-03-13 07:00:49+00:00,"48.887536403814, 2.3343077301979",Paris,75056,0.041666666666666664,7
20116,Haies - Réunion,OUI,20,18,2,0,2,OUI,OUI,2025-03-13 06:59:38+00:00,"48.85386896766491, 2.402426162238911",Paris,75056,0.1,7
42004,Westermeyer - Paul Vaillant-Couturier,OUI,27,0,27,20,7,OUI,OUI,2025-03-13 07:00:40+00:00,"48.819116181578764, 2.3966637253761296",Ivry-sur-Seine,94041,1.0,7
35003,Gabrielle Josserand - Edouard Vaillant,OUI,24,9,15,9,6,OUI,OUI,2025-03-13 06:58:50+00:00,"48.90271566255436, 2.3933270573616032",Pantin,93055,0.625,7
16029,Maison de Radio - France,OUI,42,1,41,38,3,OUI,OUI,2025-03-13 07:01:02+00:00,"48.85132886434057, 2.277785539627075",Paris,75056,0.9761904761904762,7
5121,Square René Viviani - Montebello,OUI,32,5,27,24,3,OUI,OUI,2025-03-13 07:00:42+00:00,"48.851904891406, 2.3478421568871",Paris,75056,0.84375,7
8019,Naples - Rome,OUI,26,21,5,3,2,OUI,OUI,2025-03-13 06:56:39+00:00,"48.879960700846226, 2.321358695626259",Paris,75056,0.19230769230769232,7
19127,Aubervilliers - Curial,OUI,23,22,1,0,1,OUI,OUI,2025-03-13 06:57:08+00:00,"48.89088305227546, 2.3688579350709915",Paris,75056,0.043478260869565216,7
9017,Lallier - Trudaine,OUI,28,21,7,0,7,OUI,OUI,2025-03-13 07:00:47+00:00,"48.88109246617963, 2.3408224806189537",Paris,75056,0.25,7
1120,Lavandieres Sainte Opportune - Rivoli,OUI,22,15,7,4,3,OUI,OUI,2025-03-13 06:59:57+00:00,"48.859279702476, 2.3466217517853",Paris,75056,0.3181818181818182,7
18008,Square Léon,OUI,33,30,3,3,0,OUI,OUI,2025-03-13 06:57:38+00:00,"48.88667396788626, 2.353205569088459",Paris,75056,0.09090909090909091,7
14112,Méchain - Faubourg Saint-Jacques,OUI,15,9,6,3,3,OUI,OUI,2025-03-13 07:00:56+00:00,"48.83586772099485, 2.33798034198275",Paris,75056,0.4,7
7008,Villersexel - Saint-Germain,OUI,16,8,8,6,2,OUI,OUI,2025-03-13 07:00:15+00:00,"48.858297001218, 2.3237934708595",Paris,75056,0.5,7
47004,Stade Auguste Delaune,OUI,21,2,19,18,1,OUI,OUI,2025-03-13 06:58:41+00:00,"48.80896378683884, 2.4345204234123234",Maisons-Alfort,94046,0.9047619047619048,7
16112,Chernoviz - Raynouard,OUI,36,32,4,2,2,OUI,OUI,2025-03-13 06:56:44+00:00,"48.8569864146289, 2.282173218142987",Paris,75056,0.1111111111111111,7
9026,Jean-Baptiste Pigalle - La Bruyere,OUI,17,17,0,0,0,OUI,OUI,2025-03-13 07:00:26+00:00,"48.87939826447722, 2.333709173337285",Paris,75056,0.0,7
42703,Fontainebleau - Edmond Michelet,OUI,45,44,1,0,1,OUI,OUI,2025-03-13 07:00:28+00:00,"48.80956436844049, 2.3626908659935",Le Kremlin-Bicêtre,94043,0.022222222222222223,7
18033,Belliard - Damrémont,OUI,34,21,13,13,0,OUI,OUI,2025-03-13 07:00:02+00:00,"48.89669238777841, 2.338023450388167",Paris,75056,0.38235294117647056,7
20201,Eugène Reisz - Davout,OUI,20,16,4,0,4,OUI,OUI,2025-03-13 06:59:29+00:00,"48.85631874632638, 2.410396970808506",Paris,75056,0.2,7
11010,Boulets - Faubourg Saint-Antoine,OUI,42,23,19,6,13,OUI,OUI,2025-03-13 06:56:49+00:00,"48.849259262115, 2.3917546141943",Paris,75056,0.4523809523809524,7
22102,Mont Valérien - Michel Salles,OUI,24,6,18,8,10,OUI,OUI,2025-03-13 06:58:03+00:00,"48.8561915, 2.2152966",Saint-Cloud,92064,0.75,7
16122,Route de la Muette - Porte de Neuilly,OUI,49,41,8,7,1,OUI,OUI,2025-03-13 07:01:01+00:00,"48.8798926, 2.2587671",Paris,75056,0.16326530612244897,7
4110,Neuve Saint-Pierre - Beautreillis,OUI,19,1,18,14,4,OUI,OUI,2025-03-13 07:00:59+00:00,"48.85355351439652, 2.3639122769236565",Paris,75056,0.9473684210526315,7
21310,Kléber - Gouverneur Général Eboué,OUI,21,8,13,11,2,OUI,OUI,2025-03-13 07:00:49+00:00,"48.826885843069796, 2.2723413258790965",Issy-les-Moulineaux,92040,0.6190476190476191,7
6032,Sabot - Rennes,OUI,25,10,15,12,3,OUI,OUI,2025-03-13 06:57:05+00:00,"48.852575112948415, 2.331552766263485",Paris,75056,0.6,7
20016,Pyrénées - Maraîchers,OUI,32,25,7,1,6,OUI,OUI,2025-03-13 06:56:34+00:00,"48.85714001395299, 2.4043509364128113",Paris,75056,0.21875,7
7020,Champ de Mars - Cler,OUI,39,10,29,28,1,OUI,OUI,2025-03-13 07:00:28+00:00,"48.856691550115315, 2.306646779179573",Paris,75056,0.7435897435897436,7
10010,Place Jacques Bonsergent,OUI,32,4,28,23,5,OUI,OUI,2025-03-13 07:00:12+00:00,"48.870948218595, 2.3612049221992",Paris,75056,0.875,7
10036,Aqueduc - Villette,OUI,22,11,11,6,5,OUI,OUI,2025-03-13 07:00:18+00:00,"48.883886063895, 2.367198803315",Paris,75056,0.5,7
16043,Place de Passy,OUI,13,9,4,3,1,OUI,OUI,2025-03-13 06:59:50+00:00,"48.85780291711202, 2.277500546942199",Paris,75056,0.3076923076923077,7
23304,Mairie de Sceaux,OUI,33,30,3,1,2,OUI,OUI,2025-03-13 06:59:35+00:00,"48.778916905132, 2.2887361764861",Sceaux,92071,0.09090909090909091,7
16027,Mozart - Jasmin,OUI,62,60,2,0,2,OUI,OUI,2025-03-13 07:00:02+00:00,"48.85286124871689, 2.268483570651513",Paris,75056,0.03225806451612903,7
6017,Sénat - Condé,OUI,32,25,7,3,4,OUI,OUI,2025-03-13 06:58:49+00:00,"48.84954227788459, 2.337939441204071",Paris,75056,0.21875,7
6107,Place Alphonse Deville,OUI,22,22,0,0,0,OUI,OUI,2025-03-13 06:57:49+00:00,"48.850188262662, 2.3275961726904",Paris,75056,0.0,7
13103,Hôpital Pitié Salpêtrière,OUI,49,36,13,1,12,OUI,OUI,2025-03-13 06:57:48+00:00,"48.8377016, 2.3604946",Paris,75056,0.2653061224489796,7
14030,Pernety - Raymond Losserand,OUI,32,30,2,0,2,OUI,OUI,2025-03-13 07:01:06+00:00,"48.834254627953, 2.317609339387",Paris,75056,0.0625,7
9101,Cadet - La Fayette,OUI,18,12,6,6,0,OUI,OUI,2025-03-13 07:00:32+00:00,"48.875601632672, 2.3435704037547",Paris,75056,0.3333333333333333,7
13046,Eugène Oudiné - Dessous Des Berges,OUI,44,26,18,12,6,OUI,OUI,2025-03-13 06:59:29+00:00,"48.8256423, 2.3750226",Paris,75056,0.4090909090909091,7
1117,Pont Neuf - Rivoli,OUI,24,12,12,11,1,OUI,OUI,2025-03-13 06:57:34+00:00,"48.860089892617, 2.344057559967",Paris,75056,0.5,7
15003,Gare Montparnasse - Vaugirard,OUI,66,40,26,19,7,OUI,OUI,2025-03-13 07:00:58+00:00,"48.8418071798797, 2.31951002690117",Paris,75056,0.3939393939393939,7
23903,Stade Gaston Bouillant,OUI,29,14,15,3,12,OUI,OUI,2025-03-13 06:58:37+00:00,"48.939958667023, 2.3279571813836",Villeneuve-la-Garenne,92078,0.5172413793103449,7
17022,Pereire - Place de Wagram,OUI,45,42,3,3,0,OUI,OUI,2025-03-13 07:01:02+00:00,"48.887070607581215, 2.304111124531457",Paris,75056,0.06666666666666667,7
31704,Jeanne Hornet - Girardot,OUI,28,27,1,0,1,OUI,OUI,2025-03-13 06:59:35+00:00,"48.873802681432146, 2.427820265293122",Bagnolet,93006,0.03571428571428571,7
12161,Diderot - Reuilly,OUI,43,8,35,33,2,OUI,OUI,2025-03-13 07:00:56+00:00,"48.847208456061, 2.3861273378134",Paris,75056,0.813953488372093,7
21311,Parvis Corentin Celton,OUI,51,0,51,47,4,OUI,OUI,2025-03-13 07:00:50+00:00,"48.82747252522725, 2.2784319519996648",Issy-les-Moulineaux,92040,1.0,7
15107,Palais des Sports,OUI,21,2,19,15,4,OUI,OUI,2025-03-13 07:00:52+00:00,"48.833468517426, 2.2858720645308",Paris,75056,0.9047619047619048,7
15059,Parc André Citroën,OUI,64,5,59,57,2,OUI,OUI,2025-03-13 07:00:53+00:00,"48.840639944296655, 2.2780618071556096",Paris,75056,0.921875,7
18017,Caulaincourt - Place Constantin Pecqueur,OUI,43,22,21,11,10,OUI,OUI,2025-03-13 07:00:00+00:00,"48.889677905028, 2.3381787144261",Paris,75056,0.4883720930232558,7
23403,Chateau,OUI,21,11,10,8,2,OUI,OUI,2025-03-13 06:56:53+00:00,"48.774661399959, 2.3135878035462",Bourg-la-Reine,92014,0.47619047619047616,7
19041,Belleville - Pyrénées,OUI,38,30,8,1,7,OUI,OUI,2025-03-13 06:59:06+00:00,"48.8741908, 2.3860039",Paris,75056,0.21052631578947367,7
4013,Vieille du Temple - Francs Bourgeois,OUI,27,5,22,18,4,OUI,OUI,2025-03-13 07:00:29+00:00,"48.858256413365815, 2.35821794718504",Paris,75056,0.8148148148148148,7
11043,Place Pasdeloup,OUI,18,0,18,16,2,OUI,OUI,2025-03-13 07:00:13+00:00,"48.862654215631, 2.3670325062844",Paris,75056,1.0,7
31023,Place François Mitterand,OUI,34,31,3,3,0,OUI,OUI,2025-03-13 07:00:11+00:00,"48.86492782016328, 2.442958317697048",Montreuil,93048,0.08823529411764706,7
13010,Place d'Italie - Vincent Auriol,OUI,39,6,33,13,20,OUI,OUI,2025-03-13 06:59:32+00:00,"48.831481874467, 2.3567550292319",Paris,75056,0.8461538461538461,7
19023,Manin - Simon Bolivar,OUI,24,14,10,0,10,OUI,OUI,2025-03-13 06:59:26+00:00,"48.876499654127, 2.3794073625991",Paris,75056,0.4166666666666667,7
32603,Calmette,OUI,31,27,4,1,3,OUI,OUI,2025-03-13 07:00:49+00:00,"48.88104925098552, 2.424993216991425",Les Lilas,93045,0.12903225806451613,7
18137,Poissonniers - Nord,OUI,28,26,2,1,1,OUI,OUI,2025-03-13 06:58:36+00:00,"48.892511213520656, 2.3522228747606277",Paris,75056,0.07142857142857142,7
17201,Porte Maillot - Perreire,OUI,50,37,13,7,6,OUI,OUI,2025-03-13 07:01:06+00:00,"48.878021154637, 2.2842371277102",Paris,75056,0.26,7
7101,Raspail - Chomel,OUI,49,37,12,9,3,OUI,OUI,2025-03-13 06:59:28+00:00,"48.852233164303, 2.3266580700874",Paris,75056,0.24489795918367346,7
45001,Hôtel de Ville de Champigny sur Marne,OUI,21,2,19,8,11,OUI,OUI,2025-03-13 07:00:42+00:00,"48.813810628405, 2.5096759200096",Champigny-sur-Marne,94017,0.9047619047619048,7
17116,Reims - Porte d'Asnières,OUI,26,23,3,1,2,OUI,OUI,2025-03-13 07:00:11+00:00,"48.891834448210986, 2.300144659954865",Paris,75056,0.11538461538461539,7
9118,Faubourg Poissonniere - Delta,OUI,36,30,6,3,3,OUI,OUI,2025-03-13 06:55:27+00:00,"48.882555807626765, 2.3497482016682625",Paris,75056,0.16666666666666666,7
13041,Porte d'Ivry,OUI,49,36,13,11,2,OUI,OUI,2025-03-13 06:59:33+00:00,"48.821768747596, 2.3688706755638",Paris,75056,0.2653061224489796,7
21024,Billancourt - Général Leclerc,OUI,22,4,18,11,7,OUI,OUI,2025-03-13 07:00:29+00:00,"48.8322649, 2.2380413",Boulogne-Billancourt,92012,0.8181818181818182,7
4011,Hôtel de Ville - Pont-Marie,OUI,31,6,25,20,5,OUI,OUI,2025-03-13 07:01:01+00:00,"48.853899645527, 2.3569472506642",Paris,75056,0.8064516129032258,7
10163,Gare du Nord - Demarquay,OUI,29,16,13,3,10,OUI,OUI,2025-03-13 07:01:01+00:00,"48.881154, 2.358411",Paris,75056,0.4482758620689655,7
14006,Saint-Jacques - Tombe Issoire,OUI,21,16,5,1,4,OUI,OUI,2025-03-13 07:00:28+00:00,"48.833206330538864, 2.3369108140468597",Paris,75056,0.23809523809523808,7
2001,Greneta - Sebastopol,OUI,32,21,11,10,1,OUI,OUI,2025-03-13 06:57:26+00:00,"48.865242333228, 2.3516669869423",Paris,75056,0.34375,7
7013,Duroc - Place de Breteuil,OUI,46,27,19,11,8,OUI,OUI,2025-03-13 07:00:21+00:00,"48.847460641142, 2.3126140236855",Paris,75056,0.41304347826086957,7
20019,Place du Maquis du Vercors,OUI,30,28,2,0,2,OUI,OUI,2025-03-13 07:00:22+00:00,"48.877321579493575, 2.4083782732486725",Paris,75056,0.06666666666666667,7
32018,Franciade - Gabriel Péri,OUI,25,9,16,12,4,OUI,OUI,2025-03-13 07:00:06+00:00,"48.93261499331498, 2.355954498052597",Saint-Denis,93066,0.64,7
8056,Beaujon - Wagram,OUI,28,23,5,0,5,OUI,OUI,2025-03-13 06:58:22+00:00,"48.875352455985, 2.2964416444302",Paris,75056,0.17857142857142858,7
11003,Keller - La Roquette,OUI,34,16,18,17,1,OUI,OUI,2025-03-13 07:00:14+00:00,"48.8555508, 2.3752778",Paris,75056,0.5294117647058824,7
18138,Station Paris Basketball - Ney - Charles Hermite,OUI,19,10,9,5,4,OUI,OUI,2025-03-13 06:56:42+00:00,"48.898748039775, 2.3645754531026",Paris,75056,0.47368421052631576,7
41206,Place des Larris,OUI,34,26,8,2,6,OUI,OUI,2025-03-13 06:55:24+00:00,"48.8568363, 2.4780236",Fontenay-sous-Bois,94033,0.23529411764705882,7
7016,Surcouf - Université,OUI,56,19,37,32,5,OUI,OUI,2025-03-13 07:00:28+00:00,"48.861273016278, 2.3094535509142",Paris,75056,0.6607142857142857,7
19031,Manin - Crimée,OUI,21,15,6,0,6,OUI,OUI,2025-03-13 07:00:51+00:00,"48.8831217743719, 2.3863670602440834",Paris,75056,0.2857142857142857,7
12041,Bois de Vincennes.,OUI,58,31,27,7,20,OUI,OUI,2025-03-13 06:58:54+00:00,"48.8338064, 2.4132221",Saint-Mandé,94067,0.46551724137931033,7
13114,Nationale - Marcel Duchamp,OUI,23,11,12,4,8,OUI,OUI,2025-03-13 07:01:03+00:00,"48.82463749337136, 2.3678014799952507",Paris,75056,0.5217391304347826,7
12108,Bercy.,OUI,64,43,21,16,5,OUI,OUI,2025-03-13 06:58:34+00:00,"48.839966914994, 2.3788625746965",Paris,75056,0.328125,7
20017,Saint-Blaise - Mouraud,OUI,27,20,7,2,5,OUI,OUI,2025-03-13 07:01:00+00:00,"48.85696177597818, 2.40869477391243",Paris,75056,0.25925925925925924,7
21114,Gustave Eiffel - Parc des Impressionnistes,OUI,30,16,14,12,2,OUI,OUI,2025-03-13 07:00:12+00:00,"48.90390619651018, 2.2946908324956894",Clichy,92024,0.4666666666666667,7
11019,Charonne - Philippe-Auguste,OUI,31,16,15,11,4,OUI,OUI,2025-03-13 07:01:01+00:00,"48.855603162026, 2.39054639062",Paris,75056,0.4838709677419355,7
31013,Centenaire - Sorins,OUI,42,35,7,0,7,OUI,OUI,2025-03-13 07:00:59+00:00,"48.85853523359734, 2.4273508787155156",Montreuil,93048,0.16666666666666666,7
8015,Roquépine - Malesherbes,OUI,50,40,10,5,5,OUI,OUI,2025-03-13 06:57:14+00:00,"48.87345073390807, 2.320404499769211",Paris,75056,0.2,7
17016,Brochant - Square des Batignolles,OUI,31,16,15,7,8,OUI,OUI,2025-03-13 06:59:29+00:00,"48.88818698581028, 2.316861143151153",Paris,75056,0.4838709677419355,7
6014,Pont de Lodi - Dauphine,OUI,20,11,9,9,0,OUI,OUI,2025-03-13 06:58:25+00:00,"48.855296898603285, 2.339947307565249",Paris,75056,0.45,7
20202,Dupont de l'Eure - Gambetta,OUI,29,22,7,0,7,OUI,OUI,2025-03-13 07:00:01+00:00,"48.8679385, 2.4003649",Paris,75056,0.2413793103448276,7
14116,Romain Rolland,OUI,25,22,3,0,3,OUI,OUI,2025-03-13 06:55:56+00:00,"48.820215229662765, 2.3234144234418346",Montrouge,92049,0.12,7
18019,Square Raymond Souplex,OUI,50,45,5,1,4,OUI,OUI,2025-03-13 07:01:00+00:00,"48.89183721478911, 2.335426103165901",Paris,75056,0.1,7
47002,Les Juilliottes,OUI,21,6,15,11,4,OUI,OUI,2025-03-13 06:59:27+00:00,"48.8043072, 2.4437362",Maisons-Alfort,94046,0.7142857142857143,7
33005,République - Henri Barbusse,OUI,31,9,22,12,10,OUI,OUI,2025-03-13 07:00:43+00:00,"48.90661553626751, 2.389432489871979",Aubervilliers,93001,0.7096774193548387,7
4010,Saint-Antoine Sévigné,OUI,27,8,19,15,4,OUI,OUI,2025-03-13 07:01:05+00:00,"48.8550222, 2.3612322",Paris,75056,0.7037037037037037,7
2110,Jeûneurs - Mulhouse,OUI,27,23,4,3,1,OUI,OUI,2025-03-13 06:58:56+00:00,"48.868997, 2.346925",Paris,75056,0.14814814814814814,7
11034,Parmentier - Fontaine au Roi,OUI,43,16,27,22,5,OUI,OUI,2025-03-13 06:58:18+00:00,"48.86787670551736, 2.372705978671471",Paris,75056,0.627906976744186,7
7026,Place de Finlande,OUI,24,2,22,19,3,OUI,OUI,2025-03-13 06:58:33+00:00,"48.862408335967, 2.3113624379039",Paris,75056,0.9166666666666666,7
9012,Rougemont - Poissonnière,OUI,30,23,7,7,0,OUI,OUI,2025-03-13 06:59:26+00:00,"48.871611569354755, 2.345873080193996",Paris,75056,0.23333333333333334,7
1016,Thérèse - Opéra,OUI,24,21,3,2,1,OUI,OUI,2025-03-13 06:59:10+00:00,"48.866483514509, 2.3344334212238",Paris,75056,0.125,7
15020,Mairie du 15ème,OUI,31,6,25,21,4,OUI,OUI,2025-03-13 07:01:03+00:00,"48.8417762, 2.2986539",Paris,75056,0.8064516129032258,7
14007,Ferrus - Saint-Jacques,OUI,34,20,14,8,6,OUI,OUI,2025-03-13 07:00:27+00:00,"48.8313878, 2.3408563",Paris,75056,0.4117647058823529,7
13113,Vistule - Choisy,OUI,33,9,24,10,14,OUI,OUI,2025-03-13 07:00:52+00:00,"48.82365543660611, 2.3615723848342896",Paris,75056,0.7272727272727273,7
11107,Faidherbe - Dahomey,OUI,40,4,36,24,12,OUI,OUI,2025-03-13 06:59:59+00:00,"48.851358329771806, 2.383823134795429",Paris,75056,0.9,7
15061,Square Desnouettes,OUI,21,11,10,8,2,OUI,OUI,2025-03-13 06:56:58+00:00,"48.83476837934194, 2.284142297394666",Paris,75056,0.47619047619047616,7
3101,Porte Saint-Martin,OUI,32,16,16,14,2,OUI,OUI,2025-03-13 06:59:28+00:00,"48.86860172112996, 2.35570102930069",Paris,75056,0.5,7
23008,Hôtel de Ville de Levallois Perret,OUI,25,13,12,9,3,OUI,OUI,2025-03-13 07:00:29+00:00,"48.89314451997415, 2.2888818383216862",Levallois-Perret,92044,0.48,7
8105,François 1er - Lincoln,OUI,29,26,3,1,2,OUI,OUI,2025-03-13 06:58:53+00:00,"48.869517979344, 2.3024262188416",Paris,75056,0.10344827586206896,7
21108,Mairie de Clichy,OUI,44,40,4,1,3,OUI,OUI,2025-03-13 07:01:02+00:00,"48.903653634661, 2.3059353232384",Clichy,92024,0.09090909090909091,7
15058,Place du Moulin de Javel,OUI,42,23,19,12,7,OUI,OUI,2025-03-13 06:58:47+00:00,"48.84021670922, 2.2716060653329",Paris,75056,0.4523809523809524,7
31018,Gambetta - Michelet,OUI,30,30,0,0,0,OUI,OUI,2025-03-13 06:58:28+00:00,"48.85273792380526, 2.429966032505036",Montreuil,93048,0.0,7
2101,Bachaumont - Montmartre,OUI,33,5,28,25,3,OUI,OUI,2025-03-13 06:59:48+00:00,"48.86617395079137, 2.3449775576591496",Paris,75056,0.8484848484848485,7
5019,Poissy - Saint-Germain,OUI,24,8,16,15,1,OUI,OUI,2025-03-13 06:59:53+00:00,"48.84969649427, 2.3529685288668",Paris,75056,0.6666666666666666,7
8049,Georges V - François 1er,OUI,20,18,2,1,1,OUI,OUI,2025-03-13 06:58:53+00:00,"48.87034, 2.30082",Paris,75056,0.1,7
17033,Carnot - Général Lanrezac,OUI,29,26,3,0,3,OUI,OUI,2025-03-13 07:00:30+00:00,"48.875443870736, 2.2938242935036",Paris,75056,0.10344827586206896,7
22017,Charles de Gaulle - Louis Philippe,OUI,27,18,9,6,3,OUI,OUI,2025-03-13 07:01:05+00:00,"48.881742142181, 2.2710045335353",Neuilly-sur-Seine,92051,0.3333333333333333,7
10164,Claude Vellefaux - Sambre et Meuse,OUI,32,30,2,1,1,OUI,OUI,2025-03-13 06:57:40+00:00,"48.875022, 2.370478",Paris,75056,0.0625,7
19021,Mairie du 19ème,OUI,24,15,9,2,7,OUI,OUI,2025-03-13 07:01:05+00:00,"48.88256264247959, 2.3812624812126164",Paris,75056,0.375,7
9113,Bleue - Trévise,OUI,27,20,7,6,1,OUI,OUI,2025-03-13 06:58:23+00:00,"48.87578906564573, 2.347289621829987",Paris,75056,0.25925925925925924,7
17104,Jardin Marguerite Long,OUI,21,15,6,4,2,OUI,OUI,2025-03-13 06:56:39+00:00,"48.8816985773914, 2.2836575657129288",Paris,75056,0.2857142857142857,7
20103,Le Vau - Maurice Bertaux,OUI,23,19,4,1,3,OUI,OUI,2025-03-13 07:01:01+00:00,"48.86803439043193, 2.411030612453627",Paris,75056,0.17391304347826086,7
21004,Jean Jaurès - Reine,OUI,31,6,25,25,0,OUI,OUI,2025-03-13 06:58:03+00:00,"48.84009622558849, 2.239872515201569",Boulogne-Billancourt,92012,0.8064516129032258,7
2014,Daunou - Louis le Grand,OUI,31,21,10,2,8,OUI,OUI,2025-03-13 06:57:45+00:00,"48.869113, 2.332515",Paris,75056,0.3225806451612903,7
22002,Argenson - Château,OUI,24,13,11,5,6,OUI,OUI,2025-03-13 06:53:03+00:00,"48.888559314669514, 2.2642001509666447",Neuilly-sur-Seine,92051,0.4583333333333333,7
4109,Mornay - Sully,OUI,13,6,7,4,3,OUI,OUI,2025-03-13 07:00:23+00:00,"48.84970399548416, 2.364460788667202",Paris,75056,0.5384615384615384,7
35008,Place de l'Eglise - Pantin,OUI,29,23,6,3,3,OUI,OUI,2025-03-13 06:59:32+00:00,"48.892809461520265, 2.4124351143836975",Pantin,93055,0.20689655172413793,7
11048,Place Mireille Havet,OUI,42,2,40,35,5,OUI,OUI,2025-03-13 07:00:47+00:00,"48.850533, 2.383756",Paris,75056,0.9523809523809523,7
13022,Butte aux Cailles - Esperance,OUI,30,22,8,3,5,OUI,OUI,2025-03-13 06:55:30+00:00,"48.82758774190948, 2.3492151126265526",Paris,75056,0.26666666666666666,7
12154,Square Georges Melies,OUI,38,16,22,6,16,OUI,OUI,2025-03-13 07:00:48+00:00,"48.84070239213081, 2.409667745232582",Paris,75056,0.5789473684210527,7
13019,Fernand Braudel - Vincent Auriol,OUI,36,29,7,3,4,OUI,OUI,2025-03-13 06:58:31+00:00,"48.83637852318147, 2.3723404482007027",Paris,75056,0.19444444444444445,7
19030,Melun - Jean Jaurès,OUI,26,19,7,6,1,OUI,OUI,2025-03-13 06:57:45+00:00,"48.8837796723475, 2.376477420330048",Paris,75056,0.2692307692307692,7
21952,Place Tony de Graaff,OUI,42,7,35,24,11,OUI,OUI,2025-03-13 06:59:45+00:00,"48.8181645, 2.2458109",Meudon,92048,0.8333333333333334,7
20045,Louis Ganne - Davout,OUI,30,28,2,0,2,OUI,OUI,2025-03-13 06:55:05+00:00,"48.86338720692607, 2.409725748002529",Paris,75056,0.06666666666666667,7
11110,Roquette - Folie Regnault,OUI,50,37,13,9,4,OUI,OUI,2025-03-13 06:59:40+00:00,"48.859246959155485, 2.386553623578705",Paris,75056,0.26,7
11044,Square du Bataclan,OUI,17,6,11,10,1,OUI,OUI,2025-03-13 06:55:29+00:00,"48.8633762, 2.3711327",Paris,75056,0.6470588235294118,7
12153,Terroirs de France - Lheureux,OUI,55,43,12,8,4,OUI,OUI,2025-03-13 07:00:26+00:00,"48.83212027074841, 2.388618104159832",Paris,75056,0.21818181818181817,7
5030,Sorbonne - Ecoles,OUI,47,33,14,5,9,OUI,OUI,2025-03-13 07:01:05+00:00,"48.849686566191, 2.3434996604919",Paris,75056,0.2978723404255319,7
14127,Odessa - Départ,OUI,39,33,6,2,4,OUI,OUI,2025-03-13 07:01:00+00:00,"48.842885590081, 2.3244281485677",Paris,75056,0.15384615384615385,7
16041,Versailles - Claude Terrasse,OUI,46,7,39,26,13,OUI,OUI,2025-03-13 07:01:05+00:00,"48.840219338074, 2.263834191153",Paris,75056,0.8478260869565217,7
12033,François Truffaut - Saint Emilion,OUI,66,54,12,7,5,OUI,OUI,2025-03-13 07:00:47+00:00,"48.83372354344807, 2.386601903271428",Paris,75056,0.18181818181818182,7
9015,Lamartine - Faubourg Montmartre,OUI,28,9,19,16,3,OUI,OUI,2025-03-13 07:00:23+00:00,"48.876613982891, 2.3397656902671",Paris,75056,0.6785714285714286,7
22012,Madeleine Michelis - Roule,OUI,24,7,17,9,8,OUI,OUI,2025-03-13 07:00:04+00:00,"48.88260431301364, 2.2773634269833565",Neuilly-sur-Seine,92051,0.7083333333333334,7
8029,Place du Canada,OUI,56,52,4,2,2,OUI,OUI,2025-03-13 06:57:14+00:00,"48.865346269363, 2.3101937879648",Paris,75056,0.07142857142857142,7
18035,René Binet - Porte de Montmartre,OUI,36,29,7,2,5,OUI,OUI,2025-03-13 06:52:59+00:00,"48.89905109950848, 2.3365534096956253",Paris,75056,0.19444444444444445,7
16031,Vignes - Boulainvilliers,OUI,20,17,3,0,3,OUI,OUI,2025-03-13 06:59:11+00:00,"48.856399483950504, 2.275240458548069",Paris,75056,0.15,7
13110,Moulin de la Pointe,OUI,20,19,1,0,1,OUI,OUI,2025-03-13 06:55:30+00:00,"48.82092946051445, 2.3563179373741145",Paris,75056,0.05,7
17005,Brochant - Clichy,OUI,53,35,18,17,1,OUI,OUI,2025-03-13 06:59:51+00:00,"48.89032998912038, 2.319730559929781",Paris,75056,0.33962264150943394,7
23105,Sèvres Rive Gauche,OUI,33,18,15,14,1,OUI,OUI,2025-03-13 07:01:00+00:00,"48.821443218278, 2.2150785306885",Sèvres,92072,0.45454545454545453,7
21017,Place Marcel Sembat,OUI,51,19,32,32,0,OUI,OUI,2025-03-13 07:00:07+00:00,"48.83328865030686, 2.2441747784614567",Boulogne-Billancourt,92012,0.6274509803921569,7
15009,Suffren - Pérignon,OUI,45,17,28,24,4,OUI,OUI,2025-03-13 07:00:09+00:00,"48.84717561492764, 2.307052147596786",Paris,75056,0.6222222222222222,7
14016,René Coty - Parc Montsouris,OUI,54,50,4,3,1,OUI,OUI,2025-03-13 06:59:31+00:00,"48.82479134498032, 2.336124926805496",Paris,75056,0.07407407407407407,7
21120,Docteur Calmette - Martre,OUI,29,18,11,8,3,OUI,OUI,2025-03-13 06:56:33+00:00,"48.898969358483, 2.3086513252383",Clichy,92024,0.3793103448275862,7
12120,Lac Daumesnil - Saint-Maurice,OUI,49,34,15,13,2,OUI,OUI,2025-03-13 07:01:02+00:00,"48.82774555743318, 2.4183654785156246",Paris,75056,0.30612244897959184,7
48009,République - Auguste Perret,OUI,30,29,1,1,0,OUI,OUI,2025-03-13 07:00:44+00:00,"48.78695280952244, 2.3518594354391094",Villejuif,94076,0.03333333333333333,7
18142,Jessaint - Marx Dormoy,OUI,30,23,7,3,4,OUI,OUI,2025-03-13 06:57:31+00:00,"48.88484543106364, 2.358930408954621",Paris,75056,0.23333333333333334,7
14125,Dareau - Broussais,OUI,22,15,7,2,5,OUI,OUI,2025-03-13 06:59:36+00:00,"48.8307758, 2.3361804",Paris,75056,0.3181818181818182,7
23005,Gare de Clichy-Levallois,OUI,24,8,16,15,1,OUI,OUI,2025-03-13 06:59:32+00:00,"48.89679827481989, 2.2984680533409123",Levallois-Perret,92044,0.6666666666666666,7
31017,Jean Moulin - Paul Doumer,OUI,17,17,0,0,0,OUI,OUI,2025-03-13 07:00:52+00:00,"48.8622179854695, 2.45533436536789",Montreuil,93048,0.0,7
20117,Saint-Fargeau - Mortier,OUI,31,30,1,0,1,OUI,OUI,2025-03-13 06:59:38+00:00,"48.87266656122256, 2.407912909984589",Paris,75056,0.03225806451612903,7
18114,Véron - Lepic,OUI,22,17,5,2,3,OUI,OUI,2025-03-13 06:57:08+00:00,"48.88526123395252, 2.334559857845307",Paris,75056,0.22727272727272727,7
21009,Le Corbusier - Jean Jaurès,OUI,45,42,3,0,3,OUI,OUI,2025-03-13 06:59:44+00:00,"48.83780830557548, 2.2408381104469304",Boulogne-Billancourt,92012,0.06666666666666667,7
44103,Pont De Charenton,OUI,18,0,18,9,9,OUI,OUI,2025-03-13 06:59:02+00:00,"48.8179685, 2.4199531",Saint-Maurice,94069,1.0,7
13047,Boutroux - Porte de Vitry,OUI,49,24,25,21,4,OUI,OUI,2025-03-13 06:58:14+00:00,"48.822632, 2.377738",Paris,75056,0.5102040816326531,7
4107,Beaumarchais - Pas de la Mule,OUI,17,3,14,12,2,OUI,OUI,2025-03-13 06:58:22+00:00,"48.855580507049, 2.3684333673431",Paris,75056,0.8235294117647058,7
22403,Pierre Brossolette - Adolphe Pinard,OUI,23,14,9,5,4,OUI,OUI,2025-03-13 06:56:57+00:00,"48.821772279548, 2.3131558299065",Malakoff,92046,0.391304347826087,7
42011,Quai Marcel Boyer - Victor Hugo,OUI,29,18,11,9,2,OUI,OUI,2025-03-13 06:56:08+00:00,"48.822556366667, 2.3920395970345",Ivry-sur-Seine,94041,0.3793103448275862,7
9013,Mairie du 9ème,OUI,23,17,6,6,0,OUI,OUI,2025-03-13 06:53:34+00:00,"48.873267137583, 2.3407534480528",Paris,75056,0.2608695652173913,7
20047,Cours de Vincennes - Davout,OUI,48,25,23,8,15,OUI,OUI,2025-03-13 07:00:21+00:00,"48.847238029966, 2.4107042336225",Paris,75056,0.4791666666666667,7
14128,Gergovie - Vercingétorix,OUI,29,27,2,0,2,OUI,OUI,2025-03-13 06:59:00+00:00,"48.83453413883994, 2.313154547426182",Paris,75056,0.06896551724137931,7
21951,Place Centrale,OUI,22,19,3,1,2,OUI,OUI,2025-03-13 06:59:56+00:00,"48.78740167690531, 2.2278830409049992",Meudon,92048,0.13636363636363635,7
19036,Hôpital Robert Debré,OUI,33,28,5,0,5,OUI,OUI,2025-03-13 06:56:47+00:00,"48.88005222200894, 2.4008650346327003",Paris,75056,0.15151515151515152,7
92005,Gare de Nanterre Ville,OUI,42,19,23,18,5,OUI,OUI,2025-03-13 07:00:28+00:00,"48.8950295, 2.1957932",Nanterre,92050,0.5476190476190477,7
31101,Jules Guesde - Laennec,OUI,19,13,6,0,6,OUI,OUI,2025-03-13 06:53:16+00:00,"48.87628983900398, 2.5006942078471184",Rosny-sous-Bois,93064,0.3157894736842105,7
22103,Senard - Charles Blum,OUI,24,21,3,2,1,OUI,OUI,2025-03-13 06:51:41+00:00,"48.857315824799, 2.221091687679291",Saint-Cloud,92064,0.125,7
31026,Demi-Lune - Aristide Briand,OUI,20,14,6,0,6,OUI,OUI,2025-03-13 06:58:04+00:00,"48.87626381919953, 2.4562818557024",Montreuil,93048,0.3,7
19113,Pré Saint-Gervais - Lilas,OUI,27,24,3,0,3,OUI,OUI,2025-03-13 06:58:01+00:00,"48.877870626988, 2.3959073424339",Paris,75056,0.1111111111111111,7
17001,Guy Môquet - Saint-Ouen,OUI,44,21,23,14,9,OUI,OUI,2025-03-13 06:59:39+00:00,"48.892777719023975, 2.3270335793495183",Paris,75056,0.5227272727272727,7
10039,Sambre et Meuse - Villette,OUI,24,19,5,1,4,OUI,OUI,2025-03-13 07:00:24+00:00,"48.874405666217, 2.3738072379951",Paris,75056,0.20833333333333334,7
12129,Bois de Vincennes - Porte Jaune,OUI,35,33,2,2,0,OUI,OUI,2025-03-13 07:00:49+00:00,"48.838751246689455, 2.4605489149689674",Paris,75056,0.05714285714285714,7
35004,Place du Président Salvador Allende,OUI,59,45,14,2,12,OUI,OUI,2025-03-13 06:59:08+00:00,"48.897307310356055, 2.40079153681279",Pantin,93055,0.23728813559322035,7
31707,Edouard Vaillant - Galliéni,OUI,47,44,3,1,2,OUI,OUI,2025-03-13 06:56:57+00:00,"48.858462881661, 2.4147954583168",Bagnolet,93006,0.06382978723404255,7
32021,Place du Front Populaire - George Sand,OUI,65,61,4,2,2,OUI,OUI,2025-03-13 07:00:21+00:00,"48.90680713698062, 2.364541214992642",Saint-Denis,93066,0.06153846153846154,7
8011,Clapeyron - Moscou,OUI,14,8,6,5,1,OUI,OUI,2025-03-13 06:59:13+00:00,"48.88078819514121, 2.324815057218075",Paris,75056,0.42857142857142855,7
11031,Jacquard - Ternaux,OUI,39,9,30,26,4,OUI,OUI,2025-03-13 07:00:34+00:00,"48.8646605, 2.373162",Paris,75056,0.7692307692307693,7
13020,Paul Klee - Place Augusta Holmes,OUI,43,35,8,4,4,OUI,OUI,2025-03-13 06:57:01+00:00,"48.838946417408025, 2.3704235663952966",Paris,75056,0.18604651162790697,7
9016,Choron - Martyrs,OUI,15,5,10,9,1,OUI,OUI,2025-03-13 07:00:10+00:00,"48.877851443503, 2.3396701365709",Paris,75056,0.6666666666666666,7
19124,Alexander Fleming - Belvédère,OUI,31,20,11,4,7,OUI,OUI,2025-03-13 07:01:05+00:00,"48.88179064200294, 2.4030599377642674",Paris,75056,0.3548387096774194,7
15131,Charles Lecocq - Lecourbe,OUI,29,6,23,20,3,OUI,OUI,2025-03-13 07:00:30+00:00,"48.84044, 2.294867",Paris,75056,0.7931034482758621,7
7010,Constantine - Université,OUI,59,45,14,12,2,OUI,OUI,2025-03-13 07:00:52+00:00,"48.860680473738, 2.3148481955842",Paris,75056,0.23728813559322035,7
15125,Parc Suzanne Lenglen,OUI,51,24,27,19,8,OUI,OUI,2025-03-13 07:00:35+00:00,"48.833250690537874, 2.2765403240919113",Paris,75056,0.5294117647058824,7
14113,Santé - Arago,OUI,37,26,11,8,3,OUI,OUI,2025-03-13 06:59:13+00:00,"48.83507657562064, 2.3415737262044938",Paris,75056,0.2972972972972973,7
13117,Stade Georges Carpentier,OUI,39,16,23,5,18,OUI,OUI,2025-03-13 06:58:44+00:00,"48.820482438381, 2.3668321967125",Paris,75056,0.5897435897435898,7
35015,Averroès - Aimé Césaire,OUI,18,13,5,5,0,OUI,OUI,2025-03-13 06:59:47+00:00,"48.91405323432864, 2.412636950612068",Pantin,93055,0.2777777777777778,7
13027,Mazagran - Pierre de Coubertin,OUI,15,14,1,1,0,OUI,OUI,2025-03-13 06:56:41+00:00,"48.816218640260445, 2.344226874411106",Paris,75056,0.06666666666666667,7
15019,Paul Barruel - Vaugirard,OUI,36,25,11,8,3,OUI,OUI,2025-03-13 06:59:32+00:00,"48.84014918546239, 2.3044332861900334",Paris,75056,0.3055555555555556,7
21118,Neuilly - Petit,OUI,15,0,15,6,9,OUI,OUI,2025-03-13 06:59:46+00:00,"48.898965361341254, 2.29627937078476",Clichy,92024,1.0,7
20203,Evariste Galois,OUI,20,19,1,0,1,OUI,OUI,2025-03-13 06:59:45+00:00,"48.873341356228, 2.4133544409574",Paris,75056,0.05,7
11103,Pelée - Alphonse Baudin,OUI,34,1,33,30,3,OUI,OUI,2025-03-13 06:59:59+00:00,"48.8600265, 2.3710541",Paris,75056,0.9705882352941176,7
7024,Rapp - Place du Général Gouraud,OUI,28,23,5,5,0,OUI,OUI,2025-03-13 07:00:25+00:00,"48.858102885107, 2.3004072904587",Paris,75056,0.17857142857142858,7
20039,Belleville - Couronnes,OUI,48,28,20,5,15,OUI,OUI,2025-03-13 06:59:19+00:00,"48.868831082877, 2.3809862136841",Paris,75056,0.4166666666666667,7
20004,Commandant l'Herminier - Gallieni,OUI,17,11,6,3,3,OUI,OUI,2025-03-13 06:59:51+00:00,"48.847040552603, 2.4160453677177",Paris,75056,0.35294117647058826,7
22013,Mairie de Neuilly sur Seine,OUI,30,17,13,12,1,OUI,OUI,2025-03-13 07:01:03+00:00,"48.88494728765838, 2.2677031159400944",Neuilly-sur-Seine,92051,0.43333333333333335,7
12150,Bastille - Quai de la Rapée,OUI,27,4,23,21,2,OUI,OUI,2025-03-13 07:00:57+00:00,"48.84682410855, 2.3669364675879",Paris,75056,0.8518518518518519,7
21316,Cimetière d'Issy-les-Moulineaux,OUI,23,22,1,0,1,OUI,OUI,2025-03-13 06:59:16+00:00,"48.817699773925, 2.2609312087297",Issy-les-Moulineaux,92040,0.043478260869565216,7
12125,Pyramide - Parc Floral,OUI,49,41,8,1,7,OUI,OUI,2025-03-13 06:57:10+00:00,"48.837442, 2.440452",Paris,75056,0.16326530612244897,7
19025,Botzaris - Crimée,OUI,20,12,8,2,6,OUI,OUI,2025-03-13 06:59:04+00:00,"48.87959698690176, 2.3887913337477067",Paris,75056,0.4,7
13515,Auguste Blanqui - Glacière,OUI,58,44,14,11,3,OUI,OUI,2025-03-13 07:00:57+00:00,"48.831151602964, 2.343822196126",Paris,75056,0.2413793103448276,7
16009,Saint-Didier - Raymond Poincaré,OUI,17,16,1,1,0,OUI,OUI,2025-03-13 07:00:36+00:00,"48.86642312020962, 2.285863497192411",Paris,75056,0.058823529411764705,7
10152,Gare du Nord - Place de Valenciennes,OUI,24,19,5,1,4,OUI,OUI,2025-03-13 07:01:03+00:00,"48.879089, 2.354235",Paris,75056,0.20833333333333334,7
21029,Cours de l'Ile Seguin - Parc Billancourt,OUI,28,14,14,6,8,OUI,OUI,2025-03-13 07:00:33+00:00,"48.82714055843935, 2.234234511852265",Boulogne-Billancourt,92012,0.5,7
10037,Quai de Valmy,OUI,26,20,6,3,3,OUI,OUI,2025-03-13 07:00:48+00:00,"48.88126951579429, 2.368186041712761",Paris,75056,0.23076923076923078,7
16003,André Maurois - Joseph et Marie Hackin,OUI,27,15,12,9,3,OUI,OUI,2025-03-13 06:58:15+00:00,"48.8778983, 2.2789591",Paris,75056,0.4444444444444444,7
9036,Athènes - Clichy,OUI,18,15,3,0,3,OUI,OUI,2025-03-13 07:00:58+00:00,"48.878113787876, 2.32956021945824",Paris,75056,0.16666666666666666,7
15072,Place Fernand Forest,OUI,29,2,27,20,7,OUI,OUI,2025-03-13 07:01:03+00:00,"48.849269143836, 2.281863167882",Paris,75056,0.9310344827586207,7
17029,Pierre Demours - Laugier,OUI,36,26,10,8,2,OUI,OUI,2025-03-13 06:59:42+00:00,"48.8813072, 2.294846",Paris,75056,0.2777777777777778,7
16014,Eylau - Trocadéro,OUI,22,18,4,3,1,OUI,OUI,2025-03-13 07:00:15+00:00,"48.863354122371, 2.2864209115505",Paris,75056,0.18181818181818182,7
10004,Metz - Faubourg Saint-Denis,OUI,44,24,20,17,3,OUI,OUI,2025-03-13 06:59:55+00:00,"48.870893, 2.353521",Paris,75056,0.45454545454545453,7
16007,Longchamp - Place d'Iéna,OUI,25,22,3,1,2,OUI,OUI,2025-03-13 06:59:38+00:00,"48.864917233434, 2.2926748171449",Paris,75056,0.12,7
21203,Place Jules Ferry,OUI,28,26,2,1,1,OUI,OUI,2025-03-13 06:54:01+00:00,"48.812107928414775, 2.325837314128876",Montrouge,92049,0.07142857142857142,7
21708,Marcel Yol - Jullien,OUI,29,0,29,7,22,OUI,OUI,2025-03-13 07:00:38+00:00,"48.82537611802588, 2.287235018058929",Vanves,92075,1.0,7
5034,Censier - Santeuil,OUI,63,37,26,23,3,OUI,OUI,2025-03-13 07:00:40+00:00,"48.840658921385234, 2.3537524044513702",Paris,75056,0.4126984126984127,7
21702,Gare SNCF Vanves-Malakoff,OUI,49,47,2,1,1,OUI,OUI,2025-03-13 07:00:00+00:00,"48.819002163836444, 2.292150005103606",Vanves,92075,0.04081632653061224,7
10017,Gare de l'Est - Fidélité,OUI,14,8,6,6,0,OUI,OUI,2025-03-13 06:56:02+00:00,"48.874575, 2.356796",Paris,75056,0.42857142857142855,7
11109,Pierre Levée - Fontaine Timbaud,OUI,22,13,9,6,3,OUI,OUI,2025-03-13 06:59:20+00:00,"48.86632723374305, 2.3711163550615306",Paris,75056,0.4090909090909091,7
10153,Gare du Nord - Denain,OUI,20,12,8,1,7,OUI,OUI,2025-03-13 07:00:13+00:00,"48.879595787608, 2.3544725775719",Paris,75056,0.4,7
15052,Convention - Vaugirard,OUI,45,12,33,24,9,OUI,OUI,2025-03-13 07:01:00+00:00,"48.83767682233156, 2.295586926020252",Paris,75056,0.7333333333333333,7
12006,Gare de Lyon - Van Gogh,OUI,41,24,17,13,4,OUI,OUI,2025-03-13 07:00:12+00:00,"48.843839785643, 2.3704450240357",Paris,75056,0.4146341463414634,7
31021,Résistance - Hoche,OUI,28,28,0,0,0,OUI,OUI,2025-03-13 06:55:07+00:00,"48.864273423741956, 2.435784414410591",Montreuil,93048,0.0,7
10110,Louis Blanc - Jemmapes,OUI,31,16,15,6,9,OUI,OUI,2025-03-13 07:00:41+00:00,"48.879330755297, 2.3684485629201",Paris,75056,0.4838709677419355,7
44002,Paul Vaillant-Couturier - Gare RER,OUI,25,1,24,18,6,OUI,OUI,2025-03-13 07:00:52+00:00,"48.80108159069614, 2.402097210288048",Vitry-sur-Seine,94081,0.96,7
21115,Chancé Milly - Cimetière Communal Sud,OUI,32,8,24,23,1,OUI,OUI,2025-03-13 07:00:56+00:00,"48.89687189382465, 2.303922325372696",Clichy,92024,0.75,7
16115,Raffet - Montmorency,OUI,39,36,3,1,2,OUI,OUI,2025-03-13 07:00:58+00:00,"48.85258670812, 2.2629252456151954",Paris,75056,0.07692307692307693,7
13048,Wurtz - Tolbiac,OUI,28,28,0,0,0,NON,NON,2025-03-13 06:57:09+00:00,"48.82631195621, 2.344585955143",Paris,75056,0.0,7
15123,Commerce - Letellier,OUI,42,25,17,15,2,OUI,OUI,2025-03-13 06:59:23+00:00,"48.84797660373612, 2.2966245196598805",Paris,75056,0.40476190476190477,7
41210,Hôtel de ville de Fontenay-sous-Bois,OUI,19,17,2,0,2,OUI,OUI,2025-03-13 06:49:19+00:00,"48.84949749106274, 2.4750164151191716",Fontenay-sous-Bois,94033,0.10526315789473684,7
21030,Fessart - Château,OUI,20,1,19,19,0,OUI,OUI,2025-03-13 07:00:26+00:00,"48.84245, 2.23989",Boulogne-Billancourt,92012,0.95,7
42304,Marc Sangnier - Division Leclerc,OUI,21,2,19,15,4,OUI,OUI,2025-03-13 07:00:40+00:00,"48.78599652305309, 2.329955510795116",Cachan,94016,0.9047619047619048,7
16024,Ranelagh - Maison de la Radio,OUI,20,3,17,11,6,OUI,OUI,2025-03-13 06:59:52+00:00,"48.85293603169479, 2.280449643731117",Paris,75056,0.85,7
13039,Ivry - Simone Weil,OUI,18,16,2,2,0,OUI,OUI,2025-03-13 06:56:33+00:00,"48.823283932030755, 2.3659095168113713",Paris,75056,0.1111111111111111,7
15043,Brancion - Lefebvre,OUI,9,9,0,0,0,OUI,OUI,2025-03-13 06:55:05+00:00,"48.82900222785569, 2.301431038163409",Paris,75056,0.0,7
21031,Cimetière de Boulogne-Billancourt,OUI,40,14,26,24,2,OUI,OUI,2025-03-13 06:59:41+00:00,"48.830764, 2.252024",Boulogne-Billancourt,92012,0.65,7
17039,Place Saint-Ferdinand,OUI,38,33,5,3,2,OUI,OUI,2025-03-13 06:57:32+00:00,"48.87815529789739, 2.288518047864942",Paris,75056,0.13157894736842105,7
20009,Docteurs Déjérine - Pte de Montreuil,OUI,19,18,1,0,1,OUI,OUI,2025-03-13 06:59:13+00:00,"48.85398448133697, 2.41208288897222",Paris,75056,0.05263157894736842,7
22604,Hôtel de Ville de Fontenay-aux-Roses,OUI,32,31,1,1,0,OUI,OUI,2025-03-13 06:58:52+00:00,"48.790844603480856, 2.2871455930319455",Fontenay-aux-Roses,92032,0.03125,7
11032,Jean-Pierre Timbaud - Vaucouleurs,OUI,43,20,23,17,6,OUI,OUI,2025-03-13 07:00:12+00:00,"48.867937, 2.377885",Paris,75056,0.5348837209302325,7
42305,Vanne - Saussaies,OUI,20,13,7,1,6,OUI,OUI,2025-03-13 06:58:58+00:00,"48.786404, 2.338848",Cachan,94016,0.35,7
21955,Vaugirard - Verrerie,OUI,24,2,22,18,4,OUI,OUI,2025-03-13 06:57:53+00:00,"48.820881336842, 2.2367222622987",Meudon,92048,0.9166666666666666,7
8001,Petit Palais,OUI,42,35,7,4,3,OUI,OUI,2025-03-13 06:56:07+00:00,"48.8667692, 2.3157655",Paris,75056,0.16666666666666666,7
16101,Malakoff - Place de la Porte Maillot,OUI,26,24,2,2,0,OUI,OUI,2025-03-13 06:52:04+00:00,"48.876733496638, 2.2834577411413",Paris,75056,0.07692307692307693,7
13121,Bruneseau - Quai d'Ivry,OUI,46,3,43,39,4,OUI,OUI,2025-03-13 07:00:10+00:00,"48.824945637583, 2.3885661363602",Ivry-sur-Seine,94041,0.9347826086956522,7
10012,Vinaigriers - Magenta,OUI,24,10,14,12,2,OUI,OUI,2025-03-13 06:59:39+00:00,"48.8731167, 2.3593052",Paris,75056,0.5833333333333334,7
21307,Victor Cresson - Telles de la Poterie,OUI,28,2,26,23,3,OUI,OUI,2025-03-13 06:58:37+00:00,"48.822698842979, 2.2686498274964",Issy-les-Moulineaux,92040,0.9285714285714286,7
21028,Pierre Lefaucheux - Traversière,OUI,34,16,18,17,1,OUI,OUI,2025-03-13 07:00:48+00:00,"48.82435208303827, 2.2417913004755974",Boulogne-Billancourt,92012,0.5294117647058824,7
4003,Quai aux Fleurs - Pont Saint-Louis,OUI,17,5,12,12,0,OUI,OUI,2025-03-13 07:00:57+00:00,"48.852915956209, 2.3521957173944",Paris,75056,0.7058823529411765,7
13011,Hôpital - Campo-Formio,OUI,11,7,4,1,3,OUI,OUI,2025-03-13 06:56:53+00:00,"48.835405, 2.358218",Paris,75056,0.36363636363636365,7
10018,Square Alban Satragne,OUI,28,24,4,3,1,OUI,OUI,2025-03-13 06:58:30+00:00,"48.875388227727, 2.3559567333359",Paris,75056,0.14285714285714285,7
31025,Paul Signac - Aristide Briand,OUI,33,33,0,0,0,OUI,OUI,2025-03-13 07:00:57+00:00,"48.86950262156371, 2.4502260982990265",Montreuil,93048,0.0,7
32301,Mairie de Romainville,OUI,17,16,1,0,1,OUI,OUI,2025-03-13 06:56:44+00:00,"48.885109, 2.435679",Romainville,93063,0.058823529411764705,7
5014,Jean Calvin - Tournefort,OUI,28,22,6,5,1,OUI,OUI,2025-03-13 07:00:58+00:00,"48.84158856925782, 2.348489575088024",Paris,75056,0.21428571428571427,7
20108,Jardin de l'Hospice Debrousse,OUI,23,20,3,1,2,OUI,OUI,2025-03-13 06:59:34+00:00,"48.861451061938, 2.40568600595",Paris,75056,0.13043478260869565,7
23902,Gallieni - Lycée Charles Petitet,OUI,44,20,24,14,10,OUI,OUI,2025-03-13 06:59:30+00:00,"48.927640283627, 2.3308986340524",Villeneuve-la-Garenne,92078,0.5454545454545454,7
21219,Amaury Duval - Gabriel Péri,OUI,36,31,5,2,3,OUI,OUI,2025-03-13 06:56:15+00:00,"48.81718759671675, 2.323841750621796",Montrouge,92049,0.1388888888888889,7
14101,Gare Montparnasse - Edgar Quinet,OUI,33,22,11,8,3,OUI,OUI,2025-03-13 06:59:07+00:00,"48.841487851079, 2.3233232282801",Paris,75056,0.3333333333333333,7
8549,George V - Christophe Colomb,OUI,22,17,5,0,5,OUI,OUI,2025-03-13 06:58:53+00:00,"48.87046, 2.30104",Paris,75056,0.22727272727272727,7
8020,Batignolles - Beudant,OUI,43,33,10,0,10,OUI,OUI,2025-03-13 07:00:59+00:00,"48.88216401466375, 2.319852970540523",Paris,75056,0.23255813953488372,7
20007,Buzenval - Avron,OUI,49,47,2,2,0,OUI,OUI,2025-03-13 06:57:44+00:00,"48.851617204999, 2.4015135973077",Paris,75056,0.04081632653061224,7
17015,Place de Lévis,OUI,47,37,10,2,8,OUI,OUI,2025-03-13 07:00:15+00:00,"48.883546851533254, 2.3131933808326726",Paris,75056,0.2127659574468085,7
13033,Porte d'Italie,OUI,13,11,2,1,1,OUI,OUI,2025-03-13 06:59:47+00:00,"48.817161987718954, 2.360236309468746",Paris,75056,0.15384615384615385,7
42003,Place de l'Insurrection d'Août 1944,OUI,30,9,21,20,1,OUI,OUI,2025-03-13 07:00:54+00:00,"48.81477852751594, 2.398074567317963",Ivry-sur-Seine,94041,0.7,7
42701,Charles Gide - Fort de Bicêtre,OUI,29,4,25,4,21,OUI,OUI,2025-03-13 06:58:46+00:00,"48.8071937956922, 2.353984415531159",Le Kremlin-Bicêtre,94043,0.8620689655172413,7
4001,Arcole - Notre-Dame,OUI,27,20,7,2,5,OUI,OUI,2025-03-13 06:58:52+00:00,"48.853883541328, 2.3493797332048",Paris,75056,0.25925925925925924,7
20122,Vitruve - Davout,OUI,23,21,2,0,2,OUI,OUI,2025-03-13 07:00:03+00:00,"48.86053161154489, 2.4091592812626543",Paris,75056,0.08695652173913043,7
12043,Daumesnil - Hébrard,OUI,39,10,29,26,3,OUI,OUI,2025-03-13 07:00:47+00:00,"48.8429, 2.38474",Paris,75056,0.7435897435897436,7
16020,Place de la Porte de Passy,OUI,34,28,6,4,2,OUI,OUI,2025-03-13 07:00:27+00:00,"48.857341095470794, 2.2644165538827115",Paris,75056,0.17647058823529413,7
17023,Porte d'Asnières,OUI,34,23,11,5,6,OUI,OUI,2025-03-13 06:59:22+00:00,"48.89035817610495, 2.3036286234855656",Paris,75056,0.3235294117647059,7
13126,Place Nationale - Château-des-Rentiers,OUI,17,10,7,6,1,OUI,OUI,2025-03-13 06:58:23+00:00,"48.829268, 2.365212",Paris,75056,0.4117647058823529,7
44007,Camille Groult - Guy Môquet,OUI,21,5,16,13,3,OUI,OUI,2025-03-13 07:00:18+00:00,"48.787482746521306, 2.3976725712418556",Vitry-sur-Seine,94081,0.7619047619047619,7
15023,La Motte-Picquet - Grenelle,OUI,31,6,25,24,1,OUI,OUI,2025-03-13 06:59:22+00:00,"48.84858321339195, 2.299347817897797",Paris,75056,0.8064516129032258,7
10105,Mazagran - Bonne Nouvelle,OUI,25,15,10,10,0,OUI,OUI,2025-03-13 07:00:17+00:00,"48.870047123655, 2.3511248454452",Paris,75056,0.4,7
22501,Théâtre de La Garenne,OUI,20,14,6,4,2,OUI,OUI,2025-03-13 06:59:56+00:00,"48.905658361454, 2.2345951981176",La Garenne-Colombes,92035,0.3,7
17003,Jacques Kellner - Saint-Ouen,OUI,43,36,7,5,2,OUI,OUI,2025-03-13 06:55:35+00:00,"48.895809485802886, 2.327897409164145",Paris,75056,0.16279069767441862,7
40009,Lycée Saint Exupéry - Juliette Savar,OUI,29,18,11,8,3,OUI,OUI,2025-03-13 06:56:22+00:00,"48.783021513972, 2.4637357216879",Créteil,94028,0.3793103448275862,7
42501,Raspail - Albert Schweitzer,OUI,27,8,19,17,2,OUI,OUI,2025-03-13 06:59:12+00:00,"48.81031545, 2.34395871",Gentilly,94037,0.7037037037037037,7
6008,Assas - Luxembourg,OUI,33,25,8,3,5,OUI,OUI,2025-03-13 07:00:17+00:00,"48.843734468779, 2.3334283818759",Paris,75056,0.24242424242424243,7
23003,Président Wilson - Baudin,OUI,27,18,9,6,3,OUI,OUI,2025-03-13 07:00:57+00:00,"48.89826887103676, 2.2849336266517644",Levallois-Perret,92044,0.3333333333333333,7
21204,Estienne d'Orves - Henri Ginoux,OUI,31,27,4,1,3,OUI,OUI,2025-03-13 06:57:01+00:00,"48.815388220397274, 2.320886790760933",Montrouge,92049,0.12903225806451613,7
14131,Jourdan - Monticelli,OUI,30,13,17,3,14,OUI,OUI,2025-03-13 07:00:28+00:00,"48.822032, 2.329095",Paris,75056,0.5666666666666667,7
21217,Louis Rolland - République,OUI,26,12,14,4,10,OUI,OUI,2025-03-13 06:57:24+00:00,"48.81710889740748, 2.3193106434955717",Montrouge,92049,0.5384615384615384,7
19108,Gaston Tessier - Rosa Parks RER,OUI,37,22,15,9,6,OUI,OUI,2025-03-13 06:58:01+00:00,"48.8963765, 2.3743692",Paris,75056,0.40540540540540543,7
15030,Emeriau - Beaugrenelle,OUI,70,15,55,53,2,OUI,OUI,2025-03-13 06:59:09+00:00,"48.84791249714942, 2.2843059897422795",Paris,75056,0.7857142857142857,7
4002,Marché aux fleurs,OUI,18,14,4,3,1,OUI,OUI,2025-03-13 07:00:50+00:00,"48.855258115391, 2.3473754525185",Paris,75056,0.2222222222222222,7
16011,Victor Hugo - La Pompe,OUI,40,23,17,2,15,OUI,OUI,2025-03-13 07:00:47+00:00,"48.86795222470859, 2.28146318346262",Paris,75056,0.425,7
13109,Brillat-Savarin - Küss,OUI,19,9,10,5,5,OUI,OUI,2025-03-13 07:00:50+00:00,"48.822203, 2.350422",Paris,75056,0.5263157894736842,7
25001,Colmar - Victor Hugo,OUI,29,19,10,7,3,OUI,OUI,2025-03-13 06:56:53+00:00,"48.88652251096166, 2.173960916697979",Rueil-Malmaison,92063,0.3448275862068966,7
42209,Place de l'Europe - Quai de Bercy,OUI,14,2,12,8,4,OUI,OUI,2025-03-13 06:58:02+00:00,"48.82529858840266, 2.3945679143071175",Charenton-le-Pont,94018,0.8571428571428571,7
47001,Place de la Gare,OUI,45,2,43,37,6,OUI,OUI,2025-03-13 07:00:49+00:00,"48.80253358011283, 2.4275037646293645",Maisons-Alfort,94046,0.9555555555555556,7
43001,Paris - Laitières,OUI,22,15,7,1,6,OUI,OUI,2025-03-13 06:53:25+00:00,"48.84630274151258, 2.4207553267478947",Vincennes,94080,0.3181818181818182,7
13032,Italie - Jardin Joan Miro,OUI,24,19,5,0,5,OUI,OUI,2025-03-13 06:59:47+00:00,"48.81990914045756, 2.3592948541045193",Paris,75056,0.20833333333333334,7
22206,Louis Pasteur - Albert Petit,OUI,30,30,0,0,0,OUI,OUI,2025-03-13 06:59:55+00:00,"48.796261, 2.317289",Bagneux,92007,0.0,7
15064,Javel - André Citroën,OUI,44,5,39,34,5,OUI,OUI,2025-03-13 06:57:11+00:00,"48.846276485475, 2.2786368057132",Paris,75056,0.8863636363636364,7
11021,Charonne - Pierre Bayle,OUI,23,12,11,6,5,OUI,OUI,2025-03-13 06:58:27+00:00,"48.858445054262, 2.3903981223891",Paris,75056,0.4782608695652174,7
14010,Jean Moulin - Place Victor et Hélène Basch,OUI,37,34,3,0,3,OUI,OUI,2025-03-13 07:01:03+00:00,"48.82764910241, 2.3261967301369",Paris,75056,0.08108108108108109,7
9114,Faubourg Poissonnière - Dunkerque,OUI,30,22,8,3,5,OUI,OUI,2025-03-13 06:59:34+00:00,"48.880883445404436, 2.349934279918671",Paris,75056,0.26666666666666666,7
13128,Quai de la Gare - Pont de Bercy,OUI,29,7,22,18,4,OUI,OUI,2025-03-13 06:58:32+00:00,"48.83730787972, 2.3740861260598",Paris,75056,0.7586206896551724,7
12007,Gare de Lyon - Chalon,OUI,45,27,18,13,5,OUI,OUI,2025-03-13 06:58:39+00:00,"48.845666194202, 2.3741452395916",Paris,75056,0.4,7
15057,Lucien Bossoutrot - Général Martial Vallin,OUI,38,17,21,10,11,OUI,OUI,2025-03-13 06:58:44+00:00,"48.836956046311, 2.2741072252393",Paris,75056,0.5526315789473685,7
35007,Benjamin Delessert - Jean Lolive,OUI,20,17,3,0,3,OUI,OUI,2025-03-13 06:56:36+00:00,"48.89392043619345, 2.417981922626496",Pantin,93055,0.15,7
16002,Pergolèse - Malakoff,OUI,37,35,2,0,2,OUI,OUI,2025-03-13 07:00:41+00:00,"48.87521088779225, 2.2842781618237495",Paris,75056,0.05405405405405406,7
44101,Place Mongolfier,OUI,37,16,21,11,10,OUI,OUI,2025-03-13 06:59:31+00:00,"48.815160030060376, 2.4592879414558415",Saint-Maurice,94069,0.5675675675675675,7
23010,Voltaire - Anatole France,OUI,25,22,3,1,2,OUI,OUI,2025-03-13 06:58:05+00:00,"48.891999360256904, 2.284262739121914",Levallois-Perret,92044,0.12,7
10165,Gare de l'Est - Place du 11 Novembre 1918,OUI,39,30,9,8,1,OUI,OUI,2025-03-13 07:00:27+00:00,"48.876327, 2.3585464",Paris,75056,0.23076923076923078,7
21401,Mairie de Clamart,OUI,31,29,2,0,2,OUI,OUI,2025-03-13 06:58:12+00:00,"48.800612, 2.262151",Clamart,92023,0.06451612903225806,7
22303,Lucien Lanternier - Le Luth,OUI,26,9,17,12,5,OUI,OUI,2025-03-13 07:00:26+00:00,"48.93159430558871, 2.2889783978462224",Gennevilliers,92036,0.6538461538461539,7
13044,Place Jeanne d'Arc,OUI,36,27,9,4,5,OUI,OUI,2025-03-13 07:01:05+00:00,"48.829575, 2.369126",Paris,75056,0.25,7
92001,Mairie de quartier du Plateau - Mont-Valérien,OUI,20,7,13,4,9,OUI,OUI,2025-03-13 06:53:56+00:00,"48.8799933, 2.2072437",Nanterre,92050,0.65,7
43010,La Jarry - Place Diderot,OUI,25,13,12,6,6,OUI,OUI,2025-03-13 06:56:52+00:00,"48.849726940367326, 2.452013790607453",Vincennes,94080,0.48,7
23004,Paul Vaillant-Couturier - Victor Hugo,OUI,33,14,19,16,3,OUI,OUI,2025-03-13 06:59:27+00:00,"48.89819702263572, 2.293848017974069",Levallois-Perret,92044,0.5757575757575758,7
17107,Berthier - Place Stuart Merril,OUI,36,20,16,12,4,OUI,OUI,2025-03-13 07:00:05+00:00,"48.885927922355044, 2.2933450341224675",Paris,75056,0.4444444444444444,7
21306,Place Lafayette,OUI,61,36,25,16,9,OUI,OUI,2025-03-13 06:59:57+00:00,"48.829654975522, 2.2638675570488",Issy-les-Moulineaux,92040,0.4098360655737705,7
15004,Vaugirard - Pasteur,OUI,21,4,17,17,0,OUI,OUI,2025-03-13 06:58:44+00:00,"48.84040868803496, 2.3154367133975033",Paris,75056,0.8095238095238095,7
33015,Charles Tillon - Cimetière Communal,OUI,26,1,25,7,18,OUI,OUI,2025-03-13 06:59:35+00:00,"48.91844023641836, 2.3935630917549138",Aubervilliers,93001,0.9615384615384616,7
6027,Blaise-Desgoffe - Vaugirard,OUI,31,8,23,4,19,OUI,OUI,2025-03-13 07:00:57+00:00,"48.846128877747, 2.3242672160268",Paris,75056,0.7419354838709677,7
7017,La Motte-Picquet - La Tour Maubourg,OUI,39,17,22,21,1,OUI,OUI,2025-03-13 07:00:01+00:00,"48.856926701847, 2.3096215831203",Paris,75056,0.5641025641025641,7
18007,Goutte d'or - Barbès,OUI,20,8,12,8,4,OUI,OUI,2025-03-13 06:57:09+00:00,"48.885124323627, 2.3496962338686",Paris,75056,0.6,7
15311,Quai du Président Roosevelt - Pont Aval,OUI,30,15,15,14,1,OUI,OUI,2025-03-13 06:57:18+00:00,"48.8343883676388, 2.2656820714473724",Paris,75056,0.5,7
19128,Quai de l'Oise - Aisne,OUI,28,14,14,3,11,OUI,OUI,2025-03-13 06:59:28+00:00,"48.8906231, 2.3833701",Paris,75056,0.5,7
41205,Maréchal Joffre - Verdun,OUI,20,20,0,0,0,OUI,OUI,2025-03-13 06:58:36+00:00,"48.85385, 2.470307",Fontenay-sous-Bois,94033,0.0,7
15005,Place Jacques et Thérèse Tréfouël,OUI,41,9,32,24,8,OUI,OUI,2025-03-13 07:00:24+00:00,"48.842726498317, 2.3125657439232",Paris,75056,0.7804878048780488,7
22015,Île de la Jatte,OUI,23,22,1,0,1,OUI,OUI,2025-03-13 06:57:42+00:00,"48.894036161302104, 2.2666339203715324",Neuilly-sur-Seine,92051,0.043478260869565216,7
18006,Square Louise Michel,OUI,35,31,4,0,4,OUI,OUI,2025-03-13 06:59:21+00:00,"48.884687354509, 2.3441386967897",Paris,75056,0.11428571428571428,7
44016,Balzac - Olympes de Gouges,OUI,28,10,18,8,10,OUI,OUI,2025-03-13 06:55:47+00:00,"48.77850332486751, 2.4006786569952965",Vitry-sur-Seine,94081,0.6428571428571429,7
9027,Douai - Pierre Fontaine,OUI,23,20,3,2,1,OUI,OUI,2025-03-13 07:00:29+00:00,"48.88229101148092, 2.33324121683836",Paris,75056,0.13043478260869565,7
44005,Place Saint-Just,OUI,19,9,10,7,3,OUI,OUI,2025-03-13 06:55:09+00:00,"48.790379518724265, 2.3895226791501045",Vitry-sur-Seine,94081,0.5263157894736842,7
17108,Bessières - Porte de Clichy,OUI,29,16,13,10,3,OUI,OUI,2025-03-13 07:01:06+00:00,"48.89611762451474, 2.31790903955698",Paris,75056,0.4482758620689655,7
9004,Gérando - Rochechouart,OUI,21,13,8,1,7,OUI,OUI,2025-03-13 07:00:23+00:00,"48.88294340845, 2.3464846238494",Paris,75056,0.38095238095238093,7
4020,Place Edmond Michelet,OUI,23,18,5,5,0,OUI,OUI,2025-03-13 06:55:26+00:00,"48.860134890542, 2.3500636965036",Paris,75056,0.21739130434782608,7
32601,Porte des Lilas - Faidherbe,OUI,39,24,15,6,9,OUI,OUI,2025-03-13 07:00:58+00:00,"48.87861855668978, 2.4120327830314636",Les Lilas,93045,0.38461538461538464,7
15022,Emile Zola - Fondary,OUI,39,9,30,29,1,OUI,OUI,2025-03-13 07:00:12+00:00,"48.847051143113745, 2.2953405976295476",Paris,75056,0.7692307692307693,7
33016,Fort d'Aubervilliers,OUI,20,8,12,11,1,OUI,OUI,2025-03-13 06:54:43+00:00,"48.91502382370325, 2.4035281687974925",Aubervilliers,93001,0.6,7
22408,Place du 14 Juillet,OUI,22,22,0,0,0,OUI,OUI,2025-03-13 06:58:33+00:00,"48.819266959525, 2.3011998832226",Malakoff,92046,0.0,7
12026,Place Ginette Hamelin,OUI,50,28,22,20,2,OUI,OUI,2025-03-13 06:58:58+00:00,"48.837853, 2.382064",Paris,75056,0.44,7
5012,Estrapade - Ulm,OUI,16,15,1,0,1,OUI,OUI,2025-03-13 06:58:49+00:00,"48.84512772828, 2.3454568170362",Paris,75056,0.0625,7
10162,Alexandre Parodi - Quai de Valmy,OUI,23,17,6,3,3,OUI,OUI,2025-03-13 06:58:48+00:00,"48.879359419425, 2.3665961623192",Paris,75056,0.2608695652173913,7
8037,Monceau - Malesherbes,OUI,37,27,10,5,5,OUI,OUI,2025-03-13 06:58:38+00:00,"48.8795079, 2.3145456",Paris,75056,0.2702702702702703,7
6012,Saint-Germain - Ciseaux,OUI,16,15,1,1,0,OUI,OUI,2025-03-13 07:00:18+00:00,"48.853305277595, 2.3344654618827",Paris,75056,0.0625,7
11017,Charonne - Bureau,OUI,44,41,3,1,2,OUI,OUI,2025-03-13 07:00:15+00:00,"48.854176, 2.396093",Paris,75056,0.06818181818181818,7
27005,Gare du Stade,OUI,18,12,6,1,5,OUI,OUI,2025-03-13 06:53:34+00:00,"48.9312676, 2.2603778",Colombes,92025,0.3333333333333333,7
1021,Halles - Bourdonnais,OUI,19,8,11,7,4,OUI,OUI,2025-03-13 07:00:35+00:00,"48.860448992575, 2.3460162431002",Paris,75056,0.5789473684210527,7
15071,Suffren - Champ de Mars,OUI,21,6,15,13,2,OUI,OUI,2025-03-13 07:00:52+00:00,"48.8547194, 2.2952168",Paris,75056,0.7142857142857143,7
35006,Delizy - Louis Nadot,OUI,21,20,1,0,1,OUI,OUI,2025-03-13 06:58:11+00:00,"48.896212845581346, 2.4094578623771667",Pantin,93055,0.047619047619047616,7
9024,Taitbout - La Fayette,OUI,51,45,6,3,3,OUI,OUI,2025-03-13 06:58:43+00:00,"48.8733298892, 2.3352625966072",Paris,75056,0.11764705882352941,7
12018,Saint-Mandé - Fabre d'Eglantine,OUI,33,23,10,7,3,OUI,OUI,2025-03-13 06:59:24+00:00,"48.8453579, 2.3965022",Paris,75056,0.30303030303030304,7
8201,Arsène Houssaye - Friedland,OUI,29,27,2,0,2,OUI,OUI,2025-03-13 06:52:46+00:00,"48.874510616163, 2.2994716674148",Paris,75056,0.06896551724137931,7
17119,Toqueville - Cardinet,OUI,31,27,4,3,1,OUI,OUI,2025-03-13 06:59:54+00:00,"48.88490187110713, 2.3109393194317818",Paris,75056,0.12903225806451613,7
17111,Lemercier - Cardinet,OUI,23,13,10,5,5,OUI,OUI,2025-03-13 07:00:42+00:00,"48.890097168851746, 2.317377626895905",Paris,75056,0.43478260869565216,7
15011,Cambronne - Villa Croix Nivert,OUI,62,26,36,35,1,OUI,OUI,2025-03-13 06:59:47+00:00,"48.845847561366, 2.3017574474216",Paris,75056,0.5806451612903226,7
18030,Joseph Dijon - Ornano,OUI,37,32,5,4,1,OUI,OUI,2025-03-13 06:59:34+00:00,"48.89374453351521, 2.3476678133010864",Paris,75056,0.13513513513513514,7
51002,Placette Grégoire Collas,OUI,25,14,11,5,6,OUI,OUI,2025-03-13 07:01:05+00:00,"48.94342014002797, 2.2487476095557213",Argenteuil,95018,0.44,7
5024,Place Monge,OUI,21,20,1,0,1,OUI,OUI,2025-03-13 06:57:25+00:00,"48.842761803051, 2.3524079471827",Paris,75056,0.047619047619047616,7
13009,Auguste Blanqui - Corvisart,OUI,26,7,19,7,12,OUI,OUI,2025-03-13 07:00:04+00:00,"48.8300989, 2.3502726",Paris,75056,0.7307692307692307,7
31005,Square Denise Buisson,OUI,45,37,8,4,4,OUI,OUI,2025-03-13 06:57:07+00:00,"48.8562322730982, 2.426436245441437",Montreuil,93048,0.17777777777777778,7
21319,Esplanade du Foncet - Camille Desmoulins,OUI,27,3,24,20,4,OUI,OUI,2025-03-13 07:00:36+00:00,"48.827090233494964, 2.2606857866048813",Issy-les-Moulineaux,92040,0.8888888888888888,7
21314,Chemin de Bretagne,OUI,28,8,20,13,7,OUI,OUI,2025-03-13 07:01:02+00:00,"48.824753068884, 2.2588385956052",Issy-les-Moulineaux,92040,0.7142857142857143,7
9102,Londres - Place d'Estienne d'Orves,OUI,24,21,3,1,2,OUI,OUI,2025-03-13 06:57:46+00:00,"48.876693805756986, 2.3305362090468407",Paris,75056,0.125,7
12005,Crozatier - Faubourg Saint-Antoine,OUI,40,7,33,32,1,OUI,OUI,2025-03-13 06:59:02+00:00,"48.850440013405, 2.378901366211",Paris,75056,0.825,7
9006,Dunkerque - Trudaine,OUI,16,12,4,0,4,OUI,OUI,2025-03-13 06:58:04+00:00,"48.88215166773376, 2.3463253676891327",Paris,75056,0.25,7
13516,Glacière - Soeur Catherine Marie,OUI,40,23,17,15,2,OUI,OUI,2025-03-13 06:59:26+00:00,"48.829522989420596, 2.343570403754711",Paris,75056,0.425,7
8116,Champs-Elysees - Bassano,OUI,25,25,0,0,0,NON,NON,2021-02-21 19:09:18+00:00,"48.871811807816, 2.300238981843",Paris,75056,0.0,19
12155,Rottembourg - Général Michel Bizot,OUI,43,8,35,31,4,OUI,OUI,2025-03-13 07:00:37+00:00,"48.83787825992554, 2.4044052511453633",Paris,75056,0.813953488372093,7
92006,Place Nelson Mandela,OUI,30,29,1,0,1,OUI,OUI,2025-03-13 06:55:50+00:00,"48.897874318180556, 2.2182820737361912",Nanterre,92050,0.03333333333333333,7
10021,Marché Saint-Quentin,OUI,14,12,2,0,2,OUI,OUI,2025-03-13 06:58:23+00:00,"48.877356057652, 2.3545114456374",Paris,75056,0.14285714285714285,7
12038,Picpus - Louis Braille,OUI,43,38,5,4,1,OUI,OUI,2025-03-13 07:00:14+00:00,"48.839988788912, 2.4005256685521",Paris,75056,0.11627906976744186,7
5115,Buffon - Jardin des Plantes,OUI,28,11,17,17,0,OUI,OUI,2025-03-13 06:56:53+00:00,"48.842668466104875, 2.3618587106466293",Paris,75056,0.6071428571428571,7
9011,Geoffroy - Marie,OUI,18,12,6,5,1,OUI,OUI,2025-03-13 06:57:21+00:00,"48.873781940593325, 2.344513876337893",Paris,75056,0.3333333333333333,7
44011,Lebrun - Colonel Fabien,OUI,27,23,4,2,2,OUI,OUI,2025-03-13 06:58:54+00:00,"48.78266870733145, 2.381317801773548",Vitry-sur-Seine,94081,0.14814814814814814,7
12028,Vivaldi - Antoine-Julien Hénard,OUI,27,12,15,9,6,OUI,OUI,2025-03-13 07:01:02+00:00,"48.841923663276546, 2.389728979467376",Paris,75056,0.5555555555555556,7
2108,Vivienne - Montmartre,OUI,37,28,9,3,6,OUI,OUI,2025-03-13 07:00:42+00:00,"48.871347597383, 2.3414588347077",Paris,75056,0.24324324324324326,7
9034,Godot de Mauroy - Madeleine,OUI,21,17,4,0,4,OUI,OUI,2025-03-13 06:59:38+00:00,"48.869789, 2.326347",Paris,75056,0.19047619047619047,7
21707,Square Etienne Jarousse,OUI,22,16,6,4,2,OUI,OUI,2025-03-13 06:58:33+00:00,"48.82485182597129, 2.2925933450460434",Vanves,92075,0.2727272727272727,7
12035,Madagascar - Meuniers,OUI,32,15,17,17,0,OUI,OUI,2025-03-13 06:58:00+00:00,"48.83460464474706, 2.3970650508999825",Paris,75056,0.53125,7
5001,Harpe - Saint-Germain,OUI,43,34,9,7,2,OUI,OUI,2025-03-13 06:59:38+00:00,"48.851518815017, 2.3436703160405",Paris,75056,0.20930232558139536,7
41211,Louis Xavier de Ricard - Ancienne Mairie,OUI,34,31,3,2,1,OUI,OUI,2025-03-13 06:59:57+00:00,"48.84629899065091, 2.472420372068882",Fontenay-sous-Bois,94033,0.08823529411764706,7
8027,Mairie du 8ème,OUI,14,12,2,1,1,OUI,OUI,2025-03-13 06:58:30+00:00,"48.877932, 2.318264",Paris,75056,0.14285714285714285,7
12101,Charenton - Prague,OUI,28,5,23,21,2,OUI,OUI,2025-03-13 07:00:07+00:00,"48.848175129981, 2.3763584494312",Paris,75056,0.8214285714285714,7
15039,Abbé Groult - Convention,OUI,13,8,5,4,1,OUI,OUI,2025-03-13 07:00:28+00:00,"48.83596927866069, 2.302064039509349",Paris,75056,0.38461538461538464,7
4019,Cloître Saint-Merri - Renard,OUI,29,13,16,12,4,OUI,OUI,2025-03-13 06:56:44+00:00,"48.858835448898, 2.3518279194832",Paris,75056,0.5517241379310345,7
21315,Jules Guesdes - Général de Gaulle,OUI,24,11,13,3,10,OUI,OUI,2025-03-13 06:59:25+00:00,"48.81930581291959, 2.278934195637703",Issy-les-Moulineaux,92040,0.5416666666666666,7
15129,Hôpital Necker,OUI,39,27,12,8,4,OUI,OUI,2025-03-13 07:00:00+00:00,"48.846043490118454, 2.313245013356209",Paris,75056,0.3076923076923077,7
23102,Hôtel de Ville de Sèvres,OUI,31,15,16,9,7,OUI,OUI,2025-03-13 07:00:39+00:00,"48.824363561289, 2.2131047397852",Sèvres,92072,0.5161290322580645,7
51001,Gare d'Argenteuil,OUI,37,18,19,3,16,OUI,OUI,2025-03-13 06:59:39+00:00,"48.947022436806705, 2.256898172199726",Argenteuil,95018,0.5135135135135135,7
15036,Croix Nivert - Square Saint-Lambert,OUI,47,47,0,0,0,NON,NON,2025-03-03 09:03:43+00:00,"48.843051521591, 2.2952004522085",Paris,75056,0.0,9
6022,Marché Saint-Germain,OUI,18,14,4,4,0,OUI,OUI,2025-03-13 06:59:52+00:00,"48.85165625855281, 2.335500307381153",Paris,75056,0.2222222222222222,7
21402,Place Aimé Césaire,OUI,27,25,2,0,2,OUI,OUI,2025-03-13 07:00:16+00:00,"48.783194713067815, 2.2429127991199493",Clamart,92023,0.07407407407407407,7
15006,Cherche-Midi - Hôpital Necker,OUI,37,37,0,0,0,OUI,OUI,2025-03-13 06:52:35+00:00,"48.84461063309956, 2.317914068698883",Paris,75056,0.0,7
41403,Gare RER - Malleret-Joinville,OUI,20,0,20,16,4,OUI,OUI,2025-03-13 06:59:22+00:00,"48.802936, 2.42531",Alfortville,94002,1.0,7
9007,Condorcet - Turgot,OUI,19,17,2,0,2,OUI,OUI,2025-03-13 07:00:57+00:00,"48.87985155789093, 2.345232367515564",Paris,75056,0.10526315789473684,7
13018,Bruant - Vincent Auriol,OUI,25,7,18,5,13,OUI,OUI,2025-03-13 06:58:47+00:00,"48.834848452929, 2.3668264996271",Paris,75056,0.72,7
17024,Villiers - Batignolles,OUI,23,13,10,5,5,OUI,OUI,2025-03-13 07:00:28+00:00,"48.88125253846116, 2.31653843075037",Paris,75056,0.43478260869565216,7
21303,Jean Monnet - Iles,OUI,32,2,30,30,0,OUI,OUI,2025-03-13 07:00:54+00:00,"48.823393984057304, 2.2497073194874866",Issy-les-Moulineaux,92040,0.9375,7
15127,Place Charles Michels,OUI,35,17,18,14,4,OUI,OUI,2025-03-13 06:59:20+00:00,"48.846401, 2.28502",Paris,75056,0.5142857142857142,7
33014,Parc Eli Lotar,OUI,19,5,14,10,4,OUI,OUI,2025-03-13 07:00:42+00:00,"48.91844993053703, 2.3727085813879967",Aubervilliers,93001,0.7368421052631579,7
33103,Jean Jaurès - Jules Jacquemin,OUI,22,11,11,2,9,OUI,OUI,2025-03-13 06:59:44+00:00,"48.88433053604843, 2.4082902455152104",Le Pré-Saint-Gervais,93061,0.5,7
13052,Leredde - Tolbiac,OUI,44,33,11,8,3,OUI,OUI,2025-03-13 07:01:04+00:00,"48.82887629664, 2.3744382709265",Paris,75056,0.25,7
14032,Mairie du 14ème,OUI,31,22,9,1,8,OUI,OUI,2025-03-13 06:56:20+00:00,"48.83254578123, 2.3254923149943",Paris,75056,0.2903225806451613,7
20105,Benoît Frachon - République,OUI,28,24,4,2,2,OUI,OUI,2025-03-13 06:57:43+00:00,"48.85230729014318, 2.415605485439301",Paris,75056,0.14285714285714285,7
16019,Porte de la Muette,OUI,34,31,3,3,0,OUI,OUI,2025-03-13 06:57:08+00:00,"48.86302317841182, 2.2687188170157406",Paris,75056,0.08823529411764706,7
14011,Place des Droits de l'Enfant,OUI,37,31,6,0,6,OUI,OUI,2025-03-13 06:59:33+00:00,"48.8274804, 2.3319217",Paris,75056,0.16216216216216217,7
10033,Gare du Nord - Saint-Vincent de Paul,OUI,24,19,5,2,3,OUI,OUI,2025-03-13 06:58:14+00:00,"48.880955741648, 2.3524305148385",Paris,75056,0.20833333333333334,7
41401,Marne - Charles de Gaulle,OUI,26,7,19,17,2,OUI,OUI,2025-03-13 07:00:16+00:00,"48.815071719544434, 2.4121668934822087",Alfortville,94002,0.7307692307692307,7
6002,Saint-Benoît - Jacob,OUI,22,16,6,4,2,OUI,OUI,2025-03-13 06:55:51+00:00,"48.85545136013941, 2.3334722220897675",Paris,75056,0.2727272727272727,7
20022,Porte de Bagnolet,OUI,32,31,1,1,0,OUI,OUI,2025-03-13 06:59:18+00:00,"48.864707139122984, 2.408344637349607",Paris,75056,0.03125,7
14031,Didot - Place de Moro-Giafferi,OUI,19,16,3,1,2,OUI,OUI,2025-03-13 06:55:47+00:00,"48.8337, 2.3215",Paris,75056,0.15789473684210525,7
12036,Reuilly - Place Felix Eboue,OUI,40,34,6,0,6,OUI,OUI,2025-03-13 06:54:32+00:00,"48.84030274499962, 2.394630398715453",Paris,75056,0.15,7
20044,Davout - Volga,OUI,27,21,6,4,2,OUI,OUI,2025-03-13 06:58:05+00:00,"48.852919679957296, 2.410522909779111",Paris,75056,0.2222222222222222,7
10008,Cité Riverin - Château d'Eau,OUI,18,3,15,14,1,OUI,OUI,2025-03-13 06:59:55+00:00,"48.870702423554306, 2.358739863900845",Paris,75056,0.8333333333333334,7
33012,Landy - Heurtault,OUI,29,15,14,4,10,OUI,OUI,2025-03-13 07:00:00+00:00,"48.915096534520316, 2.375951372087002",Aubervilliers,93001,0.4827586206896552,7
16036,Porte Molitor,OUI,58,19,39,26,13,OUI,OUI,2025-03-13 07:00:47+00:00,"48.84524763511433, 2.2569015249609947",Paris,75056,0.6724137931034483,7
2013,Favart - Italiens,OUI,17,12,5,4,1,OUI,OUI,2025-03-13 06:59:27+00:00,"48.871446353921, 2.3382901058508",Paris,75056,0.29411764705882354,7
42505,Charles Frérot - Albert Guilpin,OUI,29,16,13,9,4,OUI,OUI,2025-03-13 07:00:26+00:00,"48.8155839183714, 2.3505029082298283",Gentilly,94037,0.4482758620689655,7
3102,Bourg l'Abbé - Saint-Martin,OUI,36,21,15,14,1,OUI,OUI,2025-03-13 07:00:28+00:00,"48.86393331949257, 2.352406270802021",Paris,75056,0.4166666666666667,7
8117,Place de la Madeleine - Royale,OUI,41,34,7,4,3,OUI,OUI,2025-03-13 06:58:51+00:00,"48.869228052648, 2.324421107769",Paris,75056,0.17073170731707318,7
10019,Paradis - Hauteville,OUI,31,14,17,10,7,OUI,OUI,2025-03-13 07:00:01+00:00,"48.874999954666755, 2.3522757401923404",Paris,75056,0.5483870967741935,7
10032,Claude Vellefaux - Hôpital Saint-Louis,OUI,31,23,8,7,1,OUI,OUI,2025-03-13 07:00:35+00:00,"48.872859139003, 2.3700717069851",Paris,75056,0.25806451612903225,7
11033,Bréguet - Sabin,OUI,30,10,20,20,0,OUI,OUI,2025-03-13 07:00:09+00:00,"48.856931678257, 2.3706749462105",Paris,75056,0.6666666666666666,7
18139,Poissonniers - Championnet,OUI,27,19,8,3,5,OUI,OUI,2025-03-13 07:00:42+00:00,"48.89543299733937, 2.3530178144574165",Paris,75056,0.2962962962962963,7
41203,Stalingrad - Rigollots,OUI,48,40,8,5,3,OUI,OUI,2025-03-13 07:01:03+00:00,"48.84997403844251, 2.45557576417923",Fontenay-sous-Bois,94033,0.16666666666666666,7
16042,Murat - Porte de Saint-Cloud,OUI,38,4,34,30,4,OUI,OUI,2025-03-13 07:00:52+00:00,"48.83750862621299, 2.2577651962637906",Paris,75056,0.8947368421052632,7
18039,Jardins d'Eole,OUI,19,18,1,0,1,OUI,OUI,2025-03-13 07:00:42+00:00,"48.8869703, 2.3668488",Paris,75056,0.05263157894736842,7
1006,Grande Truanderie - Saint-Denis,OUI,29,20,9,8,1,OUI,OUI,2025-03-13 06:56:14+00:00,"48.8626302, 2.3498075",Paris,75056,0.3103448275862069,7
15008,Sèvres - Lecourbe,OUI,60,44,16,9,7,OUI,OUI,2025-03-13 07:00:37+00:00,"48.8447677, 2.3110086",Paris,75056,0.26666666666666666,7
14026,Plantes - Moulin Vert,OUI,44,44,0,0,0,OUI,OUI,2025-03-13 06:56:31+00:00,"48.83005755305626, 2.3232302069664006",Paris,75056,0.0,7
22201,Henri Ravera - Gabriel Péri,OUI,27,20,7,0,7,OUI,OUI,2025-03-13 06:56:51+00:00,"48.79722273833844, 2.302115857601166",Bagneux,92007,0.25925925925925924,7
16012,Flandrin - Longchamp,OUI,40,29,11,7,4,OUI,OUI,2025-03-13 07:01:03+00:00,"48.86877849178477, 2.274354539176829",Paris,75056,0.275,7
11112,Jules Vallès - Charonne,OUI,23,6,17,16,1,OUI,OUI,2025-03-13 06:59:32+00:00,"48.854284379935, 2.3847674578428",Paris,75056,0.7391304347826086,7
12015,Place de la Nation - Picpus,OUI,36,20,16,3,13,OUI,OUI,2025-03-13 06:58:54+00:00,"48.846821681548, 2.4001130461693",Paris,75056,0.4444444444444444,7
16105,Crevaux - Bugeaud,OUI,31,26,5,2,3,OUI,OUI,2025-03-13 06:57:20+00:00,"48.87080942867, 2.2811490076919",Paris,75056,0.16129032258064516,7
48004,Maxime Gorki - Louis Aragon,OUI,19,11,8,1,7,OUI,OUI,2025-03-13 06:58:45+00:00,"48.78909814728443, 2.368387877941132",Villejuif,94076,0.42105263157894735,7
4006,Bourdon - Pont Morland,OUI,49,27,22,22,0,OUI,OUI,2025-03-13 07:00:57+00:00,"48.8478103, 2.3659356",Paris,75056,0.4489795918367347,7
14001,Edgar Quinet - Gaité,OUI,27,25,2,2,0,OUI,OUI,2025-03-13 06:57:03+00:00,"48.841160928966, 2.324595451355",Paris,75056,0.07407407407407407,7
18202,Diane Arbus,OUI,37,28,9,2,7,OUI,OUI,2025-03-13 06:59:24+00:00,"48.898800717199, 2.3524022474885",Paris,75056,0.24324324324324326,7
26004,Gare RER les Grésillons,OUI,22,13,9,7,2,OUI,OUI,2025-03-13 06:59:13+00:00,"48.919898633572764, 2.31458459136273",Asnières-sur-Seine,92004,0.4090909090909091,7
15128,Cadix - Hameau,OUI,35,12,23,17,6,OUI,OUI,2025-03-13 06:59:56+00:00,"48.8340107632249, 2.289516180753708",Paris,75056,0.6571428571428571,7
15001,Gare Montparnasse - Arrivée,OUI,41,32,9,2,7,OUI,OUI,2025-03-13 07:00:14+00:00,"48.843827994315, 2.3225811123848",Paris,75056,0.21951219512195122,7
44014,Camille Risch - Paul Armangot,OUI,25,13,12,4,8,OUI,OUI,2025-03-13 07:01:01+00:00,"48.774703, 2.373685",Vitry-sur-Seine,94081,0.48,7
19110,Square Claude Bernard,OUI,28,23,5,3,2,OUI,OUI,2025-03-13 07:00:21+00:00,"48.89876016219984, 2.375325746834278",Paris,75056,0.17857142857142858,7
12037,Reuilly - Daumesnil,OUI,36,22,14,8,6,OUI,OUI,2025-03-13 06:58:21+00:00,"48.8395385, 2.3972516",Paris,75056,0.3888888888888889,7
5007,Ecoles - Carmes,OUI,32,26,6,3,3,OUI,OUI,2025-03-13 06:57:19+00:00,"48.848904447989405, 2.3473486304283147",Paris,75056,0.1875,7
1007,Turbigo - Française,OUI,16,13,3,1,2,OUI,OUI,2025-03-13 07:00:32+00:00,"48.86358858111446, 2.3477794602513313",Paris,75056,0.1875,7
3008,Perle - Vieille du Temple,OUI,35,20,15,15,0,OUI,OUI,2025-03-13 06:58:03+00:00,"48.8601346, 2.3611206",Paris,75056,0.42857142857142855,7
47003,Charentonneau - Maisons Alfort,OUI,20,10,10,7,3,OUI,OUI,2025-03-13 07:01:03+00:00,"48.809932980484355, 2.443288456496946",Maisons-Alfort,94046,0.5,7
6010,Chevreuse - Montparnasse,OUI,15,12,3,1,2,OUI,OUI,2025-03-13 07:00:37+00:00,"48.841739161231, 2.3315522167367",Paris,75056,0.2,7
18004,Place des Abbesses,OUI,11,8,3,1,2,OUI,OUI,2025-03-13 06:52:23+00:00,"48.884542726149725, 2.3386867716908455",Paris,75056,0.2727272727272727,7
5015,Epée de Bois - Mouffetard,OUI,62,56,6,5,1,OUI,OUI,2025-03-13 07:00:59+00:00,"48.841508690388835, 2.350066713988781",Paris,75056,0.0967741935483871,7
20001,Place de la Nation - Charonne,OUI,34,25,9,3,6,OUI,OUI,2025-03-13 07:00:04+00:00,"48.848364667777, 2.3997623859813",Paris,75056,0.2647058823529412,7
45002,Roger Salengro - Général de Gaulle,OUI,27,7,20,5,15,OUI,OUI,2025-03-13 06:59:00+00:00,"48.820029010376956, 2.4846760556101803",Champigny-sur-Marne,94017,0.7407407407407407,7
12019,Gare de Reuilly - Picpus,OUI,26,16,10,3,7,OUI,OUI,2025-03-13 07:00:44+00:00,"48.84267354116789, 2.3972943797707558",Paris,75056,0.38461538461538464,7
16013,Mairie du 16ème,OUI,35,28,7,1,6,OUI,OUI,2025-03-13 06:55:51+00:00,"48.863936848471994, 2.2765953093767166",Paris,75056,0.2,7
20104,Louis Lumière.,OUI,22,18,4,0,4,OUI,OUI,2025-03-13 06:54:20+00:00,"48.86216198070008, 2.41112578185621",Paris,75056,0.18181818181818182,7
7012,Cité Vaneau,OUI,24,17,7,4,3,OUI,OUI,2025-03-13 07:01:05+00:00,"48.8542210666207, 2.319614924490452",Paris,75056,0.2916666666666667,7
14135,Jourdan - Cité Universitaire,OUI,39,23,16,8,8,OUI,OUI,2025-03-13 07:00:55+00:00,"48.819897343156676, 2.3397007964124366",Paris,75056,0.41025641025641024,7
20008,Pyrénées - Avron,OUI,31,31,0,0,0,OUI,OUI,2025-03-13 06:55:14+00:00,"48.853246898211985, 2.405871044529538",Paris,75056,0.0,7
3010,Beaubourg - Michel-le-Comte,OUI,15,8,7,5,2,OUI,OUI,2025-03-13 06:54:32+00:00,"48.862534941806, 2.3543103039265",Paris,75056,0.4666666666666667,7
18034,Leibniz - Jean Dollfus,OUI,32,24,8,5,3,OUI,OUI,2025-03-13 06:58:46+00:00,"48.896328348515986, 2.333390423834684",Paris,75056,0.25,7
8110,Gare Saint-Lazare - Stockholm,OUI,31,16,15,6,9,OUI,OUI,2025-03-13 07:00:59+00:00,"48.877127316667654, 2.322417162358761",Paris,75056,0.4838709677419355,7
9009,Square Montholon,OUI,20,13,7,5,2,OUI,OUI,2025-03-13 07:00:55+00:00,"48.876620377545024, 2.3457641154527664",Paris,75056,0.35,7
20024,Gambetta - Père Lachaise,OUI,27,21,6,1,5,OUI,OUI,2025-03-13 06:54:45+00:00,"48.864295696165875, 2.398228667282044",Paris,75056,0.2222222222222222,7
6104,Herschel - Observatoire,OUI,36,24,12,2,10,OUI,OUI,2025-03-13 06:59:41+00:00,"48.84342376221923, 2.3376645147800446",Paris,75056,0.3333333333333333,7
12156,Niger - Soult,OUI,22,13,9,4,5,OUI,OUI,2025-03-13 07:00:45+00:00,"48.84369906369085, 2.410361237220498",Paris,75056,0.4090909090909091,7
16102,Pergolèse - Marbeau,OUI,26,24,2,2,0,OUI,OUI,2025-03-13 07:00:40+00:00,"48.873568706869, 2.2815125225299",Paris,75056,0.07692307692307693,7
18140,Porte de Clignancourt - Ney,OUI,39,31,8,2,6,OUI,OUI,2025-03-13 07:01:04+00:00,"48.899641123987095, 2.344321422278881",Paris,75056,0.20512820512820512,7
4021,Centre Georges Pompidou,OUI,24,23,1,0,1,OUI,OUI,2025-03-13 06:54:40+00:00,"48.861419, 2.352581",Paris,75056,0.041666666666666664,7
10034,Louis Blanc - La Chapelle,OUI,21,13,8,0,8,OUI,OUI,2025-03-13 07:00:13+00:00,"48.884008964514, 2.3599335551262",Paris,75056,0.38095238095238093,7
17019,Phalsbourg - Villiers,OUI,19,13,6,0,6,OUI,OUI,2025-03-13 07:00:49+00:00,"48.88242307900951, 2.3090453445911407",Paris,75056,0.3157894736842105,7
21309,Mairie d'Issy,OUI,40,22,18,6,12,OUI,OUI,2025-03-13 07:00:11+00:00,"48.823767792468, 2.2723111510277",Issy-les-Moulineaux,92040,0.45,7
19010,Emile Reynaud - Porte de la Villette,OUI,22,6,16,2,14,OUI,OUI,2025-03-13 06:58:34+00:00,"48.90098953630053, 2.3887022584676743",Paris,75056,0.7272727272727273,7
20034,Sorbier - Ménilmontant,OUI,23,22,1,0,1,OUI,OUI,2025-03-13 07:00:53+00:00,"48.868542395661, 2.3897721245885",Paris,75056,0.043478260869565216,7
10009,Mairie du 10ème,OUI,18,4,14,13,1,OUI,OUI,2025-03-13 06:59:05+00:00,"48.872089449907, 2.3575825989246",Paris,75056,0.7777777777777778,7
13005,Cordelières - Arago,OUI,43,6,37,30,7,OUI,OUI,2025-03-13 07:00:33+00:00,"48.83548071896613, 2.348572461702221",Paris,75056,0.8604651162790697,7
41405,Place de l'Europe - Alfortville,OUI,24,5,19,17,2,OUI,OUI,2025-03-13 07:00:53+00:00,"48.78913702405837, 2.4284800887107854",Alfortville,94002,0.7916666666666666,7
19002,Centquatre,OUI,38,17,21,0,21,NON,NON,2025-03-13 07:00:31+00:00,"48.889333538455, 2.3707854375243",Paris,75056,0.5526315789473685,7
20006,Pyrénées - Plaine,OUI,12,4,8,3,5,OUI,OUI,2025-03-13 06:59:00+00:00,"48.85026702458, 2.4062821269035",Paris,75056,0.6666666666666666,7
19201,Petit - Georges Thill,OUI,22,12,10,3,7,OUI,OUI,2025-03-13 07:01:06+00:00,"48.88603131999171, 2.3895753175020222",Paris,75056,0.45454545454545453,7
10011,Bourse du Travail,OUI,15,1,14,12,2,OUI,OUI,2025-03-13 07:01:05+00:00,"48.868976638826, 2.3623438552022",Paris,75056,0.9333333333333333,7
22301,Chausson - Gabriel Péri,OUI,20,7,13,13,0,OUI,OUI,2025-03-13 07:00:50+00:00,"48.921891003481115, 2.2952306270599365",Gennevilliers,92036,0.65,7
21953,Gare de Bellevue,OUI,20,16,4,1,3,OUI,OUI,2025-03-13 07:00:55+00:00,"48.8192404685572, 2.2295309230685234",Meudon,92048,0.2,7
15132,Bargue -  Dutot,OUI,21,14,7,3,4,OUI,OUI,2025-03-13 06:56:46+00:00,"48.837884, 2.308876",Paris,75056,0.3333333333333333,7
21506,Maurice Payret-Dortail,OUI,22,18,4,1,3,OUI,OUI,2025-03-13 06:59:47+00:00,"48.87811957063342, 2.2233625128865246",Suresnes,92073,0.18181818181818182,7
8028,Arsène Houssaye - Champs-Elysées,OUI,28,24,4,2,2,OUI,OUI,2025-03-13 06:56:05+00:00,"48.873409276267, 2.2977904602885",Paris,75056,0.14285714285714285,7
14103,Maine - Liancourt,OUI,25,24,1,0,1,OUI,OUI,2025-03-13 06:59:17+00:00,"48.835064363954, 2.323731449974",Paris,75056,0.04,7
14137,Maurice d'Ocagne - General Maudhuy,OUI,29,15,14,5,9,OUI,OUI,2025-03-13 07:00:33+00:00,"48.82414282524159, 2.3158789426088333",Paris,75056,0.4827586206896552,7
3001,Beaumarchais - Saint-Gilles,OUI,44,28,16,14,2,OUI,OUI,2025-03-13 06:57:19+00:00,"48.8580378, 2.3679352",Paris,75056,0.36363636363636365,7
14019,Sarrette - Général Leclerc,OUI,21,21,0,0,0,OUI,OUI,2025-03-13 06:54:34+00:00,"48.825030852925, 2.3264128693982",Paris,75056,0.0,7
7021,Bosquet - Saint-Dominique,OUI,28,8,20,18,2,OUI,OUI,2025-03-13 07:00:26+00:00,"48.858651709526, 2.3037165802346",Paris,75056,0.7142857142857143,7
3011,Turbigo - Réaumur,OUI,31,3,28,17,11,OUI,OUI,2025-03-13 07:00:24+00:00,"48.865574047531, 2.3564198613167",Paris,75056,0.9032258064516129,7
21026,Sèvres - Général Leclerc,OUI,29,19,10,8,2,OUI,OUI,2025-03-13 07:00:16+00:00,"48.830121559055, 2.2314262390137",Boulogne-Billancourt,92012,0.3448275862068966,7
31709,Place de la Fraternité,OUI,21,12,9,0,9,OUI,OUI,2025-03-13 07:00:19+00:00,"48.85716405838368, 2.422847449779511",Montreuil,93048,0.42857142857142855,7
32013,Saint-Denis - Université,OUI,19,16,3,1,2,OUI,OUI,2025-03-13 06:59:58+00:00,"48.94563430946964, 2.3638297989964485",Saint-Denis,93066,0.15789473684210525,7
10027,Dunkerque - Alsace,OUI,20,9,11,3,8,OUI,OUI,2025-03-13 07:00:39+00:00,"48.879355, 2.358379",Paris,75056,0.55,7
22503,Joffre - Aigle,OUI,19,8,11,3,8,OUI,OUI,2025-03-13 06:56:35+00:00,"48.904033, 2.245096",La Garenne-Colombes,92035,0.5789473684210527,7
10006,Petites Ecuries - Faubourg Saint-Denis,OUI,25,16,9,6,3,OUI,OUI,2025-03-13 07:00:04+00:00,"48.87287120589831, 2.3542150855064397",Paris,75056,0.36,7
1102,Française - Etienne Marcel,OUI,35,17,18,18,0,OUI,OUI,2025-03-13 07:01:01+00:00,"48.864053304653766, 2.347587011754513",Paris,75056,0.5142857142857142,7
22401,Charles de Gaulle - Plateau de Vanves,OUI,32,31,1,0,1,OUI,OUI,2025-03-13 07:00:40+00:00,"48.82233088973263, 2.298571803412886",Malakoff,92046,0.03125,7
13017,Nationale - Vincent Auriol,OUI,33,29,4,0,4,OUI,OUI,2025-03-13 06:59:53+00:00,"48.83252708397293, 2.362354410392119",Paris,75056,0.12121212121212122,7
12002,Lacuée - Lyon,OUI,15,3,12,4,8,OUI,OUI,2025-03-13 06:57:57+00:00,"48.849268481958, 2.3704585433006",Paris,75056,0.8,7
24006,Adolphe Lalyre - Armand Silvestre,OUI,39,17,22,4,18,OUI,OUI,2025-03-13 07:00:28+00:00,"48.90406266961591, 2.273416221141815",Courbevoie,92026,0.5641025641025641,7
4103,Archives - Rivoli,OUI,19,13,6,3,3,OUI,OUI,2025-03-13 06:57:07+00:00,"48.857346707443, 2.3539767041802",Paris,75056,0.3157894736842105,7
3009,Temple - Haudriettes,OUI,19,11,8,8,0,OUI,OUI,2025-03-13 07:00:53+00:00,"48.861636880212, 2.3566960206458",Paris,75056,0.42105263157894735,7
9037,Parme - Clichy,OUI,24,22,2,0,2,OUI,OUI,2025-03-13 06:58:05+00:00,"48.881266424227, 2.3281970934506",Paris,75056,0.08333333333333333,7
14132,Bézout - Général Leclerc,OUI,28,27,1,0,1,OUI,OUI,2025-03-13 07:00:50+00:00,"48.82884804502439, 2.3285973072052",Paris,75056,0.03571428571428571,7
2015,Louis le Grand - Italiens,OUI,32,27,5,0,5,OUI,OUI,2025-03-13 06:56:24+00:00,"48.870508937204, 2.3340544619393",Paris,75056,0.15625,7
2005,Montmartre - Etienne Marcel,OUI,15,8,7,6,1,OUI,OUI,2025-03-13 07:01:05+00:00,"48.86502194581, 2.3450684401448",Paris,75056,0.4666666666666667,7
19129,Solitaires - Place des Fêtes,OUI,29,29,0,0,0,NON,NON,2025-02-23 09:26:05+00:00,"48.876601, 2.391769",Paris,75056,0.0,9
23702,Hôtel de Ville de Chaville,OUI,20,17,3,0,3,OUI,OUI,2025-03-13 06:54:40+00:00,"48.80887149094033, 2.188134044408798",Chaville,92022,0.15,7
20029,Frères Flavien - Porte des Lilas,OUI,23,14,9,4,5,OUI,OUI,2025-03-13 06:53:00+00:00,"48.8780992764359, 2.41104629853209",Paris,75056,0.391304347826087,7
19012,Lally-Tollendal - Armand Carrel,OUI,27,16,11,4,7,OUI,OUI,2025-03-13 07:00:25+00:00,"48.88270066221072, 2.374717555940151",Paris,75056,0.4074074074074074,7
2003,Saint-Denis - Réaumur,OUI,31,17,14,12,2,OUI,OUI,2025-03-13 07:00:13+00:00,"48.8661116315789, 2.3507790675507594",Paris,75056,0.45161290322580644,7
14023,Adolphe Pinard - Victor Hugo,OUI,51,49,2,1,1,OUI,OUI,2025-03-13 07:00:48+00:00,"48.8236825874564, 2.3077843710780144",Malakoff,92046,0.0392156862745098,7
15111,Olivier de Serres - Leriche,OUI,24,16,8,3,5,OUI,OUI,2025-03-13 07:00:45+00:00,"48.83460221715206, 2.2957482933998112",Paris,75056,0.3333333333333333,7
22502,Kléber - National,OUI,20,15,5,1,4,OUI,OUI,2025-03-13 07:00:38+00:00,"48.906333898712234, 2.2393910586833954",La Garenne-Colombes,92035,0.25,7
12020,Cours de Vincennes - Soult,OUI,44,35,9,6,3,OUI,OUI,2025-03-13 07:00:07+00:00,"48.846918761569, 2.4105220288038",Paris,75056,0.20454545454545456,7
3003,Fille du Calvaire - Turenne,OUI,26,8,18,16,2,OUI,OUI,2025-03-13 06:57:59+00:00,"48.86210505412563, 2.3649600148200993",Paris,75056,0.6923076923076923,7
2021,Cléry - Montmartre,OUI,58,49,9,5,4,OUI,OUI,2025-03-13 07:01:00+00:00,"48.867458, 2.3445211",Paris,75056,0.15517241379310345,7
19111,Cesaria Evora - Rosa Parks,OUI,35,31,4,3,1,OUI,OUI,2025-03-13 07:00:21+00:00,"48.89717672825043, 2.3745173960924144",Paris,75056,0.11428571428571428,7
4014,Blancs-Manteaux - Archives,OUI,28,7,21,19,2,OUI,OUI,2025-03-13 06:55:58+00:00,"48.85941800703, 2.3559471219778",Paris,75056,0.75,7
9111,Victoire - Laffitte,OUI,19,11,8,6,2,OUI,OUI,2025-03-13 06:58:24+00:00,"48.87514373494672, 2.338118505144376",Paris,75056,0.42105263157894735,7
3012,Square Emile - Chautemps,OUI,25,8,17,10,7,OUI,OUI,2025-03-13 07:00:56+00:00,"48.867433724231, 2.3536357283592",Paris,75056,0.68,7
5122,Saint-Michel - Luxembourg,OUI,27,15,12,5,7,OUI,OUI,2025-03-13 07:01:03+00:00,"48.84501507626, 2.3394941166043",Paris,75056,0.4444444444444444,7
14022,Didot - Mariniers,OUI,35,35,0,0,0,OUI,OUI,2025-03-13 06:54:14+00:00,"48.82650543613106, 2.313136198271666",Paris,75056,0.0,7
13125,Gare d'Austerlitz - Pont Charles de Gaulle,OUI,55,32,23,12,11,OUI,OUI,2025-03-13 07:00:38+00:00,"48.842319830109, 2.3670300096273",Paris,75056,0.41818181818181815,7
2002,Etienne Marcel - Montorgueil,OUI,24,13,11,11,0,OUI,OUI,2025-03-13 06:56:19+00:00,"48.86450567259199, 2.3461959511041637",Paris,75056,0.4583333333333333,7
8036,Lisbonne - Monceau,OUI,46,36,10,5,5,OUI,OUI,2025-03-13 06:57:25+00:00,"48.877455676814, 2.3096942214195",Paris,75056,0.21739130434782608,7
31001,Lagny - Auguste Blanqui,OUI,26,19,7,5,2,OUI,OUI,2025-03-13 06:59:09+00:00,"48.84922568052601, 2.4218603968620305",Montreuil,93048,0.2692307692307692,7
48005,Eugène Varlin - Place de la Paix,OUI,23,17,6,1,5,OUI,OUI,2025-03-13 07:00:53+00:00,"48.792862, 2.363093",Villejuif,94076,0.2608695652173913,7
21507,Gardenat-Lapostol - Velettes,OUI,20,15,5,1,4,OUI,OUI,2025-03-13 07:00:17+00:00,"48.87387, 2.224185",Suresnes,92073,0.25,7
21215,Verdier - Jean Jaurès,OUI,32,31,1,0,1,OUI,OUI,2025-03-13 06:55:18+00:00,"48.81614048711214, 2.3123561963438988",Montrouge,92049,0.03125,7
22306,Place du 17 Octobre,OUI,16,13,3,2,1,OUI,OUI,2025-03-13 06:55:47+00:00,"48.91962690034779, 2.2978286134199792",Gennevilliers,92036,0.1875,7
21706,Jean Bleuzen - Square du 11 Novembre,OUI,45,31,14,12,2,OUI,OUI,2025-03-13 07:00:59+00:00,"48.8232579, 2.2965213",Vanves,92075,0.3111111111111111,7
3006,Mairie du 3ème,OUI,24,2,22,19,3,OUI,OUI,2025-03-13 06:59:26+00:00,"48.86446178139141, 2.361762821674347",Paris,75056,0.9166666666666666,7
1014,Rivoli - Musée du Louvre,OUI,20,14,6,1,5,OUI,OUI,2025-03-13 07:00:01+00:00,"48.86364636851945, 2.33409583568573",Paris,75056,0.3,7
26006,Bas - Gabriel Péri,OUI,30,6,24,18,6,OUI,OUI,2025-03-13 06:58:34+00:00,"48.91585580539625, 2.2948095202445984",Asnières-sur-Seine,92004,0.8,7
4015,Mairie du 4ème,OUI,39,25,14,13,1,OUI,OUI,2025-03-13 06:59:18+00:00,"48.855949910497, 2.3563823103905",Paris,75056,0.358974358974359,7
42211,Séminaire de Conflans - Liberté,OUI,25,6,19,2,17,OUI,OUI,2025-03-13 07:00:34+00:00,"48.823194, 2.404179",Charenton-le-Pont,94018,0.76,7
21110,Parc Roger Salengro,OUI,31,7,24,21,3,OUI,OUI,2025-03-13 07:00:58+00:00,"48.905303858642, 2.31055945158",Clichy,92024,0.7741935483870968,7
13054,Pau Casals - Neuve Tolbiac,OUI,53,49,4,3,1,OUI,OUI,2025-03-13 07:00:33+00:00,"48.8311602, 2.3774395",Paris,75056,0.07547169811320754,7
6031,Pierre Sarrazin - Saint-Michel,OUI,31,18,13,12,1,OUI,OUI,2025-03-13 06:58:14+00:00,"48.850908146398, 2.342130728066",Paris,75056,0.41935483870967744,7
2004,Square Pierre Lazareff,OUI,17,7,10,9,1,OUI,OUI,2025-03-13 06:56:45+00:00,"48.867141720746, 2.3483933508396",Paris,75056,0.5882352941176471,7
14133,Froidevaux - Boulard,OUI,34,33,1,0,1,OUI,OUI,2025-03-13 06:59:08+00:00,"48.835147319625, 2.3294411972165",Paris,75056,0.029411764705882353,7
19130,Place Paul Delouvrier,OUI,26,20,6,4,2,OUI,OUI,2025-03-13 06:59:01+00:00,"48.89197621431365, 2.3851288855075836",Paris,75056,0.23076923076923078,7
4012,Tiron - Rivoli,OUI,27,3,24,21,3,OUI,OUI,2025-03-13 06:59:24+00:00,"48.855692253233, 2.3579058051109",Paris,75056,0.8888888888888888,7
35012,Candale - Mehul,OUI,24,15,9,0,9,OUI,OUI,2025-03-13 07:00:41+00:00,"48.8893935006175, 2.414379715919495",Pantin,93055,0.375,7
41208,Alouettes - Maréchal de Lattre de Tassigny,OUI,21,16,5,1,4,OUI,OUI,2025-03-13 07:00:02+00:00,"48.85511009293948, 2.4930700287222862",Fontenay-sous-Bois,94033,0.23809523809523808,7
4018,Saint-Bon - Rivoli,OUI,14,5,9,4,5,OUI,OUI,2025-03-13 06:58:33+00:00,"48.857999643315, 2.3502172809763",Paris,75056,0.6428571428571429,7
42704,Mairie du Kremlin-Bicêtre,OUI,25,21,4,0,4,OUI,OUI,2025-03-13 06:58:29+00:00,"48.81191981537702, 2.3570189997553825",Le Kremlin-Bicêtre,94043,0.16,7
16044,Porte de Saint Cloud - Parc des Princes,OUI,32,13,19,16,3,OUI,OUI,2025-03-13 06:54:51+00:00,"48.838662757066, 2.2525164484978",Paris,75056,0.59375,7
4017,Place de l'Hôtel de Ville,OUI,13,6,7,7,0,OUI,OUI,2025-03-13 06:56:27+00:00,"48.8573314, 2.351458",Paris,75056,0.5384615384615384,7
4007,Place de la Bastille - Bourdon,OUI,33,11,22,18,4,OUI,OUI,2025-03-13 07:00:03+00:00,"48.852364355271, 2.3681089282036",Paris,75056,0.6666666666666666,7
42026,Barbès - Monique Maunoury,OUI,40,29,11,6,5,OUI,OUI,2025-03-13 06:59:19+00:00,"48.81552718820216, 2.3687169334905405",Ivry-sur-Seine,94041,0.275,7
5004,Saint-Jacques - Val de Grâce,OUI,19,12,7,2,5,OUI,OUI,2025-03-13 07:00:31+00:00,"48.8417514, 2.3413893",Paris,75056,0.3684210526315789,7
2012,Choiseul - Quatre Septembre,OUI,44,37,7,2,5,OUI,OUI,2025-03-13 06:54:29+00:00,"48.8699355331869, 2.3359975218772893",Paris,75056,0.1590909090909091,7
10041,Gare du Nord - La Chapelle,OUI,18,13,5,3,2,OUI,OUI,2025-03-13 07:00:04+00:00,"48.884178287286, 2.3561057075858",Paris,75056,0.2777777777777778,7
12163,Hippodrome Paris-Vincennes,OUI,42,41,1,1,0,OUI,OUI,2025-03-13 06:53:52+00:00,"48.82048387758518, 2.446271181106568",Paris,75056,0.023809523809523808,7
4101,Bastille - Beaumarchais,OUI,20,5,15,15,0,OUI,OUI,2025-03-13 07:00:04+00:00,"48.853833463852, 2.3685702681541",Paris,75056,0.75,7
3002,Saint-Gilles - Turenne,OUI,15,4,11,9,2,OUI,OUI,2025-03-13 07:00:07+00:00,"48.858158956779, 2.3647149920992",Paris,75056,0.7333333333333333,7
1018,Alger - Rivoli,OUI,14,7,7,4,3,OUI,OUI,2025-03-13 07:01:04+00:00,"48.864773553495, 2.3294493936128",Paris,75056,0.5,7
21509,Gardenat Lapostol - Franklin Roosevelt,OUI,24,20,4,2,2,OUI,OUI,2025-03-13 06:53:33+00:00,"48.871839, 2.222505",Suresnes,92073,0.16666666666666666,7
2008,Mairie du 2ème,OUI,28,23,5,2,3,OUI,OUI,2025-03-13 06:59:16+00:00,"48.8672190355135, 2.3404625437747044",Paris,75056,0.17857142857142858,7
1012,Jean-Jacques Rousseau - Deux Ecus,OUI,21,10,11,10,1,OUI,OUI,2025-03-13 07:00:52+00:00,"48.86297805972131, 2.3414635285735126",Paris,75056,0.5238095238095238,7
1026,Place du Lieutenant Henri Karcher,OUI,29,23,6,6,0,OUI,OUI,2025-03-13 07:00:39+00:00,"48.863490871724466, 2.3400671035051346",Paris,75056,0.20689655172413793,7
21505,Édouard Vaillant - Place Jean Jaurès,OUI,21,16,5,2,3,OUI,OUI,2025-03-13 07:00:24+00:00,"48.86265537999924, 2.2089037319128613",Suresnes,92073,0.23809523809523808,7
18015,Custine - Ramey,OUI,40,39,1,0,1,OUI,OUI,2025-03-13 07:00:21+00:00,"48.888735896947, 2.3469526693225",Paris,75056,0.025,7
2016,Aboukir - Alexandrie,OUI,20,9,11,11,0,OUI,OUI,2025-03-13 06:58:37+00:00,"48.86868344444473, 2.3502043269474897",Paris,75056,0.55,7
1017,Saint-Honoré - 29 juillet,OUI,18,16,2,2,0,OUI,OUI,2025-03-13 06:57:44+00:00,"48.86557114282421, 2.330567417577153",Paris,75056,0.1111111111111111,7
44001,Quai Jules Guesde - Saint-Simon,OUI,30,0,30,26,4,OUI,OUI,2025-03-13 07:00:08+00:00,"48.80391487219, 2.4089661620274",Vitry-sur-Seine,94081,1.0,7
23107,Gare de Sèvres - Ville d'Avray,OUI,22,15,7,4,3,OUI,OUI,2025-03-13 07:00:49+00:00,"48.826262366227, 2.2001516849313",Sèvres,92072,0.3181818181818182,7
4009,Village Saint-Paul,OUI,24,2,22,17,5,OUI,OUI,2025-03-13 07:00:40+00:00,"48.852639866625, 2.3607301712036",Paris,75056,0.9166666666666666,7
22601,Marx Dormoy - Château Sainte-Barbe,OUI,21,17,4,1,3,OUI,OUI,2025-03-13 07:00:25+00:00,"48.791782341055324, 2.297856844961643",Fontenay-aux-Roses,92032,0.19047619047619047,7
33020,Waldeck Rochet - Germaine Tillon,OUI,30,24,6,2,4,OUI,OUI,2025-03-13 06:54:58+00:00,"48.91105960199651, 2.3676301538944244",Aubervilliers,93001,0.2,7
12164,Stade Pershing,OUI,26,26,0,0,0,NON,NON,2025-02-26 05:58:32+00:00,"48.829107826857, 2.4583535268903",Paris,75056,0.0,6
32019,Place du 8 mai 1945.,OUI,28,21,7,3,4,OUI,OUI,2025-03-13 06:54:54+00:00,"48.938882272105, 2.3566243797541",Saint-Denis,93066,0.25,7
48008,Guy Môquet - Parvis Georges Marchais,OUI,30,27,3,0,3,OUI,OUI,2025-03-13 06:58:47+00:00,"48.79518840095975, 2.35943466424942",Villejuif,94076,0.1,7
9039,Chaussée d'Antin - Haussmann,OUI,22,16,6,3,3,OUI,OUI,2025-03-13 06:58:47+00:00,"48.87243, 2.33359",Paris,75056,0.2727272727272727,7
19202,Marseillaise - Grenade,OUI,43,38,5,1,4,OUI,OUI,2025-03-13 06:59:11+00:00,"48.889371092747, 2.3979396821544",Paris,75056,0.11627906976744186,7
22506,Gare des Vallées,OUI,18,12,6,5,1,OUI,OUI,2025-03-13 07:00:22+00:00,"48.913179, 2.257726",La Garenne-Colombes,92035,0.3333333333333333,7
14201,Decrès - Alésia,OUI,29,28,1,0,1,OUI,OUI,2025-03-13 07:01:03+00:00,"48.832200060759, 2.3139070151575",Paris,75056,0.034482758620689655,7
1025,Oratoire - Rivoli,OUI,17,8,9,9,0,OUI,OUI,2025-03-13 07:00:27+00:00,"48.861342760889, 2.3400047421455",Paris,75056,0.5294117647058824,7
5003,Le Goff - Gay-Lussac,OUI,34,28,6,3,3,OUI,OUI,2025-03-13 06:58:05+00:00,"48.846102400979, 2.3412207886577",Paris,75056,0.17647058823529413,7
23101,Grande Rue - Europe,OUI,25,13,12,5,7,OUI,OUI,2025-03-13 07:01:01+00:00,"48.8218104687602, 2.205879874527455",Sèvres,92072,0.48,7
27001,Square Victor Basch,OUI,19,0,19,9,10,OUI,OUI,2025-03-13 06:58:44+00:00,"48.914304862261, 2.2289156913757",Colombes,92025,1.0,7
17106,Berthier - Porte de Clichy,OUI,24,14,10,5,5,OUI,OUI,2025-03-13 07:00:04+00:00,"48.894222687781, 2.3125872006816",Paris,75056,0.4166666666666667,7
17021,Jouffroy d'Abbans - Villiers,OUI,32,19,13,6,7,OUI,OUI,2025-03-13 07:00:46+00:00,"48.884215547037, 2.3056533560157",Paris,75056,0.40625,7
1116,Ventadour - Opéra,OUI,25,16,9,6,3,OUI,OUI,2025-03-13 06:59:54+00:00,"48.866810653323, 2.3343884482519",Paris,75056,0.36,7
3007,Archives - Pastourelle,OUI,26,15,11,8,3,OUI,OUI,2025-03-13 06:59:49+00:00,"48.8623615, 2.3595041",Paris,75056,0.4230769230769231,7
32024,Port - Confluence,OUI,23,13,10,5,5,OUI,OUI,2025-03-13 06:57:42+00:00,"48.936093926526, 2.3436167797955",Saint-Denis,93066,0.43478260869565216,7
35005,Quai de l'Aisne - Général Leclerc,OUI,26,23,3,0,3,OUI,OUI,2025-03-13 07:00:10+00:00,"48.895713, 2.400571",Pantin,93055,0.11538461538461539,7
15040,Saint-Amand - Labrouste,OUI,34,27,7,3,4,OUI,OUI,2025-03-13 07:00:36+00:00,"48.834097274832295, 2.3087677359581",Paris,75056,0.20588235294117646,7
6007,Bréa - Raspail,OUI,22,20,2,2,0,OUI,OUI,2025-03-13 06:57:49+00:00,"48.842738478258, 2.3297942217634",Paris,75056,0.09090909090909091,7
6201,Saint Pères - Saint Germain,OUI,22,4,18,10,8,OUI,OUI,2025-03-13 06:59:50+00:00,"48.853729675265, 2.3300181032703",Paris,75056,0.8181818181818182,7
22603,Place de la Division Leclerc,OUI,33,32,1,0,1,OUI,OUI,2025-03-13 06:57:13+00:00,"48.793824988636516, 2.2731140430551027",Fontenay-aux-Roses,92032,0.030303030303030304,7
6026,Saint-Placide - Cherche Midi,OUI,66,65,1,1,0,OUI,OUI,2025-03-13 07:00:48+00:00,"48.8490535919234, 2.325317971408367",Paris,75056,0.015151515151515152,7
21119,Belfort - Victor Hugo,OUI,21,7,14,12,2,OUI,OUI,2025-03-13 06:58:51+00:00,"48.9018492, 2.3172724",Clichy,92024,0.6666666666666666,7
42018,Amédée Huon - Fort d'Ivry,OUI,30,22,8,3,5,OUI,OUI,2025-03-13 06:58:06+00:00,"48.805131376899986, 2.388489693403244",Ivry-sur-Seine,94041,0.26666666666666666,7
16010,Belles Feuilles - Place de Mexico,OUI,22,14,8,4,4,OUI,OUI,2025-03-13 06:59:27+00:00,"48.865804746474, 2.2829206287861",Paris,75056,0.36363636363636365,7
1023,Saint-Honoré - Musée du Louvre,OUI,21,16,5,1,4,OUI,OUI,2025-03-13 07:00:02+00:00,"48.863443132848, 2.3348781846405",Paris,75056,0.23809523809523808,7
16201,Porte Dauphine,OUI,60,56,4,2,2,OUI,OUI,2025-03-13 06:55:02+00:00,"48.871139344351, 2.2749781616017",Paris,75056,0.06666666666666667,7
23042,André Theuriet - Blagis,OUI,30,21,9,3,6,OUI,OUI,2025-03-13 06:56:06+00:00,"48.77977325745441, 2.3130525648593903",Bourg-la-Reine,92014,0.3,7
31020,Résistance - Parmentier,OUI,31,24,7,6,1,OUI,OUI,2025-03-13 07:01:05+00:00,"48.85965138131299, 2.436705082654953",Montreuil,93048,0.22580645161290322,7
32020,Jules Guesdes - Carnot,OUI,14,12,2,1,1,OUI,OUI,2025-03-13 06:52:26+00:00,"48.93828169931872, 2.3508992046117783",Saint-Denis,93066,0.14285714285714285,7
28005,Jean Jaurès - Paul Lafargue,OUI,25,21,4,3,1,OUI,OUI,2025-03-13 07:00:23+00:00,"48.884933177666, 2.2484488785267",Puteaux,92062,0.16,7
1008,Les Halles - Saint-Eustache,OUI,32,32,0,0,0,OUI,OUI,2025-03-13 07:00:47+00:00,"48.86362695901683, 2.342623919248581",Paris,75056,0.0,7
18112,Arthur Ranc - Hôpital Bichat,OUI,24,24,0,0,0,OUI,OUI,2025-03-13 06:51:39+00:00,"48.8978712500682, 2.333521842956543",Paris,75056,0.0,7
2006,Place des Victoires,OUI,23,18,5,2,3,OUI,OUI,2025-03-13 06:58:00+00:00,"48.8660354, 2.3420333",Paris,75056,0.21739130434782608,7
16139,Suresnes - Muette à Neuilly,OUI,26,20,6,3,3,OUI,OUI,2025-03-13 06:53:16+00:00,"48.868570404348, 2.266000919044",Paris,75056,0.23076923076923078,7
9019,Victor Massé - Jean-Baptiste Pigalle,OUI,18,15,3,0,3,OUI,OUI,2025-03-13 06:58:44+00:00,"48.8811043724, 2.3366955667734",Paris,75056,0.16666666666666666,7
42028,Verdun - Carnot,OUI,28,19,9,3,6,OUI,OUI,2025-03-13 06:59:06+00:00,"48.808439376064946, 2.373795211315155",Ivry-sur-Seine,94041,0.32142857142857145,7
44004,Place de l'Eglise - Vitry-sur-Seine,OUI,28,3,25,21,4,OUI,OUI,2025-03-13 06:59:32+00:00,"48.791922819921815, 2.395057752728462",Vitry-sur-Seine,94081,0.8928571428571429,7
12166,Parc Floral du Bel Air,OUI,23,15,8,2,6,OUI,OUI,2025-03-13 07:00:57+00:00,"48.839285711865735, 2.438560165464878",Paris,75056,0.34782608695652173,7
19046,Porte de Pantin.,OUI,31,26,5,1,4,OUI,OUI,2025-03-13 07:00:58+00:00,"48.889199725577, 2.3950181901455",Paris,75056,0.16129032258064516,7
12113,Cardinal Lavigerie,OUI,46,3,43,36,7,OUI,OUI,2025-03-13 07:00:43+00:00,"48.832934193699835, 2.402636749399156",Paris,75056,0.9347826086956522,7
2102,Saint-Marc - Feydeau,OUI,36,33,3,1,2,OUI,OUI,2025-03-13 07:01:06+00:00,"48.870326843044, 2.3418715826353",Paris,75056,0.08333333333333333,7
42019,Lampes,OUI,42,7,35,35,0,OUI,OUI,2025-03-13 07:01:02+00:00,"48.81152481985875, 2.4017931148409843",Ivry-sur-Seine,94041,0.8333333333333334,7
6029,Vaugirard - Monsieur le Prince,OUI,24,4,20,9,11,OUI,OUI,2025-03-13 07:00:36+00:00,"48.848951441614, 2.3411329463124",Paris,75056,0.8333333333333334,7
23301,Les Blagis,OUI,24,9,15,11,4,OUI,OUI,2025-03-13 07:00:25+00:00,"48.785205, 2.302526",Sceaux,92071,0.625,7
27006,Victor Hugo - Gare,OUI,19,16,3,2,1,OUI,OUI,2025-03-13 06:54:28+00:00,"48.923133952658, 2.2600970417261",Colombes,92025,0.15789473684210525,7
42210,Victor Hugo - Paul Eluard,OUI,30,4,26,25,1,OUI,OUI,2025-03-13 06:59:10+00:00,"48.819602554907, 2.4114319673051",Charenton-le-Pont,94018,0.8666666666666667,7
1015,Place André Malraux,OUI,17,8,9,8,1,OUI,OUI,2025-03-13 07:00:03+00:00,"48.863925158727, 2.3356226831675",Paris,75056,0.5294117647058824,7
20010,Sorbier - Gasnier-Guy,OUI,33,33,0,0,0,OUI,OUI,2025-03-13 06:58:44+00:00,"48.865217631011, 2.3936596512794",Paris,75056,0.0,7
1024,Coquillière - Louvre,OUI,17,15,2,2,0,OUI,OUI,2025-03-13 06:57:38+00:00,"48.863795909662, 2.3425736278296",Paris,75056,0.11764705882352941,7
10166,Strasbourg - Saint-Denis,OUI,15,11,4,3,1,OUI,OUI,2025-03-13 06:58:43+00:00,"48.869601642433, 2.3542908579111",Paris,75056,0.26666666666666666,7
2020,Danielle Casanova - Opéra,OUI,20,15,5,3,2,OUI,OUI,2025-03-13 07:00:32+00:00,"48.867643242297, 2.3333894088864",Paris,75056,0.25,7
13049,Vincent Auriol - Louise Weiss,OUI,22,19,3,2,1,OUI,OUI,2025-03-13 06:56:13+00:00,"48.834001935501, 2.3703888058662",Paris,75056,0.13636363636363635,7
6015,André Mazet - Saint-André des Arts,OUI,55,12,43,42,1,OUI,OUI,2025-03-13 06:59:17+00:00,"48.85375581057431, 2.3390958085656166",Paris,75056,0.7818181818181819,7
10201,Magenta - Chabrol,OUI,21,13,8,5,3,OUI,OUI,2025-03-13 07:00:58+00:00,"48.876495350882, 2.3560990020633",Paris,75056,0.38095238095238093,7
8202,Londres - Europe,OUI,27,24,3,1,2,OUI,OUI,2025-03-13 06:56:15+00:00,"48.878618556803, 2.3248164693922",Paris,75056,0.1111111111111111,7
12016,Saint-Mande - Picpus,OUI,34,24,10,6,4,OUI,OUI,2025-03-13 06:58:41+00:00,"48.845127728278, 2.4015686296482",Paris,75056,0.29411764705882354,7
32011,Stade de France - Francis de Pressensé,OUI,43,17,26,4,22,OUI,OUI,2025-03-13 07:00:56+00:00,"48.919141953558, 2.3620655760169",Saint-Denis,93066,0.6046511627906976,7
34013,Blanqui - Docteur Bauer,OUI,21,9,12,4,8,OUI,OUI,2025-03-13 06:59:09+00:00,"48.907735489085, 2.3407192814591",Saint-Ouen-sur-Seine,93070,0.5714285714285714,7
12202,Charenton - Wattignies,OUI,40,19,21,21,0,OUI,OUI,2025-03-13 07:00:07+00:00,"48.836919119234, 2.3916775206425",Paris,75056,0.525,7
44008,Youri Gagarine - Commune de Paris,OUI,32,3,29,11,18,OUI,OUI,2025-03-13 06:57:47+00:00,"48.782427463041, 2.3939734697342",Vitry-sur-Seine,94081,0.90625,7
23206,Béranger - Félix Faure,OUI,26,15,11,0,11,OUI,OUI,2025-03-13 07:00:10+00:00,"48.80404828621485, 2.2848263373723436",Châtillon,92020,0.4230769230769231,7
23104,Quai de Sèvres - Manufacture Nationale,OUI,26,18,8,5,3,OUI,OUI,2025-03-13 07:01:02+00:00,"48.828688, 2.22499",Sèvres,92072,0.3076923076923077,7
8040,Pierre Charron - Champs-Elysées,OUI,30,25,5,2,3,OUI,OUI,2025-03-13 06:54:24+00:00,"48.870103359864, 2.3043501377106",Paris,75056,0.16666666666666666,7
21011,Silly - Louis Blériot,OUI,23,7,16,10,6,OUI,OUI,2025-03-13 07:00:04+00:00,"48.83219045374266, 2.2340199351310734",Boulogne-Billancourt,92012,0.6956521739130435,7
10202,Bichat - Grange aux Belles,OUI,29,22,7,7,0,OUI,OUI,2025-03-13 07:00:31+00:00,"48.873688, 2.365015",Paris,75056,0.2413793103448276,7
20140,Paganini - Davout,OUI,21,12,9,3,6,OUI,OUI,2025-03-13 06:58:52+00:00,"48.85135, 2.412021",Paris,75056,0.42857142857142855,7
42030,Stéphanie Bouvard - Gambetta,OUI,29,8,21,20,1,OUI,OUI,2025-03-13 07:00:17+00:00,"48.814548138856, 2.4024386957288",Ivry-sur-Seine,94041,0.7241379310344828,7
48012,Stalingrad - Henri Luisette,OUI,26,25,1,0,1,OUI,OUI,2025-03-13 06:58:11+00:00,"48.78363092456589, 2.366935946761926",Villejuif,94076,0.038461538461538464,7
8018,Saint-Augustin,OUI,29,26,3,3,0,OUI,OUI,2025-03-13 06:58:53+00:00,"48.8762009747008, 2.319786250591278",Paris,75056,0.10344827586206896,7
23303,Gare de Robinson,OUI,29,26,3,1,2,OUI,OUI,2025-03-13 06:51:25+00:00,"48.7799259211605, 2.281828634440899",Sceaux,92071,0.10344827586206896,7
42022,Gare RER - Maurice Grandcoing,OUI,36,1,35,33,2,OUI,OUI,2025-03-13 06:58:57+00:00,"48.813881, 2.392429",Ivry-sur-Seine,94041,0.9722222222222222,7
48001,Chastenet de Géry - Marcel Paul,OUI,25,20,5,1,4,OUI,OUI,2025-03-13 06:58:30+00:00,"48.800123, 2.3567359",Villejuif,94076,0.2,7
15018,Dutot - Place Alleray,OUI,56,42,14,10,4,OUI,OUI,2025-03-13 06:57:58+00:00,"48.836826091766, 2.3071701095578",Paris,75056,0.25,7
51008,Martyrs de Châteaubriant - Jean Grandel,OUI,38,28,10,1,9,OUI,OUI,2025-03-13 06:53:22+00:00,"48.951432, 2.211214",Argenteuil,95018,0.2631578947368421,7
26012,Jardin Modèle - Pierre Boudou,OUI,15,8,7,4,3,OUI,OUI,2025-03-13 07:00:31+00:00,"48.914866710946, 2.3057010525935",Asnières-sur-Seine,92004,0.4666666666666667,7
18135,Ney - Porte de Montmartre,OUI,23,20,3,1,2,OUI,OUI,2025-03-13 06:48:11+00:00,"48.897918, 2.3364872",Paris,75056,0.13043478260869565,7
20048,Bagnolet - Place Saint-Blaise,OUI,27,21,6,1,5,OUI,OUI,2025-03-13 06:57:51+00:00,"48.85973, 2.40334",Paris,75056,0.2222222222222222,7
34011,Clef des Champs - Albert Dhalenne,OUI,26,2,24,8,16,OUI,OUI,2025-03-13 07:00:01+00:00,"48.914938, 2.330665",Saint-Ouen-sur-Seine,93070,0.9230769230769231,7
45004,République - Louis Loucheur,OUI,37,3,34,5,29,OUI,OUI,2025-03-13 07:00:09+00:00,"48.823549261189, 2.5101865455508",Champigny-sur-Marne,94017,0.918918918918919,7
21704,Place du Maréchal de Lattre de Tassigny,OUI,27,2,25,19,6,OUI,OUI,2025-03-13 06:57:52+00:00,"48.821707715257055, 2.2853431485432423",Vanves,92075,0.9259259259259259,7
23202,Henri Barbusse - Gabriel Péri,OUI,14,10,4,1,3,OUI,OUI,2025-03-13 07:00:06+00:00,"48.801773795836, 2.2874166362216",Châtillon,92020,0.2857142857142857,7
19121,Belleville -  Pré Saint-Gervais,OUI,21,19,2,0,2,OUI,OUI,2025-03-13 06:55:11+00:00,"48.875565910073, 2.3930460959673",Paris,75056,0.09523809523809523,7
32605,Mairie,OUI,19,16,3,0,3,OUI,OUI,2025-03-13 06:53:34+00:00,"48.87914304162, 2.4163350908311",Les Lilas,93045,0.15789473684210525,7
25007,Bons Raisins - Voltaire,OUI,24,20,4,1,3,OUI,OUI,2025-03-13 06:57:40+00:00,"48.87282451461399, 2.1947155570850896",Rueil-Malmaison,92063,0.16666666666666666,7
17202,Mariotte - Batignolles,OUI,18,17,1,0,1,OUI,OUI,2025-03-13 06:58:20+00:00,"48.884571659595, 2.321469503475",Paris,75056,0.05555555555555555,7
21002,Place Denfert-Rochereau,OUI,20,0,20,10,10,OUI,OUI,2025-03-13 06:59:33+00:00,"48.843252536286684, 2.245987951755524",Boulogne-Billancourt,92012,1.0,7
17020,Jouffroy d'Abbans - Malesherbes,OUI,26,7,19,7,12,OUI,OUI,2025-03-13 07:00:58+00:00,"48.8850134, 2.3070717",Paris,75056,0.7307692307692307,7
13024,Bobillot - Tolbiac,OUI,33,10,23,20,3,OUI,OUI,2025-03-13 07:00:02+00:00,"48.8255961335041, 2.350204177200794",Paris,75056,0.696969696969697,7
42024,Danielle Casanova - Ledru-Rollin,OUI,28,5,23,19,4,OUI,OUI,2025-03-13 06:59:39+00:00,"48.815783497876815, 2.383259721100331",Ivry-sur-Seine,94041,0.8214285714285714,7
20142,Mûriers - Père Lachaise,OUI,19,19,0,0,0,OUI,OUI,2025-03-13 06:53:04+00:00,"48.864130509668044, 2.39164982067019",Paris,75056,0.0,7
5027,Gobelins - Port-Royal,OUI,39,7,32,29,3,OUI,OUI,2025-03-13 07:00:35+00:00,"48.837135900263, 2.3515201359987",Paris,75056,0.8205128205128205,7
24101,Place Charles de Gaulle,OUI,24,21,3,1,2,OUI,OUI,2025-03-13 07:00:19+00:00,"48.826073335699, 2.1894485725692",Ville-d'Avray,92077,0.125,7
48006,Maxime Gorki - Paul Vaillant-Couturier,OUI,19,17,2,0,2,OUI,OUI,2025-03-13 06:59:22+00:00,"48.79673508795443, 2.3683342337608337",Villejuif,94076,0.10526315789473684,7
21329,Gare - Aristide Briand,OUI,28,9,19,14,5,OUI,OUI,2025-03-13 07:00:50+00:00,"48.821410564722, 2.2555950104387",Issy-les-Moulineaux,92040,0.6785714285714286,7
19117,Euryale Dehaynin - Loire,OUI,29,27,2,0,2,OUI,OUI,2025-03-13 06:55:36+00:00,"48.886248917304805, 2.3774591088294987",Paris,75056,0.06896551724137931,7
13015,Chevaleret - Louise Weiss,OUI,35,30,5,5,0,OUI,OUI,2025-03-13 07:00:43+00:00,"48.832586513351, 2.37121138812",Paris,75056,0.14285714285714285,7
15053,Lecourbe - Convention,OUI,46,18,28,20,8,OUI,OUI,2025-03-13 07:00:45+00:00,"48.83923319241899, 2.2915197908878326",Paris,75056,0.6086956521739131,7
19114,Manin - Secrétan,OUI,20,11,9,1,8,OUI,OUI,2025-03-13 07:00:46+00:00,"48.8791665, 2.3787959",Paris,75056,0.45,7
15041,Franquet - Labrouste,OUI,37,29,8,8,0,OUI,OUI,2025-03-13 07:00:19+00:00,"48.83287705011431, 2.306762784719467",Paris,75056,0.21621621621621623,7
12123,Château de Vincennes,OUI,50,32,18,8,10,OUI,OUI,2025-03-13 07:01:03+00:00,"48.84423193255657, 2.439209537709179",Paris,75056,0.36,7
10003,Hauteville - Bonne Nouvelle,OUI,17,14,3,2,1,OUI,OUI,2025-03-13 06:54:46+00:00,"48.87077436024, 2.3496496368327",Paris,75056,0.17647058823529413,7
24004,Paix - Verdun,OUI,30,26,4,3,1,OUI,OUI,2025-03-13 07:00:52+00:00,"48.900504, 2.261173",Courbevoie,92026,0.13333333333333333,7
11022,Roquette - Auguste Laurent,OUI,15,5,10,9,1,OUI,OUI,2025-03-13 06:57:32+00:00,"48.858001906023354, 2.381797702650783",Paris,75056,0.6666666666666666,7
23041,Général Leclerc - Bièvre,OUI,24,20,4,2,2,OUI,OUI,2025-03-13 06:57:38+00:00,"48.782414428747316, 2.3166695237159733",Bourg-la-Reine,92014,0.16666666666666666,7
41103,Place de la vache noire,OUI,22,19,3,0,3,OUI,OUI,2025-03-13 06:57:37+00:00,"48.81040517059777, 2.327060401439667",Arcueil,94003,0.13636363636363635,7
24005,Edith Cavell - Volta,OUI,32,25,7,3,4,OUI,OUI,2025-03-13 07:00:54+00:00,"48.901616564286975, 2.269354350864887",Courbevoie,92026,0.21875,7
13028,Gouthière - Poterne des Peupliers,OUI,32,27,5,4,1,OUI,OUI,2025-03-13 06:57:50+00:00,"48.820507, 2.351342",Paris,75056,0.15625,7
31104,Mairie de Rosny-sous-Bois,OUI,26,10,16,10,6,OUI,OUI,2025-03-13 07:00:45+00:00,"48.871256519012, 2.4865807592869",Rosny-sous-Bois,93064,0.6153846153846154,7
15069,Félix Faure - Convention,OUI,44,12,32,29,3,OUI,OUI,2025-03-13 06:59:13+00:00,"48.841249336041, 2.2883866008495",Paris,75056,0.7272727272727273,7
15203,Porte de Versailles,OUI,25,16,9,7,2,OUI,OUI,2025-03-13 06:57:43+00:00,"48.832324016657, 2.2875617349045",Paris,75056,0.36,7
20012,Buzenval - Vignoles,OUI,17,13,4,3,1,OUI,OUI,2025-03-13 06:59:30+00:00,"48.853858171688, 2.4000040814281",Paris,75056,0.23529411764705882,7
13116,Place du Docteur Yersin,OUI,50,48,2,0,2,OUI,OUI,2025-03-13 06:58:01+00:00,"48.82010494991975, 2.3725583776831627",Paris,75056,0.04,7
14004,Port Royal - Hôpital Cochin,OUI,22,18,4,0,4,OUI,OUI,2025-03-13 07:01:00+00:00,"48.838608030238, 2.3406994164846",Paris,75056,0.18181818181818182,7
11111,Léon Frot - Charonne,OUI,17,10,7,5,2,OUI,OUI,2025-03-13 07:00:58+00:00,"48.854963800335234, 2.387217085372007",Paris,75056,0.4117647058823529,7
48002,LCL Campus - Place Oscar Niemeyer,OUI,37,35,2,2,0,OUI,OUI,2025-03-13 06:52:37+00:00,"48.805342480621576, 2.363983690738678",Villejuif,94076,0.05405405405405406,7
15012,Cambronne - Mademoiselle,OUI,62,27,35,31,4,OUI,OUI,2025-03-13 06:59:59+00:00,"48.843277330035214, 2.30230766886348",Paris,75056,0.5645161290322581,7
30003,Moscou - Edouard Vaillant,OUI,29,19,10,3,7,OUI,OUI,2025-03-13 06:59:13+00:00,"48.90755810177, 2.4689837335263",Bobigny,93008,0.3448275862068966,7
18016,Francoeur - Caulaincourt,OUI,33,32,1,0,1,OUI,OUI,2025-03-13 06:59:59+00:00,"48.8899944409612, 2.342529706656933",Paris,75056,0.030303030303030304,7
20020,Pyrénées - Charles Renouvier,OUI,28,25,3,0,3,OUI,OUI,2025-03-13 07:00:02+00:00,"48.86095933229224, 2.400421852042113",Paris,75056,0.10714285714285714,7
21022,Dôme - République,OUI,23,12,11,10,1,OUI,OUI,2025-03-13 07:00:43+00:00,"48.832681, 2.250257",Boulogne-Billancourt,92012,0.4782608695652174,7
12008,Hector Malot - Daumesnil,OUI,53,5,48,47,1,OUI,OUI,2025-03-13 07:00:17+00:00,"48.84693552991762, 2.3770876228809357",Paris,75056,0.9056603773584906,7
20003,Pyrénées - Cours de Vincennes,OUI,19,0,19,3,16,OUI,OUI,2025-03-13 06:53:57+00:00,"48.847796779935, 2.4061721563339",Paris,75056,1.0,7
12102,Bercy - Traversiére,OUI,29,20,9,8,1,OUI,OUI,2025-03-13 07:00:34+00:00,"48.846192642574, 2.3703800886869",Paris,75056,0.3103448275862069,7
41602,Place Charles Digeon,OUI,29,25,4,4,0,OUI,OUI,2025-03-13 06:58:49+00:00,"48.84354203133597, 2.418427169322968",Saint-Mandé,94067,0.13793103448275862,7
13120,Pierre Joseph Desault,OUI,18,2,16,16,0,OUI,OUI,2025-03-13 06:59:46+00:00,"48.82110230800372, 2.378775402903557",Paris,75056,0.8888888888888888,7
14027,Gergovie - Alésia,OUI,54,52,2,0,2,OUI,OUI,2025-03-13 07:00:47+00:00,"48.83088717455243, 2.318882101207347",Paris,75056,0.037037037037037035,7
13006,Duméril - Jeanne d'Arc,OUI,39,15,24,21,3,OUI,OUI,2025-03-13 06:59:48+00:00,"48.838151608087, 2.3571084495564",Paris,75056,0.6153846153846154,7
42303,Place Eustache Deschamps,OUI,20,9,11,6,5,OUI,OUI,2025-03-13 07:00:54+00:00,"48.793855, 2.336637",Cachan,94016,0.55,7
15050,Dominique Pado - Croix Nivert,OUI,22,9,13,12,1,OUI,OUI,2025-03-13 06:58:46+00:00,"48.83648798164934, 2.2897250577807426",Paris,75056,0.5909090909090909,7
41605,Général De Gaulle - Vivien,OUI,21,8,13,4,9,OUI,OUI,2025-03-13 07:00:36+00:00,"48.83607420090204, 2.4189166724681854",Saint-Mandé,94067,0.6190476190476191,7
16025,Jean de la Fontaine - Boulainvilliers,OUI,66,20,46,39,7,OUI,OUI,2025-03-13 06:59:42+00:00,"48.85264791461651, 2.2758664190769196",Paris,75056,0.696969696969697,7
35013,Guillaume Tell - Parc Henri Barbusse,OUI,20,13,7,1,6,OUI,OUI,2025-03-13 06:58:31+00:00,"48.88958925894009, 2.4198862910270695",Pantin,93055,0.35,7
13036,Olympiades,OUI,36,23,13,3,10,OUI,OUI,2025-03-13 07:00:32+00:00,"48.826764665199, 2.3650860786438",Paris,75056,0.3611111111111111,7
15024,Suffren - La Motte-Piquet,OUI,22,3,19,16,3,OUI,OUI,2025-03-13 06:59:36+00:00,"48.850881230919, 2.3012199997902",Paris,75056,0.8636363636363636,7
43004,Montreuil - République,OUI,22,17,5,1,4,OUI,OUI,2025-03-13 06:59:30+00:00,"48.85026349463687, 2.4345204234123234",Vincennes,94080,0.22727272727272727,7
12119,Dom-Pérignon - Gravelle,OUI,47,14,33,29,4,OUI,OUI,2025-03-13 07:00:51+00:00,"48.825481574435, 2.409880310297",Paris,75056,0.7021276595744681,7
14009,Tombe Issoire - René Coty,OUI,34,29,5,1,4,OUI,OUI,2025-03-13 06:59:57+00:00,"48.830512876709, 2.3343613743782",Paris,75056,0.14705882352941177,7
43007,Hôtel de Ville de Vincennes,OUI,26,18,8,4,4,OUI,OUI,2025-03-13 07:00:14+00:00,"48.84827609706963, 2.4398955702781677",Vincennes,94080,0.3076923076923077,7
17117,Pereire - Saussure,OUI,32,18,14,14,0,OUI,OUI,2025-03-13 07:00:40+00:00,"48.888229075478, 2.3101296275854",Paris,75056,0.4375,7
16116,George Sand - Jean de La Fontaine,OUI,29,5,24,20,4,OUI,OUI,2025-03-13 06:59:08+00:00,"48.84986918764119, 2.268257387525699",Paris,75056,0.8275862068965517,7
16017,Siam - La Pompe,OUI,16,14,2,0,2,OUI,OUI,2025-03-13 06:59:44+00:00,"48.861720329027264, 2.275346568555312",Paris,75056,0.125,7
5033,Saint-Séverin - Saint-Michel,OUI,30,7,23,20,3,OUI,OUI,2025-03-13 06:59:59+00:00,"48.852731305488, 2.3440927639604",Paris,75056,0.7666666666666667,7
18021,Marcadet - Ramey,OUI,21,17,4,3,1,OUI,OUI,2025-03-13 07:00:53+00:00,"48.890875, 2.3449019",Paris,75056,0.19047619047619047,7
15045,Porte de la Plaine,OUI,35,26,9,7,2,OUI,OUI,2025-03-13 06:58:59+00:00,"48.82805169605981, 2.2924277186393742",Paris,75056,0.2571428571428571,7
20013,Alexandre Dumas - Place de la Réunion,OUI,44,41,3,0,3,OUI,OUI,2025-03-13 06:57:08+00:00,"48.85533710742046, 2.3997703687646292",Paris,75056,0.06818181818181818,7
25004,Marcel Pourtout - Édouard Manet,OUI,24,0,24,19,5,OUI,OUI,2025-03-13 06:58:36+00:00,"48.87555620763429, 2.1655967831611638",Rueil-Malmaison,92063,1.0,7
21023,Ancienne Mairie - André Morizet,OUI,25,12,13,7,6,OUI,OUI,2025-03-13 07:00:53+00:00,"48.838311, 2.234077",Boulogne-Billancourt,92012,0.52,7
12022,Sahel - Général Michel Bizot,OUI,30,15,15,13,2,OUI,OUI,2025-03-13 06:59:58+00:00,"48.840872964793355, 2.4044444784522057",Paris,75056,0.5,7
17110,Legendre - Nollet,OUI,29,23,6,1,5,OUI,OUI,2025-03-13 06:59:28+00:00,"48.887742186754224, 2.320293079881375",Paris,75056,0.20689655172413793,7
15027,Duhamel - André Gide,OUI,20,14,6,1,5,OUI,OUI,2025-03-13 06:59:27+00:00,"48.8365662244334, 2.312707121097412",Paris,75056,0.3,7
20014,Charonne - Alexandre Dumas,OUI,34,26,8,3,5,OUI,OUI,2025-03-13 07:00:01+00:00,"48.856077415056, 2.3948693275452",Paris,75056,0.23529411764705882,7
31105,Lavoisier - Missak Manouchian,OUI,13,3,10,2,8,OUI,OUI,2025-03-13 06:54:31+00:00,"48.86286468896063, 2.495676465332508",Rosny-sous-Bois,93064,0.7692307692307693,7
30004,Jean Jaurès - Place de la Libération,OUI,28,4,24,10,14,OUI,OUI,2025-03-13 06:59:24+00:00,"48.90617751921, 2.4391458057475",Bobigny,93008,0.8571428571428571,7
42205,Place Aristide Briand,OUI,35,10,25,15,10,OUI,OUI,2025-03-13 06:54:18+00:00,"48.82189236575831, 2.413003742694855",Charenton-le-Pont,94018,0.7142857142857143,7
14035,Maine - Jean Zay,OUI,45,34,11,4,7,OUI,OUI,2025-03-13 07:01:02+00:00,"48.837925263898, 2.3225428909063",Paris,75056,0.24444444444444444,7
22701,Général Leclerc - République,OUI,28,4,24,18,6,OUI,OUI,2025-03-13 06:59:18+00:00,"48.915885074177, 2.2682306702811",Bois-Colombes,92009,0.8571428571428571,7
8046,Marceau - Président Wilson,OUI,29,27,2,1,1,OUI,OUI,2025-03-13 06:57:43+00:00,"48.8652359, 2.3002513",Paris,75056,0.06896551724137931,7
31701,Mairie de Bagnolet,OUI,28,19,9,2,7,OUI,OUI,2025-03-13 07:00:33+00:00,"48.868421318555, 2.4179587885737",Bagnolet,93006,0.32142857142857145,7
8007,Rome - Provence,OUI,29,9,20,18,2,OUI,OUI,2025-03-13 06:58:39+00:00,"48.874230055580306, 2.325570111724113",Paris,75056,0.6896551724137931,7
22404,Pierre Brossolette - 12 Février 1934,OUI,24,19,5,1,4,OUI,OUI,2025-03-13 07:00:29+00:00,"48.8176962416867, 2.3076123744249344",Malakoff,92046,0.20833333333333334,7
6028,Quatre Vents - Carrefour de l'Odéon,OUI,37,25,12,12,0,OUI,OUI,2025-03-13 06:59:06+00:00,"48.851751374458864, 2.338161695134053",Paris,75056,0.32432432432432434,7
20032,Square des Amandiers,OUI,25,24,1,1,0,OUI,OUI,2025-03-13 07:00:20+00:00,"48.86615630668046, 2.3891324177384377",Paris,75056,0.04,7
20005,Reynaldo Hahn - Lagny,OUI,19,17,2,1,1,OUI,OUI,2025-03-13 06:55:16+00:00,"48.849266043601794, 2.412330328844772",Paris,75056,0.10526315789473684,7
20110,Gambetta - Tourelles,OUI,20,18,2,0,2,OUI,OUI,2025-03-13 07:00:25+00:00,"48.875337902264, 2.4059921130538",Paris,75056,0.1,7
21207,Verdier - République,OUI,29,21,8,5,3,OUI,OUI,2025-03-13 06:56:59+00:00,"48.815403766277, 2.31739372015",Montrouge,92049,0.27586206896551724,7
14005,René Coty - Place Denfert-Rochereau,OUI,36,2,34,12,22,OUI,OUI,2025-03-13 07:00:00+00:00,"48.833056477316, 2.3329411447048",Paris,75056,0.9444444444444444,7
15120,Colonel Pierre Avia,OUI,29,20,9,8,1,OUI,OUI,2025-03-13 06:58:35+00:00,"48.8296843300915, 2.275342586850291",Paris,75056,0.3103448275862069,7
21218,Gabriel Péri - Place de la Libération,OUI,17,13,4,0,4,OUI,OUI,2025-03-13 06:59:51+00:00,"48.819828421929, 2.3117361743705",Montrouge,92049,0.23529411764705882,7
21205,Arthur Auger - Jean Jaurès,OUI,23,18,5,1,4,OUI,OUI,2025-03-13 06:59:40+00:00,"48.813736445585235, 2.3069277405738835",Montrouge,92049,0.21739130434782608,7
17006,Guy Môquet - Compoint,OUI,34,21,13,10,3,OUI,OUI,2025-03-13 07:01:06+00:00,"48.89213559044868, 2.32321947813034",Paris,75056,0.38235294117647056,7
15114,Pasteur - Cotentin,OUI,33,23,10,3,7,OUI,OUI,2025-03-13 07:00:34+00:00,"48.8389284, 2.316356",Paris,75056,0.30303030303030304,7
18101,Championnet.,OUI,21,10,11,3,8,OUI,OUI,2025-03-13 07:00:45+00:00,"48.8953643, 2.3498166",Paris,75056,0.5238095238095238,7
11029,Ménilmontant - Oberkampf,OUI,39,33,6,1,5,OUI,OUI,2025-03-13 06:58:41+00:00,"48.866617658681, 2.3830134404158",Paris,75056,0.15384615384615385,7
11016,Philippe-Auguste,OUI,48,31,17,4,13,OUI,OUI,2025-03-13 06:58:19+00:00,"48.851853488265, 2.3932945355773",Paris,75056,0.3541666666666667,7
11028,Guillaume Bertrand - République,OUI,38,13,25,11,14,OUI,OUI,2025-03-13 07:00:44+00:00,"48.863825174341, 2.380906377155",Paris,75056,0.6578947368421053,7
12122,Bois de Vincennes - Polygone,OUI,50,45,5,3,2,OUI,OUI,2025-03-13 06:54:26+00:00,"48.83544491617421, 2.431421081436563",Paris,75056,0.1,7
22014,Victor Hugo - Bineau,OUI,25,16,9,5,4,OUI,OUI,2025-03-13 07:00:24+00:00,"48.88758225888669, 2.2783890366554265",Neuilly-sur-Seine,92051,0.36,7
16033,Marché d'Auteuil,OUI,31,16,15,15,0,OUI,OUI,2025-03-13 07:00:00+00:00,"48.84842761367387, 2.265253821160005",Paris,75056,0.4838709677419355,7
21027,Fief - République,OUI,24,16,8,5,3,OUI,OUI,2025-03-13 07:00:56+00:00,"48.83170888166024, 2.255771979689598",Boulogne-Billancourt,92012,0.3333333333333333,7
16023,Passy - Place du Costa Rica,OUI,30,22,8,3,5,OUI,OUI,2025-03-13 07:00:27+00:00,"48.8584893, 2.2839655",Paris,75056,0.26666666666666666,7
15044,Dantzig - Lefebvre,OUI,33,29,4,0,4,OUI,OUI,2025-03-13 06:54:41+00:00,"48.83013921586756, 2.295934036374092",Paris,75056,0.12121212121212122,7
24007,Jean-Baptiste Charcot - Sainte-Geneviève,OUI,21,15,6,2,4,OUI,OUI,2025-03-13 06:58:43+00:00,"48.90310883721567, 2.278892956674099",Courbevoie,92026,0.2857142857142857,7
25002,Hôtel de Ville de Rueil-Malmaison,OUI,19,7,12,12,0,OUI,OUI,2025-03-13 06:59:50+00:00,"48.878194, 2.181724",Rueil-Malmaison,92063,0.631578947368421,7
6004,Regard - Rennes,OUI,46,40,6,4,2,OUI,OUI,2025-03-13 07:00:57+00:00,"48.847385404956, 2.3268555477262",Paris,75056,0.13043478260869565,7
15113,Arsonval - Falguière,OUI,24,23,1,1,0,OUI,OUI,2025-03-13 06:56:22+00:00,"48.84040040365445, 2.313117867297474",Paris,75056,0.041666666666666664,7
19014,Lorraine - Jean Jaurès,OUI,19,14,5,2,3,OUI,OUI,2025-03-13 06:56:49+00:00,"48.8863865, 2.3825772",Paris,75056,0.2631578947368421,7
20011,Pyrénées - Dagorno,OUI,20,18,2,0,2,OUI,OUI,2025-03-13 06:58:22+00:00,"48.855425770695085, 2.4051643162965775",Paris,75056,0.1,7
15014,Volontaires - Vaugirard,OUI,33,20,13,11,2,OUI,OUI,2025-03-13 07:00:04+00:00,"48.84132050184004, 2.30808901725357",Paris,75056,0.3939393939393939,7
6020,Place Saint-André des Arts,OUI,33,16,17,13,4,OUI,OUI,2025-03-13 06:59:24+00:00,"48.852886173881, 2.3426544293761",Paris,75056,0.5151515151515151,7
13055,M.- A. Lagroua Weill-Hallé -  F. Dolto,OUI,59,48,11,5,6,OUI,OUI,2025-03-13 06:57:44+00:00,"48.828595283857425, 2.380220606266108",Paris,75056,0.1864406779661017,7
21007,Rond-Point Rhin et Danube,OUI,53,44,9,1,8,OUI,OUI,2025-03-13 06:59:04+00:00,"48.840452820991764, 2.2280225157737736",Boulogne-Billancourt,92012,0.16981132075471697,7
6005,Montparnasse -  Square Ozanam,OUI,49,23,26,22,4,OUI,OUI,2025-03-13 06:59:20+00:00,"48.843310567822, 2.3265242949128",Paris,75056,0.5306122448979592,7
19007,Flandre - Ourcq,OUI,29,22,7,2,5,OUI,OUI,2025-03-13 06:59:34+00:00,"48.89260159189023, 2.3790915682911873",Paris,75056,0.2413793103448276,7
16022,Jean Bologne - Passy,OUI,19,18,1,1,0,OUI,OUI,2025-03-13 06:55:17+00:00,"48.857566889784465, 2.280027395306772",Paris,75056,0.05263157894736842,7
21016,Point du Jour - Jean Jaurès,OUI,39,16,23,21,2,OUI,OUI,2025-03-13 06:57:38+00:00,"48.828753141436465, 2.245911467014621",Boulogne-Billancourt,92012,0.5897435897435898,7
19001,Crimée - Ourcq,OUI,55,43,12,10,2,OUI,OUI,2025-03-13 06:58:17+00:00,"48.894104140316, 2.3729460884673",Paris,75056,0.21818181818181817,7
11018,Saint-Maur - République,OUI,37,16,21,11,10,OUI,OUI,2025-03-13 07:00:53+00:00,"48.864185861455, 2.3783174157143",Paris,75056,0.5675675675675675,7
21107,Bertrand Sincholle - Henri Barbusse,OUI,18,9,9,9,0,OUI,OUI,2025-03-13 07:00:53+00:00,"48.89925982394349, 2.3042294383049016",Clichy,92024,0.5,7
13023,Bobillot - Moulin des Prés,OUI,28,21,7,3,4,OUI,OUI,2025-03-13 07:00:37+00:00,"48.828657346203, 2.353020646317",Paris,75056,0.25,7
13037,Ivry - Baudricourt,OUI,19,7,12,6,6,OUI,OUI,2025-03-13 06:56:38+00:00,"48.824695995415006, 2.363106073577468",Paris,75056,0.631578947368421,7
12040,Porte de Charenton,OUI,66,43,23,9,14,OUI,OUI,2025-03-13 07:00:36+00:00,"48.831240105856, 2.3989107459784",Paris,75056,0.3484848484848485,7
5031,Lacépède - Linné,OUI,52,41,11,7,4,OUI,OUI,2025-03-13 07:01:06+00:00,"48.8437035476636, 2.354651279747486",Paris,75056,0.21153846153846154,7
20106,Mairie du 20ème,OUI,27,24,3,0,3,OUI,OUI,2025-03-13 06:56:30+00:00,"48.865302324275, 2.3990669846535",Paris,75056,0.1111111111111111,7
14025,Jacquier - Didot,OUI,30,30,0,0,0,OUI,OUI,2025-03-13 07:00:43+00:00,"48.82953336292279, 2.318179272115231",Paris,75056,0.0,7
5105,Geoffroy-Saint-Hilaire - Saint-Marcel,OUI,17,3,14,11,3,OUI,OUI,2025-03-13 06:59:47+00:00,"48.83907826424974, 2.356877340669728",Paris,75056,0.8235294117647058,7
42027,Verdun - Pierre et Marie Curie,OUI,26,24,2,0,2,OUI,OUI,2025-03-13 06:57:58+00:00,"48.812822398263286, 2.3707106709480286",Ivry-sur-Seine,94041,0.07692307692307693,7
19123,Metz - Marne,OUI,30,29,1,0,1,OUI,OUI,2025-03-13 06:59:00+00:00,"48.891163, 2.3865705",Paris,75056,0.03333333333333333,7
16104,Paul Valery - Victor Hugo,OUI,33,32,1,0,1,OUI,OUI,2025-03-13 06:58:03+00:00,"48.87137406080164, 2.2887128591537476",Paris,75056,0.030303030303030304,7
22007,Commandant Charcot - Bretteville,OUI,32,5,27,15,12,OUI,OUI,2025-03-13 06:59:59+00:00,"48.87530570765423, 2.2558460757136345",Neuilly-sur-Seine,92051,0.84375,7
20033,Etienne Dolet - Place Maurice Chevalier,OUI,45,23,22,9,13,OUI,OUI,2025-03-13 06:59:39+00:00,"48.86798303359366, 2.3851405311143026",Paris,75056,0.4888888888888889,7
12039,Général Michel Bizot - Claude Decaen,OUI,35,10,25,19,6,OUI,OUI,2025-03-13 07:00:57+00:00,"48.83481262982544, 2.400927788127704",Paris,75056,0.7142857142857143,7
30005,Convention - Campus de Bobigny,OUI,29,21,8,1,7,OUI,OUI,2025-03-13 07:00:10+00:00,"48.914920058264, 2.4172238067445",Bobigny,93008,0.27586206896551724,7
12017,Saint-Mandé - Docteur Arnold Netter,OUI,36,9,27,19,8,OUI,OUI,2025-03-13 06:58:34+00:00,"48.84462585769668, 2.404946386814118",Paris,75056,0.75,7
6009,Guynemer - Jardin du Luxembourg,OUI,33,20,13,9,4,OUI,OUI,2025-03-13 06:59:50+00:00,"48.8466127, 2.3325478",Paris,75056,0.3939393939393939,7
17050,Batignolles - Abel Truchet,OUI,26,25,1,0,1,OUI,OUI,2025-03-13 06:54:33+00:00,"48.883103904582, 2.3238347490884",Paris,75056,0.038461538461538464,7
21510,Fontaine du Tertre - Calvaire,OUI,22,21,1,0,1,OUI,OUI,2025-03-13 07:00:22+00:00,"48.8702539, 2.2187778",Suresnes,92073,0.045454545454545456,7
13013,Saint-Marcel - Hôpital,OUI,20,17,3,1,2,OUI,OUI,2025-03-13 06:59:51+00:00,"48.839504424583, 2.3609894170229",Paris,75056,0.15,7
11040,Temple - Jean-Pierre Timbaud,OUI,32,16,16,15,1,OUI,OUI,2025-03-13 06:59:30+00:00,"48.86446597201, 2.3660597205162",Paris,75056,0.5,7
8044,Alfred de Vigny - Place du Général Brocard,OUI,32,27,5,1,4,OUI,OUI,2025-03-13 07:01:02+00:00,"48.87836138361425, 2.305254448220567",Paris,75056,0.15625,7
21511,Marcel Monge - Marcel Dassault,OUI,46,18,28,27,1,OUI,OUI,2025-03-13 07:00:30+00:00,"48.86096384533371, 2.2246733296048142",Suresnes,92073,0.6086956521739131,7
1201,Perrault - Place du Louvre,OUI,27,15,12,11,1,OUI,OUI,2025-03-13 07:00:38+00:00,"48.860273568996, 2.3412468419093",Paris,75056,0.4444444444444444,7
21112,Claude Debussy - Marc Bloch,OUI,52,41,11,9,2,OUI,OUI,2025-03-13 07:00:33+00:00,"48.910388180512, 2.3117771744728",Clichy,92024,0.21153846153846154,7
51007,Résistance - Romain Rolland,OUI,28,21,7,0,7,OUI,OUI,2025-03-13 06:54:46+00:00,"48.950873482371, 2.2310190077797",Argenteuil,95018,0.25,7
25009,Place des Arts - Jean Mermoz,OUI,20,2,18,12,6,OUI,OUI,2025-03-13 07:00:13+00:00,"48.880391139734, 2.1832160452221",Rueil-Malmaison,92063,0.9,7
17036,Place Tristan Bernard,OUI,28,20,8,3,5,OUI,OUI,2025-03-13 07:00:30+00:00,"48.8794936, 2.2915423",Paris,75056,0.2857142857142857,7
26010,Louis Armand - Bernard Palissy,OUI,15,4,11,8,3,OUI,OUI,2025-03-13 06:58:08+00:00,"48.916974, 2.313384",Asnières-sur-Seine,92004,0.7333333333333333,7
13008,Place d'Italie - Soeur Rosalie,OUI,52,34,18,5,13,OUI,OUI,2025-03-13 06:59:03+00:00,"48.831908520394, 2.3546943448098",Paris,75056,0.34615384615384615,7
20030,Ménilmontant - Père Lachaise,OUI,40,28,12,0,12,OUI,OUI,2025-03-13 06:59:58+00:00,"48.863287291502, 2.3869940266013",Paris,75056,0.3,7
11038,Temple - Charlot,OUI,41,9,32,31,1,OUI,OUI,2025-03-13 07:00:26+00:00,"48.865709343796, 2.3652737250724",Paris,75056,0.7804878048780488,7
23106,Pavé des Gardes - Charles Vaillant,OUI,20,11,9,9,0,OUI,OUI,2025-03-13 07:00:10+00:00,"48.81168551728, 2.2111820107205",Sèvres,92072,0.45,7
21033,Sèvres - Maréchal Juin,OUI,17,6,11,10,1,OUI,OUI,2025-03-13 07:00:46+00:00,"48.8324305, 2.2292812",Boulogne-Billancourt,92012,0.6470588235294118,7
21508,Georges Pompidou - Verdun,OUI,24,2,22,11,11,OUI,OUI,2025-03-13 06:59:24+00:00,"48.875481, 2.232443",Suresnes,92073,0.9166666666666666,7
8003,Galilée - Vernet,OUI,47,42,5,0,5,OUI,OUI,2025-03-13 06:56:25+00:00,"48.871715878697, 2.2985444962978",Paris,75056,0.10638297872340426,7
15032,Félix Faure - Lourmel,OUI,54,15,39,37,2,OUI,OUI,2025-03-13 07:00:32+00:00,"48.83868901709515, 2.2818081825971603",Paris,75056,0.7222222222222222,7
22703,Place Jean Mermoz,OUI,27,16,11,4,7,OUI,OUI,2025-03-13 06:58:01+00:00,"48.9220937, 2.2718348",Bois-Colombes,92009,0.4074074074074074,7
20037,Gambetta - Saint Fargeau,OUI,24,23,1,0,1,OUI,OUI,2025-03-13 06:54:08+00:00,"48.871244610447015, 2.4039056897163396",Paris,75056,0.041666666666666664,7
24010,Charles de Gaulle - Rue de l'Alma,OUI,27,12,15,6,9,OUI,OUI,2025-03-13 06:59:55+00:00,"48.896620592993, 2.252313240191",Courbevoie,92026,0.5555555555555556,7
19045,Macdonald - Césaria Evora,OUI,65,53,12,3,9,OUI,OUI,2025-03-13 07:00:43+00:00,"48.89883, 2.37933",Paris,75056,0.18461538461538463,7
41101,Paul Doumer - Stalingrad,OUI,24,16,8,5,3,OUI,OUI,2025-03-13 06:58:02+00:00,"48.806518992199, 2.3368880152702",Arcueil,94003,0.3333333333333333,7
13053,Chevaleret - Tolbiac,OUI,21,6,15,7,8,OUI,OUI,2025-03-13 07:00:43+00:00,"48.82941, 2.375934",Paris,75056,0.7142857142857143,7
16140,Hippodrome de Longchamp,OUI,25,2,23,21,2,OUI,OUI,2025-03-13 06:59:40+00:00,"48.86413226532, 2.239905372262",Paris,75056,0.92,7
9029,Saint-Lazare - Place d'Estienne d'Orves,OUI,39,35,4,2,2,OUI,OUI,2025-03-13 06:58:51+00:00,"48.8768345, 2.3329067",Paris,75056,0.10256410256410256,7
3201,Payenne - Square George Caïn,OUI,23,10,13,9,4,OUI,OUI,2025-03-13 07:01:05+00:00,"48.8578329, 2.3622643",Paris,75056,0.5652173913043478,7
48011,Epi d'Or - Chevilly,OUI,20,16,4,0,4,OUI,OUI,2025-03-13 07:00:30+00:00,"48.781109786782, 2.3549050362061",Villejuif,94076,0.2,7
20035,Pyrénées - Ménilmontant,OUI,25,24,1,0,1,OUI,OUI,2025-03-13 07:01:03+00:00,"48.8693268535238, 2.395084574818611",Paris,75056,0.04,7
34009,Dora Maar - Nadia Guendouz,OUI,27,5,22,13,9,OUI,OUI,2025-03-13 07:00:09+00:00,"48.905452421305, 2.3220406472683",Saint-Ouen-sur-Seine,93070,0.8148148148148148,7
22302,Gare RER - Général de Gaulle,OUI,38,24,14,9,5,OUI,OUI,2025-03-13 06:57:34+00:00,"48.933548439566, 2.3064726536317",Gennevilliers,92036,0.3684210526315789,7
7007,Musée d'Orsay,OUI,64,28,36,33,3,OUI,OUI,2025-03-13 06:59:11+00:00,"48.859726157909, 2.3258604481816",Paris,75056,0.5625,7
22208,Stalingrad - Barbara,OUI,19,18,1,0,1,OUI,OUI,2025-03-13 06:58:48+00:00,"48.809223658808, 2.3175904558822",Bagneux,92007,0.05263157894736842,7
41212,Nungesser - Santé,OUI,22,20,2,0,2,OUI,OUI,2025-03-13 07:01:02+00:00,"48.852335, 2.448967",Fontenay-sous-Bois,94033,0.09090909090909091,7
45005,Stalingrad - Général de Gaulle,OUI,26,9,17,5,12,OUI,OUI,2025-03-13 06:58:32+00:00,"48.823450589614, 2.4965062363218",Champigny-sur-Marne,94017,0.6538461538461539,7
41304,Port - Maurice Chevalier,OUI,29,5,24,23,1,OUI,OUI,2025-03-13 06:59:42+00:00,"48.832474421632, 2.490257616467",Nogent-sur-Marne,94052,0.8275862068965517,7
18045,Pierre Ginier - Clichy,OUI,15,14,1,0,1,OUI,OUI,2025-03-13 06:56:01+00:00,"48.8867667, 2.326228",Paris,75056,0.06666666666666667,7
10151,Gare du Nord - Faubourg Saint-Denis,OUI,28,16,12,6,6,OUI,OUI,2025-03-13 07:00:39+00:00,"48.879612765504, 2.3568402975798",Paris,75056,0.42857142857142855,7
14110,Abbé Carton - Plantes,OUI,25,20,5,0,5,OUI,OUI,2025-03-13 07:00:39+00:00,"48.827673823166, 2.3209181427956",Paris,75056,0.2,7
8031,Jean Mermoz - Champs-Elysées,OUI,44,41,3,0,3,OUI,OUI,2025-03-13 06:59:43+00:00,"48.869689856852, 2.3107324540615",Paris,75056,0.06818181818181818,7
22305,Jean Jaurès - Place du Dr Roux,OUI,34,21,13,6,7,OUI,OUI,2025-03-13 07:00:06+00:00,"48.927567032796, 2.2947337017374",Gennevilliers,92036,0.38235294117647056,7
26011,Ménil - Argenteuil,OUI,17,5,12,9,3,OUI,OUI,2025-03-13 06:59:33+00:00,"48.925901818305, 2.2741496502338",Asnières-sur-Seine,92004,0.7058823529411765,7
11201,Faubourg St-Antoine - Place de la Nation,OUI,16,3,13,2,11,OUI,OUI,2025-03-13 06:59:56+00:00,"48.8487726, 2.393606",Paris,75056,0.8125,7
22209,Verdun - Henri Barbusse,OUI,23,18,5,0,5,OUI,OUI,2025-03-13 06:55:42+00:00,"48.802056061754, 2.3159965061736",Bagneux,92007,0.21739130434782608,7
22602,Place Henri Dunant - Gare RER,OUI,30,23,7,2,5,OUI,OUI,2025-03-13 06:58:33+00:00,"48.788093281931, 2.2909234046643",Fontenay-aux-Roses,92032,0.23333333333333334,7
35021,Cartier Bresson - Denis Papin,OUI,31,24,7,3,4,OUI,OUI,2025-03-13 07:00:50+00:00,"48.902616, 2.397814",Pantin,93055,0.22580645161290322,7
32023,Guy Môquet - Jean Moulin,OUI,28,4,24,11,13,OUI,OUI,2025-03-13 07:01:04+00:00,"48.940931521020836, 2.363948999931771",Saint-Denis,93066,0.8571428571428571,7
18018,Carpeaux - Place Jacques Froment,OUI,17,8,9,2,7,OUI,OUI,2025-03-13 07:00:02+00:00,"48.8906542, 2.3309428",Paris,75056,0.5294117647058824,7
23201,Avenir,OUI,42,35,7,0,7,OUI,OUI,2025-03-13 06:59:56+00:00,"48.8103438, 2.3003776",Châtillon,92020,0.16666666666666666,7
10025,Jemmapes - Ecluses Saint-Martin,OUI,14,4,10,4,6,OUI,OUI,2025-03-13 07:00:45+00:00,"48.87748519186726, 2.3660067468881607",Paris,75056,0.7142857142857143,7
12001,Bastille - Biscornet,OUI,58,18,40,37,3,OUI,OUI,2025-03-13 07:00:19+00:00,"48.851355779579, 2.369220033288",Paris,75056,0.6896551724137931,7
32305,Saint-Germain - Verdun,OUI,29,22,7,0,7,OUI,OUI,2025-03-13 06:59:20+00:00,"48.882877330093, 2.4331868384644",Romainville,93063,0.2413793103448276,7
21320,Président Roosevelt - Rouget de Lisle,OUI,40,29,11,7,4,OUI,OUI,2025-03-13 07:00:25+00:00,"48.83047518749, 2.2616135525345",Issy-les-Moulineaux,92040,0.275,7
21954,Val-Fleury,OUI,22,15,7,2,5,OUI,OUI,2025-03-13 06:57:13+00:00,"48.807671407991, 2.2407217696309",Meudon,92048,0.3181818181818182,7
11001,Richard Lenoir - Place de la Bastille,OUI,46,21,25,20,5,OUI,OUI,2025-03-13 06:59:36+00:00,"48.8538327, 2.3697222",Paris,75056,0.5434782608695652,7
22507,Châteaudun - Place de la Liberté,OUI,25,18,7,3,4,OUI,OUI,2025-03-13 06:57:46+00:00,"48.90970830301211, 2.2454486480600626",La Garenne-Colombes,92035,0.28,7
17127,Porte de Clichy - Place des Nations Unies,OUI,36,9,27,27,0,OUI,OUI,2025-03-13 06:59:42+00:00,"48.896737263309504, 2.310542999196392",Paris,75056,0.75,7
12106,Gare de Lyon - Roland Barthes,OUI,68,32,36,27,9,OUI,OUI,2025-03-13 07:00:15+00:00,"48.84395729494058, 2.3790882155299187",Paris,75056,0.5294117647058824,7
31303,Simone Signoret - Paris,OUI,26,16,10,5,5,OUI,OUI,2025-03-13 06:56:09+00:00,"48.903600624712865, 2.465406596265139",Noisy-le-Sec,93053,0.38461538461538464,7
23205,Parc des Pierrettes,OUI,22,18,4,0,4,OUI,OUI,2025-03-13 06:57:02+00:00,"48.7973062, 2.2909969",Châtillon,92020,0.18181818181818182,7
5107,Pontoise - La Tournelle,OUI,22,5,17,16,1,OUI,OUI,2025-03-13 07:00:37+00:00,"48.850458009188, 2.3524542754922",Paris,75056,0.7727272727272727,7
25010,Maréchal Leclerc de Hauteclocque - Marché Buzenval,OUI,30,22,8,5,3,OUI,OUI,2025-03-13 06:58:36+00:00,"48.858446, 2.192077",Rueil-Malmaison,92063,0.26666666666666666,7
10026,Gare de l'Est - Chateau Landon,OUI,52,45,7,4,3,OUI,OUI,2025-03-13 06:58:51+00:00,"48.879305, 2.362424",Paris,75056,0.1346153846153846,7
12165,Champs de Manoeuvre - Cartoucherie,OUI,32,25,7,5,2,OUI,OUI,2025-03-13 06:56:53+00:00,"48.835261, 2.447974",Paris,75056,0.21875,7
17010,Jonquière - Docteur Paul Brousse,OUI,38,11,27,22,5,OUI,OUI,2025-03-13 07:00:49+00:00,"48.894799816683985, 2.318705212173216",Paris,75056,0.7105263157894737,7
22018,Charles de Gaulle - Les Sablons,OUI,35,29,6,3,3,OUI,OUI,2025-03-13 06:57:19+00:00,"48.880987514929, 2.2715748726513",Neuilly-sur-Seine,92051,0.17142857142857143,7
18026,Ruisseau - Ordener,OUI,31,29,2,1,1,OUI,OUI,2025-03-13 06:56:38+00:00,"48.89299462568024, 2.340144887566567",Paris,75056,0.06451612903225806,7
21327,Jean Bouin - Gouverneur Général Eboué,OUI,31,9,22,22,0,OUI,OUI,2025-03-13 06:58:39+00:00,"48.824792734266, 2.2651904328524",Issy-les-Moulineaux,92040,0.7096774193548387,7
18024,Clignancourt - Ordener,OUI,34,28,6,3,3,OUI,OUI,2025-03-13 06:57:48+00:00,"48.891457726153774, 2.348636478060487",Paris,75056,0.17647058823529413,7
23203,Division Leclerc - Kléber,OUI,25,8,17,5,12,OUI,OUI,2025-03-13 06:57:31+00:00,"48.798666226364, 2.2833752789972",Châtillon,92020,0.68,7
16006,Lauriston - Copernic,OUI,19,18,1,0,1,OUI,OUI,2025-03-13 06:58:20+00:00,"48.86926, 2.289918",Paris,75056,0.05263157894736842,7
9035,Gare Saint-Lazare - Place de Budapest,OUI,43,29,14,4,10,OUI,OUI,2025-03-13 06:58:30+00:00,"48.877753, 2.327339",Paris,75056,0.32558139534883723,7
13205,Choisy - Pointe d'Ivry,OUI,24,14,10,8,2,OUI,OUI,2025-03-13 07:00:57+00:00,"48.822154170359, 2.3633708034878",Paris,75056,0.4166666666666667,7
19018,Cité de la Musique,OUI,54,30,24,11,13,OUI,OUI,2025-03-13 07:00:26+00:00,"48.888796556487, 2.3925811931922",Paris,75056,0.4444444444444444,7
7201,Place De Fontenoy - Saxe,OUI,18,12,6,2,4,OUI,OUI,2025-03-13 06:56:51+00:00,"48.850270554523, 2.3069813815839",Paris,75056,0.3333333333333333,7
17126,Hélène et François Missoffe - Emile Borel,OUI,28,19,9,8,1,OUI,OUI,2025-03-13 06:56:41+00:00,"48.89990653843488, 2.321543991674844",Paris,75056,0.32142857142857145,7
34005,Adrien Lesesne - Docteur Bauer,OUI,29,15,14,4,10,OUI,OUI,2025-03-13 06:55:47+00:00,"48.90263867304635, 2.348248063431511",Saint-Ouen-sur-Seine,93070,0.4827586206896552,7
15062,Convention - Lourmel,OUI,35,3,32,29,3,OUI,OUI,2025-03-13 07:00:38+00:00,"48.842055041656, 2.2859910875559",Paris,75056,0.9142857142857143,7
26008,Henri Barbusse - Bourguignons,OUI,33,13,20,5,15,OUI,OUI,2025-03-13 07:00:27+00:00,"48.91301722799713, 2.2734212270774417",Asnières-sur-Seine,92004,0.6060606060606061,7
13203,Square de Choisy - Eastman,OUI,23,17,6,3,3,OUI,OUI,2025-03-13 07:00:41+00:00,"48.828543456283, 2.3583075090494",Paris,75056,0.2608695652173913,7
26009,Marceau Delorme - Pierre Brossolette,OUI,26,7,19,13,6,OUI,OUI,2025-03-13 07:00:59+00:00,"48.91206062860357, 2.295897423568745",Asnières-sur-Seine,92004,0.7307692307692307,7
47007,Liberté - Vert-de-Maisons,OUI,20,3,17,13,4,OUI,OUI,2025-03-13 06:57:04+00:00,"48.790147809608, 2.4328628182411",Maisons-Alfort,94046,0.85,7
34008,Garibaldi - Gabriel Péri,OUI,29,23,6,3,3,OUI,OUI,2025-03-13 06:59:32+00:00,"48.905741911394, 2.3316044208059",Saint-Ouen-sur-Seine,93070,0.20689655172413793,7
13202,Place Farhat Hached,OUI,28,13,15,6,9,OUI,OUI,2025-03-13 07:00:10+00:00,"48.825487045602, 2.3816306985827",Paris,75056,0.5357142857142857,7
34012,Bateliers - Quai de Seine,OUI,24,15,9,4,5,OUI,OUI,2025-03-13 06:58:59+00:00,"48.915817585516, 2.3239533298594",Saint-Ouen-sur-Seine,93070,0.375,7
19204,Rampal - Belleville,OUI,19,17,2,0,2,OUI,OUI,2025-03-13 06:57:00+00:00,"48.873114661405, 2.3798409114805",Paris,75056,0.10526315789473684,7
23204,Roland Garros - Jean Bouin,OUI,27,19,8,3,5,OUI,OUI,2025-03-13 06:58:38+00:00,"48.809460857173, 2.2853198638301",Châtillon,92020,0.2962962962962963,7
18042,Place Pigalle,OUI,20,18,2,0,2,OUI,OUI,2025-03-13 06:58:41+00:00,"48.8827555, 2.3361566",Paris,75056,0.1,7
31301,Gare RER,OUI,25,15,10,3,7,OUI,OUI,2025-03-13 06:58:34+00:00,"48.896280181078, 2.4581568985227",Noisy-le-Sec,93053,0.4,7
11037,Faubourg Du Temple - Republique,OUI,38,0,38,32,6,OUI,OUI,2025-03-13 07:00:30+00:00,"48.867872484749, 2.3648982158072",Paris,75056,1.0,7
21514,Place de la Paix - Abbé Saint-Pierre,OUI,24,17,7,5,2,OUI,OUI,2025-03-13 06:54:53+00:00,"48.86462724459225, 2.2047570338469806",Suresnes,92073,0.2916666666666667,7
11020,Belfort - Voltaire,OUI,38,2,36,29,7,OUI,OUI,2025-03-13 06:59:44+00:00,"48.8563358, 2.3829901",Paris,75056,0.9473684210526315,7
18023,Ordener - Poissonniers,OUI,35,28,7,1,6,OUI,OUI,2025-03-13 06:58:34+00:00,"48.891213890844654, 2.351288666219873",Paris,75056,0.2,7
8039,Colisée - Champs-Elysées,OUI,15,9,6,0,6,OUI,OUI,2025-03-13 06:59:22+00:00,"48.870475399387, 2.3076190799475",Paris,75056,0.4,7
8008,Joseph Sansboeuf - Saint Lazare,OUI,31,25,6,4,2,OUI,OUI,2025-03-13 07:00:43+00:00,"48.875315630653, 2.3229019716382",Paris,75056,0.1935483870967742,7
11102,Alexandre Dumas - Voltaire,OUI,58,24,34,21,13,OUI,OUI,2025-03-13 07:00:17+00:00,"48.852888670365, 2.3891476408096",Paris,75056,0.5862068965517241,7
31202,Gabriel Péri - Jules Ferry,OUI,28,8,20,16,4,OUI,OUI,2025-03-13 07:00:27+00:00,"48.926182814311, 2.3912295762525",La Courneuve,93027,0.7142857142857143,7
12157,Fabre d'Eglantine - Place de la Nation,OUI,66,45,21,8,13,OUI,OUI,2025-03-13 07:01:01+00:00,"48.8471116, 2.3956204",Paris,75056,0.3181818181818182,7
31201,Suzanne Masson,OUI,33,1,32,12,20,OUI,OUI,2025-03-13 06:59:54+00:00,"48.923306888013, 2.3847292397611",La Courneuve,93027,0.9696969696969697,7
21213,Vanne - Général de Gaulle,OUI,25,19,6,2,4,OUI,OUI,2025-03-13 07:01:02+00:00,"48.815007, 2.328318",Montrouge,92049,0.24,7
15013,Volontaires - Lecourbe,OUI,28,5,23,17,6,OUI,OUI,2025-03-13 07:00:51+00:00,"48.84351378799, 2.3065522313118",Paris,75056,0.8214285714285714,7
3004,Place de la République - Temple,OUI,16,0,16,14,2,OUI,OUI,2025-03-13 06:55:37+00:00,"48.867211201859, 2.3635464370545",Paris,75056,1.0,7
13204,Tolbiac - Boussingault,OUI,39,34,5,4,1,OUI,OUI,2025-03-13 07:01:00+00:00,"48.826177754027, 2.3420378552202",Paris,75056,0.1282051282051282,7
11009,Boulets - Voltaire,OUI,22,8,14,13,1,OUI,OUI,2025-03-13 07:00:16+00:00,"48.85218705621, 2.3890301585197",Paris,75056,0.6363636363636364,7
13035,Choisy - Tolbiac,OUI,20,12,8,3,5,OUI,OUI,2025-03-13 06:58:20+00:00,"48.82591155587, 2.3602393269539",Paris,75056,0.4,7
35001,Jean Jaurès - Ouvrières Pivéreuses,OUI,21,14,7,2,5,OUI,OUI,2025-03-13 06:59:53+00:00,"48.910423437526, 2.3995766043663",Pantin,93055,0.3333333333333333,7
15060,Place de la Montagne du Goulet,OUI,20,3,17,14,3,OUI,OUI,2025-03-13 07:00:26+00:00,"48.8443415, 2.2773844",Paris,75056,0.85,7
10114,Granges aux Belles - Hôpital Saint-Louis,OUI,60,43,17,12,5,OUI,OUI,2025-03-13 06:59:27+00:00,"48.874794994841, 2.366669436985",Paris,75056,0.2833333333333333,7
7023,Bourdonnais - Tour Eiffel,OUI,54,27,27,21,6,OUI,OUI,2025-03-13 07:00:48+00:00,"48.860897797941, 2.295599598447",Paris,75056,0.5,7
18134,Ney - Porte de Clignancourt,OUI,23,20,3,0,3,OUI,OUI,2025-03-13 06:59:21+00:00,"48.8978867, 2.3458001",Paris,75056,0.13043478260869565,7
7025,Octave Gréard - Tour Eiffel,OUI,32,18,14,10,4,OUI,OUI,2025-03-13 06:58:43+00:00,"48.856502977696, 2.2931787543289",Paris,75056,0.4375,7
13051,Halle Freyssinet - Parvis Alan Turing,OUI,23,21,2,2,0,OUI,OUI,2025-03-13 06:56:00+00:00,"48.832846814471, 2.3711421713233",Paris,75056,0.08695652173913043,7
4108,Quai de Béthune - Pont de la Tournelle,OUI,25,5,20,19,1,OUI,OUI,2025-03-13 06:59:12+00:00,"48.85097433194, 2.3563072085381",Paris,75056,0.8,7
8038,François 1er - Montaigne,OUI,52,45,7,7,0,OUI,OUI,2025-03-13 06:57:58+00:00,"48.866887649978, 2.3066755757207",Paris,75056,0.1346153846153846,7
40007,Préfecture de Créteil,OUI,27,5,22,14,8,OUI,OUI,2025-03-13 07:00:50+00:00,"48.783680285918, 2.4544713672215",Créteil,94028,0.8148148148148148,7
21501,Pont de Suresnes,OUI,17,9,8,3,5,OUI,OUI,2025-03-13 07:00:03+00:00,"48.867415092322, 2.2258946679617",Suresnes,92073,0.47058823529411764,7
40010,Haut du Mont-Mesly,OUI,21,16,5,2,3,OUI,OUI,2025-03-13 06:53:51+00:00,"48.780191921646, 2.4685737495183",Créteil,94028,0.23809523809523808,7
5201,Saint-Jacques - Soufflot,OUI,16,10,6,2,4,OUI,OUI,2025-03-13 07:00:32+00:00,"48.846280383395, 2.3430785379567",Paris,75056,0.375,7
40012,Stade de la Habette,OUI,16,14,2,0,2,OUI,OUI,2025-03-13 06:59:09+00:00,"48.774397033806, 2.4668785263921",Créteil,94028,0.125,7
18041,Rochechouart - Martyrs,OUI,16,14,2,0,2,OUI,OUI,2025-03-13 07:00:30+00:00,"48.882193779572, 2.3405495658517",Paris,75056,0.125,7
40013,Hôtel de Ville de Créteil,OUI,36,19,17,13,4,OUI,OUI,2025-03-13 06:59:55+00:00,"48.77699496201, 2.4552552404284",Créteil,94028,0.4722222222222222,7
11014,Place de la Nation - Taillebourg,OUI,45,1,44,20,24,OUI,OUI,2025-03-13 07:01:04+00:00,"48.8488408, 2.3973043",Paris,75056,0.9777777777777777,7
12107,Diderot - Pierre Bourdan,OUI,21,5,16,7,9,OUI,OUI,2025-03-13 07:00:41+00:00,"48.847648620797, 2.3902582749724",Paris,75056,0.7619047619047619,7
35002,Jean Jaurès - Presles,OUI,31,28,3,0,3,OUI,OUI,2025-03-13 07:00:26+00:00,"48.907134414988, 2.3960057280531",Pantin,93055,0.0967741935483871,7
23011,Bineau - Louise Michel,OUI,26,25,1,0,1,OUI,OUI,2025-03-13 07:01:02+00:00,"48.88666162207, 2.2843274474144",Levallois-Perret,92044,0.038461538461538464,7
18044,Clichy - Douai,OUI,32,26,6,1,5,OUI,OUI,2025-03-13 07:00:42+00:00,"48.883687771522, 2.328063700029",Paris,75056,0.1875,7
16005,Raymond Poincaré - Place Victor Hugo,OUI,22,19,3,1,2,OUI,OUI,2025-03-13 06:59:51+00:00,"48.87030612437, 2.2850745414202",Paris,75056,0.13636363636363635,7
16103,Traktir - Foch,OUI,20,18,2,0,2,OUI,OUI,2025-03-13 06:59:08+00:00,"48.872755334614, 2.2915497802487",Paris,75056,0.1,7
40003,Centre Hospitalier Intercommunal de Créteil,OUI,17,15,2,1,1,OUI,OUI,2025-03-13 06:57:06+00:00,"48.797078298909, 2.463801423807",Créteil,94028,0.11764705882352941,7
11046,Place de la République - Voltaire,OUI,16,1,15,13,2,OUI,OUI,2025-03-13 06:59:37+00:00,"48.866830968942, 2.3654810339212",Paris,75056,0.9375,7
40004,Créteil Village,OUI,25,4,21,7,14,OUI,OUI,2025-03-13 07:00:38+00:00,"48.79122395576, 2.4642198533952",Créteil,94028,0.84,7
11011,Richard Lenoir - Voltaire,OUI,22,6,16,13,3,OUI,OUI,2025-03-13 06:58:39+00:00,"48.86164273878, 2.3727491497993",Paris,75056,0.7272727272727273,7
40008,Créteil Pompadour,OUI,44,14,30,12,18,OUI,OUI,2025-03-13 07:01:03+00:00,"48.773011623355, 2.435166164893",Créteil,94028,0.6818181818181818,7
7111,Ecole Militaire - Place Joffre,OUI,23,17,6,2,4,OUI,OUI,2025-03-13 07:00:33+00:00,"48.852060203583, 2.3017993569374",Paris,75056,0.2608695652173913,7
14021,Place de la Porte de Châtillon,OUI,59,54,5,3,2,OUI,OUI,2025-03-13 07:01:03+00:00,"48.8242469, 2.3186306",Paris,75056,0.0847457627118644,7
11012,Montreuil - Voltaire,OUI,33,24,9,2,7,OUI,OUI,2025-03-13 07:00:18+00:00,"48.850507011842, 2.3930755582745",Paris,75056,0.2727272727272727,7
15105,Fédération - Suffren,OUI,24,4,20,20,0,OUI,OUI,2025-03-13 06:59:47+00:00,"48.852828153442, 2.2978776320815",Paris,75056,0.8333333333333334,7
40015,Iles de Loisirs de Créteil,OUI,24,4,20,10,10,OUI,OUI,2025-03-13 06:59:59+00:00,"48.780258200618, 2.4455094301232",Créteil,94028,0.8333333333333334,7
18205,Mauroy - Cheminots,OUI,30,15,15,2,13,OUI,OUI,2025-03-13 06:58:09+00:00,"48.897715198403, 2.357895075822",Paris,75056,0.5,7
51005,Yves Farges - Route d'Enghien,OUI,33,16,17,6,11,OUI,OUI,2025-03-13 06:58:25+00:00,"48.95756799268, 2.2834496977978",Argenteuil,95018,0.5151515151515151,7
8057,Hoche - Tilsitt,OUI,31,30,1,0,1,OUI,OUI,2025-03-13 06:59:42+00:00,"48.874836457837, 2.2971323132515",Paris,75056,0.03225806451612903,7
9025,Taitbout - Châteaudun,OUI,53,43,10,10,0,OUI,OUI,2025-03-13 06:57:28+00:00,"48.876383969379, 2.3353566779335",Paris,75056,0.18867924528301888,7
32004,Wilson - Landy,OUI,39,20,19,12,7,OUI,OUI,2025-03-13 07:00:30+00:00,"48.91516726221354, 2.357633225619793",Saint-Denis,93066,0.48717948717948717,7
7109,Place Joffre - Frédéric le Play,OUI,37,30,7,6,1,OUI,OUI,2025-03-13 06:58:56+00:00,"48.853754486938, 2.3044242337346",Paris,75056,0.1891891891891892,7
35014,Charles de Gaulle - Jean Lolive,OUI,26,19,7,2,5,OUI,OUI,2025-03-13 06:58:19+00:00,"48.8932644350857, 2.4126765131950383",Pantin,93055,0.2692307692307692,7
40014,Créteil Pointe du Lac,OUI,28,3,25,9,16,OUI,OUI,2025-03-13 06:59:15+00:00,"48.769807356177, 2.4623027310281",Créteil,94028,0.8928571428571429,7
15103,Cauchy - Cévennes,OUI,50,6,44,43,1,OUI,OUI,2025-03-13 06:59:48+00:00,"48.843372571022, 2.2751328349113",Paris,75056,0.88,7
12201,Dugommier,OUI,52,18,34,28,6,OUI,OUI,2025-03-13 07:01:03+00:00,"48.838811048815, 2.3896577954292",Paris,75056,0.6538461538461539,7
18043,Clichy - Place Blanche,OUI,18,15,3,2,1,OUI,OUI,2025-03-13 07:00:57+00:00,"48.883601088297, 2.3332237824798",Paris,75056,0.16666666666666666,7
12105,Bercy - Villot,OUI,32,3,29,17,12,OUI,OUI,2025-03-13 06:59:30+00:00,"48.841795009027, 2.3767850184816",Paris,75056,0.90625,7
1003,Saint-Denis - Rivoli,OUI,42,25,17,16,1,OUI,OUI,2025-03-13 06:58:09+00:00,"48.859059340842, 2.3476943001151",Paris,75056,0.40476190476190477,7
26005,Hôtel de Ville d'Asnières sur Seine,OUI,25,19,6,5,1,OUI,OUI,2025-03-13 06:59:00+00:00,"48.90999330025577, 2.288238108158112",Asnières-sur-Seine,92004,0.24,7
32012,Carrefour Pleyel,OUI,65,44,21,6,15,OUI,OUI,2025-03-13 06:59:01+00:00,"48.92034156960326, 2.3438543826341625",Saint-Denis,93066,0.3230769230769231,7
23801,Place de la Gare,OUI,20,13,7,2,5,OUI,OUI,2025-03-13 06:51:40+00:00,"48.838513582184, 2.1866139007512",Garches,92033,0.35,7
27004,Gare de la Garenne-Colombes,OUI,27,15,12,4,8,OUI,OUI,2025-03-13 06:57:48+00:00,"48.909752, 2.239145",Colombes,92025,0.4444444444444444,7
23703,Gare de Chaville Rive Gauche,OUI,18,16,2,1,1,OUI,OUI,2025-03-13 06:57:53+00:00,"48.805160304345, 2.188277207315",Chaville,92022,0.1111111111111111,7
17123,Mstislav Rostropovitch - Berthier,OUI,18,16,2,1,1,OUI,OUI,2025-03-13 06:54:01+00:00,"48.892120821173975, 2.309234105050564",Paris,75056,0.1111111111111111,7
13106,Bobillot - Paulin Mery,OUI,22,4,18,1,17,OUI,OUI,2025-03-13 07:00:11+00:00,"48.829899841747, 2.3543356766749",Paris,75056,0.8181818181818182,7
6001,Institut de France,OUI,17,11,6,5,1,OUI,OUI,2025-03-13 06:56:43+00:00,"48.857615678565, 2.3358313530377",Paris,75056,0.35294117647058826,7
10031,Louis Blanc - Aqueduc,OUI,36,23,13,6,7,OUI,OUI,2025-03-13 07:00:49+00:00,"48.882030182599, 2.363561578095",Paris,75056,0.3611111111111111,7
17038,Grande Armée - Brunel,OUI,60,56,4,2,2,OUI,OUI,2025-03-13 07:00:45+00:00,"48.876116, 2.288124",Paris,75056,0.06666666666666667,7
13123,BNF - Bibliothèque Nationale de France,OUI,43,38,5,4,1,OUI,OUI,2025-03-13 06:54:35+00:00,"48.8350268238, 2.3760157451034",Paris,75056,0.11627906976744186,7
20137,Borrégo - Gambetta,OUI,25,24,1,0,1,OUI,OUI,2025-03-13 06:52:46+00:00,"48.87330497045532, 2.4014145880937576",Paris,75056,0.04,7
32001,Proudhon - Président Wilson,OUI,30,13,17,4,13,OUI,OUI,2025-03-13 07:00:41+00:00,"48.906442763495, 2.3584905266762",Saint-Denis,93066,0.5666666666666667,7
31708,Noisy le Sec - Jean-Baptiste Clément,OUI,19,18,1,0,1,OUI,OUI,2025-03-13 06:59:15+00:00,"48.874515389637, 2.4152836203575",Bagnolet,93006,0.05263157894736842,7
33019,Madeleine Vionnet,OUI,28,9,19,6,13,OUI,OUI,2025-03-13 07:00:06+00:00,"48.902519074064, 2.3740895837545",Aubervilliers,93001,0.6785714285714286,7
10013,Alibert - Jemmapes,OUI,56,29,27,25,2,OUI,OUI,2025-03-13 07:01:01+00:00,"48.871044051984, 2.3661044619878",Paris,75056,0.48214285714285715,7
21302,Aristide Briand - Place de la Résistance,OUI,44,3,41,37,4,OUI,OUI,2025-03-13 06:59:20+00:00,"48.82124248401006, 2.2511002421379094",Issy-les-Moulineaux,92040,0.9318181818181818,7
15026,Bir Hakeim,OUI,31,15,16,11,5,OUI,OUI,2025-03-13 07:00:26+00:00,"48.853844054334, 2.289705348222",Paris,75056,0.5161290322580645,7
1022,Danielle Casanova - Place Vendôme,OUI,37,24,13,6,7,OUI,OUI,2025-03-13 06:55:45+00:00,"48.868266498223, 2.3304839059711",Paris,75056,0.35135135135135137,7
41301,Bois de Vincennes - Gare,OUI,50,33,17,14,3,OUI,OUI,2025-03-13 06:57:02+00:00,"48.836022242887, 2.470833995083",Nogent-sur-Marne,94052,0.34,7
19203,Pailleron - Bouret,OUI,26,4,22,4,18,OUI,OUI,2025-03-13 06:57:58+00:00,"48.880516995482, 2.3763902374411",Paris,75056,0.8461538461538461,7
34014,Michelet - Dr Bauer,OUI,29,19,10,3,7,OUI,OUI,2025-03-13 05:46:54+00:00,"48.906125424194, 2.3440374449846",Saint-Ouen-sur-Seine,93070,0.3448275862068966,6
21404,Jean Jaurès - Gare de Clamart,OUI,20,10,10,0,10,OUI,OUI,2025-03-13 07:00:09+00:00,"48.81321981219, 2.2716768079163",Clamart,92023,0.5,7
1002,Victoria - Place du Chatelet,OUI,19,14,5,1,4,OUI,OUI,2025-03-13 07:01:00+00:00,"48.857992591527, 2.3469167947769",Paris,75056,0.2631578947368421,7
8052,Balzac - Champs Elysées,OUI,29,25,4,1,3,OUI,OUI,2025-03-13 06:59:07+00:00,"48.872699639621, 2.3001953959465",Paris,75056,0.13793103448275862,7
12010,Daumesnil - Picpus,OUI,22,8,14,7,7,OUI,OUI,2025-03-13 07:00:32+00:00,"48.8374688, 2.401765",Paris,75056,0.6363636363636364,7
4104,Sebastopol - Rambuteau,OUI,15,4,11,9,2,OUI,OUI,2025-03-13 07:00:49+00:00,"48.86181809267, 2.3501381278038",Paris,75056,0.7333333333333333,7
40002,Bleuets - Bordières,OUI,21,16,5,2,3,OUI,OUI,2025-03-13 06:58:13+00:00,"48.802117531472, 2.4543687905029",Créteil,94028,0.23809523809523808,7
8002,Gare Saint-Lazare - Cour du Havre,OUI,41,4,37,20,17,OUI,OUI,2025-03-13 07:00:05+00:00,"48.875674400851, 2.3265598341823",Paris,75056,0.9024390243902439,7
15056,Place Balard,OUI,24,1,23,18,5,OUI,OUI,2025-03-13 06:58:38+00:00,"48.836395736424, 2.2784192115068",Paris,75056,0.9583333333333334,7
12127,Tremblay - Lac des Minimes,OUI,46,39,7,1,6,OUI,OUI,2025-03-13 06:59:50+00:00,"48.834131261494, 2.4547516554594",Paris,75056,0.15217391304347827,7
21021,Enfants du Paradis - Peupliers,OUI,42,27,15,13,2,OUI,OUI,2025-03-13 07:00:46+00:00,"48.833122686454, 2.2571459412575",Boulogne-Billancourt,92012,0.35714285714285715,7
9104,Caumartin - Provence,OUI,22,14,8,4,4,OUI,OUI,2025-03-13 06:58:56+00:00,"48.874422773426545, 2.3284685611724854",Paris,75056,0.36363636363636365,7
8004,Malesherbes - Place de la Madeleine,OUI,79,62,17,8,9,OUI,OUI,2025-03-13 07:00:42+00:00,"48.870406028483, 2.323243509808",Paris,75056,0.21518987341772153,7
40001,Hôpital Mondor,OUI,28,9,19,10,9,OUI,OUI,2025-03-13 09:00:13+00:00,"48.798922410229, 2.4537451531298",Créteil,94028,0.6785714285714286,9
16107,Benjamin Godard - Victor Hugo,OUI,32,28,4,1,3,OUI,OUI,2025-03-13 09:00:59+00:00,"48.865983, 2.275725",Paris,75056,0.125,9
44015,Rouget de L'isle - Watteau,OUI,20,8,12,1,11,OUI,OUI,2025-03-13 09:01:23+00:00,"48.778192750803, 2.3963020229163",Vitry-sur-Seine,94081,0.6,9
9020,Toudouze - Clauzel,OUI,21,18,3,0,3,OUI,OUI,2025-03-13 09:00:57+00:00,"48.87929591733507, 2.3373600840568547",Paris,75056,0.14285714285714285,9
14111,Cassini - Denfert-Rochereau,OUI,23,9,14,7,7,OUI,OUI,2025-03-13 08:59:34+00:00,"48.837525839067, 2.3360354080796",Paris,75056,0.6086956521739131,9
11104,Charonne - Robert et Sonia Delaunay,OUI,20,20,0,0,0,OUI,OUI,2025-03-13 08:58:30+00:00,"48.855907555969, 2.3925706744194",Paris,75056,0.0,9
14014,Jourdan - Stade Charléty,OUI,60,54,6,2,4,OUI,OUI,2025-03-13 08:59:01+00:00,"48.819428333369, 2.3433353751898",Paris,75056,0.1,9
8026,Messine - Place Du Pérou,OUI,12,2,10,8,2,OUI,OUI,2025-03-13 08:59:32+00:00,"48.875448033960744, 2.315508019010038",Paris,75056,0.8333333333333334,9
32017,Basilique,OUI,20,10,10,1,9,OUI,OUI,2025-03-13 08:55:10+00:00,"48.93626891059109, 2.3588666820200914",Saint-Denis,93066,0.5,9
13007,Le Brun - Gobelins,OUI,47,28,19,17,2,OUI,OUI,2025-03-13 08:54:37+00:00,"48.835092787824, 2.3534681351338",Paris,75056,0.40425531914893614,9
6003,Saint-Sulpice,OUI,21,12,9,6,3,OUI,OUI,2025-03-13 09:00:21+00:00,"48.85165383178419, 2.3308077827095985",Paris,75056,0.42857142857142855,9
7002,Vaneau - Sèvres,OUI,35,19,16,13,3,OUI,OUI,2025-03-13 09:00:52+00:00,"48.848563233059, 2.3204218259346",Paris,75056,0.45714285714285713,9
6108,Saint-Romain - Cherche-Midi,OUI,16,12,4,2,2,OUI,OUI,2025-03-13 09:01:09+00:00,"48.84708159081946, 2.321374788880348",Paris,75056,0.25,9
5110,Lacépède - Monge,OUI,23,23,0,0,0,OUI,OUI,2025-03-13 08:56:37+00:00,"48.84389286531899, 2.3519663885235786",Paris,75056,0.0,9
42016,Pierre et Marie Curie - Maurice Thorez,OUI,26,23,3,1,2,OUI,OUI,2025-03-13 08:56:10+00:00,"48.81580226360801, 2.376804985105991",Ivry-sur-Seine,94041,0.11538461538461539,9
33006,André Karman - République,OUI,30,26,4,1,3,OUI,OUI,2025-03-13 08:55:03+00:00,"48.91039875761846, 2.3851355910301213",Aubervilliers,93001,0.13333333333333333,9
40011,Bas du Mont-Mesly,OUI,26,18,8,5,3,OUI,OUI,2025-03-13 09:01:13+00:00,"48.779035118572, 2.4609763908985",Créteil,94028,0.3076923076923077,9
30002,Jean Rostand - Paul Vaillant Couturier,OUI,39,26,13,6,7,OUI,OUI,2025-03-13 09:01:27+00:00,"48.908168131015, 2.4530601033354",Bobigny,93008,0.3333333333333333,9
21010,Silly - Galliéni,OUI,25,18,7,6,1,OUI,OUI,2025-03-13 09:00:17+00:00,"48.835583838706, 2.2325500845909",Boulogne-Billancourt,92012,0.28,9
32304,Charcot - Benfleet,OUI,28,27,1,0,1,NON,NON,2025-03-13 09:00:53+00:00,"48.878370277021, 2.440523876268",Romainville,93063,0.03571428571428571,9
25006,Place Nelson Mandela,OUI,22,20,2,1,1,OUI,OUI,2025-03-13 08:58:47+00:00,"48.862453313908, 2.1961666225454",Rueil-Malmaison,92063,0.09090909090909091,9
7003,Square Boucicaut,OUI,59,26,33,16,17,OUI,OUI,2025-03-13 08:57:41+00:00,"48.851296433665276, 2.325061820447445",Paris,75056,0.559322033898305,9
17041,Guersant - Gouvion-Saint-Cyr,OUI,33,20,13,4,9,OUI,OUI,2025-03-13 08:59:01+00:00,"48.88287775178599, 2.287667370814871",Paris,75056,0.3939393939393939,9
15047,Morillons - Dantzig,OUI,51,51,0,0,0,OUI,OUI,2025-03-13 08:52:23+00:00,"48.83310149953933, 2.299380004405976",Paris,75056,0.0,9
5016,Thouin - Cardinal Lemoine,OUI,16,12,4,0,4,OUI,OUI,2025-03-13 08:54:13+00:00,"48.84504716661511, 2.3494647851273465",Paris,75056,0.25,9
17026,Jouffroy d'Abbans - Wagram,OUI,39,15,24,11,13,OUI,OUI,2025-03-13 09:00:51+00:00,"48.881973298352, 2.301132157445",Paris,75056,0.6153846153846154,9
11025,Froment - Bréguet,OUI,43,23,20,9,11,OUI,OUI,2025-03-13 08:59:30+00:00,"48.8570414504784, 2.37289470306807",Paris,75056,0.46511627906976744,9
6021,Beaux-Arts - Bonaparte,OUI,20,1,19,11,8,OUI,OUI,2025-03-13 09:00:53+00:00,"48.856451985396, 2.3348518833518",Paris,75056,0.95,9
15202,Bracion - Périphérique,OUI,30,23,7,4,3,OUI,OUI,2025-03-13 09:01:27+00:00,"48.826103771275, 2.3004549373748",Paris,75056,0.23333333333333334,9
12109,Mairie du 12ème,OUI,30,25,5,4,1,OUI,OUI,2025-03-13 09:01:14+00:00,"48.840855311763, 2.3875549435616",Paris,75056,0.16666666666666666,9
8050,Boétie - Ponthieu,OUI,43,3,40,11,29,OUI,OUI,2025-03-13 09:00:50+00:00,"48.871417284355, 2.3076787590981",Paris,75056,0.9302325581395349,9
31024,Romainville - Vaillant-Couturier,OUI,36,35,1,0,1,OUI,OUI,2025-03-13 09:01:01+00:00,"48.86785, 2.446748",Montreuil,93048,0.027777777777777776,9
13101,Croulebarde - Corvisart,OUI,33,23,10,7,3,OUI,OUI,2025-03-13 09:01:14+00:00,"48.830981659316855, 2.3481646925210953",Paris,75056,0.30303030303030304,9
17044,Porte de Saint-Ouen - Bessières,OUI,42,37,5,3,2,OUI,OUI,2025-03-13 08:58:31+00:00,"48.89792240854517, 2.32851451022192",Paris,75056,0.11904761904761904,9
14108,Le Brix et Mesmin - Jourdan,OUI,19,19,0,0,0,OUI,OUI,2025-03-13 08:55:50+00:00,"48.82234096593411, 2.327861653302471",Paris,75056,0.0,9
17025,Chazelles - Courcelles,OUI,33,12,21,4,17,OUI,OUI,2025-03-13 09:00:07+00:00,"48.879406604954, 2.3034455627202988",Paris,75056,0.6363636363636364,9
2022,Saint-Fiacre - Poissonière,OUI,33,3,30,17,13,OUI,OUI,2025-03-13 09:00:49+00:00,"48.870828911558, 2.3459213599563",Paris,75056,0.9090909090909091,9
21326,Moulin de Pierre - Abbé Grégoire,OUI,20,19,1,0,1,OUI,OUI,2025-03-13 08:55:03+00:00,"48.822036188382, 2.2754641655975",Issy-les-Moulineaux,92040,0.05,9
19033,Cambrai - Benjamin Constant,OUI,40,32,8,3,5,OUI,OUI,2025-03-13 09:00:20+00:00,"48.89594736851349, 2.381133802246315",Paris,75056,0.2,9
43002,Lagny - Victor Basch,OUI,23,9,14,11,3,OUI,OUI,2025-03-13 08:59:53+00:00,"48.84884147189881, 2.426325418925233",Vincennes,94080,0.6086956521739131,9
20143,Ramponeau - Belleville,OUI,44,43,1,0,1,OUI,OUI,2025-03-13 08:57:31+00:00,"48.871031137596, 2.379056852114",Paris,75056,0.022727272727272728,9
16138,Saint-Cloud - Hippodrome,OUI,30,21,9,3,6,OUI,OUI,2025-03-13 08:54:32+00:00,"48.85772148887421, 2.2549109905958176",Paris,75056,0.3,9
22207,Rond-point du Dr Albert Schweitzer,OUI,21,16,5,4,1,OUI,OUI,2025-03-13 09:01:26+00:00,"48.78980918988166, 2.3143940046429634",Bagneux,92007,0.23809523809523808,9
21216,Louis Lejeune - Barbès,OUI,24,23,1,0,1,OUI,OUI,2025-03-13 09:01:06+00:00,"48.81807418981508, 2.3267009854316716",Montrouge,92049,0.041666666666666664,9
92002,Théâtre des Amandiers - Palais des sports,OUI,23,6,17,8,9,OUI,OUI,2025-03-13 08:59:38+00:00,"48.892648526839, 2.2136941552162",Nanterre,92050,0.7391304347826086,9
15068,Général Martial Valin - Pont du Garigliano,OUI,14,3,11,4,7,OUI,OUI,2025-03-13 08:59:01+00:00,"48.83823094269141, 2.270506024360657",Paris,75056,0.7857142857142857,9
19027,Serrurier,OUI,18,17,1,0,1,OUI,OUI,2025-03-13 08:56:34+00:00,"48.880493403246, 2.398064173758",Paris,75056,0.05555555555555555,9
17048,De Toqueville - Terrasse,OUI,30,27,3,3,0,OUI,OUI,2025-03-13 09:00:45+00:00,"48.882428, 2.314002",Paris,75056,0.1,9
31028,Raspail Barbès,OUI,28,26,2,0,2,OUI,OUI,2025-03-13 09:00:22+00:00,"48.8529945, 2.4247387",Montreuil,93048,0.07142857142857142,9
9008,Tour d'Auvergne - Rodier,OUI,16,14,2,0,2,OUI,OUI,2025-03-13 09:00:15+00:00,"48.879161, 2.343698",Paris,75056,0.125,9
44017,Jules Guesde - Pont du Port à l'Anglais,OUI,26,2,24,23,1,OUI,OUI,2025-03-13 08:58:40+00:00,"48.79628807093802, 2.417212128639221",Vitry-sur-Seine,94081,0.9230769230769231,9
8103,Artois - Berri,OUI,22,2,20,7,13,OUI,OUI,2025-03-13 09:00:34+00:00,"48.87393521240818, 2.3064258322119713",Paris,75056,0.9090909090909091,9
8048,Marceau - Chaillot,OUI,18,4,14,4,10,OUI,OUI,2025-03-13 08:58:00+00:00,"48.868834023334, 2.2986030816809",Paris,75056,0.7777777777777778,9
16118,Michel-Ange - Parent de Rosan,OUI,24,20,4,1,3,OUI,OUI,2025-03-13 09:00:54+00:00,"48.840579923690115, 2.2584119439125065",Paris,75056,0.16666666666666666,9
13118,Regnault - Patay,OUI,62,10,52,42,10,OUI,OUI,2025-03-13 08:58:36+00:00,"48.82435782216384, 2.377065159380436",Paris,75056,0.8387096774193549,9
2017,Caire - Dussoubs,OUI,38,5,33,26,7,OUI,OUI,2025-03-13 09:01:03+00:00,"48.86785342111862, 2.349364310503006",Paris,75056,0.868421052631579,9
18111,Félix Ziem - Armand Gauthier,OUI,21,21,0,0,0,OUI,OUI,2025-03-13 08:56:57+00:00,"48.88949630486821, 2.333393658804396",Paris,75056,0.0,9
14013,Liard - Amiral Mouchez,OUI,26,25,1,1,0,OUI,OUI,2025-03-13 08:57:28+00:00,"48.8214169, 2.342167",Paris,75056,0.038461538461538464,9
9002,Abbeville - Faubourg Poissonnière,OUI,13,11,2,1,1,OUI,OUI,2025-03-13 08:58:01+00:00,"48.879223, 2.349147",Paris,75056,0.15384615384615385,9
15112,Vigée-Lebrun - Anselme Payen,OUI,23,19,4,3,1,OUI,OUI,2025-03-13 08:59:42+00:00,"48.838683941628375, 2.3110422492027287",Paris,75056,0.17391304347826086,9
16110,Octave Feuillet - Albéric Magnard,OUI,21,1,20,3,17,OUI,OUI,2025-03-13 09:00:05+00:00,"48.86106902949534, 2.2730283066630363",Paris,75056,0.9523809523809523,9
13030,Italie - Tolbiac,OUI,21,20,1,1,0,OUI,OUI,2025-03-13 08:53:36+00:00,"48.82557229464416, 2.3576171323657036",Paris,75056,0.047619047619047616,9
43009,Place Jean-Spire-Lemaître,OUI,48,47,1,0,1,OUI,OUI,2025-03-13 08:51:55+00:00,"48.8468428626593, 2.452062070369721",Vincennes,94080,0.020833333333333332,9
48003,Youri Gagarine - Karl Marx,OUI,22,18,4,2,2,OUI,OUI,2025-03-13 08:57:27+00:00,"48.78448485079149, 2.35908430069685",Villejuif,94076,0.18181818181818182,9
9001,Bellefond - Poissonnière,OUI,15,12,3,1,2,OUI,OUI,2025-03-13 08:59:53+00:00,"48.87759897050706, 2.348463758826256",Paris,75056,0.2,9
41303,Gare de Nogent-le-Perreux,OUI,30,18,12,10,2,OUI,OUI,2025-03-13 08:58:48+00:00,"48.83842553348809, 2.493693307042122",Nogent-sur-Marne,94052,0.4,9
17032,Jean Oestreicher - Porte de Champerret,OUI,21,3,18,10,8,OUI,OUI,2025-03-13 09:01:18+00:00,"48.88655580065981, 2.288640439510346",Paris,75056,0.8571428571428571,9
12031,Gabriel Lamé,OUI,35,26,9,6,3,OUI,OUI,2025-03-13 09:00:22+00:00,"48.8351212784276, 2.385534569621086",Paris,75056,0.2571428571428571,9
8016,Square Louis XVI,OUI,29,5,24,14,10,OUI,OUI,2025-03-13 08:58:56+00:00,"48.87320440102894, 2.323658830743138",Paris,75056,0.8275862068965517,9
1001,Quai de l'Horloge - Pont Neuf,OUI,16,0,16,11,5,OUI,OUI,2025-03-13 09:00:34+00:00,"48.857058739111, 2.3417982839439",Paris,75056,1.0,9
10115,Granges aux Belles,OUI,27,24,3,2,1,OUI,OUI,2025-03-13 09:00:46+00:00,"48.8761373390584, 2.3680844979417",Paris,75056,0.1111111111111111,9
13104,Gare d'Austerlitz - Quai Saint-Bernard,OUI,26,4,22,16,6,OUI,OUI,2025-03-13 08:59:33+00:00,"48.84369030864, 2.3657163977623",Paris,75056,0.8461538461538461,9
10029,Dunkerque - Rocroy,OUI,24,23,1,0,1,OUI,OUI,2025-03-13 08:56:48+00:00,"48.880726, 2.351464",Paris,75056,0.041666666666666664,9
9038,Douai - Bruxelles,OUI,26,18,8,1,7,OUI,OUI,2025-03-13 09:01:17+00:00,"48.88320784122797, 2.3308449949028507",Paris,75056,0.3076923076923077,9
10161,Gare de l'Est - Faubourg-Saint-Martin,OUI,32,25,7,4,3,OUI,OUI,2025-03-13 08:56:15+00:00,"48.875642647477, 2.3594588041306",Paris,75056,0.21875,9
31103,Gare Rosny-Bois-Perrier,OUI,32,14,18,0,18,OUI,OUI,2025-03-13 08:59:16+00:00,"48.88115023337061, 2.480436824262142",Rosny-sous-Bois,93064,0.5625,9
5022,Boulangers - Cardinal Lemoine,OUI,18,6,12,5,7,OUI,OUI,2025-03-13 09:01:24+00:00,"48.8462904, 2.3521495",Paris,75056,0.6666666666666666,9
17008,Porte Pouchet-Bessières,OUI,23,13,10,10,0,OUI,OUI,2025-03-13 09:01:22+00:00,"48.8978765, 2.3230632",Paris,75056,0.43478260869565216,9
21328,Verger - Colonel Guichard,OUI,29,27,2,0,2,OUI,OUI,2025-03-13 09:01:20+00:00,"48.816376985087, 2.2670380088932",Issy-les-Moulineaux,92040,0.06896551724137931,9
18203,Lamarck - Saint-Ouen,OUI,40,40,0,0,0,NON,NON,2025-03-13 08:56:38+00:00,"48.891334555236, 2.3272445342326",Paris,75056,0.0,9
17040,Pereire - Ternes,OUI,48,46,2,1,1,OUI,OUI,2025-03-13 08:46:03+00:00,"48.87973954830735, 2.288012132048607",Paris,75056,0.041666666666666664,9
8053,Place Georges Guillaumin,OUI,27,12,15,4,11,OUI,OUI,2025-03-13 09:01:19+00:00,"48.874750203957, 2.301771435326",Paris,75056,0.5555555555555556,9
8009,Gare Saint-Lazare - Isly,OUI,25,12,13,10,3,OUI,OUI,2025-03-13 09:00:24+00:00,"48.874777677621296, 2.326515804784655",Paris,75056,0.52,9
9014,Faubourg Montmartre - La Fayette,OUI,33,3,30,20,10,OUI,OUI,2025-03-13 09:00:15+00:00,"48.875254549053, 2.3408536612988",Paris,75056,0.9090909090909091,9
7018,Ségur - d'Estrées,OUI,19,2,17,8,9,OUI,OUI,2025-03-13 09:01:26+00:00,"48.851419978983, 2.3097044974566",Paris,75056,0.8947368421052632,9
19105,Ambroise Rendu - Porte Brunet,OUI,17,10,7,2,5,OUI,OUI,2025-03-13 09:00:26+00:00,"48.883667, 2.395733",Paris,75056,0.4117647058823529,9
5005,Gay Lussac - Saint-Jacques,OUI,24,8,16,6,10,OUI,OUI,2025-03-13 08:56:59+00:00,"48.844730256132, 2.3419239448664",Paris,75056,0.6666666666666666,9
9022,Rossini - Laffitte,OUI,33,0,33,19,14,OUI,OUI,2025-03-13 08:59:54+00:00,"48.87334627510507, 2.337980867701675",Paris,75056,1.0,9
21323,Charlot - Stade Gabriel Voisin,OUI,31,1,30,25,5,OUI,OUI,2025-03-13 09:01:16+00:00,"48.827228120536, 2.268122527474",Issy-les-Moulineaux,92040,0.967741935483871,9
26003,Argenteuil - Voltaire,OUI,16,14,2,1,1,OUI,OUI,2025-03-13 08:44:52+00:00,"48.91864865955558, 2.2814112156629562",Asnières-sur-Seine,92004,0.125,9
9106,Boudreau - Auber,OUI,27,4,23,9,14,OUI,OUI,2025-03-13 09:01:24+00:00,"48.87219, 2.329423",Paris,75056,0.8518518518518519,9
12151,Gare de Lyon - Place Louis Armand,OUI,58,9,49,45,4,OUI,OUI,2025-03-13 08:58:23+00:00,"48.845515089794, 2.3726498446286",Paris,75056,0.8448275862068966,9
31706,Château - République,OUI,25,18,7,3,4,OUI,OUI,2025-03-13 09:00:35+00:00,"48.862923800596, 2.4155035614967",Bagnolet,93006,0.28,9
5020,Institut du Monde Arabe - Saint-Germain,OUI,38,1,37,35,2,OUI,OUI,2025-03-13 09:00:32+00:00,"48.849063299501, 2.3558086529374",Paris,75056,0.9736842105263158,9
22409,Henri Barbusse - Stalingrad,OUI,15,15,0,0,0,OUI,OUI,2025-03-13 08:54:13+00:00,"48.814183748660554, 2.2872862592339516",Malakoff,92046,0.0,9
92007,Pesaro - Préfecture,OUI,21,10,11,2,9,OUI,OUI,2025-03-13 09:00:32+00:00,"48.89577046284005, 2.223908342421055",Nanterre,92050,0.5238095238095238,9
19015,Thionville - Ourcq,OUI,22,22,0,0,0,OUI,OUI,2025-03-13 09:00:21+00:00,"48.88917613743794, 2.3833653330802917",Paris,75056,0.0,9
16026,Ranelagh - Mozart,OUI,7,6,1,1,0,OUI,OUI,2025-03-13 08:59:42+00:00,"48.8554439, 2.2704418",Paris,75056,0.14285714285714285,9
17004,Legendre - Clichy,OUI,38,35,3,1,2,OUI,OUI,2025-03-13 08:54:09+00:00,"48.88896161855884, 2.322528975094376",Paris,75056,0.07894736842105263,9
9028,Moncey - Blanche,OUI,17,11,6,4,2,OUI,OUI,2025-03-13 08:57:58+00:00,"48.88006587474148, 2.3310810327529907",Paris,75056,0.35294117647058826,9
19003,Quai de la Seine,OUI,23,21,2,1,1,OUI,OUI,2025-03-13 08:58:14+00:00,"48.884492238407525, 2.3703941702842717",Paris,75056,0.08695652173913043,9
19026,Place de Rhin et Danube,OUI,14,13,1,0,1,OUI,OUI,2025-03-13 09:00:22+00:00,"48.88192765861766, 2.392586767673493",Paris,75056,0.07142857142857142,9
10107,Gare du Nord - Hôpital Lariboisière,OUI,49,45,4,3,1,OUI,OUI,2025-03-13 08:57:37+00:00,"48.881949, 2.352339",Paris,75056,0.08163265306122448,9
16039,Exelmans - Versailles,OUI,47,20,27,20,7,OUI,OUI,2025-03-13 09:00:25+00:00,"48.84097491091973, 2.264390252530575",Paris,75056,0.574468085106383,9
26002,Redoute - Les Courtilles,OUI,37,9,28,16,12,OUI,OUI,2025-03-13 09:01:00+00:00,"48.929867194519, 2.2836696356535",Asnières-sur-Seine,92004,0.7567567567567568,9
8034,Berri - Haussmann,OUI,34,1,33,12,21,OUI,OUI,2025-03-13 08:59:16+00:00,"48.874746047357135, 2.3082953318953514",Paris,75056,0.9705882352941176,9
17043,Belidor - Gouvion-Saint-Cyr,OUI,38,28,10,9,1,OUI,OUI,2025-03-13 09:00:24+00:00,"48.88022154052015, 2.2854680567979813",Paris,75056,0.2631578947368421,9
19043,Delphine Seyrig - Général Leclerc,OUI,52,46,6,3,3,OUI,OUI,2025-03-13 08:57:59+00:00,"48.893923963057865, 2.39790290594101",Pantin,93055,0.11538461538461539,9
11023,Saint-Maur - Roquette,OUI,46,41,5,2,3,OUI,OUI,2025-03-13 09:00:30+00:00,"48.858688774062955, 2.383553994571467",Paris,75056,0.10869565217391304,9
5032,Panthéon - Valette,OUI,39,2,37,7,30,OUI,OUI,2025-03-13 09:01:09+00:00,"48.847020571652, 2.3464982619671",Paris,75056,0.9487179487179487,9
45003,11 Novembre 1918 - 8 Mai 1945,OUI,36,13,23,14,9,OUI,OUI,2025-03-13 08:55:20+00:00,"48.80889533774377, 2.5382421165704727",Champigny-sur-Marne,94017,0.6388888888888888,9
46002,Rouget de Lisle,OUI,35,2,33,16,17,OUI,OUI,2025-03-13 08:55:05+00:00,"48.764615483395254, 2.4071189761161804",Choisy-le-Roi,94022,0.9428571428571428,9
11002,Roquette - Thiéré,OUI,22,3,19,14,5,OUI,OUI,2025-03-13 09:01:19+00:00,"48.85507930579506, 2.3733686318721463",Paris,75056,0.8636363636363636,9
10016,Récollets - Square Villemin,OUI,17,13,4,2,2,OUI,OUI,2025-03-13 08:53:47+00:00,"48.875034655883944, 2.359801238597928",Paris,75056,0.23529411764705882,9
12111,Claude Decaen - Cannebière,OUI,25,25,0,0,0,OUI,OUI,2025-03-13 08:59:12+00:00,"48.83761417037952, 2.397253782195704",Paris,75056,0.0,9
31009,Place Du Général De Gaulle,OUI,25,25,0,0,0,OUI,OUI,2025-03-13 08:57:31+00:00,"48.8687591, 2.4329931",Montreuil,93048,0.0,9
11047,Amelot - Saint-Sébastien,OUI,29,20,9,6,3,OUI,OUI,2025-03-13 09:01:05+00:00,"48.861142162761, 2.3677996181077",Paris,75056,0.3103448275862069,9
14020,Cimetière de Montrouge,OUI,58,53,5,1,4,OUI,OUI,2025-03-13 08:58:07+00:00,"48.821466904768, 2.3215785772007",Paris,75056,0.08620689655172414,9
18107,Chartres - La Charbonnière,OUI,34,33,1,0,1,OUI,OUI,2025-03-13 08:56:57+00:00,"48.8847601, 2.3534657",Paris,75056,0.029411764705882353,9
33017,Anatole France - President Roosevelt,OUI,25,18,7,5,2,OUI,OUI,2025-03-13 09:00:12+00:00,"48.9155156, 2.3814103",Aubervilliers,93001,0.28,9
20042,Pyrénées - Emmery,OUI,39,39,0,0,0,OUI,OUI,2025-03-13 09:00:41+00:00,"48.872010281270974, 2.392039597034455",Paris,75056,0.0,9
33102,Gabriel Péri - Francisco Ferrer,OUI,17,17,0,0,0,OUI,OUI,2025-03-13 08:58:47+00:00,"48.88633710236977, 2.407338917255402",Le Pré-Saint-Gervais,93061,0.0,9
15067,Desaix - Edgar Faure,OUI,11,3,8,5,3,OUI,OUI,2025-03-13 08:57:00+00:00,"48.852804604940296, 2.293077029857222",Paris,75056,0.7272727272727273,9
11113,Richard Lenoir - Republique,OUI,53,15,38,35,3,OUI,OUI,2025-03-13 08:59:12+00:00,"48.8667175, 2.3692541",Paris,75056,0.7169811320754716,9
17030,Pereire - Rennequin,OUI,22,20,2,1,1,OUI,OUI,2025-03-13 08:57:04+00:00,"48.88364782887555, 2.2952447086572647",Paris,75056,0.09090909090909091,9
5018,Mutualité,OUI,37,21,16,14,2,OUI,OUI,2025-03-13 08:57:06+00:00,"48.848225572724, 2.3502873256803",Paris,75056,0.43243243243243246,9
6006,Notre-Dame-des-Champs - Stanislas,OUI,18,2,16,13,3,OUI,OUI,2025-03-13 08:57:13+00:00,"48.84479928858768, 2.329337755887181",Paris,75056,0.8888888888888888,9
19101,Square Simon Bolivar,OUI,23,20,3,1,2,OUI,OUI,2025-03-13 09:00:31+00:00,"48.875089888322, 2.3826304078102",Paris,75056,0.13043478260869565,9
11027,Saint-Ambroise - Parmentier,OUI,34,17,17,13,4,OUI,OUI,2025-03-13 09:01:14+00:00,"48.862147844548, 2.3772348091006",Paris,75056,0.5,9
19103,Manin - Carrières d'Amérique,OUI,17,16,1,0,1,OUI,OUI,2025-03-13 08:58:59+00:00,"48.88467214209463, 2.3919698596000676",Paris,75056,0.058823529411764705,9
12128,Pyramide - Ecole du Breuil,OUI,32,23,9,3,6,OUI,OUI,2025-03-13 08:58:29+00:00,"48.82237977153955, 2.4586871266365056",Paris,75056,0.28125,9
14138,Porte de Vanves,OUI,29,27,2,2,0,OUI,OUI,2025-03-13 09:01:22+00:00,"48.828012849445, 2.3056878894567",Paris,75056,0.06896551724137931,9
8010,Liège - Moscou,OUI,15,11,4,0,4,OUI,OUI,2025-03-13 08:58:46+00:00,"48.8795431, 2.3264628",Paris,75056,0.26666666666666666,9
12114,Victor Hugo - Jeanne Jugan,OUI,28,26,2,0,2,OUI,OUI,2025-03-13 08:54:06+00:00,"48.843949064031825, 2.415081394834419",Paris,75056,0.07142857142857142,9
31022,Mairie de Montreuil,OUI,51,49,2,2,0,OUI,OUI,2025-03-13 09:01:27+00:00,"48.86131452758348, 2.440614402294159",Montreuil,93048,0.0392156862745098,9
46003,Conservatoire de Musique,OUI,24,2,22,18,4,OUI,OUI,2025-03-13 09:01:25+00:00,"48.77093586667601, 2.4034014344215398",Choisy-le-Roi,94022,0.9166666666666666,9
41302,Charles de Gaulle - Beauté,OUI,48,48,0,0,0,OUI,OUI,2025-03-13 08:58:51+00:00,"48.83649602312711, 2.479562651149885",Nogent-sur-Marne,94052,0.0,9
41209,Cimetière de Fontenay-sous-Bois,OUI,15,15,0,0,0,OUI,OUI,2025-03-13 08:58:49+00:00,"48.84706173362218, 2.4787822365760808",Fontenay-sous-Bois,94033,0.0,9
15042,Henry Farman,OUI,16,6,10,10,0,OUI,OUI,2025-03-13 08:56:53+00:00,"48.83372430280548, 2.2713854536414146",Paris,75056,0.625,9
13001,Port-Royal - Hôpital du Val-de-Grâce,OUI,17,11,6,2,4,OUI,OUI,2025-03-13 09:01:06+00:00,"48.837668272811, 2.3448138346607",Paris,75056,0.35294117647058826,9
18011,Pajol - Place Herbert,OUI,39,37,2,0,2,OUI,OUI,2025-03-13 08:54:55+00:00,"48.8927825, 2.3635598",Paris,75056,0.05128205128205128,9
18028,Championnet - Vauvenargues,OUI,31,29,2,0,2,OUI,OUI,2025-03-13 09:00:04+00:00,"48.89401874744574, 2.3319872841238976",Paris,75056,0.06451612903225806,9
42706,Roger Salengro - Fontainebleau,OUI,25,23,2,1,1,OUI,OUI,2025-03-13 08:59:52+00:00,"48.814548697325, 2.3611663654447",Le Kremlin-Bicêtre,94043,0.08,9
8017,Rocher - Laborde,OUI,65,48,17,8,9,OUI,OUI,2025-03-13 09:00:06+00:00,"48.87590240712654, 2.322616316378116",Paris,75056,0.26153846153846155,9
21212,Marne - Germain Dardan,OUI,21,17,4,2,2,OUI,OUI,2025-03-13 08:56:50+00:00,"48.81217465201, 2.3035024699104",Montrouge,92049,0.19047619047619047,9
5124,Erasme - Ulm,OUI,22,0,22,4,18,OUI,OUI,2025-03-13 09:00:28+00:00,"48.84264375274712, 2.3445946723222733",Paris,75056,1.0,9
44006,Concorde - Stalingrad,OUI,34,31,3,2,1,OUI,OUI,2025-03-13 08:57:05+00:00,"48.7985844, 2.3821302",Vitry-sur-Seine,94081,0.08823529411764706,9
14106,Marc Sangnier - Porte de Vanves,OUI,20,18,2,1,1,OUI,OUI,2025-03-13 09:00:49+00:00,"48.825218683556734, 2.3107116669416428",Paris,75056,0.1,9
19120,Carducci - Place Hannah Arendt,OUI,27,24,3,0,3,OUI,OUI,2025-03-13 09:00:59+00:00,"48.877436681515796, 2.3860743641853337",Paris,75056,0.1111111111111111,9
18022,Marcadet - Barbès,OUI,34,32,2,0,2,OUI,OUI,2025-03-13 09:00:14+00:00,"48.890451120965, 2.3490573929687",Paris,75056,0.058823529411764705,9
18003,Cimetière de Montmartre,OUI,43,43,0,0,0,OUI,OUI,2025-03-13 09:00:50+00:00,"48.886472466142, 2.3328901827335",Paris,75056,0.0,9
8054,Bertie Albrecht - Hoche,OUI,32,12,20,8,12,OUI,OUI,2025-03-13 08:58:17+00:00,"48.87614039826388, 2.301303138307601",Paris,75056,0.625,9
15104,Hôpital Européen Georges Pompidou,OUI,64,5,59,50,9,OUI,OUI,2025-03-13 09:01:24+00:00,"48.837695319163, 2.2753742337227",Paris,75056,0.921875,9
15109,Cevennes - Bergers,OUI,28,23,5,3,2,OUI,OUI,2025-03-13 08:59:52+00:00,"48.84240765130395, 2.281037718057633",Paris,75056,0.17857142857142858,9
14003,Schoelcher - Raspail,OUI,48,44,4,2,2,OUI,OUI,2025-03-13 08:58:53+00:00,"48.83681733526843, 2.3312794080411474",Paris,75056,0.08333333333333333,9
21209,Molière - République,OUI,30,29,1,0,1,OUI,OUI,2025-03-13 08:58:40+00:00,"48.81111581390707, 2.3145738624448158",Montrouge,92049,0.03333333333333333,9
43008,Fontenay - Libération,OUI,25,17,8,1,7,OUI,OUI,2025-03-13 08:59:08+00:00,"48.847803063647, 2.4451419711113",Vincennes,94080,0.32,9
4016,Lobau - Hôtel de Ville,OUI,59,7,52,44,8,OUI,OUI,2025-03-13 09:00:05+00:00,"48.8562118, 2.3532536",Paris,75056,0.8813559322033898,9
21312,Lucie Aubrac - Fort,OUI,30,30,0,0,0,OUI,OUI,2025-03-13 08:52:21+00:00,"48.818144834008976, 2.271184623241425",Issy-les-Moulineaux,92040,0.0,9
15133,Saint Lambert - Blomet,OUI,27,25,2,2,0,OUI,OUI,2025-03-13 09:01:26+00:00,"48.83659148147257, 2.2930556908249855",Paris,75056,0.07407407407407407,9
14008,Mouton Duvernet - Général Leclerc,OUI,27,22,5,0,5,OUI,OUI,2025-03-13 09:00:46+00:00,"48.831632518293, 2.3293121159077",Paris,75056,0.18518518518518517,9
15110,Place Robert Guillemard,OUI,22,1,21,17,4,OUI,OUI,2025-03-13 08:58:56+00:00,"48.836191728066666, 2.2811267160086417",Paris,75056,0.9545454545454546,9
15054,Lecourbe - Jean Maridor,OUI,18,15,3,2,1,OUI,OUI,2025-03-13 09:00:34+00:00,"48.83796366147599, 2.2877392172813416",Paris,75056,0.16666666666666666,9
21006,Marcelin Berthelot,OUI,27,20,7,4,3,OUI,OUI,2025-03-13 09:00:39+00:00,"48.8415473058801, 2.233161628246308",Boulogne-Billancourt,92012,0.25925925925925924,9
15106,Grenelle - Violet,OUI,34,21,13,12,1,OUI,OUI,2025-03-13 09:00:53+00:00,"48.84993035512154, 2.294612042605877",Paris,75056,0.38235294117647056,9
20131,Repos - Cimetière du Père Lachaise,OUI,33,32,1,1,0,OUI,OUI,2025-03-13 08:53:19+00:00,"48.859358523593, 2.3896131366845",Paris,75056,0.030303030303030304,9
18046,Etienne Jodelle - Saint Ouen,OUI,31,28,3,0,3,OUI,OUI,2025-03-13 08:51:37+00:00,"48.88794016394694, 2.326124420314341",Paris,75056,0.0967741935483871,9
21015,Nationale - Place Jules Guesde,OUI,23,2,21,10,11,OUI,OUI,2025-03-13 09:00:27+00:00,"48.82753962462998, 2.2416052222251897",Boulogne-Billancourt,92012,0.9130434782608695,9
22406,Guy Môquet - Etienne Dolet,OUI,22,21,1,0,1,OUI,OUI,2025-03-13 08:57:28+00:00,"48.81527009991819, 2.298078276995073",Malakoff,92046,0.045454545454545456,9
44003,Gabriel Péri - Danielle Casanova,OUI,20,3,17,10,7,OUI,OUI,2025-03-13 08:57:47+00:00,"48.790114, 2.4025777",Vitry-sur-Seine,94081,0.85,9
31102,Boissière - Etienne Dolet,OUI,20,18,2,1,1,OUI,OUI,2025-03-13 08:57:27+00:00,"48.876111, 2.4677312",Montreuil,93048,0.1,9
5028,Censier - Jardin des Plantes,OUI,28,6,22,20,2,OUI,OUI,2025-03-13 08:58:01+00:00,"48.84107178161383, 2.355475388467312",Paris,75056,0.7857142857142857,9
2111,Chabanais - Petits Champs,OUI,29,1,28,20,8,OUI,OUI,2025-03-13 09:00:18+00:00,"48.86703740186721, 2.336716018617153",Paris,75056,0.9655172413793104,9
48010,Karl Marx,OUI,16,2,14,4,10,OUI,OUI,2025-03-13 08:53:10+00:00,"48.784527937293184, 2.3646667979455587",Villejuif,94076,0.875,9
14012,Sibelle - Alésia,OUI,37,35,2,0,2,OUI,OUI,2025-03-13 08:51:52+00:00,"48.826701758539215, 2.3384983465075493",Paris,75056,0.05405405405405406,9
22203,Tertres - Fontaine,OUI,27,23,4,0,4,OUI,OUI,2025-03-13 08:59:12+00:00,"48.787553654715644, 2.306235730648041",Bagneux,92007,0.14814814814814814,9
21005,Hôtel de Ville de Boulogne Billancourt,OUI,25,8,17,8,9,OUI,OUI,2025-03-13 08:54:31+00:00,"48.83495885166784, 2.2416803240776066",Boulogne-Billancourt,92012,0.68,9
1119,Cossonnerie - Sébastopol,OUI,23,9,14,7,7,OUI,OUI,2025-03-13 08:58:52+00:00,"48.86132665908402, 2.349419631063938",Paris,75056,0.6086956521739131,9
35010,Hoche - Jean Lolive,OUI,18,12,6,4,2,OUI,OUI,2025-03-13 08:59:25+00:00,"48.89110239200789, 2.402843534946442",Pantin,93055,0.3333333333333333,9
35020,Marcelle - Thalie,OUI,20,20,0,0,0,OUI,OUI,2025-03-13 08:57:39+00:00,"48.8835462, 2.4137883",Pantin,93055,0.0,9
10042,Enghien - Faubourg Poissonnière,OUI,32,8,24,16,8,OUI,OUI,2025-03-13 09:00:01+00:00,"48.872420063053, 2.3483952362828",Paris,75056,0.75,9
1020,Cambon - Rivoli,OUI,34,1,33,19,14,OUI,OUI,2025-03-13 08:59:59+00:00,"48.866143390992, 2.3251800647137",Paris,75056,0.9705882352941176,9
17203,Place de la Porte de Champeret,OUI,28,11,17,16,1,OUI,OUI,2025-03-13 09:01:16+00:00,"48.886062068226, 2.2917001576821",Paris,75056,0.6071428571428571,9
25003,Henri Ste-Claire Déville - Paul Héroult,OUI,21,7,14,6,8,OUI,OUI,2025-03-13 09:01:26+00:00,"48.892663, 2.172411",Rueil-Malmaison,92063,0.6666666666666666,9
42014,Place Marcel Cachin,OUI,32,4,28,25,3,OUI,OUI,2025-03-13 08:58:36+00:00,"48.81411442356866, 2.39090770483017",Ivry-sur-Seine,94041,0.875,9
20115,Louis Lumière - Porte de Bagnolet,OUI,20,20,0,0,0,OUI,OUI,2025-03-13 08:52:48+00:00,"48.86431136000005, 2.4105210229754443",Paris,75056,0.0,9
8045,Place de la Reine Astrid,OUI,56,23,33,16,17,OUI,OUI,2025-03-13 08:59:54+00:00,"48.864920982538, 2.3025491823859",Paris,75056,0.5892857142857143,9
22402,Jean Jaurès - Salvador Allende,OUI,42,41,1,0,1,OUI,OUI,2025-03-13 09:00:20+00:00,"48.821475594736775, 2.3026576638221745",Malakoff,92046,0.023809523809523808,9
14124,David Weill - Parc Montsouris,OUI,22,20,2,0,2,OUI,OUI,2025-03-13 08:55:38+00:00,"48.821092374256104, 2.333725690841675",Paris,75056,0.09090909090909091,9
9116,Victoire - Chaussée d'Antin,OUI,24,3,21,10,11,OUI,OUI,2025-03-13 09:01:24+00:00,"48.875065791004396, 2.3316738009452824",Paris,75056,0.875,9
11030,Oberkampf - République,OUI,21,19,2,1,1,OUI,OUI,2025-03-13 09:00:57+00:00,"48.86531608707, 2.37611478491",Paris,75056,0.09523809523809523,9
44013,Edouard Tremblay - Julian Grimaux,OUI,30,26,4,2,2,OUI,OUI,2025-03-13 08:53:08+00:00,"48.781383825117, 2.3723508417606",Vitry-sur-Seine,94081,0.13333333333333333,9
11039,Richard Lenoir - Jean-Pierre Timbaud,OUI,35,14,21,20,1,OUI,OUI,2025-03-13 09:00:50+00:00,"48.865804276686, 2.3693370749669",Paris,75056,0.6,9
6025,Assas - Rennes,OUI,32,20,12,6,6,OUI,OUI,2025-03-13 09:00:35+00:00,"48.8492084999386, 2.32851454623001",Paris,75056,0.375,9
11026,Chemin Vert - Saint-Maur,OUI,44,38,6,4,2,OUI,OUI,2025-03-13 08:58:34+00:00,"48.86112461407359, 2.381299026310444",Paris,75056,0.13636363636363635,9
15034,Lakanal - Commerce,OUI,48,10,38,38,0,OUI,OUI,2025-03-13 09:01:01+00:00,"48.84442462786544, 2.294059172272682",Paris,75056,0.7916666666666666,9
32604,Square du Théâtre du Garde-Chasse,OUI,50,47,3,0,3,OUI,OUI,2025-03-13 08:55:01+00:00,"48.881287375060616, 2.420119643211365",Les Lilas,93045,0.06,9
41202,Gare Rer de Fontenay sous Bois,OUI,57,56,1,0,1,OUI,OUI,2025-03-13 08:52:14+00:00,"48.8436279, 2.4630465",Fontenay-sous-Bois,94033,0.017543859649122806,9
41601,Général De Gaulle - Alouette,OUI,23,22,1,1,0,OUI,OUI,2025-03-13 09:01:05+00:00,"48.839109, 2.4175664",Saint-Mandé,94067,0.043478260869565216,9
42021,Raspail - Manufacture des Oeillets,OUI,30,6,24,23,1,OUI,OUI,2025-03-13 09:00:35+00:00,"48.8094458, 2.3903009",Ivry-sur-Seine,94041,0.8,9
23006,Jules Guesde - Alsace,OUI,24,4,20,10,10,OUI,OUI,2025-03-13 08:58:25+00:00,"48.890566275506, 2.2950777411461",Levallois-Perret,92044,0.8333333333333334,9
31003,Paris - Emile Zola,OUI,29,28,1,0,1,OUI,OUI,2025-03-13 09:00:46+00:00,"48.854898095789295, 2.4186685681343083",Montreuil,93048,0.034482758620689655,9
15021,Joseph Liouville - Croix Nivert,OUI,63,37,26,24,2,OUI,OUI,2025-03-13 09:00:22+00:00,"48.844835471244416, 2.297508493065834",Paris,75056,0.4126984126984127,9
17013,Legendre - Dulong,OUI,23,20,3,0,3,OUI,OUI,2025-03-13 08:56:47+00:00,"48.885325169402904, 2.316423766314984",Paris,75056,0.13043478260869565,9
9010,Rochechouart lamartine,OUI,23,20,3,0,3,OUI,OUI,2025-03-13 08:58:20+00:00,"48.876719895109, 2.344393021854",Paris,75056,0.13043478260869565,9
19024,Botzaris - Parc des Buttes Chaumont,OUI,20,19,1,0,1,OUI,OUI,2025-03-13 08:53:07+00:00,"48.877951, 2.381464",Paris,75056,0.05,9
11105,Parmentier - République,OUI,21,16,5,1,4,OUI,OUI,2025-03-13 08:59:10+00:00,"48.8644954, 2.3750124",Paris,75056,0.23809523809523808,9
17105,Place Madeleine Daniélou,OUI,42,17,25,17,8,OUI,OUI,2025-03-13 09:00:50+00:00,"48.883498, 2.282015",Paris,75056,0.5952380952380952,9
17125,Marie-Georges Picquart - Pereire,OUI,31,24,7,2,5,OUI,OUI,2025-03-13 08:58:12+00:00,"48.88863669349711, 2.3111706599593163",Paris,75056,0.22580645161290322,9
18009,Jean-François Lépine - Stephenson,OUI,22,20,2,0,2,OUI,OUI,2025-03-13 08:52:34+00:00,"48.88611466796807, 2.356855627529275",Paris,75056,0.09090909090909091,9
16136,Théophile Gautier - François Millet,OUI,27,22,5,4,1,OUI,OUI,2025-03-13 09:00:59+00:00,"48.85034821320644, 2.273029983043671",Paris,75056,0.18518518518518517,9
16108,Sablons - Georges Mandel,OUI,38,36,2,1,1,OUI,OUI,2025-03-13 08:53:38+00:00,"48.863875, 2.28189",Paris,75056,0.05263157894736842,9
19032,Villette - Belleville,OUI,39,34,5,2,3,OUI,OUI,2025-03-13 09:01:23+00:00,"48.8726877314, 2.376461327076",Paris,75056,0.1282051282051282,9
43005,Gare RER de Vincennes,OUI,48,28,20,4,16,OUI,OUI,2025-03-13 09:01:27+00:00,"48.847563015126106, 2.433383166790009",Vincennes,94080,0.4166666666666667,9
19022,Marché Secrétan,OUI,25,19,6,1,5,OUI,OUI,2025-03-13 08:59:26+00:00,"48.88125496379482, 2.373463287949562",Paris,75056,0.24,9
22003,Beffroy,OUI,26,4,22,5,17,OUI,OUI,2025-03-13 09:01:27+00:00,"48.886591074488, 2.2613945603371",Neuilly-sur-Seine,92051,0.8461538461538461,9
21701,Larmeroux - Baudelaire,OUI,28,28,0,0,0,OUI,OUI,2025-03-13 08:55:59+00:00,"48.816939911292, 2.2809894804846",Vanves,92075,0.0,9
13050,Quai Panhard et Levassor,OUI,57,1,56,29,27,OUI,OUI,2025-03-13 08:59:40+00:00,"48.828374828097, 2.3842737458056",Paris,75056,0.9824561403508771,9
16008,Galilée - Kléber,OUI,30,13,17,3,14,OUI,OUI,2025-03-13 09:00:39+00:00,"48.867411865714, 2.2907813801148",Paris,75056,0.5666666666666667,9
11024,Mairie du 11ème,OUI,51,32,19,16,3,OUI,OUI,2025-03-13 09:00:28+00:00,"48.858925, 2.3789759",Paris,75056,0.37254901960784315,9
20134,Lieutenant Chauré - Etienne Marey,OUI,19,19,0,0,0,OUI,OUI,2025-03-13 08:59:59+00:00,"48.86746195408435, 2.405970990657807",Paris,75056,0.0,9
21008,Victor Hugo - Galliéni,OUI,33,20,13,13,0,OUI,OUI,2025-03-13 08:57:24+00:00,"48.838020154411, 2.2460845112801",Boulogne-Billancourt,92012,0.3939393939393939,9
24001,Arche - Léonard de Vinci,OUI,28,11,17,8,9,OUI,OUI,2025-03-13 08:52:54+00:00,"48.89790972494496, 2.2383723043644914",Courbevoie,92026,0.6071428571428571,9
22016,Charles de Gaulle - Sablonville,OUI,26,13,13,5,8,OUI,OUI,2025-03-13 09:01:20+00:00,"48.87991924860035, 2.2763770446181297",Neuilly-sur-Seine,92051,0.5,9
11035,Parmentier - Abel Rabaud,OUI,50,46,4,2,2,OUI,OUI,2025-03-13 09:01:08+00:00,"48.86921273836114, 2.371688821240712",Paris,75056,0.08,9
14136,Auguste Cain - Jean Moulin,OUI,40,38,2,0,2,OUI,OUI,2025-03-13 08:57:20+00:00,"48.82577028927573, 2.3210415244102482",Paris,75056,0.05,9
46001,Place Paul Eluard,OUI,19,5,14,9,5,OUI,OUI,2025-03-13 08:56:20+00:00,"48.7672039733195, 2.4144977331161503",Choisy-le-Roi,94022,0.7368421052631579,9
32302,Chemin Vert - Fraternité,OUI,20,17,3,1,2,OUI,OUI,2025-03-13 08:57:44+00:00,"48.877141208359035, 2.4461565166711807",Romainville,93063,0.15,9
16040,Exelmans - Michel-Ange,OUI,31,16,15,13,2,OUI,OUI,2025-03-13 09:01:13+00:00,"48.84309486651855, 2.2597770800669053",Paris,75056,0.4838709677419355,9
10014,Marseille - Beaurepaire,OUI,46,11,35,32,3,OUI,OUI,2025-03-13 09:00:07+00:00,"48.871624306962985, 2.3639265082738348",Paris,75056,0.7608695652173914,9
42302,Aristide Briand - Gare de Bagneux,OUI,20,18,2,1,1,OUI,OUI,2025-03-13 08:56:56+00:00,"48.79387269664978, 2.321148812770844",Cachan,94016,0.1,9
42010,Mairie d'Ivry-sur-Seine,OUI,51,21,30,27,3,OUI,OUI,2025-03-13 09:00:17+00:00,"48.81057120969284, 2.3842826485633855",Ivry-sur-Seine,94041,0.5882352941176471,9
9032,Mathurins - Auber,OUI,35,5,30,19,11,OUI,OUI,2025-03-13 09:00:27+00:00,"48.872988840744, 2.3294984212276",Paris,75056,0.8571428571428571,9
15046,Parc Georges Brassens - Brancion,OUI,28,27,1,0,1,OUI,OUI,2025-03-13 09:00:51+00:00,"48.83227829269761, 2.3022570088505745",Paris,75056,0.03571428571428571,9
19016,Hautpoul - Jean Jaurès,OUI,29,27,2,1,1,OUI,OUI,2025-03-13 08:55:59+00:00,"48.886393679436, 2.3865414544355",Paris,75056,0.06896551724137931,9
22006,Pierret - Madrid,OUI,27,5,22,12,10,OUI,OUI,2025-03-13 09:00:35+00:00,"48.882976576876565, 2.260125767248034",Neuilly-sur-Seine,92051,0.8148148148148148,9
21104,Madame de Sanzillon - Mozart,OUI,22,5,17,8,9,OUI,OUI,2025-03-13 09:01:21+00:00,"48.90379820774301, 2.3187401890754704",Clichy,92024,0.7727272727272727,9
17028,Reims - Raymond Pitet,OUI,36,13,23,19,4,OUI,OUI,2025-03-13 09:00:29+00:00,"48.8888, 2.296319",Paris,75056,0.6388888888888888,9
11042,Grand Prieuré - Crussol,OUI,46,18,28,25,3,OUI,OUI,2025-03-13 09:01:26+00:00,"48.864660627935, 2.3692265531829",Paris,75056,0.6086956521739131,9
21301,Saint-Vincent - Verdun,OUI,33,2,31,27,4,OUI,OUI,2025-03-13 09:00:43+00:00,"48.819211549234495, 2.254007756710053",Issy-les-Moulineaux,92040,0.9393939393939394,9
1013,Place du Palais Royal,OUI,65,1,64,40,24,OUI,OUI,2025-03-13 09:01:23+00:00,"48.862382970647, 2.3384822532535",Paris,75056,0.9846153846153847,9
19029,Seine - Flandre,OUI,18,17,1,0,1,OUI,OUI,2025-03-13 09:00:19+00:00,"48.886785741479684, 2.3746193200349808",Paris,75056,0.05555555555555555,9
8025,Miromesnil - La Boétie,OUI,32,2,30,10,20,OUI,OUI,2025-03-13 09:01:02+00:00,"48.873722412917, 2.3158480972052",Paris,75056,0.9375,9
32003,Wilson - Métallurgie,OUI,28,13,15,10,5,OUI,OUI,2025-03-13 09:01:01+00:00,"48.909423010092326, 2.3584435880184174",Saint-Denis,93066,0.5357142857142857,9
7102,Mairie du 7ème,OUI,48,7,41,23,18,OUI,OUI,2025-03-13 09:01:22+00:00,"48.8577967, 2.3192664",Paris,75056,0.8541666666666666,9
32026,Leroy des Barres - Médiathèque,OUI,27,3,24,10,14,OUI,OUI,2025-03-13 09:00:42+00:00,"48.928253687082, 2.3681719727966",Saint-Denis,93066,0.8888888888888888,9
42504,Gare RER de Gentilly,OUI,30,27,3,2,1,OUI,OUI,2025-03-13 09:00:57+00:00,"48.814280450380224, 2.3410347104072575",Gentilly,94037,0.1,9
9005,Square d'Anvers,OUI,31,31,0,0,0,OUI,OUI,2025-03-13 08:57:25+00:00,"48.882633484311, 2.3448844062122",Paris,75056,0.0,9
32016,Place de la Porte de Paris,OUI,37,25,12,2,10,OUI,OUI,2025-03-13 08:59:56+00:00,"48.93009363207303, 2.3564037680625916",Saint-Denis,93066,0.32432432432432434,9
13002,Arago - Glacière,OUI,26,18,8,6,2,OUI,OUI,2025-03-13 09:01:20+00:00,"48.83486054775774, 2.3445770524322067",Paris,75056,0.3076923076923077,9
15201,Place Amédée Gordini - Lefebvre,OUI,36,30,6,3,3,OUI,OUI,2025-03-13 08:54:38+00:00,"48.83061737745, 2.2920634208276",Paris,75056,0.16666666666666666,9
19008,Flandre - Alphonse Karr,OUI,26,23,3,1,2,OUI,OUI,2025-03-13 08:56:20+00:00,"48.89465, 2.381868",Paris,75056,0.11538461538461539,9
20121,Boyer - Ménilmontant,OUI,19,19,0,0,0,OUI,OUI,2025-03-13 09:01:19+00:00,"48.868895162679, 2.3919824145635",Paris,75056,0.0,9
11004,Charonne - Faubourg Saint-Antoine,OUI,32,4,28,25,3,OUI,OUI,2025-03-13 09:01:24+00:00,"48.852191909696, 2.3740932717919",Paris,75056,0.875,9
19013,Laumière - Petit,OUI,32,32,0,0,0,OUI,OUI,2025-03-13 08:53:13+00:00,"48.88467368538326, 2.380039058625698",Paris,75056,0.0,9
92008,Hôtel de Ville de Nanterre,OUI,35,13,22,13,9,OUI,OUI,2025-03-13 09:00:57+00:00,"48.892371898250424, 2.205548956990242",Nanterre,92050,0.6285714285714286,9
42301,Gare Arcueil - Cachan,OUI,25,11,14,2,12,OUI,OUI,2025-03-13 09:00:55+00:00,"48.799824, 2.328171",Arcueil,94003,0.56,9
51004,Général Delambre - Prebuard,OUI,28,16,12,2,10,OUI,OUI,2025-03-13 08:53:51+00:00,"48.93870344444, 2.2234171606307",Argenteuil,95018,0.42857142857142855,9
26013,Quai du docteur Dervaux,OUI,26,14,12,10,2,OUI,OUI,2025-03-13 08:56:38+00:00,"48.910482, 2.297998",Asnières-sur-Seine,92004,0.46153846153846156,9
18012,Stephenson - Doudeauville,OUI,35,34,1,1,0,OUI,OUI,2025-03-13 08:59:41+00:00,"48.888537048944826, 2.3561610281467438",Paris,75056,0.02857142857142857,9
20111,Villiers de l'Isle Adam - Pyrénées,OUI,20,20,0,0,0,OUI,OUI,2025-03-13 08:51:32+00:00,"48.867362, 2.396222",Paris,75056,0.0,9
19125,Place de l'Édit de Nantes,OUI,26,26,0,0,0,OUI,OUI,2025-03-13 08:57:55+00:00,"48.88879, 2.3785",Paris,75056,0.0,9
20043,Charonne - Avron,OUI,26,25,1,1,0,OUI,OUI,2025-03-13 08:59:33+00:00,"48.851602665222, 2.3984030470379",Paris,75056,0.038461538461538464,9
5123,Saint-Germain - Thenard,OUI,29,10,19,15,4,OUI,OUI,2025-03-13 09:00:55+00:00,"48.850571, 2.3471015",Paris,75056,0.6551724137931034,9
42015,Place Jean Ferrat,OUI,23,21,2,1,1,OUI,OUI,2025-03-13 08:58:34+00:00,"48.8184945213025, 2.3744174838066106",Ivry-sur-Seine,94041,0.08695652173913043,9
21313,Guynemer - Séverine,OUI,25,1,24,18,6,OUI,OUI,2025-03-13 09:00:06+00:00,"48.83091743371036, 2.2790706530213356",Issy-les-Moulineaux,92040,0.96,9
31010,Stalingrad - Désiré Chevalier,OUI,41,40,1,0,1,OUI,OUI,2025-03-13 08:57:31+00:00,"48.85670169739857, 2.445072233676911",Montreuil,93048,0.024390243902439025,9
17102,Alfred Roll - Berthier,OUI,28,17,11,7,4,OUI,OUI,2025-03-13 09:00:07+00:00,"48.887808570529, 2.3000952981763",Paris,75056,0.39285714285714285,9
18201,Tristan Tzara -  Tchaïkovski,OUI,32,31,1,1,0,OUI,OUI,2025-03-13 08:57:19+00:00,"48.89490221746837, 2.3648490384221077",Paris,75056,0.03125,9
28001,Richard Wallace - Place du 8 Mai 1945,OUI,29,13,16,11,5,OUI,OUI,2025-03-13 09:00:21+00:00,"48.87866794788021, 2.2420343756675725",Puteaux,92062,0.5517241379310345,9
41402,Victor Hugo - Ecoles,OUI,22,15,7,6,1,OUI,OUI,2025-03-13 08:56:30+00:00,"48.80476007936134, 2.4180373930262093",Alfortville,94002,0.3181818181818182,9
11007,Jean Macé - Faidherbe,OUI,59,48,11,5,6,OUI,OUI,2025-03-13 08:59:52+00:00,"48.85337548426, 2.3828620836139",Paris,75056,0.1864406779661017,9
12009,Charenton - Diderot,OUI,18,10,8,4,4,OUI,OUI,2025-03-13 09:01:26+00:00,"48.846171461187, 2.3793068155646",Paris,75056,0.4444444444444444,9
15025,Dupleix - du Guesclin,OUI,46,19,27,22,5,OUI,OUI,2025-03-13 08:58:26+00:00,"48.85147910413369, 2.296709530055523",Paris,75056,0.5869565217391305,9
14036,Boulard - Daguerre,OUI,43,42,1,0,1,OUI,OUI,2025-03-13 08:57:03+00:00,"48.83446472680611, 2.3293386027216907",Paris,75056,0.023255813953488372,9
35018,Ancien Canal - Hélène Brion,OUI,22,21,1,1,0,OUI,OUI,2025-03-13 08:59:04+00:00,"48.89484799296163, 2.4188338592648506",Pantin,93055,0.045454545454545456,9
18110,Departement - Pajol,OUI,16,14,2,0,2,OUI,OUI,2025-03-13 09:00:15+00:00,"48.886674849730184, 2.3613611608743668",Paris,75056,0.125,9
19205,Simon Bolivar - Henri Turot,OUI,23,23,0,0,0,OUI,OUI,2025-03-13 08:55:23+00:00,"48.877475489801, 2.3739709492211",Paris,75056,0.0,9
19005,Flandre - Riquet,OUI,19,18,1,1,0,OUI,OUI,2025-03-13 09:01:19+00:00,"48.888013281448, 2.3737595955229",Paris,75056,0.05263157894736842,9
11036,Jules Ferry - Faubourg du Temple Paris,OUI,56,36,20,18,2,OUI,OUI,2025-03-13 09:01:27+00:00,"48.868397, 2.3678933",Paris,75056,0.35714285714285715,9
10113,Parmentier - Hôpital Saint-Louis,OUI,39,37,2,2,0,OUI,OUI,2025-03-13 09:00:53+00:00,"48.871379874257, 2.3698963836667",Paris,75056,0.05128205128205128,9
43003,Hôpital Bégin,OUI,26,26,0,0,0,NON,NON,2025-03-13 08:57:33+00:00,"48.84571672113, 2.4272462725639",Vincennes,94080,0.0,9
41606,Pasteur - Gambetta,OUI,19,4,15,7,8,OUI,OUI,2025-03-13 09:00:24+00:00,"48.84572797384512, 2.4236011505126953",Saint-Mandé,94067,0.7894736842105263,9
9021,Saint Georges - d'Aumale,OUI,22,20,2,1,1,OUI,OUI,2025-03-13 09:00:42+00:00,"48.87778639599673, 2.337429821491241",Paris,75056,0.09090909090909091,9
17045,Place des Ternes.,OUI,44,42,2,2,0,OUI,OUI,2025-03-13 09:01:10+00:00,"48.878438631226516, 2.297727763652802",Paris,75056,0.045454545454545456,9
23009,Anatole France - Louise Michel,OUI,47,41,6,3,3,OUI,OUI,2025-03-13 08:59:36+00:00,"48.88873214926474, 2.2881576418876652",Levallois-Perret,92044,0.1276595744680851,9
12013,Montgallet - Reuilly,OUI,14,6,8,3,5,OUI,OUI,2025-03-13 08:55:48+00:00,"48.844291, 2.3896481",Paris,75056,0.5714285714285714,9
12027,Montgallet - Charenton,OUI,15,13,2,2,0,OUI,OUI,2025-03-13 08:52:58+00:00,"48.842647778701, 2.3861649278137",Paris,75056,0.13333333333333333,9
21305,Place Jacques Madaule,OUI,23,4,19,19,0,OUI,OUI,2025-03-13 09:01:03+00:00,"48.823933787309, 2.2606918215752",Issy-les-Moulineaux,92040,0.8260869565217391,9
42029,Stalingrad - Germaine Tailleferre,OUI,27,24,3,0,3,OUI,OUI,2025-03-13 08:59:57+00:00,"48.80257200481316, 2.3786691203713417",Ivry-sur-Seine,94041,0.1111111111111111,9
7015,Varenne,OUI,44,15,29,18,11,OUI,OUI,2025-03-13 09:00:28+00:00,"48.857202661803, 2.3152771219611",Paris,75056,0.6590909090909091,9
8035,Bienfaisance - Place de Narvik,OUI,34,1,33,17,16,OUI,OUI,2025-03-13 08:59:30+00:00,"48.87660163459077, 2.3129771277308464",Paris,75056,0.9705882352941176,9
26007,Square Gilbert Thomain,OUI,19,13,6,6,0,OUI,OUI,2025-03-13 08:52:57+00:00,"48.90717373809284, 2.2695400938391685",Asnières-sur-Seine,92004,0.3157894736842105,9
6013,Jacques Callot - Mazarine,OUI,27,1,26,23,3,OUI,OUI,2025-03-13 09:00:41+00:00,"48.855280175332, 2.3375743255019",Paris,75056,0.9629629629629629,9
16111,Faustin Hélie - Desbordes-Valmore,OUI,27,26,1,0,1,OUI,OUI,2025-03-13 08:58:17+00:00,"48.859403, 2.276522",Paris,75056,0.037037037037037035,9
12115,Porte de Vincennes,OUI,32,29,3,2,1,OUI,OUI,2025-03-13 08:58:13+00:00,"48.846454, 2.415514",Paris,75056,0.09375,9
17011,Fragonard - Porte de Clichy,OUI,55,21,34,31,3,OUI,OUI,2025-03-13 08:59:19+00:00,"48.894155633419, 2.3143893107772",Paris,75056,0.6181818181818182,9
8033,Commandant Rivière,OUI,39,3,36,24,12,OUI,OUI,2025-03-13 08:59:55+00:00,"48.872933, 2.309796",Paris,75056,0.9230769230769231,9
43402,Place de Verdun,OUI,40,19,21,19,2,OUI,OUI,2025-03-13 08:59:34+00:00,"48.8202823, 2.473775",Joinville-le-Pont,94042,0.525,9
16121,Jardin d'Acclimatation,OUI,30,21,9,5,4,OUI,OUI,2025-03-13 09:01:26+00:00,"48.878772242510465, 2.270772233605385",Paris,75056,0.3,9
33018,Edouard Poisson - Victor Hugo,OUI,26,22,4,2,2,OUI,OUI,2025-03-13 08:58:27+00:00,"48.91118557052621, 2.379864752692811",Aubervilliers,93001,0.15384615384615385,9
15010,Square Cambronne,OUI,59,13,46,43,3,OUI,OUI,2025-03-13 09:00:14+00:00,"48.84756654526, 2.3025691509247",Paris,75056,0.7796610169491526,9
11115,Montreuil - Gonnet,OUI,24,21,3,1,2,OUI,OUI,2025-03-13 08:57:21+00:00,"48.850500564921, 2.3890856287864",Paris,75056,0.125,9
17037,Bayen - Pereire,OUI,21,15,6,4,2,OUI,OUI,2025-03-13 08:58:38+00:00,"48.881804409079656, 2.2921088710427284",Paris,75056,0.2857142857142857,9
5021,Jussieu - Fossés Saint-Bernard,OUI,38,2,36,34,2,OUI,OUI,2025-03-13 09:00:04+00:00,"48.847185510023, 2.3534858599305",Paris,75056,0.9473684210526315,9
25005,18 juin 1940 - Buzenval,OUI,25,18,7,4,3,OUI,OUI,2025-03-13 08:53:25+00:00,"48.868807, 2.185428",Rueil-Malmaison,92063,0.28,9
23001,Paul Vaillant Couturier - Chaptal,OUI,36,0,36,25,11,OUI,OUI,2025-03-13 09:01:10+00:00,"48.893479576183, 2.2775253653526",Levallois-Perret,92044,1.0,9
13045,Jean Colly - Tolbiac,OUI,36,32,4,2,2,OUI,OUI,2025-03-13 09:00:03+00:00,"48.827817291597846, 2.3705490678548813",Paris,75056,0.1111111111111111,9
41102,Gare de Laplace,OUI,43,40,3,3,0,OUI,OUI,2025-03-13 08:58:22+00:00,"48.80893199114179, 2.3349460959434514",Arcueil,94003,0.06976744186046512,9
19115,Porte de la Villette,OUI,26,17,9,5,4,OUI,OUI,2025-03-13 09:01:15+00:00,"48.89835196548483, 2.386150136590004",Paris,75056,0.34615384615384615,9
18141,Clignancourt - Sofia,OUI,19,19,0,0,0,OUI,OUI,2025-03-13 08:59:32+00:00,"48.88511992309783, 2.34719488842051",Paris,75056,0.0,9
14034,Ouest - Château,OUI,23,23,0,0,0,OUI,OUI,2025-03-13 09:00:54+00:00,"48.83617286014242, 2.319392143923804",Paris,75056,0.0,9
16124,Route de Sèvres - Porte de Bagatelle,OUI,65,10,55,52,3,OUI,OUI,2025-03-13 08:59:25+00:00,"48.87525984132485, 2.249415814876557",Paris,75056,0.8461538461538461,9
32010,Place aux Étoiles,OUI,37,10,27,7,20,OUI,OUI,2025-03-13 08:59:56+00:00,"48.91835629408464, 2.3523425683379173",Saint-Denis,93066,0.7297297297297297,9
33003,Bordier - Félix Faure,OUI,43,37,6,5,1,OUI,OUI,2025-03-13 08:59:46+00:00,"48.90390751882016, 2.3830059170722966",Aubervilliers,93001,0.13953488372093023,9
19044,Grands Moulins de Pantin,OUI,50,35,15,4,11,OUI,OUI,2025-03-13 09:00:02+00:00,"48.89738369720229, 2.3959985375404362",Paris,75056,0.3,9
33009,Félix Faure - Sadi Carnot,OUI,33,23,10,7,3,OUI,OUI,2025-03-13 09:01:18+00:00,"48.90812110228388, 2.378623187541962",Aubervilliers,93001,0.30303030303030304,9
24002,Gare de Courbevoie,OUI,32,27,5,5,0,OUI,OUI,2025-03-13 08:54:34+00:00,"48.8993867, 2.2506506",Courbevoie,92026,0.15625,9
5106,Cujas - Saint-Michel,OUI,19,1,18,1,17,OUI,OUI,2025-03-13 09:01:24+00:00,"48.848191348584, 2.341831654854",Paris,75056,0.9473684210526315,9
33001,Victor Hugo - Magasins Généraux,OUI,34,23,11,4,7,OUI,OUI,2025-03-13 08:56:51+00:00,"48.903281401126755, 2.368072383105755",Aubervilliers,93001,0.3235294117647059,9
22505,Mairie de La Garenne Colombes,OUI,22,16,6,6,0,OUI,OUI,2025-03-13 08:58:17+00:00,"48.90663823468682, 2.24679596722126",La Garenne-Colombes,92035,0.2727272727272727,9
16034,Porte d'Auteuil,OUI,32,29,3,2,1,OUI,OUI,2025-03-13 08:56:56+00:00,"48.8479394142243, 2.2608396783471107",Paris,75056,0.09375,9
16018,Flandrin - Henri Martin,OUI,18,15,3,0,3,OUI,OUI,2025-03-13 09:01:22+00:00,"48.8643275, 2.2724174",Paris,75056,0.16666666666666666,9
41404,Carnot - Pâquerettes,OUI,24,2,22,20,2,OUI,OUI,2025-03-13 09:00:48+00:00,"48.79592939432515, 2.4261841177940373",Alfortville,94002,0.9166666666666666,9
12034,Pirogues de Bercy - Libourne,OUI,48,29,19,6,13,OUI,OUI,2025-03-13 08:59:10+00:00,"48.832308, 2.38637",Paris,75056,0.3958333333333333,9
7009,Assemblée Nationale,OUI,74,11,63,28,35,OUI,OUI,2025-03-13 08:57:32+00:00,"48.861411014652, 2.3201214185208",Paris,75056,0.8513513513513513,9
15033,Place Violet,OUI,29,20,9,8,1,OUI,OUI,2025-03-13 09:01:22+00:00,"48.84487893836502, 2.2905756533145905",Paris,75056,0.3103448275862069,9
92003,Chanzy - Sud-Est,OUI,25,25,0,0,0,OUI,OUI,2025-03-13 08:59:20+00:00,"48.888912037698766, 2.195632159709931",Nanterre,92050,0.0,9
25008,Place du 8 Mai 1945,OUI,18,13,5,5,0,OUI,OUI,2025-03-13 08:59:37+00:00,"48.871552174017, 2.2025031970585",Rueil-Malmaison,92063,0.2777777777777778,9
5119,Jussieu - Guy de la Brosse,OUI,40,0,40,23,17,OUI,OUI,2025-03-13 09:00:49+00:00,"48.845665, 2.355653",Paris,75056,1.0,9
20132,Réunion - Avron,OUI,26,25,1,1,0,OUI,OUI,2025-03-13 08:58:32+00:00,"48.852566752033766, 2.403928068708116",Paris,75056,0.038461538461538464,9
17007,Navier - Epinettes,OUI,36,35,1,0,1,OUI,OUI,2025-03-13 09:00:44+00:00,"48.89587780769155, 2.3226776719093327",Paris,75056,0.027777777777777776,9
15122,Place Charles Vallin,OUI,26,24,2,1,1,OUI,OUI,2025-03-13 08:57:46+00:00,"48.835523812041, 2.3025986552238",Paris,75056,0.07692307692307693,9
16129,Ceinture du Lac Inferieure - Saint-Cloud,OUI,41,37,4,0,4,OUI,OUI,2025-03-13 08:56:40+00:00,"48.86218070933143, 2.2617871686816216",Paris,75056,0.0975609756097561,9
42707,Place Jean-Baptiste Clément,OUI,23,21,2,1,1,OUI,OUI,2025-03-13 09:01:20+00:00,"48.81240466867336, 2.3617091774940495",Le Kremlin-Bicêtre,94043,0.08695652173913043,9
31705,Champeaux - Gallieni,OUI,47,46,1,0,1,OUI,OUI,2025-03-13 08:52:21+00:00,"48.864459134684644, 2.4161778017878532",Bagnolet,93006,0.02127659574468085,9
35009,Jean Lolive - Parc Stalingrad,OUI,22,18,4,3,1,OUI,OUI,2025-03-13 08:57:39+00:00,"48.89206174403158, 2.4091735482215886",Pantin,93055,0.18181818181818182,9
23802,Raymond Poincaré - Allée de la Marche,OUI,22,13,9,7,2,OUI,OUI,2025-03-13 08:56:10+00:00,"48.838634069623, 2.1724102640451",Garches,92033,0.4090909090909091,9
19019,Petit - Manin,OUI,22,22,0,0,0,NON,NON,2025-03-13 08:54:23+00:00,"48.886506875343, 2.3938155401308",Paris,75056,0.0,9
12126,Gravelle - Route du Bac,OUI,51,40,11,8,3,OUI,OUI,2025-03-13 09:01:27+00:00,"48.824407, 2.418455",Paris,75056,0.21568627450980393,9
8055,Courcelles - Place des Ternes,OUI,28,23,5,3,2,OUI,OUI,2025-03-13 09:01:16+00:00,"48.878199928923124, 2.2992860188665043",Paris,75056,0.17857142857142858,9
41604,Lagny - Joffre,OUI,30,5,25,19,6,OUI,OUI,2025-03-13 08:59:59+00:00,"48.84930687084088, 2.417949736118317",Saint-Mandé,94067,0.8333333333333334,9
27002,Parc Pierre Lagravère,OUI,30,12,18,9,9,OUI,OUI,2025-03-13 08:59:47+00:00,"48.92650488131725, 2.239069678491417",Colombes,92025,0.6,9
15017,Place Falguière,OUI,22,22,0,0,0,OUI,OUI,2025-03-13 09:00:02+00:00,"48.83629973941847, 2.3104464635252953",Paris,75056,0.0,9
21109,Guichet - Jean Jaurès,OUI,23,21,2,0,2,OUI,OUI,2025-03-13 09:00:17+00:00,"48.905169868129036, 2.3023840785026555",Clichy,92024,0.08695652173913043,9
17018,Parc Monceau,OUI,18,3,15,7,8,OUI,OUI,2025-03-13 08:55:43+00:00,"48.881077914129, 2.3095492646098",Paris,75056,0.8333333333333334,9
23701,Parvis Robert Schuman - Roger Salengro,OUI,24,12,12,3,9,OUI,OUI,2025-03-13 08:56:10+00:00,"48.812657470558754, 2.1921751275658607",Chaville,92022,0.5,9
26001,Gare d'Asnières sur Seine,OUI,21,12,9,7,2,OUI,OUI,2025-03-13 09:00:46+00:00,"48.90636459217474, 2.2835066914558415",Asnières-sur-Seine,92004,0.42857142857142855,9
21502,Verdun - Place Henri IV,OUI,25,5,20,14,6,OUI,OUI,2025-03-13 09:00:57+00:00,"48.870797375639214, 2.2277003154158592",Suresnes,92073,0.8,9
92004,Nanterre - Université,OUI,19,9,10,7,3,OUI,OUI,2025-03-13 08:53:26+00:00,"48.901365, 2.212693",Nanterre,92050,0.5263157894736842,9
31012,Place Carnot,OUI,23,22,1,0,1,OUI,OUI,2025-03-13 08:56:55+00:00,"48.85593932186797, 2.441531717777252",Montreuil,93048,0.043478260869565216,9
18020,Francoeur - Marcadet,OUI,20,19,1,0,1,OUI,OUI,2025-03-13 08:59:47+00:00,"48.89104123261663, 2.340014585442034",Paris,75056,0.05,9
12024,Gare de Bercy,OUI,35,10,25,23,2,OUI,OUI,2025-03-13 08:58:44+00:00,"48.839794573906, 2.3826066032052",Paris,75056,0.7142857142857143,9
5026,Pascal - Claude Bernard,OUI,46,3,43,32,11,OUI,OUI,2025-03-13 09:00:33+00:00,"48.839061952159746, 2.3499782010912895",Paris,75056,0.9347826086956522,9
35019,Anatole France - Jean Lolive,OUI,27,18,9,3,6,OUI,OUI,2025-03-13 08:59:32+00:00,"48.8949922, 2.4253764",Pantin,93055,0.3333333333333333,9
5002,Sommerard - Saint-Jacques,OUI,34,8,26,22,4,OUI,OUI,2025-03-13 09:00:03+00:00,"48.850310432924466, 2.345015835298588",Paris,75056,0.7647058823529411,9
14104,Boyer-Barret - Raymond Losserand,OUI,22,21,1,0,1,OUI,OUI,2025-03-13 09:00:15+00:00,"48.83329880233322, 2.3173383995890617",Paris,75056,0.045454545454545456,9
31702,Pierre et Marie Curie - Julien Grimau,OUI,18,17,1,0,1,OUI,OUI,2025-03-13 08:54:11+00:00,"48.870714014863225, 2.424097023904324",Bagnolet,93006,0.05555555555555555,9
20113,Piat - Parc de Belleville,OUI,21,19,2,0,2,OUI,OUI,2025-03-13 09:00:18+00:00,"48.87195626635528, 2.384981390278095",Paris,75056,0.09523809523809523,9
7004,Raspail - Varenne,OUI,17,1,16,10,6,OUI,OUI,2025-03-13 09:00:56+00:00,"48.853147816545, 2.3263905197382",Paris,75056,0.9411764705882353,9
20119,Square des Saint-Simoniens,OUI,25,25,0,0,0,OUI,OUI,2025-03-13 08:56:12+00:00,"48.8701796, 2.3967273",Paris,75056,0.0,9
21013,Pierre Grenier - Pont de Billancourt,OUI,21,16,5,5,0,OUI,OUI,2025-03-13 09:00:48+00:00,"48.8258020742942, 2.2487989068031315",Boulogne-Billancourt,92012,0.23809523809523808,9
6030,Assas - Vaugirard,OUI,34,15,19,11,8,OUI,OUI,2025-03-13 09:00:33+00:00,"48.848274111398, 2.3292413726449",Paris,75056,0.5588235294117647,9
2010,Uzès - Montmartre,OUI,26,0,26,14,12,OUI,OUI,2025-03-13 09:00:22+00:00,"48.870790980240706, 2.3431010171771054",Paris,75056,1.0,9
20036,Ménilmontant - Pelleport,OUI,31,30,1,0,1,OUI,OUI,2025-03-13 09:01:24+00:00,"48.870682633845, 2.3989596023316",Paris,75056,0.03225806451612903,9
11114,Ledru-Rollin - Charonne,OUI,32,16,16,13,3,OUI,OUI,2025-03-13 09:01:26+00:00,"48.85345855607243, 2.3772463581947094",Paris,75056,0.5,9
15029,Emeriau - Place de Brazzaville,OUI,51,4,47,40,7,OUI,OUI,2025-03-13 09:01:11+00:00,"48.850785261674964, 2.2871585190296173",Paris,75056,0.9215686274509803,9
7006,Quai Voltaire,OUI,32,1,31,28,3,OUI,OUI,2025-03-13 09:01:27+00:00,"48.858942986179, 2.3314182047146",Paris,75056,0.96875,9
18005,Tardieu - Chappe,OUI,16,15,1,0,1,OUI,OUI,2025-03-13 08:55:01+00:00,"48.884146759782, 2.341845408082",Paris,75056,0.0625,9
7014,Saint-François-Xavier,OUI,42,0,42,20,22,OUI,OUI,2025-03-13 09:00:21+00:00,"48.85154484769, 2.3146149516106",Paris,75056,1.0,9
10005,Petites Ecuries - Faubourg Poissonnière,OUI,17,6,11,11,0,OUI,OUI,2025-03-13 09:01:21+00:00,"48.87397217237368, 2.348388757504776",Paris,75056,0.6470588235294118,9
8012,Batignolles - Place de Clichy,OUI,46,42,4,1,3,OUI,OUI,2025-03-13 08:58:46+00:00,"48.883474535757, 2.326493114233",Paris,75056,0.08695652173913043,9
20136,Henri Chevreau - Couronnes,OUI,26,26,0,0,0,OUI,OUI,2025-03-13 09:00:55+00:00,"48.87033205312931, 2.388777695596218",Paris,75056,0.0,9
10023,Gare de l'Est - Verdun,OUI,13,10,3,2,1,OUI,OUI,2025-03-13 08:56:38+00:00,"48.876156054271, 2.3609149083206",Paris,75056,0.23076923076923078,9
43006,Vignerons - Minimes,OUI,29,20,9,5,4,OUI,OUI,2025-03-13 09:00:53+00:00,"48.841486, 2.430793",Vincennes,94080,0.3103448275862069,9
23002,Pont de Levallois-bécon,OUI,49,7,42,11,31,OUI,OUI,2025-03-13 09:01:09+00:00,"48.8984179, 2.2791311",Levallois-Perret,92044,0.8571428571428571,9
15028,Grenelle - Dr Finlay,OUI,70,10,60,56,4,OUI,OUI,2025-03-13 09:01:16+00:00,"48.851315406715976, 2.2919502854347233",Paris,75056,0.8571428571428571,9
14139,Pierre Larousse - Raymond Losserand,OUI,29,28,1,0,1,OUI,OUI,2025-03-13 09:00:37+00:00,"48.83059564231877, 2.3119183257222176",Paris,75056,0.034482758620689655,9
8102,Lamennais - Washington,OUI,25,2,23,11,12,OUI,OUI,2025-03-13 09:01:22+00:00,"48.87352990026496, 2.303444892168045",Paris,75056,0.92,9
11101,Charles Delescluze,OUI,48,22,26,22,4,OUI,OUI,2025-03-13 09:00:42+00:00,"48.85242200848887, 2.380632497370243",Paris,75056,0.5416666666666666,9
14018,Porte d'Orléans,OUI,45,43,2,1,1,OUI,OUI,2025-03-13 09:01:14+00:00,"48.8227639, 2.3249313",Paris,75056,0.044444444444444446,9
14130,Jonquoy - Didot,OUI,30,28,2,0,2,OUI,OUI,2025-03-13 08:52:22+00:00,"48.82890454823947, 2.31648076325655",Paris,75056,0.06666666666666667,9
42503,Vladimir Ilitch Lénine - Andrée Chedid,OUI,31,30,1,0,1,OUI,OUI,2025-03-13 08:59:49+00:00,"48.813240124373, 2.3319716067039",Gentilly,94037,0.03225806451612903,9
12011,Charenton - Place du Col Bourgoin,OUI,35,23,12,9,3,OUI,OUI,2025-03-13 08:58:13+00:00,"48.844867319554, 2.3825789350545",Paris,75056,0.34285714285714286,9
21111,Professeur René Leriche - Général Leclerc,OUI,50,17,33,28,5,OUI,OUI,2025-03-13 08:57:52+00:00,"48.90782845483013, 2.307887971401215",Clichy,92024,0.66,9
21308,Bara - Henri Farman,OUI,58,2,56,35,21,OUI,OUI,2025-03-13 09:00:22+00:00,"48.833218027457846, 2.2677567601203923",Issy-les-Moulineaux,92040,0.9655172413793104,9
5116,Place Valhubert,OUI,49,0,49,44,5,OUI,OUI,2025-03-13 08:59:10+00:00,"48.844182577315, 2.3640366643667",Paris,75056,1.0,9
12032,Porte Dorée,OUI,35,6,29,18,11,OUI,OUI,2025-03-13 08:59:56+00:00,"48.8354337, 2.4077132",Paris,75056,0.8285714285714286,9
20040,Parc de Belleville - Julien Lacroix,OUI,26,24,2,0,2,OUI,OUI,2025-03-13 08:54:42+00:00,"48.8703459, 2.3842214",Paris,75056,0.07692307692307693,9
19037,Belleville - Porte des Lilas,OUI,29,27,2,0,2,OUI,OUI,2025-03-13 08:52:46+00:00,"48.87660391892763, 2.404769691129476",Paris,75056,0.06896551724137931,9
17017,Gare de Pont-Cardinet,OUI,31,24,7,4,3,OUI,OUI,2025-03-13 09:00:37+00:00,"48.88713901475306, 2.314494143994255",Paris,75056,0.22580645161290322,9
15038,Place Adolphe Cherioux - Vaugirard,OUI,62,61,1,0,1,OUI,OUI,2025-03-13 09:01:12+00:00,"48.83959442800459, 2.3010657727718353",Paris,75056,0.016129032258064516,9
34002,Capitaine Glarner - Gabriel Péri,OUI,23,16,7,5,2,OUI,OUI,2025-03-13 09:00:34+00:00,"48.902449900418745, 2.3304807533425724",Saint-Ouen-sur-Seine,93070,0.30434782608695654,9
21032,Sèvres-Gallieni,OUI,25,2,23,16,7,OUI,OUI,2025-03-13 08:58:40+00:00,"48.837809408957, 2.2281519323587",Boulogne-Billancourt,92012,0.92,9
13026,Place Jean Delay,OUI,32,31,1,1,0,OUI,OUI,2025-03-13 09:00:21+00:00,"48.823316, 2.354336",Paris,75056,0.03125,9
7005,Raspail - Bac,OUI,51,2,49,23,26,OUI,OUI,2025-03-13 09:00:43+00:00,"48.855628721101, 2.3256602883339",Paris,75056,0.9607843137254902,9
13102,Pitié-Salpêtrière,OUI,49,9,40,20,20,OUI,OUI,2025-03-13 09:00:56+00:00,"48.83748810318667, 2.365213818848133",Paris,75056,0.8163265306122449,9
32014,Place du Cornillon - Stade de France,OUI,33,18,15,7,8,OUI,OUI,2025-03-13 09:01:22+00:00,"48.92540695835961, 2.3644426837563515",Saint-Denis,93066,0.45454545454545453,9
15055,Vasco de Gama,OUI,54,23,31,24,7,OUI,OUI,2025-03-13 09:00:03+00:00,"48.83671783466264, 2.283664085650799",Paris,75056,0.5740740740740741,9
18032,Porte de Clignancourt.,OUI,55,53,2,0,2,OUI,OUI,2025-03-13 08:59:53+00:00,"48.897488, 2.343996",Paris,75056,0.03636363636363636,9
10015,Lucien Sampaix - Récollets,OUI,41,32,9,7,2,OUI,OUI,2025-03-13 08:57:31+00:00,"48.874330377560476, 2.3621229082345963",Paris,75056,0.21951219512195122,9
17124,Porte de Saint-Ouen - Henri Huchard,OUI,26,9,17,13,4,OUI,OUI,2025-03-13 08:59:22+00:00,"48.898708366365064, 2.3295360803604126",Paris,75056,0.6538461538461539,9
41207,Place du Général de Gaulle,OUI,28,13,15,1,14,OUI,OUI,2025-03-13 08:56:42+00:00,"48.8525288, 2.4877332",Fontenay-sous-Bois,94033,0.5357142857142857,9
17027,Place du Maréchal Juin - Péreire,OUI,44,24,20,17,3,OUI,OUI,2025-03-13 09:00:29+00:00,"48.885263, 2.298286",Paris,75056,0.45454545454545453,9
6103,Mézières - Rennes,OUI,53,44,9,4,5,OUI,OUI,2025-03-13 08:58:48+00:00,"48.85023459321703, 2.3303819820284843",Paris,75056,0.16981132075471697,9
51003,Hôtel de Ville d'Argenteuil,OUI,29,11,18,12,6,OUI,OUI,2025-03-13 08:59:53+00:00,"48.946504, 2.2496396",Argenteuil,95018,0.6206896551724138,9
20021,Indre - Prairies,OUI,38,37,1,0,1,OUI,OUI,2025-03-13 08:52:29+00:00,"48.86254398506782, 2.403290458023548",Paris,75056,0.02631578947368421,9
13016,Primo Levi - Frigos,OUI,33,0,33,19,14,OUI,OUI,2025-03-13 09:01:18+00:00,"48.83094844846017, 2.37965351592796",Paris,75056,1.0,9
6018,Michelet - Assas,OUI,17,3,14,2,12,OUI,OUI,2025-03-13 08:54:48+00:00,"48.842741502832, 2.3350211977959",Paris,75056,0.8235294117647058,9
8051,Batignolles - Rome,OUI,11,8,3,2,1,OUI,OUI,2025-03-13 09:01:07+00:00,"48.881823370566806, 2.3202589899301524",Paris,75056,0.2727272727272727,9
21019,Edouard Vaillant - Paul-Adolphe Souriau,OUI,26,0,26,17,9,OUI,OUI,2025-03-13 08:59:50+00:00,"48.834845858829, 2.2479459643364",Boulogne-Billancourt,92012,1.0,9
44102,Verdun - Adrien Damalix,OUI,24,13,11,10,1,OUI,OUI,2025-03-13 08:57:03+00:00,"48.8222334178559, 2.4215328320860863",Saint-Maurice,94069,0.4583333333333333,9
21105,Morice - Général Leclerc,OUI,25,16,9,8,1,OUI,OUI,2025-03-13 09:01:21+00:00,"48.90245471981591, 2.3128929734230046",Clichy,92024,0.36,9
9115,Milton - Manuel,OUI,21,21,0,0,0,OUI,OUI,2025-03-13 08:53:08+00:00,"48.878249, 2.341181",Paris,75056,0.0,9
19109,Tanger - Place du Maroc,OUI,17,15,2,1,1,OUI,OUI,2025-03-13 08:54:01+00:00,"48.8862524447104, 2.3689296841621403",Paris,75056,0.11764705882352941,9
19039,Edouard Pailleron - Simon Bolivar,OUI,23,22,1,0,1,OUI,OUI,2025-03-13 08:58:06+00:00,"48.87979886049996, 2.374839261174202",Paris,75056,0.043478260869565216,9
31019,Vincennes - Douy-Delcupe,OUI,37,36,1,1,0,OUI,OUI,2025-03-13 08:55:36+00:00,"48.85493692155721, 2.436049282550812",Montreuil,93048,0.02702702702702703,9
22001,Château - Bineau,OUI,21,0,21,9,12,OUI,OUI,2025-03-13 09:01:10+00:00,"48.890404028589806, 2.270106375217438",Neuilly-sur-Seine,92051,1.0,9
44012,Génie - Mozart,OUI,18,18,0,0,0,OUI,OUI,2025-03-13 09:01:03+00:00,"48.794902381218904, 2.3734183609485626",Vitry-sur-Seine,94081,0.0,9
18025,Mairie du 18ème,OUI,39,37,2,0,2,OUI,OUI,2025-03-13 09:00:53+00:00,"48.892939296937605, 2.3445510864257812",Paris,75056,0.05128205128205128,9
31016,Lucie Aubrac - Franklin,OUI,36,32,4,2,2,OUI,OUI,2025-03-13 08:56:37+00:00,"48.86223916006812, 2.4435862898826604",Montreuil,93048,0.1111111111111111,9
16123,Mahatma Gandhi,OUI,24,3,21,14,7,OUI,OUI,2025-03-13 08:57:55+00:00,"48.876356, 2.264205",Paris,75056,0.875,9
22101,Gare Routière de Saint Cloud,OUI,28,4,24,18,6,OUI,OUI,2025-03-13 09:01:03+00:00,"48.84288183896324, 2.222245037555695",Saint-Cloud,92064,0.8571428571428571,9
31007,Paris - Désiré Préaux,OUI,44,43,1,0,1,OUI,OUI,2025-03-13 08:54:14+00:00,"48.85742876694898, 2.4323049187660217",Montreuil,93048,0.022727272727272728,9
13043,Dunois - Clisson,OUI,51,49,2,1,1,OUI,OUI,2025-03-13 09:01:04+00:00,"48.832294, 2.3674523",Paris,75056,0.0392156862745098,9
15108,Lourmel - Marie Skobtsov,OUI,22,18,4,2,2,OUI,OUI,2025-03-13 08:59:50+00:00,"48.844974, 2.287283",Paris,75056,0.18181818181818182,9
2009,Filles Saint-Thomas - Place de la Bourse,OUI,58,19,39,20,19,OUI,OUI,2025-03-13 08:59:31+00:00,"48.868899890853, 2.3397543845203",Paris,75056,0.6724137931034483,9
17047,Courcelles - Pierre Demours,OUI,26,14,12,11,1,OUI,OUI,2025-03-13 09:00:46+00:00,"48.883769733273496, 2.29858466343129",Paris,75056,0.46153846153846156,9
16032,Eglise d'Auteuil,OUI,20,9,11,7,4,OUI,OUI,2025-03-13 08:56:24+00:00,"48.84749841771691, 2.26848387135299",Paris,75056,0.55,9
6016,Danton - Serpente,OUI,21,0,21,16,5,OUI,OUI,2025-03-13 09:00:21+00:00,"48.852297362582, 2.3414132371545",Paris,75056,1.0,9
21003,Jean Jaurès - Jean Baptiste Clément,OUI,38,15,23,12,11,OUI,OUI,2025-03-13 08:54:51+00:00,"48.84576261454011, 2.2369650006294255",Boulogne-Billancourt,92012,0.6052631578947368,9
41204,République - Danton,OUI,19,19,0,0,0,OUI,OUI,2025-03-13 08:59:54+00:00,"48.85249172181667, 2.462034523487091",Fontenay-sous-Bois,94033,0.0,9
17122,Bridaine - Lamandé,OUI,28,25,3,3,0,OUI,OUI,2025-03-13 08:58:43+00:00,"48.8862074, 2.3206239",Paris,75056,0.10714285714285714,9
17046,Mac-Mahon - Brey,OUI,25,23,2,0,2,OUI,OUI,2025-03-13 09:01:27+00:00,"48.877532084130166, 2.294512536052928",Paris,75056,0.08,9
20027,Porte de Ménilmontant,OUI,15,14,1,0,1,OUI,OUI,2025-03-13 08:56:33+00:00,"48.8691543609174, 2.40932246879487",Paris,75056,0.06666666666666667,9
18109,Pajol - Riquet,OUI,45,43,2,0,2,OUI,OUI,2025-03-13 09:00:23+00:00,"48.88960028134536, 2.3628534749150276",Paris,75056,0.044444444444444446,9
9023,Laffitte - Italiens,OUI,30,2,28,14,14,OUI,OUI,2025-03-13 08:58:04+00:00,"48.871815737396, 2.3372015478451",Paris,75056,0.9333333333333333,9
9031,Provence - Chaussée d'Antin,OUI,25,2,23,13,10,OUI,OUI,2025-03-13 09:01:25+00:00,"48.87428447542072, 2.332976511564311",Paris,75056,0.92,9
14122,Colonel Monteil - Brune,OUI,19,19,0,0,0,OUI,OUI,2025-03-13 08:55:05+00:00,"48.82650293311, 2.3092747998272",Paris,75056,0.0,9
9117,Bellefond - Maubeuge,OUI,28,26,2,1,1,OUI,OUI,2025-03-13 08:59:30+00:00,"48.878255397645, 2.3452642187476",Paris,75056,0.07142857142857142,9
19040,Belleville - Télégraphe,OUI,40,38,2,1,1,OUI,OUI,2025-03-13 08:59:14+00:00,"48.8756045, 2.3995549",Paris,75056,0.05,9
20023,Pelleport - Belgrand,OUI,14,13,1,0,1,OUI,OUI,2025-03-13 08:57:09+00:00,"48.86500081847653, 2.403980836377493",Paris,75056,0.07142857142857142,9
17121,Square des Epinettes,OUI,20,18,2,1,1,OUI,OUI,2025-03-13 08:56:31+00:00,"48.89383909781389, 2.325953990221024",Paris,75056,0.1,9
18049,Porte d'Aubervilliers,OUI,53,39,14,6,8,OUI,OUI,2025-03-13 09:01:15+00:00,"48.89859661942376, 2.3689722642302513",Paris,75056,0.2641509433962264,9
19009,Cité des Sciences et de l'Industrie,OUI,28,20,8,1,7,OUI,OUI,2025-03-13 08:57:35+00:00,"48.89659571178903, 2.384599149227142",Paris,75056,0.2857142857142857,9
10020,Chabrol - d'Hauteville,OUI,11,1,10,5,5,OUI,OUI,2025-03-13 09:01:18+00:00,"48.877018388033, 2.3513179644942",Paris,75056,0.9090909090909091,9
19038,Lassus - Delouvain,OUI,19,19,0,0,0,OUI,OUI,2025-03-13 09:00:44+00:00,"48.8755044846, 2.3890327325519",Paris,75056,0.0,9
18113,Lepic - Armée d'Orient,OUI,24,24,0,0,0,OUI,OUI,2025-03-13 08:52:04+00:00,"48.887536403814, 2.3343077301979",Paris,75056,0.0,9
18029,Emile Blemont - Poteau,OUI,39,37,2,0,2,OUI,OUI,2025-03-13 09:00:56+00:00,"48.8943782, 2.3415122",Paris,75056,0.05128205128205128,9
31703,Sadi Carnot - François Mitterrand,OUI,26,25,1,0,1,OUI,OUI,2025-03-13 08:55:39+00:00,"48.87532687671517, 2.4241617321968083",Bagnolet,93006,0.038461538461538464,9
21703,Square du Carrefour de l'Insurrection,OUI,20,15,5,0,5,OUI,OUI,2025-03-13 09:01:02+00:00,"48.820864559770676, 2.291113436222077",Vanves,92075,0.25,9
35003,Gabrielle Josserand - Edouard Vaillant,OUI,23,20,3,1,2,OUI,OUI,2025-03-13 08:59:55+00:00,"48.90271566255436, 2.3933270573616032",Pantin,93055,0.13043478260869565,9
35017,Toffier Decaux - Cartier Bresson,OUI,17,15,2,2,0,OUI,OUI,2025-03-13 08:45:57+00:00,"48.90165072551549, 2.4017545580863957",Pantin,93055,0.11764705882352941,9
47005,Ecole Vétérinaire,OUI,35,9,26,18,8,OUI,OUI,2025-03-13 09:01:00+00:00,"48.81488859822486, 2.4224362157778994",Maisons-Alfort,94046,0.7428571428571429,9
20118,Orteaux - Mouraud,OUI,24,24,0,0,0,OUI,OUI,2025-03-13 09:00:57+00:00,"48.85558642847872, 2.408762907764669",Paris,75056,0.0,9
19127,Aubervilliers - Curial,OUI,23,18,5,3,2,OUI,OUI,2025-03-13 08:59:27+00:00,"48.89088305227546, 2.3688579350709915",Paris,75056,0.21739130434782608,9
16021,François Ponsard - La Muette,OUI,23,22,1,1,0,OUI,OUI,2025-03-13 09:01:22+00:00,"48.8583666, 2.2744515",Paris,75056,0.043478260869565216,9
16015,Bassano -  Iéna,OUI,15,0,15,3,12,OUI,OUI,2025-03-13 09:01:25+00:00,"48.868144510482075, 2.296149600985935",Paris,75056,1.0,9
14002,Edgar Quinet - Raspail,OUI,44,31,13,7,6,OUI,OUI,2025-03-13 08:57:51+00:00,"48.83940266673835, 2.32971478253603",Paris,75056,0.29545454545454547,9
15070,Balard - Montagne de la Fage,OUI,35,3,32,27,5,OUI,OUI,2025-03-13 09:01:22+00:00,"48.83850740333351, 2.2782871127128606",Paris,75056,0.9142857142857143,9
15035,Place Etienne Pernet,OUI,42,12,30,27,3,OUI,OUI,2025-03-13 09:01:25+00:00,"48.84243457133779, 2.2921819612383847",Paris,75056,0.7142857142857143,9
1120,Lavandieres Sainte Opportune - Rivoli,OUI,22,3,19,15,4,OUI,OUI,2025-03-13 09:00:55+00:00,"48.859279702476, 2.3466217517853",Paris,75056,0.8636363636363636,9
14112,Méchain - Faubourg Saint-Jacques,OUI,15,9,6,1,5,OUI,OUI,2025-03-13 09:01:27+00:00,"48.83586772099485, 2.33798034198275",Paris,75056,0.4,9
11041,Square Saint-Ambroise,OUI,38,4,34,30,4,OUI,OUI,2025-03-13 09:00:29+00:00,"48.860934, 2.375841",Paris,75056,0.8947368421052632,9
9026,Jean-Baptiste Pigalle - La Bruyere,OUI,17,10,7,4,3,OUI,OUI,2025-03-13 09:01:10+00:00,"48.87939826447722, 2.333709173337285",Paris,75056,0.4117647058823529,9
15031,Théâtre - Lourmel,OUI,52,14,38,35,3,OUI,OUI,2025-03-13 08:57:58+00:00,"48.8482070397636, 2.2898658737540245",Paris,75056,0.7307692307692307,9
21001,Transvaal - Charles de Gaulle,OUI,27,3,24,10,14,OUI,OUI,2025-03-13 09:01:20+00:00,"48.848280403628806, 2.2373420120857195",Boulogne-Billancourt,92012,0.8888888888888888,9
21014,Hameau Fleuri - Marché,OUI,20,7,13,4,9,OUI,OUI,2025-03-13 09:00:11+00:00,"48.831448892608314, 2.2412404417991643",Boulogne-Billancourt,92012,0.65,9
18033,Belliard - Damrémont,OUI,34,33,1,1,0,OUI,OUI,2025-03-13 08:56:15+00:00,"48.89669238777841, 2.338023450388167",Paris,75056,0.029411764705882353,9
5121,Square René Viviani - Montebello,OUI,33,1,32,31,1,OUI,OUI,2025-03-13 09:00:54+00:00,"48.851904891406, 2.3478421568871",Paris,75056,0.9696969696969697,9
11010,Boulets - Faubourg Saint-Antoine,OUI,42,40,2,1,1,OUI,OUI,2025-03-13 08:59:34+00:00,"48.849259262115, 2.3917546141943",Paris,75056,0.047619047619047616,9
11006,Ledru-Rollin - Place du Père Chaillet,OUI,37,22,15,11,4,OUI,OUI,2025-03-13 09:00:46+00:00,"48.856433706943704, 2.379020587761426",Paris,75056,0.40540540540540543,9
15002,Maine - Antoine Bourdelle,OUI,17,16,1,1,0,OUI,OUI,2025-03-13 09:01:19+00:00,"48.84308531746595, 2.320263946784738",Paris,75056,0.058823529411764705,9
47004,Stade Auguste Delaune,OUI,21,3,18,16,2,OUI,OUI,2025-03-13 09:00:38+00:00,"48.80896378683884, 2.4345204234123234",Maisons-Alfort,94046,0.8571428571428571,9
21310,Kléber - Gouverneur Général Eboué,OUI,22,9,13,10,3,OUI,OUI,2025-03-13 09:01:14+00:00,"48.826885843069796, 2.2723413258790965",Issy-les-Moulineaux,92040,0.5909090909090909,9
16122,Route de la Muette - Porte de Neuilly,OUI,49,43,6,4,2,OUI,OUI,2025-03-13 09:00:40+00:00,"48.8798926, 2.2587671",Paris,75056,0.12244897959183673,9
23007,Président Wilson - Jean Jaures,OUI,25,21,4,4,0,OUI,OUI,2025-03-13 09:00:40+00:00,"48.89034054052266, 2.2920683026313786",Levallois-Perret,92044,0.16,9
10010,Place Jacques Bonsergent,OUI,33,6,27,18,9,OUI,OUI,2025-03-13 09:01:09+00:00,"48.870948218595, 2.3612049221992",Paris,75056,0.8181818181818182,9
20016,Pyrénées - Maraîchers,OUI,32,32,0,0,0,OUI,OUI,2025-03-13 08:57:50+00:00,"48.85714001395299, 2.4043509364128113",Paris,75056,0.0,9
16027,Mozart - Jasmin,OUI,62,60,2,2,0,OUI,OUI,2025-03-13 09:00:57+00:00,"48.85286124871689, 2.268483570651513",Paris,75056,0.03225806451612903,9
32015,Gare RER de Saint-Denis,OUI,36,26,10,8,2,OUI,OUI,2025-03-13 08:58:51+00:00,"48.93554324248177, 2.3471488058567047",Saint-Denis,93066,0.2777777777777778,9
20116,Haies - Réunion,OUI,20,20,0,0,0,OUI,OUI,2025-03-13 09:00:36+00:00,"48.85386896766491, 2.402426162238911",Paris,75056,0.0,9
16043,Place de Passy,OUI,11,10,1,0,1,OUI,OUI,2025-03-13 08:58:52+00:00,"48.85780291711202, 2.277500546942199",Paris,75056,0.09090909090909091,9
16029,Maison de Radio - France,OUI,42,0,42,40,2,OUI,OUI,2025-03-13 09:01:13+00:00,"48.85132886434057, 2.277785539627075",Paris,75056,1.0,9
42004,Westermeyer - Paul Vaillant-Couturier,OUI,31,1,30,24,6,OUI,OUI,2025-03-13 09:00:57+00:00,"48.819116181578764, 2.3966637253761296",Ivry-sur-Seine,94041,0.967741935483871,9
9017,Lallier - Trudaine,OUI,28,27,1,1,0,OUI,OUI,2025-03-13 08:59:45+00:00,"48.88109246617963, 2.3408224806189537",Paris,75056,0.03571428571428571,9
6107,Place Alphonse Deville,OUI,22,1,21,13,8,OUI,OUI,2025-03-13 09:00:40+00:00,"48.850188262662, 2.3275961726904",Paris,75056,0.9545454545454546,9
14030,Pernety - Raymond Losserand,OUI,32,31,1,0,1,OUI,OUI,2025-03-13 08:53:46+00:00,"48.834254627953, 2.317609339387",Paris,75056,0.03125,9
8019,Naples - Rome,OUI,26,22,4,0,4,OUI,OUI,2025-03-13 08:55:37+00:00,"48.879960700846226, 2.321358695626259",Paris,75056,0.15384615384615385,9
20201,Eugène Reisz - Davout,OUI,20,19,1,0,1,OUI,OUI,2025-03-13 08:57:16+00:00,"48.85631874632638, 2.410396970808506",Paris,75056,0.05,9
18008,Square Léon,OUI,33,31,2,0,2,OUI,OUI,2025-03-13 08:56:20+00:00,"48.88667396788626, 2.353205569088459",Paris,75056,0.06060606060606061,9
15003,Gare Montparnasse - Vaugirard,OUI,66,63,3,0,3,OUI,OUI,2025-03-13 08:57:35+00:00,"48.8418071798797, 2.31951002690117",Paris,75056,0.045454545454545456,9
7008,Villersexel - Saint-Germain,OUI,16,0,16,11,5,OUI,OUI,2025-03-13 09:00:18+00:00,"48.858297001218, 2.3237934708595",Paris,75056,1.0,9
4110,Neuve Saint-Pierre - Beautreillis,OUI,19,1,18,11,7,OUI,OUI,2025-03-13 09:00:34+00:00,"48.85355351439652, 2.3639122769236565",Paris,75056,0.9473684210526315,9
16112,Chernoviz - Raynouard,OUI,36,33,3,1,2,OUI,OUI,2025-03-13 09:00:13+00:00,"48.8569864146289, 2.282173218142987",Paris,75056,0.08333333333333333,9
6032,Sabot - Rennes,OUI,25,6,19,15,4,OUI,OUI,2025-03-13 08:56:25+00:00,"48.852575112948415, 2.331552766263485",Paris,75056,0.76,9
42703,Fontainebleau - Edmond Michelet,OUI,45,42,3,1,2,OUI,OUI,2025-03-13 09:00:51+00:00,"48.80956436844049, 2.3626908659935",Le Kremlin-Bicêtre,94043,0.06666666666666667,9
17022,Pereire - Place de Wagram,OUI,45,42,3,2,1,OUI,OUI,2025-03-13 08:59:26+00:00,"48.887070607581215, 2.304111124531457",Paris,75056,0.06666666666666667,9
13046,Eugène Oudiné - Dessous Des Berges,OUI,44,26,18,11,7,OUI,OUI,2025-03-13 08:59:13+00:00,"48.8256423, 2.3750226",Paris,75056,0.4090909090909091,9
10036,Aqueduc - Villette,OUI,24,23,1,0,1,OUI,OUI,2025-03-13 09:00:24+00:00,"48.883886063895, 2.367198803315",Paris,75056,0.041666666666666664,9
22102,Mont Valérien - Michel Salles,OUI,24,9,15,12,3,OUI,OUI,2025-03-13 08:58:20+00:00,"48.8561915, 2.2152966",Saint-Cloud,92064,0.625,9
6017,Sénat - Condé,OUI,32,3,29,20,9,OUI,OUI,2025-03-13 09:00:04+00:00,"48.84954227788459, 2.337939441204071",Paris,75056,0.90625,9
7020,Champ de Mars - Cler,OUI,39,15,24,22,2,OUI,OUI,2025-03-13 09:00:46+00:00,"48.856691550115315, 2.306646779179573",Paris,75056,0.6153846153846154,9
13103,Hôpital Pitié Salpêtrière,OUI,49,36,13,9,4,OUI,OUI,2025-03-13 08:58:30+00:00,"48.8377016, 2.3604946",Paris,75056,0.2653061224489796,9
23304,Mairie de Sceaux,OUI,33,28,5,1,4,OUI,OUI,2025-03-13 08:58:38+00:00,"48.778916905132, 2.2887361764861",Sceaux,92071,0.15151515151515152,9
18017,Caulaincourt - Place Constantin Pecqueur,OUI,42,40,2,0,2,OUI,OUI,2025-03-13 08:57:34+00:00,"48.889677905028, 2.3381787144261",Paris,75056,0.047619047619047616,9
12161,Diderot - Reuilly,OUI,44,0,44,40,4,OUI,OUI,2025-03-13 08:59:09+00:00,"48.847208456061, 2.3861273378134",Paris,75056,1.0,9
11043,Place Pasdeloup,OUI,18,2,16,15,1,OUI,OUI,2025-03-13 08:59:47+00:00,"48.862654215631, 2.3670325062844",Paris,75056,0.8888888888888888,9
15107,Palais des Sports,OUI,21,0,21,18,3,OUI,OUI,2025-03-13 09:01:11+00:00,"48.833468517426, 2.2858720645308",Paris,75056,1.0,9
23903,Stade Gaston Bouillant,OUI,29,20,9,4,5,OUI,OUI,2025-03-13 08:58:54+00:00,"48.939958667023, 2.3279571813836",Villeneuve-la-Garenne,92078,0.3103448275862069,9
9101,Cadet - La Fayette,OUI,18,7,11,7,4,OUI,OUI,2025-03-13 08:57:38+00:00,"48.875601632672, 2.3435704037547",Paris,75056,0.6111111111111112,9
32603,Calmette,OUI,31,30,1,1,0,OUI,OUI,2025-03-13 09:01:07+00:00,"48.88104925098552, 2.424993216991425",Les Lilas,93045,0.03225806451612903,9
19041,Belleville - Pyrénées,OUI,38,35,3,0,3,OUI,OUI,2025-03-13 08:57:11+00:00,"48.8741908, 2.3860039",Paris,75056,0.07894736842105263,9
21311,Parvis Corentin Celton,OUI,52,10,42,40,2,OUI,OUI,2025-03-13 09:01:06+00:00,"48.82747252522725, 2.2784319519996648",Issy-les-Moulineaux,92040,0.8076923076923077,9
1117,Pont Neuf - Rivoli,OUI,24,5,19,14,5,OUI,OUI,2025-03-13 08:58:28+00:00,"48.860089892617, 2.344057559967",Paris,75056,0.7916666666666666,9
23403,Chateau,OUI,21,17,4,2,2,OUI,OUI,2025-03-13 08:57:59+00:00,"48.774661399959, 2.3135878035462",Bourg-la-Reine,92014,0.19047619047619047,9
13010,Place d'Italie - Vincent Auriol,OUI,39,18,21,6,15,OUI,OUI,2025-03-13 09:01:15+00:00,"48.831481874467, 2.3567550292319",Paris,75056,0.5384615384615384,9
31023,Place François Mitterand,OUI,34,34,0,0,0,OUI,OUI,2025-03-13 09:01:23+00:00,"48.86492782016328, 2.442958317697048",Montreuil,93048,0.0,9
31704,Jeanne Hornet - Girardot,OUI,28,26,2,0,2,OUI,OUI,2025-03-13 09:00:27+00:00,"48.873802681432146, 2.427820265293122",Bagnolet,93006,0.07142857142857142,9
9118,Faubourg Poissonniere - Delta,OUI,36,34,2,0,2,OUI,OUI,2025-03-13 08:56:38+00:00,"48.882555807626765, 2.3497482016682625",Paris,75056,0.05555555555555555,9
17201,Porte Maillot - Perreire,OUI,50,30,20,9,11,OUI,OUI,2025-03-13 09:01:25+00:00,"48.878021154637, 2.2842371277102",Paris,75056,0.4,9
19023,Manin - Simon Bolivar,OUI,24,21,3,1,2,OUI,OUI,2025-03-13 08:52:46+00:00,"48.876499654127, 2.3794073625991",Paris,75056,0.125,9
15059,Parc André Citroën,OUI,64,6,58,54,4,OUI,OUI,2025-03-13 09:01:10+00:00,"48.840639944296655, 2.2780618071556096",Paris,75056,0.90625,9
18137,Poissonniers - Nord,OUI,28,27,1,1,0,OUI,OUI,2025-03-13 08:59:29+00:00,"48.892511213520656, 2.3522228747606277",Paris,75056,0.03571428571428571,9
4013,Vieille du Temple - Francs Bourgeois,OUI,28,9,19,13,6,OUI,OUI,2025-03-13 08:58:37+00:00,"48.858256413365815, 2.35821794718504",Paris,75056,0.6785714285714286,9
17116,Reims - Porte d'Asnières,OUI,26,15,11,5,6,OUI,OUI,2025-03-13 08:59:56+00:00,"48.891834448210986, 2.300144659954865",Paris,75056,0.4230769230769231,9
45001,Hôtel de Ville de Champigny sur Marne,OUI,21,1,20,9,11,OUI,OUI,2025-03-13 09:01:02+00:00,"48.813810628405, 2.5096759200096",Champigny-sur-Marne,94017,0.9523809523809523,9
13041,Porte d'Ivry,OUI,50,40,10,6,4,OUI,OUI,2025-03-13 09:01:27+00:00,"48.821768747596, 2.3688706755638",Paris,75056,0.2,9
21024,Billancourt - Général Leclerc,OUI,22,4,18,13,5,OUI,OUI,2025-03-13 09:01:04+00:00,"48.8322649, 2.2380413",Boulogne-Billancourt,92012,0.8181818181818182,9
12041,Bois de Vincennes.,OUI,58,34,24,8,16,OUI,OUI,2025-03-13 08:59:29+00:00,"48.8338064, 2.4132221",Saint-Mandé,94067,0.41379310344827586,9
10163,Gare du Nord - Demarquay,OUI,28,27,1,0,1,OUI,OUI,2025-03-13 08:59:25+00:00,"48.881154, 2.358411",Paris,75056,0.03571428571428571,9
14006,Saint-Jacques - Tombe Issoire,OUI,21,20,1,0,1,OUI,OUI,2025-03-13 09:00:42+00:00,"48.833206330538864, 2.3369108140468597",Paris,75056,0.047619047619047616,9
2001,Greneta - Sebastopol,OUI,32,4,28,20,8,OUI,OUI,2025-03-13 09:00:09+00:00,"48.865242333228, 2.3516669869423",Paris,75056,0.875,9
31013,Centenaire - Sorins,OUI,42,38,4,1,3,OUI,OUI,2025-03-13 09:00:53+00:00,"48.85853523359734, 2.4273508787155156",Montreuil,93048,0.09523809523809523,9
20019,Place du Maquis du Vercors,OUI,30,29,1,0,1,OUI,OUI,2025-03-13 09:01:21+00:00,"48.877321579493575, 2.4083782732486725",Paris,75056,0.03333333333333333,9
32018,Franciade - Gabriel Péri,OUI,25,9,16,11,5,OUI,OUI,2025-03-13 09:00:23+00:00,"48.93261499331498, 2.355954498052597",Saint-Denis,93066,0.64,9
7101,Raspail - Chomel,OUI,49,1,48,24,24,OUI,OUI,2025-03-13 08:59:15+00:00,"48.852233164303, 2.3266580700874",Paris,75056,0.9795918367346939,9
18019,Square Raymond Souplex,OUI,51,51,0,0,0,OUI,OUI,2025-03-13 08:52:25+00:00,"48.89183721478911, 2.335426103165901",Paris,75056,0.0,9
8056,Beaujon - Wagram,OUI,28,22,6,3,3,OUI,OUI,2025-03-13 09:01:14+00:00,"48.875352455985, 2.2964416444302",Paris,75056,0.21428571428571427,9
18138,Station Paris Basketball - Ney - Charles Hermite,OUI,20,8,12,7,5,OUI,OUI,2025-03-13 08:58:08+00:00,"48.898748039775, 2.3645754531026",Paris,75056,0.6,9
11003,Keller - La Roquette,OUI,34,25,9,8,1,OUI,OUI,2025-03-13 09:01:21+00:00,"48.8555508, 2.3752778",Paris,75056,0.2647058823529412,9
7016,Surcouf - Université,OUI,55,9,46,33,13,OUI,OUI,2025-03-13 09:01:19+00:00,"48.861273016278, 2.3094535509142",Paris,75056,0.8363636363636363,9
13113,Vistule - Choisy,OUI,33,21,12,9,3,OUI,OUI,2025-03-13 09:00:52+00:00,"48.82365543660611, 2.3615723848342896",Paris,75056,0.36363636363636365,9
4011,Hôtel de Ville - Pont-Marie,OUI,33,2,31,25,6,OUI,OUI,2025-03-13 09:00:52+00:00,"48.853899645527, 2.3569472506642",Paris,75056,0.9393939393939394,9
15061,Square Desnouettes,OUI,21,5,16,13,3,OUI,OUI,2025-03-13 09:00:51+00:00,"48.83476837934194, 2.284142297394666",Paris,75056,0.7619047619047619,9
12108,Bercy.,OUI,63,3,60,44,16,OUI,OUI,2025-03-13 08:58:55+00:00,"48.839966914994, 2.3788625746965",Paris,75056,0.9523809523809523,9
11019,Charonne - Philippe-Auguste,OUI,31,29,2,1,1,OUI,OUI,2025-03-13 08:59:52+00:00,"48.855603162026, 2.39054639062",Paris,75056,0.06451612903225806,9
7013,Duroc - Place de Breteuil,OUI,46,21,25,18,7,OUI,OUI,2025-03-13 09:01:19+00:00,"48.847460641142, 2.3126140236855",Paris,75056,0.5434782608695652,9
8015,Roquépine - Malesherbes,OUI,50,1,49,24,25,OUI,OUI,2025-03-13 09:01:24+00:00,"48.87345073390807, 2.320404499769211",Paris,75056,0.98,9
21114,Gustave Eiffel - Parc des Impressionnistes,OUI,30,29,1,0,1,OUI,OUI,2025-03-13 08:53:34+00:00,"48.90390619651018, 2.2946908324956894",Clichy,92024,0.03333333333333333,9
47002,Les Juilliottes,OUI,21,7,14,13,1,OUI,OUI,2025-03-13 09:00:41+00:00,"48.8043072, 2.4437362",Maisons-Alfort,94046,0.6666666666666666,9
17016,Brochant - Square des Batignolles,OUI,31,31,0,0,0,OUI,OUI,2025-03-13 08:59:52+00:00,"48.88818698581028, 2.316861143151153",Paris,75056,0.0,9
2110,Jeûneurs - Mulhouse,OUI,27,17,10,7,3,OUI,OUI,2025-03-13 09:01:25+00:00,"48.868997, 2.346925",Paris,75056,0.37037037037037035,9
20202,Dupont de l'Eure - Gambetta,OUI,29,29,0,0,0,OUI,OUI,2025-03-13 08:57:35+00:00,"48.8679385, 2.4003649",Paris,75056,0.0,9
7026,Place de Finlande,OUI,24,1,23,22,1,OUI,OUI,2025-03-13 08:59:36+00:00,"48.862408335967, 2.3113624379039",Paris,75056,0.9583333333333334,9
11034,Parmentier - Fontaine au Roi,OUI,44,40,4,2,2,OUI,OUI,2025-03-13 09:00:58+00:00,"48.86787670551736, 2.372705978671471",Paris,75056,0.09090909090909091,9
1016,Thérèse - Opéra,OUI,24,2,22,12,10,OUI,OUI,2025-03-13 08:56:12+00:00,"48.866483514509, 2.3344334212238",Paris,75056,0.9166666666666666,9
9012,Rougemont - Poissonnière,OUI,30,2,28,20,8,OUI,OUI,2025-03-13 09:00:48+00:00,"48.871611569354755, 2.345873080193996",Paris,75056,0.9333333333333333,9
17033,Carnot - Général Lanrezac,OUI,29,29,0,0,0,OUI,OUI,2025-03-13 09:01:26+00:00,"48.875443870736, 2.2938242935036",Paris,75056,0.0,9
15020,Mairie du 15ème,OUI,31,26,5,4,1,OUI,OUI,2025-03-13 09:01:12+00:00,"48.8417762, 2.2986539",Paris,75056,0.16129032258064516,9
20103,Le Vau - Maurice Bertaux,OUI,23,22,1,0,1,OUI,OUI,2025-03-13 08:51:48+00:00,"48.86803439043193, 2.411030612453627",Paris,75056,0.043478260869565216,9
41206,Place des Larris,OUI,34,29,5,1,4,OUI,OUI,2025-03-13 08:56:16+00:00,"48.8568363, 2.4780236",Fontenay-sous-Bois,94033,0.14705882352941177,9
2014,Daunou - Louis le Grand,OUI,30,10,20,7,13,OUI,OUI,2025-03-13 08:58:10+00:00,"48.869113, 2.332515",Paris,75056,0.6666666666666666,9
19031,Manin - Crimée,OUI,20,19,1,0,1,OUI,OUI,2025-03-13 08:51:49+00:00,"48.8831217743719, 2.3863670602440834",Paris,75056,0.05,9
4109,Mornay - Sully,OUI,13,7,6,3,3,OUI,OUI,2025-03-13 09:01:19+00:00,"48.84970399548416, 2.364460788667202",Paris,75056,0.46153846153846156,9
13114,Nationale - Marcel Duchamp,OUI,23,13,10,10,0,OUI,OUI,2025-03-13 09:00:49+00:00,"48.82463749337136, 2.3678014799952507",Paris,75056,0.43478260869565216,9
3101,Porte Saint-Martin,OUI,31,17,14,7,7,OUI,OUI,2025-03-13 09:01:21+00:00,"48.86860172112996, 2.35570102930069",Paris,75056,0.45161290322580644,9
20017,Saint-Blaise - Mouraud,OUI,27,26,1,0,1,OUI,OUI,2025-03-13 08:58:29+00:00,"48.85696177597818, 2.40869477391243",Paris,75056,0.037037037037037035,9
8105,François 1er - Lincoln,OUI,29,3,26,3,23,OUI,OUI,2025-03-13 09:01:09+00:00,"48.869517979344, 2.3024262188416",Paris,75056,0.896551724137931,9
23008,Hôtel de Ville de Levallois Perret,OUI,26,21,5,3,2,OUI,OUI,2025-03-13 09:00:18+00:00,"48.89314451997415, 2.2888818383216862",Levallois-Perret,92044,0.19230769230769232,9
15058,Place du Moulin de Javel,OUI,58,0,58,38,20,OUI,OUI,2025-03-13 09:00:52+00:00,"48.84021670922, 2.2716060653329",Paris,75056,1.0,9
21108,Mairie de Clichy,OUI,44,39,5,4,1,OUI,OUI,2025-03-13 09:01:23+00:00,"48.903653634661, 2.3059353232384",Clichy,92024,0.11363636363636363,9
11048,Place Mireille Havet,OUI,42,8,34,28,6,OUI,OUI,2025-03-13 09:00:30+00:00,"48.850533, 2.383756",Paris,75056,0.8095238095238095,9
6014,Pont de Lodi - Dauphine,OUI,21,17,4,3,1,OUI,OUI,2025-03-13 09:01:08+00:00,"48.855296898603285, 2.339947307565249",Paris,75056,0.19047619047619047,9
22017,Charles de Gaulle - Louis Philippe,OUI,27,16,11,8,3,OUI,OUI,2025-03-13 09:00:40+00:00,"48.881742142181, 2.2710045335353",Neuilly-sur-Seine,92051,0.4074074074074074,9
14116,Romain Rolland,OUI,25,25,0,0,0,OUI,OUI,2025-03-13 08:56:49+00:00,"48.820215229662765, 2.3234144234418346",Montrouge,92049,0.0,9
17104,Jardin Marguerite Long,OUI,21,17,4,2,2,OUI,OUI,2025-03-13 08:52:50+00:00,"48.8816985773914, 2.2836575657129288",Paris,75056,0.19047619047619047,9
31018,Gambetta - Michelet,OUI,30,30,0,0,0,OUI,OUI,2025-03-13 09:01:16+00:00,"48.85273792380526, 2.429966032505036",Montreuil,93048,0.0,9
35008,Place de l'Eglise - Pantin,OUI,29,25,4,2,2,OUI,OUI,2025-03-13 09:00:01+00:00,"48.892809461520265, 2.4124351143836975",Pantin,93055,0.13793103448275862,9
33005,République - Henri Barbusse,OUI,31,13,18,11,7,OUI,OUI,2025-03-13 09:00:25+00:00,"48.90661553626751, 2.389432489871979",Aubervilliers,93001,0.5806451612903226,9
13022,Butte aux Cailles - Esperance,OUI,30,28,2,1,1,OUI,OUI,2025-03-13 09:01:17+00:00,"48.82758774190948, 2.3492151126265526",Paris,75056,0.06666666666666667,9
5019,Poissy - Saint-Germain,OUI,24,8,16,14,2,OUI,OUI,2025-03-13 09:00:54+00:00,"48.84969649427, 2.3529685288668",Paris,75056,0.6666666666666666,9
20045,Louis Ganne - Davout,OUI,30,29,1,0,1,OUI,OUI,2025-03-13 08:56:00+00:00,"48.86338720692607, 2.409725748002529",Paris,75056,0.03333333333333333,9
14007,Ferrus - Saint-Jacques,OUI,33,20,13,5,8,OUI,OUI,2025-03-13 09:00:41+00:00,"48.8313878, 2.3408563",Paris,75056,0.3939393939393939,9
13019,Fernand Braudel - Vincent Auriol,OUI,36,20,16,11,5,OUI,OUI,2025-03-13 09:00:25+00:00,"48.83637852318147, 2.3723404482007027",Paris,75056,0.4444444444444444,9
10164,Claude Vellefaux - Sambre et Meuse,OUI,32,30,2,1,1,OUI,OUI,2025-03-13 09:00:28+00:00,"48.875022, 2.370478",Paris,75056,0.0625,9
11044,Square du Bataclan,OUI,16,6,10,9,1,OUI,OUI,2025-03-13 09:00:50+00:00,"48.8633762, 2.3711327",Paris,75056,0.625,9
11107,Faidherbe - Dahomey,OUI,40,9,31,26,5,OUI,OUI,2025-03-13 08:59:36+00:00,"48.851358329771806, 2.383823134795429",Paris,75056,0.775,9
21952,Place Tony de Graaff,OUI,42,18,24,20,4,OUI,OUI,2025-03-13 09:01:18+00:00,"48.8181645, 2.2458109",Meudon,92048,0.5714285714285714,9
9113,Bleue - Trévise,OUI,26,15,11,5,6,OUI,OUI,2025-03-13 08:58:44+00:00,"48.87578906564573, 2.347289621829987",Paris,75056,0.4230769230769231,9
9015,Lamartine - Faubourg Montmartre,OUI,30,14,16,3,13,OUI,OUI,2025-03-13 09:00:57+00:00,"48.876613982891, 2.3397656902671",Paris,75056,0.5333333333333333,9
2101,Bachaumont - Montmartre,OUI,33,5,28,24,4,OUI,OUI,2025-03-13 09:00:55+00:00,"48.86617395079137, 2.3449775576591496",Paris,75056,0.8484848484848485,9
8029,Place du Canada,OUI,56,3,53,23,30,OUI,OUI,2025-03-13 09:00:15+00:00,"48.865346269363, 2.3101937879648",Paris,75056,0.9464285714285714,9
8049,Georges V - François 1er,OUI,20,0,20,8,12,OUI,OUI,2025-03-13 09:01:19+00:00,"48.87034, 2.30082",Paris,75056,1.0,9
12153,Terroirs de France - Lheureux,OUI,55,12,43,21,22,OUI,OUI,2025-03-13 09:00:46+00:00,"48.83212027074841, 2.388618104159832",Paris,75056,0.7818181818181819,9
12154,Square Georges Melies,OUI,37,25,12,6,6,OUI,OUI,2025-03-13 08:57:49+00:00,"48.84070239213081, 2.409667745232582",Paris,75056,0.32432432432432434,9
17005,Brochant - Clichy,OUI,53,51,2,1,1,OUI,OUI,2025-03-13 08:57:09+00:00,"48.89032998912038, 2.319730559929781",Paris,75056,0.03773584905660377,9
19021,Mairie du 19ème,OUI,24,23,1,1,0,OUI,OUI,2025-03-13 09:00:44+00:00,"48.88256264247959, 2.3812624812126164",Paris,75056,0.041666666666666664,9
21017,Place Marcel Sembat,OUI,51,3,48,40,8,OUI,OUI,2025-03-13 09:00:24+00:00,"48.83328865030686, 2.2441747784614567",Boulogne-Billancourt,92012,0.9411764705882353,9
19030,Melun - Jean Jaurès,OUI,27,27,0,0,0,OUI,OUI,2025-03-13 08:53:20+00:00,"48.8837796723475, 2.376477420330048",Paris,75056,0.0,9
14127,Odessa - Départ,OUI,39,36,3,1,2,OUI,OUI,2025-03-13 09:00:55+00:00,"48.842885590081, 2.3244281485677",Paris,75056,0.07692307692307693,9
21004,Jean Jaurès - Reine,OUI,31,0,31,27,4,OUI,OUI,2025-03-13 08:59:02+00:00,"48.84009622558849, 2.239872515201569",Boulogne-Billancourt,92012,1.0,9
14016,René Coty - Parc Montsouris,OUI,54,54,0,0,0,OUI,OUI,2025-03-13 09:00:55+00:00,"48.82479134498032, 2.336124926805496",Paris,75056,0.0,9
22002,Argenson - Château,OUI,24,2,22,13,9,OUI,OUI,2025-03-13 08:58:17+00:00,"48.888559314669514, 2.2642001509666447",Neuilly-sur-Seine,92051,0.9166666666666666,9
12120,Lac Daumesnil - Saint-Maurice,OUI,49,34,15,13,2,OUI,OUI,2025-03-13 08:52:50+00:00,"48.82774555743318, 2.4183654785156246",Paris,75056,0.30612244897959184,9
5030,Sorbonne - Ecoles,OUI,47,4,43,17,26,OUI,OUI,2025-03-13 09:01:14+00:00,"48.849686566191, 2.3434996604919",Paris,75056,0.9148936170212766,9
18035,René Binet - Porte de Montmartre,OUI,36,30,6,0,6,OUI,OUI,2025-03-13 08:53:55+00:00,"48.89905109950848, 2.3365534096956253",Paris,75056,0.16666666666666666,9
16041,Versailles - Claude Terrasse,OUI,45,15,30,27,3,OUI,OUI,2025-03-13 08:59:01+00:00,"48.840219338074, 2.263834191153",Paris,75056,0.6666666666666666,9
23005,Gare de Clichy-Levallois,OUI,24,5,19,15,4,OUI,OUI,2025-03-13 08:59:49+00:00,"48.89679827481989, 2.2984680533409123",Levallois-Perret,92044,0.7916666666666666,9
11110,Roquette - Folie Regnault,OUI,50,43,7,1,6,OUI,OUI,2025-03-13 08:57:52+00:00,"48.859246959155485, 2.386553623578705",Paris,75056,0.14,9
20117,Saint-Fargeau - Mortier,OUI,31,31,0,0,0,OUI,OUI,2025-03-13 09:00:42+00:00,"48.87266656122256, 2.407912909984589",Paris,75056,0.0,9
16031,Vignes - Boulainvilliers,OUI,20,18,2,0,2,OUI,OUI,2025-03-13 09:01:24+00:00,"48.856399483950504, 2.275240458548069",Paris,75056,0.1,9
21009,Le Corbusier - Jean Jaurès,OUI,45,29,16,7,9,OUI,OUI,2025-03-13 09:01:26+00:00,"48.83780830557548, 2.2408381104469304",Boulogne-Billancourt,92012,0.35555555555555557,9
12033,François Truffaut - Saint Emilion,OUI,66,22,44,39,5,OUI,OUI,2025-03-13 09:01:24+00:00,"48.83372354344807, 2.386601903271428",Paris,75056,0.6666666666666666,9
31017,Jean Moulin - Paul Doumer,OUI,17,14,3,1,2,OUI,OUI,2025-03-13 09:01:16+00:00,"48.8622179854695, 2.45533436536789",Montreuil,93048,0.17647058823529413,9
22012,Madeleine Michelis - Roule,OUI,24,15,9,7,2,OUI,OUI,2025-03-13 09:00:29+00:00,"48.88260431301364, 2.2773634269833565",Neuilly-sur-Seine,92051,0.375,9
18114,Véron - Lepic,OUI,22,21,1,1,0,OUI,OUI,2025-03-13 08:58:09+00:00,"48.88526123395252, 2.334559857845307",Paris,75056,0.045454545454545456,9
18142,Jessaint - Marx Dormoy,OUI,30,28,2,0,2,OUI,OUI,2025-03-13 08:54:17+00:00,"48.88484543106364, 2.358930408954621",Paris,75056,0.06666666666666667,9
44103,Pont De Charenton,OUI,18,7,11,11,0,OUI,OUI,2025-03-13 09:00:17+00:00,"48.8179685, 2.4199531",Saint-Maurice,94069,0.6111111111111112,9
4010,Saint-Antoine Sévigné,OUI,27,1,26,20,6,OUI,OUI,2025-03-13 09:01:19+00:00,"48.8550222, 2.3612322",Paris,75056,0.9629629629629629,9
4107,Beaumarchais - Pas de la Mule,OUI,17,4,13,9,4,OUI,OUI,2025-03-13 09:01:15+00:00,"48.855580507049, 2.3684333673431",Paris,75056,0.7647058823529411,9
13110,Moulin de la Pointe,OUI,20,19,1,0,1,OUI,OUI,2025-03-13 08:56:23+00:00,"48.82092946051445, 2.3563179373741145",Paris,75056,0.05,9
22403,Pierre Brossolette - Adolphe Pinard,OUI,23,20,3,0,3,OUI,OUI,2025-03-13 08:58:10+00:00,"48.821772279548, 2.3131558299065",Malakoff,92046,0.13043478260869565,9
23105,Sèvres Rive Gauche,OUI,33,20,13,13,0,OUI,OUI,2025-03-13 08:52:23+00:00,"48.821443218278, 2.2150785306885",Sèvres,92072,0.3939393939393939,9
20047,Cours de Vincennes - Davout,OUI,48,26,22,8,14,OUI,OUI,2025-03-13 08:58:03+00:00,"48.847238029966, 2.4107042336225",Paris,75056,0.4583333333333333,9
15009,Suffren - Pérignon,OUI,45,3,42,31,11,OUI,OUI,2025-03-13 08:59:18+00:00,"48.84717561492764, 2.307052147596786",Paris,75056,0.9333333333333333,9
92005,Gare de Nanterre Ville,OUI,42,17,25,20,5,OUI,OUI,2025-03-13 09:00:23+00:00,"48.8950295, 2.1957932",Nanterre,92050,0.5952380952380952,9
21120,Docteur Calmette - Martre,OUI,30,11,19,17,2,OUI,OUI,2025-03-13 08:59:06+00:00,"48.898969358483, 2.3086513252383",Clichy,92024,0.6333333333333333,9
22103,Senard - Charles Blum,OUI,24,10,14,4,10,OUI,OUI,2025-03-13 08:58:53+00:00,"48.857315824799, 2.221091687679291",Saint-Cloud,92064,0.5833333333333334,9
48009,République - Auguste Perret,OUI,30,30,0,0,0,OUI,OUI,2025-03-13 08:54:26+00:00,"48.78695280952244, 2.3518594354391094",Villejuif,94076,0.0,9
10039,Sambre et Meuse - Villette,OUI,24,22,2,0,2,OUI,OUI,2025-03-13 09:01:14+00:00,"48.874405666217, 2.3738072379951",Paris,75056,0.08333333333333333,9
14125,Dareau - Broussais,OUI,22,19,3,1,2,OUI,OUI,2025-03-13 08:56:26+00:00,"48.8307758, 2.3361804",Paris,75056,0.13636363636363635,9
19036,Hôpital Robert Debré,OUI,33,30,3,0,3,OUI,OUI,2025-03-13 08:59:49+00:00,"48.88005222200894, 2.4008650346327003",Paris,75056,0.09090909090909091,9
13047,Boutroux - Porte de Vitry,OUI,49,28,21,19,2,OUI,OUI,2025-03-13 08:58:33+00:00,"48.822632, 2.377738",Paris,75056,0.42857142857142855,9
17001,Guy Môquet - Saint-Ouen,OUI,43,39,4,3,1,OUI,OUI,2025-03-13 09:01:21+00:00,"48.892777719023975, 2.3270335793495183",Paris,75056,0.09302325581395349,9
42011,Quai Marcel Boyer - Victor Hugo,OUI,29,1,28,18,10,OUI,OUI,2025-03-13 09:01:15+00:00,"48.822556366667, 2.3920395970345",Ivry-sur-Seine,94041,0.9655172413793104,9
12129,Bois de Vincennes - Porte Jaune,OUI,35,32,3,2,1,OUI,OUI,2025-03-13 08:51:51+00:00,"48.838751246689455, 2.4605489149689674",Paris,75056,0.08571428571428572,9
9013,Mairie du 9ème,OUI,23,0,23,18,5,OUI,OUI,2025-03-13 08:59:38+00:00,"48.873267137583, 2.3407534480528",Paris,75056,1.0,9
35004,Place du Président Salvador Allende,OUI,59,42,17,3,14,OUI,OUI,2025-03-13 09:01:23+00:00,"48.897307310356055, 2.40079153681279",Pantin,93055,0.288135593220339,9
21951,Place Centrale,OUI,22,20,2,1,1,OUI,OUI,2025-03-13 09:01:19+00:00,"48.78740167690531, 2.2278830409049992",Meudon,92048,0.09090909090909091,9
8011,Clapeyron - Moscou,OUI,15,14,1,0,1,OUI,OUI,2025-03-13 09:00:54+00:00,"48.88078819514121, 2.324815057218075",Paris,75056,0.06666666666666667,9
19113,Pré Saint-Gervais - Lilas,OUI,27,26,1,0,1,OUI,OUI,2025-03-13 08:55:25+00:00,"48.877870626988, 2.3959073424339",Paris,75056,0.037037037037037035,9
32021,Place du Front Populaire - George Sand,OUI,64,41,23,20,3,OUI,OUI,2025-03-13 09:01:16+00:00,"48.90680713698062, 2.364541214992642",Saint-Denis,93066,0.359375,9
14128,Gergovie - Vercingétorix,OUI,29,28,1,0,1,OUI,OUI,2025-03-13 08:59:54+00:00,"48.83453413883994, 2.313154547426182",Paris,75056,0.034482758620689655,9
15019,Paul Barruel - Vaugirard,OUI,36,32,4,0,4,OUI,OUI,2025-03-13 08:59:28+00:00,"48.84014918546239, 2.3044332861900334",Paris,75056,0.1111111111111111,9
31101,Jules Guesde - Laennec,OUI,19,15,4,0,4,OUI,OUI,2025-03-13 08:54:10+00:00,"48.87628983900398, 2.5006942078471184",Rosny-sous-Bois,93064,0.21052631578947367,9
11031,Jacquard - Ternaux,OUI,39,21,18,13,5,OUI,OUI,2025-03-13 08:59:03+00:00,"48.8646605, 2.373162",Paris,75056,0.46153846153846156,9
31026,Demi-Lune - Aristide Briand,OUI,20,19,1,0,1,OUI,OUI,2025-03-13 08:58:46+00:00,"48.87626381919953, 2.4562818557024",Montreuil,93048,0.05,9
9016,Choron - Martyrs,OUI,17,16,1,1,0,OUI,OUI,2025-03-13 09:01:08+00:00,"48.877851443503, 2.3396701365709",Paris,75056,0.058823529411764705,9
31707,Edouard Vaillant - Galliéni,OUI,48,46,2,1,1,OUI,OUI,2025-03-13 09:00:05+00:00,"48.858462881661, 2.4147954583168",Bagnolet,93006,0.041666666666666664,9
9036,Athènes - Clichy,OUI,18,10,8,2,6,OUI,OUI,2025-03-13 09:00:55+00:00,"48.878113787876, 2.32956021945824",Paris,75056,0.4444444444444444,9
13020,Paul Klee - Place Augusta Holmes,OUI,43,17,26,6,20,OUI,OUI,2025-03-13 09:00:56+00:00,"48.838946417408025, 2.3704235663952966",Paris,75056,0.6046511627906976,9
15125,Parc Suzanne Lenglen,OUI,51,7,44,37,7,OUI,OUI,2025-03-13 09:00:53+00:00,"48.833250690537874, 2.2765403240919113",Paris,75056,0.8627450980392157,9
19124,Alexander Fleming - Belvédère,OUI,31,30,1,1,0,OUI,OUI,2025-03-13 08:53:49+00:00,"48.88179064200294, 2.4030599377642674",Paris,75056,0.03225806451612903,9
13027,Mazagran - Pierre de Coubertin,OUI,15,9,6,1,5,OUI,OUI,2025-03-13 08:59:37+00:00,"48.816218640260445, 2.344226874411106",Paris,75056,0.4,9
7010,Constantine - Université,OUI,59,7,52,41,11,OUI,OUI,2025-03-13 09:01:23+00:00,"48.860680473738, 2.3148481955842",Paris,75056,0.8813559322033898,9
21118,Neuilly - Petit,OUI,14,8,6,2,4,OUI,OUI,2025-03-13 09:00:41+00:00,"48.898965361341254, 2.29627937078476",Clichy,92024,0.42857142857142855,9
14113,Santé - Arago,OUI,37,22,15,9,6,OUI,OUI,2025-03-13 09:00:20+00:00,"48.83507657562064, 2.3415737262044938",Paris,75056,0.40540540540540543,9
11103,Pelée - Alphonse Baudin,OUI,34,18,16,9,7,OUI,OUI,2025-03-13 09:01:11+00:00,"48.8600265, 2.3710541",Paris,75056,0.47058823529411764,9
35015,Averroès - Aimé Césaire,OUI,17,11,6,5,1,OUI,OUI,2025-03-13 09:01:15+00:00,"48.91405323432864, 2.412636950612068",Pantin,93055,0.35294117647058826,9
21203,Place Jules Ferry,OUI,28,24,4,3,1,OUI,OUI,2025-03-13 09:01:17+00:00,"48.812107928414775, 2.325837314128876",Montrouge,92049,0.14285714285714285,9
20203,Evariste Galois,OUI,20,20,0,0,0,OUI,OUI,2025-03-13 09:00:42+00:00,"48.873341356228, 2.4133544409574",Paris,75056,0.0,9
5034,Censier - Santeuil,OUI,66,17,49,36,13,OUI,OUI,2025-03-13 08:58:52+00:00,"48.840658921385234, 2.3537524044513702",Paris,75056,0.7424242424242424,9
7024,Rapp - Place du Général Gouraud,OUI,29,7,22,13,9,OUI,OUI,2025-03-13 09:01:25+00:00,"48.858102885107, 2.3004072904587",Paris,75056,0.7586206896551724,9
10017,Gare de l'Est - Fidélité,OUI,13,7,6,2,4,OUI,OUI,2025-03-13 09:00:36+00:00,"48.874575, 2.356796",Paris,75056,0.46153846153846156,9
20004,Commandant l'Herminier - Gallieni,OUI,17,14,3,2,1,OUI,OUI,2025-03-13 09:00:47+00:00,"48.847040552603, 2.4160453677177",Paris,75056,0.17647058823529413,9
22013,Mairie de Neuilly sur Seine,OUI,30,25,5,2,3,OUI,OUI,2025-03-13 08:57:36+00:00,"48.88494728765838, 2.2677031159400944",Neuilly-sur-Seine,92051,0.16666666666666666,9
12150,Bastille - Quai de la Rapée,OUI,27,1,26,23,3,OUI,OUI,2025-03-13 08:59:28+00:00,"48.84682410855, 2.3669364675879",Paris,75056,0.9629629629629629,9
21029,Cours de l'Ile Seguin - Parc Billancourt,OUI,28,9,19,8,11,OUI,OUI,2025-03-13 09:00:35+00:00,"48.82714055843935, 2.234234511852265",Boulogne-Billancourt,92012,0.6785714285714286,9
12125,Pyramide - Parc Floral,OUI,49,43,6,1,5,OUI,OUI,2025-03-13 08:58:55+00:00,"48.837442, 2.440452",Paris,75056,0.12244897959183673,9
12006,Gare de Lyon - Van Gogh,OUI,41,1,40,26,14,OUI,OUI,2025-03-13 08:59:48+00:00,"48.843839785643, 2.3704450240357",Paris,75056,0.975609756097561,9
13515,Auguste Blanqui - Glacière,OUI,59,57,2,1,1,OUI,OUI,2025-03-13 08:58:53+00:00,"48.831151602964, 2.343822196126",Paris,75056,0.03389830508474576,9
16014,Eylau - Trocadéro,OUI,22,11,11,2,9,OUI,OUI,2025-03-13 09:00:58+00:00,"48.863354122371, 2.2864209115505",Paris,75056,0.5,9
10152,Gare du Nord - Place de Valenciennes,OUI,24,21,3,2,1,OUI,OUI,2025-03-13 09:00:22+00:00,"48.879089, 2.354235",Paris,75056,0.125,9
10110,Louis Blanc - Jemmapes,OUI,31,21,10,3,7,OUI,OUI,2025-03-13 09:00:30+00:00,"48.879330755297, 2.3684485629201",Paris,75056,0.3225806451612903,9
15131,Charles Lecocq - Lecourbe,OUI,28,22,6,5,1,OUI,OUI,2025-03-13 08:55:37+00:00,"48.84044, 2.294867",Paris,75056,0.21428571428571427,9
21115,Chancé Milly - Cimetière Communal Sud,OUI,32,17,15,13,2,OUI,OUI,2025-03-13 09:01:16+00:00,"48.89687189382465, 2.303922325372696",Clichy,92024,0.46875,9
10037,Quai de Valmy,OUI,26,23,3,3,0,OUI,OUI,2025-03-13 09:00:54+00:00,"48.88126951579429, 2.368186041712761",Paris,75056,0.11538461538461539,9
21702,Gare SNCF Vanves-Malakoff,OUI,49,47,2,1,1,OUI,OUI,2025-03-13 08:59:44+00:00,"48.819002163836444, 2.292150005103606",Vanves,92075,0.04081632653061224,9
13117,Stade Georges Carpentier,OUI,39,30,9,4,5,OUI,OUI,2025-03-13 09:00:58+00:00,"48.820482438381, 2.3668321967125",Paris,75056,0.23076923076923078,9
42304,Marc Sangnier - Division Leclerc,OUI,21,5,16,13,3,OUI,OUI,2025-03-13 09:00:57+00:00,"48.78599652305309, 2.329955510795116",Cachan,94016,0.7619047619047619,9
17029,Pierre Demours - Laugier,OUI,36,35,1,0,1,OUI,OUI,2025-03-13 08:57:48+00:00,"48.8813072, 2.294846",Paris,75056,0.027777777777777776,9
15052,Convention - Vaugirard,OUI,44,36,8,6,2,OUI,OUI,2025-03-13 09:00:51+00:00,"48.83767682233156, 2.295586926020252",Paris,75056,0.18181818181818182,9
10004,Metz - Faubourg Saint-Denis,OUI,44,20,24,13,11,OUI,OUI,2025-03-13 09:01:14+00:00,"48.870893, 2.353521",Paris,75056,0.5454545454545454,9
16115,Raffet - Montmorency,OUI,40,39,1,0,1,OUI,OUI,2025-03-13 09:01:12+00:00,"48.85258670812, 2.2629252456151954",Paris,75056,0.025,9
20039,Belleville - Couronnes,OUI,48,47,1,0,1,OUI,OUI,2025-03-13 08:54:00+00:00,"48.868831082877, 2.3809862136841",Paris,75056,0.020833333333333332,9
13039,Ivry - Simone Weil,OUI,18,14,4,2,2,OUI,OUI,2025-03-13 08:57:32+00:00,"48.823283932030755, 2.3659095168113713",Paris,75056,0.2222222222222222,9
21316,Cimetière d'Issy-les-Moulineaux,OUI,23,23,0,0,0,OUI,OUI,2025-03-13 09:00:14+00:00,"48.817699773925, 2.2609312087297",Issy-les-Moulineaux,92040,0.0,9
17039,Place Saint-Ferdinand,OUI,38,32,6,1,5,OUI,OUI,2025-03-13 08:53:21+00:00,"48.87815529789739, 2.288518047864942",Paris,75056,0.15789473684210525,9
19025,Botzaris - Crimée,OUI,20,19,1,0,1,OUI,OUI,2025-03-13 08:59:05+00:00,"48.87959698690176, 2.3887913337477067",Paris,75056,0.05,9
11032,Jean-Pierre Timbaud - Vaucouleurs,OUI,43,40,3,1,2,OUI,OUI,2025-03-13 09:00:50+00:00,"48.867937, 2.377885",Paris,75056,0.06976744186046512,9
16009,Saint-Didier - Raymond Poincaré,OUI,17,8,9,1,8,OUI,OUI,2025-03-13 08:58:24+00:00,"48.86642312020962, 2.285863497192411",Paris,75056,0.5294117647058824,9
16101,Malakoff - Place de la Porte Maillot,OUI,26,10,16,5,11,OUI,OUI,2025-03-13 08:58:16+00:00,"48.876733496638, 2.2834577411413",Paris,75056,0.6153846153846154,9
10153,Gare du Nord - Denain,OUI,20,19,1,0,1,OUI,OUI,2025-03-13 09:00:22+00:00,"48.879595787608, 2.3544725775719",Paris,75056,0.05,9
8001,Petit Palais,OUI,42,14,28,19,9,OUI,OUI,2025-03-13 09:01:20+00:00,"48.8667692, 2.3157655",Paris,75056,0.6666666666666666,9
16003,André Maurois - Joseph et Marie Hackin,OUI,27,12,15,12,3,OUI,OUI,2025-03-13 09:01:22+00:00,"48.8778983, 2.2789591",Paris,75056,0.5555555555555556,9
13121,Bruneseau - Quai d'Ivry,OUI,46,1,45,42,3,OUI,OUI,2025-03-13 09:01:01+00:00,"48.824945637583, 2.3885661363602",Ivry-sur-Seine,94041,0.9782608695652174,9
15072,Place Fernand Forest,OUI,28,0,28,24,4,OUI,OUI,2025-03-13 09:00:18+00:00,"48.849269143836, 2.281863167882",Paris,75056,1.0,9
10018,Square Alban Satragne,OUI,29,24,5,1,4,OUI,OUI,2025-03-13 08:59:31+00:00,"48.875388227727, 2.3559567333359",Paris,75056,0.1724137931034483,9
16007,Longchamp - Place d'Iéna,OUI,25,0,25,6,19,OUI,OUI,2025-03-13 09:01:26+00:00,"48.864917233434, 2.2926748171449",Paris,75056,1.0,9
31025,Paul Signac - Aristide Briand,OUI,33,31,2,0,2,OUI,OUI,2025-03-13 08:51:48+00:00,"48.86950262156371, 2.4502260982990265",Montreuil,93048,0.06060606060606061,9
21708,Marcel Yol - Jullien,OUI,29,14,15,6,9,OUI,OUI,2025-03-13 09:00:53+00:00,"48.82537611802588, 2.287235018058929",Vanves,92075,0.5172413793103449,9
5014,Jean Calvin - Tournefort,OUI,28,10,18,7,11,OUI,OUI,2025-03-13 09:01:16+00:00,"48.84158856925782, 2.348489575088024",Paris,75056,0.6428571428571429,9
13048,Wurtz - Tolbiac,OUI,28,28,0,0,0,NON,NON,2025-03-13 08:59:43+00:00,"48.82631195621, 2.344585955143",Paris,75056,0.0,9
20007,Buzenval - Avron,OUI,49,49,0,0,0,OUI,OUI,2025-03-13 08:59:13+00:00,"48.851617204999, 2.4015135973077",Paris,75056,0.0,9
41210,Hôtel de ville de Fontenay-sous-Bois,OUI,19,17,2,0,2,OUI,OUI,2025-03-13 09:01:11+00:00,"48.84949749106274, 2.4750164151191716",Fontenay-sous-Bois,94033,0.10526315789473684,9
16020,Place de la Porte de Passy,OUI,34,34,0,0,0,OUI,OUI,2025-03-13 09:01:20+00:00,"48.857341095470794, 2.2644165538827115",Paris,75056,0.0,9
11109,Pierre Levée - Fontaine Timbaud,OUI,22,17,5,1,4,OUI,OUI,2025-03-13 08:59:03+00:00,"48.86632723374305, 2.3711163550615306",Paris,75056,0.22727272727272727,9
17015,Place de Lévis,OUI,48,44,4,3,1,OUI,OUI,2025-03-13 08:56:34+00:00,"48.883546851533254, 2.3131933808326726",Paris,75056,0.08333333333333333,9
31021,Résistance - Hoche,OUI,28,28,0,0,0,OUI,OUI,2025-03-13 08:58:01+00:00,"48.864273423741956, 2.435784414410591",Montreuil,93048,0.0,9
15023,La Motte-Picquet - Grenelle,OUI,34,3,31,29,2,OUI,OUI,2025-03-13 09:00:16+00:00,"48.84858321339195, 2.299347817897797",Paris,75056,0.9117647058823529,9
44002,Paul Vaillant-Couturier - Gare RER,OUI,25,2,23,17,6,OUI,OUI,2025-03-13 09:01:15+00:00,"48.80108159069614, 2.402097210288048",Vitry-sur-Seine,94081,0.92,9
22501,Théâtre de La Garenne,OUI,20,18,2,1,1,OUI,OUI,2025-03-13 08:56:00+00:00,"48.905658361454, 2.2345951981176",La Garenne-Colombes,92035,0.1,9
15123,Commerce - Letellier,OUI,43,28,15,10,5,OUI,OUI,2025-03-13 08:59:34+00:00,"48.84797660373612, 2.2966245196598805",Paris,75056,0.3488372093023256,9
40009,Lycée Saint Exupéry - Juliette Savar,OUI,29,19,10,8,2,OUI,OUI,2025-03-13 08:57:37+00:00,"48.783021513972, 2.4637357216879",Créteil,94028,0.3448275862068966,9
21030,Fessart - Château,OUI,20,2,18,15,3,OUI,OUI,2025-03-13 09:00:43+00:00,"48.84245, 2.23989",Boulogne-Billancourt,92012,0.9,9
23003,Président Wilson - Baudin,OUI,28,8,20,14,6,OUI,OUI,2025-03-13 09:01:00+00:00,"48.89826887103676, 2.2849336266517644",Levallois-Perret,92044,0.7142857142857143,9
21031,Cimetière de Boulogne-Billancourt,OUI,40,16,24,22,2,OUI,OUI,2025-03-13 09:00:58+00:00,"48.830764, 2.252024",Boulogne-Billancourt,92012,0.6,9
19108,Gaston Tessier - Rosa Parks RER,OUI,37,22,15,11,4,OUI,OUI,2025-03-13 09:01:20+00:00,"48.8963765, 2.3743692",Paris,75056,0.40540540540540543,9
16024,Ranelagh - Maison de la Radio,OUI,19,5,14,11,3,OUI,OUI,2025-03-13 09:00:54+00:00,"48.85293603169479, 2.280449643731117",Paris,75056,0.7368421052631579,9
10105,Mazagran - Bonne Nouvelle,OUI,25,15,10,6,4,OUI,OUI,2025-03-13 09:00:31+00:00,"48.870047123655, 2.3511248454452",Paris,75056,0.4,9
15043,Brancion - Lefebvre,OUI,9,9,0,0,0,OUI,OUI,2025-03-13 09:00:44+00:00,"48.82900222785569, 2.301431038163409",Paris,75056,0.0,9
42501,Raspail - Albert Schweitzer,OUI,27,6,21,20,1,OUI,OUI,2025-03-13 09:00:36+00:00,"48.81031545, 2.34395871",Gentilly,94037,0.7777777777777778,9
22604,Hôtel de Ville de Fontenay-aux-Roses,OUI,32,30,2,1,1,OUI,OUI,2025-03-13 08:59:59+00:00,"48.790844603480856, 2.2871455930319455",Fontenay-aux-Roses,92032,0.0625,9
13109,Brillat-Savarin - Küss,OUI,20,18,2,2,0,OUI,OUI,2025-03-13 09:01:10+00:00,"48.822203, 2.350422",Paris,75056,0.1,9
20009,Docteurs Déjérine - Pte de Montreuil,OUI,19,19,0,0,0,OUI,OUI,2025-03-13 08:58:46+00:00,"48.85398448133697, 2.41208288897222",Paris,75056,0.0,9
21204,Estienne d'Orves - Henri Ginoux,OUI,31,28,3,1,2,OUI,OUI,2025-03-13 08:55:17+00:00,"48.815388220397274, 2.320886790760933",Montrouge,92049,0.0967741935483871,9
42305,Vanne - Saussaies,OUI,20,18,2,0,2,OUI,OUI,2025-03-13 08:59:56+00:00,"48.786404, 2.338848",Cachan,94016,0.1,9
43001,Paris - Laitières,OUI,22,7,15,5,10,OUI,OUI,2025-03-13 08:52:17+00:00,"48.84630274151258, 2.4207553267478947",Vincennes,94080,0.6818181818181818,9
21955,Vaugirard - Verrerie,OUI,24,1,23,17,6,OUI,OUI,2025-03-13 08:58:10+00:00,"48.820881336842, 2.2367222622987",Meudon,92048,0.9583333333333334,9
11021,Charonne - Pierre Bayle,OUI,23,22,1,0,1,OUI,OUI,2025-03-13 08:54:00+00:00,"48.858445054262, 2.3903981223891",Paris,75056,0.043478260869565216,9
21307,Victor Cresson - Telles de la Poterie,OUI,29,16,13,10,3,OUI,OUI,2025-03-13 08:59:33+00:00,"48.822698842979, 2.2686498274964",Issy-les-Moulineaux,92040,0.4482758620689655,9
21217,Louis Rolland - République,OUI,26,21,5,2,3,OUI,OUI,2025-03-13 08:59:54+00:00,"48.81710889740748, 2.3193106434955717",Montrouge,92049,0.19230769230769232,9
10012,Vinaigriers - Magenta,OUI,24,15,9,4,5,OUI,OUI,2025-03-13 08:58:45+00:00,"48.8731167, 2.3593052",Paris,75056,0.375,9
15030,Emeriau - Beaugrenelle,OUI,73,12,61,54,7,OUI,OUI,2025-03-13 08:59:27+00:00,"48.84791249714942, 2.2843059897422795",Paris,75056,0.8356164383561644,9
21028,Pierre Lefaucheux - Traversière,OUI,34,10,24,16,8,OUI,OUI,2025-03-13 09:00:47+00:00,"48.82435208303827, 2.2417913004755974",Boulogne-Billancourt,92012,0.7058823529411765,9
9114,Faubourg Poissonnière - Dunkerque,OUI,30,26,4,2,2,OUI,OUI,2025-03-13 08:58:46+00:00,"48.880883445404436, 2.349934279918671",Paris,75056,0.13333333333333333,9
4003,Quai aux Fleurs - Pont Saint-Louis,OUI,21,5,16,15,1,OUI,OUI,2025-03-13 09:01:08+00:00,"48.852915956209, 2.3521957173944",Paris,75056,0.7619047619047619,9
25001,Colmar - Victor Hugo,OUI,31,9,22,10,12,OUI,OUI,2025-03-13 08:52:31+00:00,"48.88652251096166, 2.173960916697979",Rueil-Malmaison,92063,0.7096774193548387,9
32301,Mairie de Romainville,OUI,17,17,0,0,0,OUI,OUI,2025-03-13 08:52:31+00:00,"48.885109, 2.435679",Romainville,93063,0.0,9
35007,Benjamin Delessert - Jean Lolive,OUI,20,18,2,0,2,OUI,OUI,2025-03-13 08:56:58+00:00,"48.89392043619345, 2.417981922626496",Pantin,93055,0.1,9
20108,Jardin de l'Hospice Debrousse,OUI,23,22,1,1,0,OUI,OUI,2025-03-13 09:00:38+00:00,"48.861451061938, 2.40568600595",Paris,75056,0.043478260869565216,9
47001,Place de la Gare,OUI,45,6,39,34,5,OUI,OUI,2025-03-13 09:00:25+00:00,"48.80253358011283, 2.4275037646293645",Maisons-Alfort,94046,0.8666666666666667,9
21219,Amaury Duval - Gabriel Péri,OUI,36,35,1,0,1,OUI,OUI,2025-03-13 08:52:45+00:00,"48.81718759671675, 2.323841750621796",Montrouge,92049,0.027777777777777776,9
44101,Place Mongolfier,OUI,37,16,21,11,10,OUI,OUI,2025-03-13 09:00:57+00:00,"48.815160030060376, 2.4592879414558415",Saint-Maurice,94069,0.5675675675675675,9
13011,Hôpital - Campo-Formio,OUI,11,4,7,4,3,OUI,OUI,2025-03-13 08:59:20+00:00,"48.835405, 2.358218",Paris,75056,0.6363636363636364,9
13032,Italie - Jardin Joan Miro,OUI,24,22,2,0,2,OUI,OUI,2025-03-13 08:59:41+00:00,"48.81990914045756, 2.3592948541045193",Paris,75056,0.08333333333333333,9
8549,George V - Christophe Colomb,OUI,22,3,19,6,13,OUI,OUI,2025-03-13 09:01:19+00:00,"48.87046, 2.30104",Paris,75056,0.8636363636363636,9
10165,Gare de l'Est - Place du 11 Novembre 1918,OUI,38,31,7,3,4,OUI,OUI,2025-03-13 08:59:23+00:00,"48.876327, 2.3585464",Paris,75056,0.18421052631578946,9
23902,Gallieni - Lycée Charles Petitet,OUI,44,20,24,15,9,OUI,OUI,2025-03-13 08:59:48+00:00,"48.927640283627, 2.3308986340524",Villeneuve-la-Garenne,92078,0.5454545454545454,9
92001,Mairie de quartier du Plateau - Mont-Valérien,OUI,20,14,6,4,2,OUI,OUI,2025-03-13 08:57:19+00:00,"48.8799933, 2.2072437",Nanterre,92050,0.3,9
13033,Porte d'Italie,OUI,13,9,4,0,4,OUI,OUI,2025-03-13 09:00:44+00:00,"48.817161987718954, 2.360236309468746",Paris,75056,0.3076923076923077,9
17107,Berthier - Place Stuart Merril,OUI,36,21,15,12,3,OUI,OUI,2025-03-13 09:01:20+00:00,"48.885927922355044, 2.2933450341224675",Paris,75056,0.4166666666666667,9
42701,Charles Gide - Fort de Bicêtre,OUI,29,15,14,3,11,OUI,OUI,2025-03-13 08:59:42+00:00,"48.8071937956922, 2.353984415531159",Le Kremlin-Bicêtre,94043,0.4827586206896552,9
15057,Lucien Bossoutrot - Général Martial Vallin,OUI,38,2,36,18,18,OUI,OUI,2025-03-13 09:00:43+00:00,"48.836956046311, 2.2741072252393",Paris,75056,0.9473684210526315,9
20122,Vitruve - Davout,OUI,23,21,2,0,2,OUI,OUI,2025-03-13 08:57:19+00:00,"48.86053161154489, 2.4091592812626543",Paris,75056,0.08695652173913043,9
6027,Blaise-Desgoffe - Vaugirard,OUI,32,22,10,4,6,OUI,OUI,2025-03-13 09:01:11+00:00,"48.846128877747, 2.3242672160268",Paris,75056,0.3125,9
13126,Place Nationale - Château-des-Rentiers,OUI,18,4,14,8,6,OUI,OUI,2025-03-13 08:59:18+00:00,"48.829268, 2.365212",Paris,75056,0.7777777777777778,9
18007,Goutte d'or - Barbès,OUI,20,18,2,0,2,OUI,OUI,2025-03-13 08:56:20+00:00,"48.885124323627, 2.3496962338686",Paris,75056,0.1,9
14101,Gare Montparnasse - Edgar Quinet,OUI,33,29,4,0,4,OUI,OUI,2025-03-13 09:01:03+00:00,"48.841487851079, 2.3233232282801",Paris,75056,0.12121212121212122,9
19128,Quai de l'Oise - Aisne,OUI,28,25,3,1,2,OUI,OUI,2025-03-13 08:59:45+00:00,"48.8906231, 2.3833701",Paris,75056,0.10714285714285714,9
8020,Batignolles - Beudant,OUI,43,39,4,1,3,OUI,OUI,2025-03-13 09:01:07+00:00,"48.88216401466375, 2.319852970540523",Paris,75056,0.09302325581395349,9
13044,Place Jeanne d'Arc,OUI,36,36,0,0,0,OUI,OUI,2025-03-13 08:54:50+00:00,"48.829575, 2.369126",Paris,75056,0.0,9
42003,Place de l'Insurrection d'Août 1944,OUI,30,1,29,25,4,OUI,OUI,2025-03-13 08:57:58+00:00,"48.81477852751594, 2.398074567317963",Ivry-sur-Seine,94041,0.9666666666666667,9
4001,Arcole - Notre-Dame,OUI,27,13,14,4,10,OUI,OUI,2025-03-13 08:59:56+00:00,"48.853883541328, 2.3493797332048",Paris,75056,0.5185185185185185,9
11017,Charonne - Bureau,OUI,44,41,3,2,1,OUI,OUI,2025-03-13 08:55:30+00:00,"48.854176, 2.396093",Paris,75056,0.06818181818181818,9
12043,Daumesnil - Hébrard,OUI,39,16,23,21,2,OUI,OUI,2025-03-13 08:58:51+00:00,"48.8429, 2.38474",Paris,75056,0.5897435897435898,9
1021,Halles - Bourdonnais,OUI,18,1,17,13,4,OUI,OUI,2025-03-13 08:59:16+00:00,"48.860448992575, 2.3460162431002",Paris,75056,0.9444444444444444,9
33015,Charles Tillon - Cimetière Communal,OUI,26,2,24,7,17,OUI,OUI,2025-03-13 08:59:55+00:00,"48.91844023641836, 2.3935630917549138",Aubervilliers,93001,0.9230769230769231,9
14131,Jourdan - Monticelli,OUI,30,25,5,3,2,OUI,OUI,2025-03-13 08:59:20+00:00,"48.822032, 2.329095",Paris,75056,0.16666666666666666,9
15311,Quai du Président Roosevelt - Pont Aval,OUI,30,0,30,20,10,OUI,OUI,2025-03-13 08:57:35+00:00,"48.8343883676388, 2.2656820714473724",Paris,75056,1.0,9
17023,Porte d'Asnières,OUI,34,25,9,7,2,OUI,OUI,2025-03-13 09:00:11+00:00,"48.89035817610495, 2.3036286234855656",Paris,75056,0.2647058823529412,9
35006,Delizy - Louis Nadot,OUI,21,19,2,2,0,OUI,OUI,2025-03-13 08:53:55+00:00,"48.896212845581346, 2.4094578623771667",Pantin,93055,0.09523809523809523,9
44007,Camille Groult - Guy Môquet,OUI,21,7,14,11,3,OUI,OUI,2025-03-13 09:00:38+00:00,"48.787482746521306, 2.3976725712418556",Vitry-sur-Seine,94081,0.6666666666666666,9
22015,Île de la Jatte,OUI,23,6,17,9,8,OUI,OUI,2025-03-13 09:00:58+00:00,"48.894036161302104, 2.2666339203715324",Neuilly-sur-Seine,92051,0.7391304347826086,9
4002,Marché aux fleurs,OUI,21,1,20,12,8,OUI,OUI,2025-03-13 09:01:08+00:00,"48.855258115391, 2.3473754525185",Paris,75056,0.9523809523809523,9
12018,Saint-Mandé - Fabre d'Eglantine,OUI,33,28,5,2,3,OUI,OUI,2025-03-13 09:01:03+00:00,"48.8453579, 2.3965022",Paris,75056,0.15151515151515152,9
17003,Jacques Kellner - Saint-Ouen,OUI,43,42,1,0,1,OUI,OUI,2025-03-13 08:56:36+00:00,"48.895809485802886, 2.327897409164145",Paris,75056,0.023255813953488372,9
17119,Toqueville - Cardinet,OUI,30,28,2,1,1,OUI,OUI,2025-03-13 08:58:18+00:00,"48.88490187110713, 2.3109393194317818",Paris,75056,0.06666666666666667,9
6008,Assas - Luxembourg,OUI,32,1,31,11,20,OUI,OUI,2025-03-13 09:01:19+00:00,"48.843734468779, 2.3334283818759",Paris,75056,0.96875,9
15011,Cambronne - Villa Croix Nivert,OUI,62,47,15,15,0,OUI,OUI,2025-03-13 09:00:04+00:00,"48.845847561366, 2.3017574474216",Paris,75056,0.24193548387096775,9
42209,Place de l'Europe - Quai de Bercy,OUI,16,4,12,9,3,OUI,OUI,2025-03-13 08:59:15+00:00,"48.82529858840266, 2.3945679143071175",Charenton-le-Pont,94018,0.75,9
51002,Placette Grégoire Collas,OUI,25,16,9,5,4,OUI,OUI,2025-03-13 08:56:05+00:00,"48.94342014002797, 2.2487476095557213",Argenteuil,95018,0.36,9
22206,Louis Pasteur - Albert Petit,OUI,30,29,1,0,1,OUI,OUI,2025-03-13 09:00:15+00:00,"48.796261, 2.317289",Bagneux,92007,0.03333333333333333,9
10162,Alexandre Parodi - Quai de Valmy,OUI,24,23,1,0,1,OUI,OUI,2025-03-13 08:56:21+00:00,"48.879359419425, 2.3665961623192",Paris,75056,0.041666666666666664,9
16011,Victor Hugo - La Pompe,OUI,40,16,24,1,23,OUI,OUI,2025-03-13 09:00:56+00:00,"48.86795222470859, 2.28146318346262",Paris,75056,0.6,9
6012,Saint-Germain - Ciseaux,OUI,16,13,3,3,0,OUI,OUI,2025-03-13 09:00:36+00:00,"48.853305277595, 2.3344654618827",Paris,75056,0.1875,9
12007,Gare de Lyon - Chalon,OUI,45,31,14,11,3,OUI,OUI,2025-03-13 08:56:29+00:00,"48.845666194202, 2.3741452395916",Paris,75056,0.3111111111111111,9
9024,Taitbout - La Fayette,OUI,51,1,50,20,30,OUI,OUI,2025-03-13 08:59:39+00:00,"48.8733298892, 2.3352625966072",Paris,75056,0.9803921568627451,9
15064,Javel - André Citroën,OUI,44,4,40,38,2,OUI,OUI,2025-03-13 08:59:44+00:00,"48.846276485475, 2.2786368057132",Paris,75056,0.9090909090909091,9
17111,Lemercier - Cardinet,OUI,24,22,2,1,1,OUI,OUI,2025-03-13 09:01:14+00:00,"48.890097168851746, 2.317377626895905",Paris,75056,0.08333333333333333,9
14010,Jean Moulin - Place Victor et Hélène Basch,OUI,38,34,4,1,3,OUI,OUI,2025-03-13 09:00:41+00:00,"48.82764910241, 2.3261967301369",Paris,75056,0.10526315789473684,9
21314,Chemin de Bretagne,OUI,28,0,28,17,11,OUI,OUI,2025-03-13 09:01:14+00:00,"48.824753068884, 2.2588385956052",Issy-les-Moulineaux,92040,1.0,9
13128,Quai de la Gare - Pont de Bercy,OUI,30,2,28,24,4,OUI,OUI,2025-03-13 08:59:54+00:00,"48.83730787972, 2.3740861260598",Paris,75056,0.9333333333333333,9
13516,Glacière - Soeur Catherine Marie,OUI,40,35,5,1,4,OUI,OUI,2025-03-13 08:57:45+00:00,"48.829522989420596, 2.343570403754711",Paris,75056,0.125,9
22303,Lucien Lanternier - Le Luth,OUI,25,10,15,12,3,OUI,OUI,2025-03-13 09:00:05+00:00,"48.93159430558871, 2.2889783978462224",Gennevilliers,92036,0.6,9
9011,Geoffroy - Marie,OUI,17,5,12,12,0,OUI,OUI,2025-03-13 09:01:05+00:00,"48.873781940593325, 2.344513876337893",Paris,75056,0.7058823529411765,9
43010,La Jarry - Place Diderot,OUI,25,24,1,0,1,OUI,OUI,2025-03-13 08:58:43+00:00,"48.849726940367326, 2.452013790607453",Vincennes,94080,0.04,9
12028,Vivaldi - Antoine-Julien Hénard,OUI,27,25,2,2,0,OUI,OUI,2025-03-13 08:56:22+00:00,"48.841923663276546, 2.389728979467376",Paris,75056,0.07407407407407407,9
16002,Pergolèse - Malakoff,OUI,37,25,12,4,8,OUI,OUI,2025-03-13 08:58:54+00:00,"48.87521088779225, 2.2842781618237495",Paris,75056,0.32432432432432434,9
9034,Godot de Mauroy - Madeleine,OUI,21,1,20,5,15,OUI,OUI,2025-03-13 09:00:33+00:00,"48.869789, 2.326347",Paris,75056,0.9523809523809523,9
15004,Vaugirard - Pasteur,OUI,21,20,1,0,1,OUI,OUI,2025-03-13 08:59:55+00:00,"48.84040868803496, 2.3154367133975033",Paris,75056,0.047619047619047616,9
5115,Buffon - Jardin des Plantes,OUI,28,9,19,14,5,OUI,OUI,2025-03-13 09:01:20+00:00,"48.842668466104875, 2.3618587106466293",Paris,75056,0.6785714285714286,9
23010,Voltaire - Anatole France,OUI,26,5,21,10,11,OUI,OUI,2025-03-13 09:01:04+00:00,"48.891999360256904, 2.284262739121914",Levallois-Perret,92044,0.8076923076923077,9
41211,Louis Xavier de Ricard - Ancienne Mairie,OUI,34,33,1,1,0,OUI,OUI,2025-03-13 08:59:52+00:00,"48.84629899065091, 2.472420372068882",Fontenay-sous-Bois,94033,0.029411764705882353,9
15005,Place Jacques et Thérèse Tréfouël,OUI,42,18,24,18,6,OUI,OUI,2025-03-13 09:01:26+00:00,"48.842726498317, 2.3125657439232",Paris,75056,0.5714285714285714,9
44011,Lebrun - Colonel Fabien,OUI,27,27,0,0,0,OUI,OUI,2025-03-13 09:00:02+00:00,"48.78266870733145, 2.381317801773548",Vitry-sur-Seine,94081,0.0,9
18006,Square Louise Michel,OUI,35,34,1,0,1,OUI,OUI,2025-03-13 09:00:19+00:00,"48.884687354509, 2.3441386967897",Paris,75056,0.02857142857142857,9
21707,Square Etienne Jarousse,OUI,22,19,3,3,0,OUI,OUI,2025-03-13 08:59:15+00:00,"48.82485182597129, 2.2925933450460434",Vanves,92075,0.13636363636363635,9
21401,Mairie de Clamart,OUI,31,27,4,0,4,OUI,OUI,2025-03-13 08:59:08+00:00,"48.800612, 2.262151",Clamart,92023,0.12903225806451613,9
51001,Gare d'Argenteuil,OUI,37,19,18,3,15,OUI,OUI,2025-03-13 08:56:52+00:00,"48.947022436806705, 2.256898172199726",Argenteuil,95018,0.4864864864864865,9
9027,Douai - Pierre Fontaine,OUI,23,20,3,2,1,OUI,OUI,2025-03-13 09:01:22+00:00,"48.88229101148092, 2.33324121683836",Paris,75056,0.13043478260869565,9
8027,Mairie du 8ème,OUI,14,0,14,9,5,OUI,OUI,2025-03-13 08:59:29+00:00,"48.877932, 2.318264",Paris,75056,1.0,9
17108,Bessières - Porte de Clichy,OUI,30,12,18,10,8,OUI,OUI,2025-03-13 09:00:18+00:00,"48.89611762451474, 2.31790903955698",Paris,75056,0.6,9
15039,Abbé Groult - Convention,OUI,12,11,1,0,1,OUI,OUI,2025-03-13 08:57:15+00:00,"48.83596927866069, 2.302064039509349",Paris,75056,0.08333333333333333,9
4020,Place Edmond Michelet,OUI,22,17,5,2,3,OUI,OUI,2025-03-13 08:56:41+00:00,"48.860134890542, 2.3500636965036",Paris,75056,0.22727272727272727,9
15036,Croix Nivert - Square Saint-Lambert,OUI,47,47,0,0,0,NON,NON,2025-03-03 09:03:43+00:00,"48.843051521591, 2.2952004522085",Paris,75056,0.0,9
15022,Emile Zola - Fondary,OUI,41,10,31,27,4,OUI,OUI,2025-03-13 09:00:10+00:00,"48.847051143113745, 2.2953405976295476",Paris,75056,0.7560975609756098,9
6022,Marché Saint-Germain,OUI,18,17,1,0,1,OUI,OUI,2025-03-13 08:59:38+00:00,"48.85165625855281, 2.335500307381153",Paris,75056,0.05555555555555555,9
23004,Paul Vaillant-Couturier - Victor Hugo,OUI,33,8,25,23,2,OUI,OUI,2025-03-13 09:00:05+00:00,"48.89819702263572, 2.293848017974069",Levallois-Perret,92044,0.7575757575757576,9
13018,Bruant - Vincent Auriol,OUI,24,6,18,16,2,OUI,OUI,2025-03-13 09:00:41+00:00,"48.834848452929, 2.3668264996271",Paris,75056,0.75,9
22408,Place du 14 Juillet,OUI,22,22,0,0,0,OUI,OUI,2025-03-13 08:59:59+00:00,"48.819266959525, 2.3011998832226",Malakoff,92046,0.0,9
9007,Condorcet - Turgot,OUI,19,17,2,0,2,OUI,OUI,2025-03-13 08:59:23+00:00,"48.87985155789093, 2.345232367515564",Paris,75056,0.10526315789473684,9
5012,Estrapade - Ulm,OUI,16,9,7,1,6,OUI,OUI,2025-03-13 09:00:27+00:00,"48.84512772828, 2.3454568170362",Paris,75056,0.4375,9
13052,Leredde - Tolbiac,OUI,43,29,14,7,7,OUI,OUI,2025-03-13 09:00:20+00:00,"48.82887629664, 2.3744382709265",Paris,75056,0.32558139534883723,9
8037,Monceau - Malesherbes,OUI,37,28,9,4,5,OUI,OUI,2025-03-13 09:00:12+00:00,"48.8795079, 2.3145456",Paris,75056,0.24324324324324326,9
17024,Villiers - Batignolles,OUI,23,22,1,0,1,OUI,OUI,2025-03-13 09:01:10+00:00,"48.88125253846116, 2.31653843075037",Paris,75056,0.043478260869565216,9
21306,Place Lafayette,OUI,61,4,57,49,8,OUI,OUI,2025-03-13 09:00:41+00:00,"48.829654975522, 2.2638675570488",Issy-les-Moulineaux,92040,0.9344262295081968,9
20105,Benoît Frachon - République,OUI,28,15,13,9,4,OUI,OUI,2025-03-13 08:58:36+00:00,"48.85230729014318, 2.415605485439301",Paris,75056,0.4642857142857143,9
7017,La Motte-Picquet - La Tour Maubourg,OUI,39,21,18,15,3,OUI,OUI,2025-03-13 09:01:20+00:00,"48.856926701847, 2.3096215831203",Paris,75056,0.46153846153846156,9
14032,Mairie du 14ème,OUI,32,28,4,0,4,OUI,OUI,2025-03-13 08:59:55+00:00,"48.83254578123, 2.3254923149943",Paris,75056,0.125,9
41205,Maréchal Joffre - Verdun,OUI,20,20,0,0,0,OUI,OUI,2025-03-13 08:59:30+00:00,"48.85385, 2.470307",Fontenay-sous-Bois,94033,0.0,9
14031,Didot - Place de Moro-Giafferi,OUI,20,18,2,1,1,OUI,OUI,2025-03-13 09:00:25+00:00,"48.8337, 2.3215",Paris,75056,0.1,9
44016,Balzac - Olympes de Gouges,OUI,28,12,16,8,8,OUI,OUI,2025-03-13 08:57:13+00:00,"48.77850332486751, 2.4006786569952965",Vitry-sur-Seine,94081,0.5714285714285714,9
20044,Davout - Volga,OUI,27,25,2,1,1,OUI,OUI,2025-03-13 09:00:08+00:00,"48.852919679957296, 2.410522909779111",Paris,75056,0.07407407407407407,9
44005,Place Saint-Just,OUI,21,15,6,6,0,OUI,OUI,2025-03-13 08:57:51+00:00,"48.790379518724265, 2.3895226791501045",Vitry-sur-Seine,94081,0.2857142857142857,9
2013,Favart - Italiens,OUI,17,1,16,6,10,OUI,OUI,2025-03-13 08:59:39+00:00,"48.871446353921, 2.3382901058508",Paris,75056,0.9411764705882353,9
9004,Gérando - Rochechouart,OUI,21,20,1,0,1,OUI,OUI,2025-03-13 09:01:03+00:00,"48.88294340845, 2.3464846238494",Paris,75056,0.047619047619047616,9
10019,Paradis - Hauteville,OUI,31,0,31,22,9,OUI,OUI,2025-03-13 09:00:48+00:00,"48.874999954666755, 2.3522757401923404",Paris,75056,1.0,9
32601,Porte des Lilas - Faidherbe,OUI,39,38,1,1,0,OUI,OUI,2025-03-13 08:54:42+00:00,"48.87861855668978, 2.4120327830314636",Les Lilas,93045,0.02564102564102564,9
11033,Bréguet - Sabin,OUI,30,7,23,20,3,OUI,OUI,2025-03-13 09:01:24+00:00,"48.856931678257, 2.3706749462105",Paris,75056,0.7666666666666667,9
33016,Fort d'Aubervilliers,OUI,20,12,8,7,1,OUI,OUI,2025-03-13 08:53:40+00:00,"48.91502382370325, 2.4035281687974925",Aubervilliers,93001,0.4,9
12026,Place Ginette Hamelin,OUI,50,24,26,23,3,OUI,OUI,2025-03-13 09:01:14+00:00,"48.837853, 2.382064",Paris,75056,0.52,9
8117,Place de la Madeleine - Royale,OUI,41,0,41,24,17,OUI,OUI,2025-03-13 09:00:35+00:00,"48.869228052648, 2.324421107769",Paris,75056,1.0,9
13009,Auguste Blanqui - Corvisart,OUI,25,11,14,7,7,OUI,OUI,2025-03-13 09:00:08+00:00,"48.8300989, 2.3502726",Paris,75056,0.56,9
10032,Claude Vellefaux - Hôpital Saint-Louis,OUI,31,26,5,4,1,OUI,OUI,2025-03-13 09:01:09+00:00,"48.872859139003, 2.3700717069851",Paris,75056,0.16129032258064516,9
27005,Gare du Stade,OUI,18,12,6,2,4,OUI,OUI,2025-03-13 08:54:00+00:00,"48.9312676, 2.2603778",Colombes,92025,0.3333333333333333,9
12015,Place de la Nation - Picpus,OUI,36,32,4,1,3,OUI,OUI,2025-03-13 08:58:07+00:00,"48.846821681548, 2.4001130461693",Paris,75056,0.1111111111111111,9
15071,Suffren - Champ de Mars,OUI,21,6,15,15,0,OUI,OUI,2025-03-13 08:58:56+00:00,"48.8547194, 2.2952168",Paris,75056,0.7142857142857143,9
18139,Poissonniers - Championnet,OUI,28,26,2,0,2,OUI,OUI,2025-03-13 09:01:12+00:00,"48.89543299733937, 2.3530178144574165",Paris,75056,0.07142857142857142,9
8201,Arsène Houssaye - Friedland,OUI,29,22,7,1,6,OUI,OUI,2025-03-13 08:54:08+00:00,"48.874510616163, 2.2994716674148",Paris,75056,0.2413793103448276,9
1006,Grande Truanderie - Saint-Denis,OUI,28,15,13,10,3,OUI,OUI,2025-03-13 08:57:47+00:00,"48.8626302, 2.3498075",Paris,75056,0.4642857142857143,9
21319,Esplanade du Foncet - Camille Desmoulins,OUI,27,0,27,24,3,OUI,OUI,2025-03-13 09:01:23+00:00,"48.827090233494964, 2.2606857866048813",Issy-les-Moulineaux,92040,1.0,9
15001,Gare Montparnasse - Arrivée,OUI,42,37,5,2,3,OUI,OUI,2025-03-13 09:00:38+00:00,"48.843827994315, 2.3225811123848",Paris,75056,0.11904761904761904,9
9102,Londres - Place d'Estienne d'Orves,OUI,24,0,24,14,10,OUI,OUI,2025-03-13 09:00:02+00:00,"48.876693805756986, 2.3305362090468407",Paris,75056,1.0,9
11112,Jules Vallès - Charonne,OUI,23,16,7,7,0,OUI,OUI,2025-03-13 09:00:30+00:00,"48.854284379935, 2.3847674578428",Paris,75056,0.30434782608695654,9
9006,Dunkerque - Trudaine,OUI,16,16,0,0,0,OUI,OUI,2025-03-13 08:59:10+00:00,"48.88215166773376, 2.3463253676891327",Paris,75056,0.0,9
5007,Ecoles - Carmes,OUI,34,6,28,16,12,OUI,OUI,2025-03-13 08:59:27+00:00,"48.848904447989405, 2.3473486304283147",Paris,75056,0.8235294117647058,9
8116,Champs-Elysees - Bassano,OUI,25,25,0,0,0,NON,NON,2021-02-21 19:09:18+00:00,"48.871811807816, 2.300238981843",Paris,75056,0.0,19
18202,Diane Arbus,OUI,37,36,1,0,1,OUI,OUI,2025-03-13 08:57:40+00:00,"48.898800717199, 2.3524022474885",Paris,75056,0.02702702702702703,9
18030,Joseph Dijon - Ornano,OUI,36,35,1,1,0,OUI,OUI,2025-03-13 08:57:54+00:00,"48.89374453351521, 2.3476678133010864",Paris,75056,0.027777777777777776,9
3008,Perle - Vieille du Temple,OUI,35,1,34,25,9,OUI,OUI,2025-03-13 09:00:32+00:00,"48.8601346, 2.3611206",Paris,75056,0.9714285714285714,9
92006,Place Nelson Mandela,OUI,30,18,12,2,10,OUI,OUI,2025-03-13 09:01:26+00:00,"48.897874318180556, 2.2182820737361912",Nanterre,92050,0.4,9
6010,Chevreuse - Montparnasse,OUI,15,1,14,3,11,OUI,OUI,2025-03-13 08:59:30+00:00,"48.841739161231, 2.3315522167367",Paris,75056,0.9333333333333333,9
5024,Place Monge,OUI,21,15,6,4,2,OUI,OUI,2025-03-13 08:58:27+00:00,"48.842761803051, 2.3524079471827",Paris,75056,0.2857142857142857,9
5015,Epée de Bois - Mouffetard,OUI,63,55,8,4,4,OUI,OUI,2025-03-13 08:57:06+00:00,"48.841508690388835, 2.350066713988781",Paris,75056,0.12698412698412698,9
31005,Square Denise Buisson,OUI,45,41,4,0,4,OUI,OUI,2025-03-13 08:58:03+00:00,"48.8562322730982, 2.426436245441437",Montreuil,93048,0.08888888888888889,9
15128,Cadix - Hameau,OUI,36,30,6,2,4,OUI,OUI,2025-03-13 08:59:32+00:00,"48.8340107632249, 2.289516180753708",Paris,75056,0.16666666666666666,9
12038,Picpus - Louis Braille,OUI,43,43,0,0,0,OUI,OUI,2025-03-13 08:58:01+00:00,"48.839988788912, 2.4005256685521",Paris,75056,0.0,9
44014,Camille Risch - Paul Armangot,OUI,25,14,11,5,6,OUI,OUI,2025-03-13 08:52:26+00:00,"48.774703, 2.373685",Vitry-sur-Seine,94081,0.44,9
12005,Crozatier - Faubourg Saint-Antoine,OUI,41,25,16,12,4,OUI,OUI,2025-03-13 09:01:16+00:00,"48.850440013405, 2.378901366211",Paris,75056,0.3902439024390244,9
1007,Turbigo - Française,OUI,16,4,12,10,2,OUI,OUI,2025-03-13 09:01:20+00:00,"48.86358858111446, 2.3477794602513313",Paris,75056,0.75,9
12155,Rottembourg - Général Michel Bizot,OUI,43,23,20,18,2,OUI,OUI,2025-03-13 09:00:55+00:00,"48.83787825992554, 2.4044052511453633",Paris,75056,0.46511627906976744,9
7012,Cité Vaneau,OUI,24,3,21,12,9,OUI,OUI,2025-03-13 08:59:22+00:00,"48.8542210666207, 2.319614924490452",Paris,75056,0.875,9
12035,Madagascar - Meuniers,OUI,31,30,1,0,1,OUI,OUI,2025-03-13 08:59:08+00:00,"48.83460464474706, 2.3970650508999825",Paris,75056,0.03225806451612903,9
20008,Pyrénées - Avron,OUI,31,28,3,2,1,OUI,OUI,2025-03-13 09:01:26+00:00,"48.853246898211985, 2.405871044529538",Paris,75056,0.0967741935483871,9
10021,Marché Saint-Quentin,OUI,14,13,1,1,0,OUI,OUI,2025-03-13 08:59:12+00:00,"48.877356057652, 2.3545114456374",Paris,75056,0.07142857142857142,9
20104,Louis Lumière.,OUI,22,22,0,0,0,OUI,OUI,2025-03-13 08:55:16+00:00,"48.86216198070008, 2.41112578185621",Paris,75056,0.0,9
2108,Vivienne - Montmartre,OUI,37,2,35,14,21,OUI,OUI,2025-03-13 09:01:20+00:00,"48.871347597383, 2.3414588347077",Paris,75056,0.9459459459459459,9
14135,Jourdan - Cité Universitaire,OUI,39,35,4,4,0,OUI,OUI,2025-03-13 08:59:26+00:00,"48.819897343156676, 2.3397007964124366",Paris,75056,0.10256410256410256,9
12101,Charenton - Prague,OUI,28,3,25,22,3,OUI,OUI,2025-03-13 09:01:09+00:00,"48.848175129981, 2.3763584494312",Paris,75056,0.8928571428571429,9
8110,Gare Saint-Lazare - Stockholm,OUI,29,24,5,4,1,OUI,OUI,2025-03-13 09:00:43+00:00,"48.877127316667654, 2.322417162358761",Paris,75056,0.1724137931034483,9
4019,Cloître Saint-Merri - Renard,OUI,29,2,27,19,8,OUI,OUI,2025-03-13 08:58:34+00:00,"48.858835448898, 2.3518279194832",Paris,75056,0.9310344827586207,9
20024,Gambetta - Père Lachaise,OUI,27,25,2,0,2,OUI,OUI,2025-03-13 08:53:24+00:00,"48.864295696165875, 2.398228667282044",Paris,75056,0.07407407407407407,9
5001,Harpe - Saint-Germain,OUI,43,34,9,5,4,OUI,OUI,2025-03-13 09:00:01+00:00,"48.851518815017, 2.3436703160405",Paris,75056,0.20930232558139536,9
18140,Porte de Clignancourt - Ney,OUI,38,29,9,2,7,OUI,OUI,2025-03-13 09:00:38+00:00,"48.899641123987095, 2.344321422278881",Paris,75056,0.23684210526315788,9
15129,Hôpital Necker,OUI,39,12,27,20,7,OUI,OUI,2025-03-13 09:01:27+00:00,"48.846043490118454, 2.313245013356209",Paris,75056,0.6923076923076923,9
10034,Louis Blanc - La Chapelle,OUI,21,21,0,0,0,OUI,OUI,2025-03-13 09:00:40+00:00,"48.884008964514, 2.3599335551262",Paris,75056,0.0,9
21315,Jules Guesdes - Général de Gaulle,OUI,24,23,1,0,1,OUI,OUI,2025-03-13 08:57:02+00:00,"48.81930581291959, 2.278934195637703",Issy-les-Moulineaux,92040,0.041666666666666664,9
16102,Pergolèse - Marbeau,OUI,26,22,4,1,3,OUI,OUI,2025-03-13 08:59:29+00:00,"48.873568706869, 2.2815125225299",Paris,75056,0.15384615384615385,9
23102,Hôtel de Ville de Sèvres,OUI,31,14,17,14,3,OUI,OUI,2025-03-13 08:59:43+00:00,"48.824363561289, 2.2131047397852",Sèvres,92072,0.5483870967741935,9
4021,Centre Georges Pompidou,OUI,24,7,17,12,5,OUI,OUI,2025-03-13 08:59:41+00:00,"48.861419, 2.352581",Paris,75056,0.7083333333333334,9
15006,Cherche-Midi - Hôpital Necker,OUI,37,27,10,7,3,OUI,OUI,2025-03-13 09:00:41+00:00,"48.84461063309956, 2.317914068698883",Paris,75056,0.2702702702702703,9
19010,Emile Reynaud - Porte de la Villette,OUI,22,18,4,0,4,OUI,OUI,2025-03-13 08:59:16+00:00,"48.90098953630053, 2.3887022584676743",Paris,75056,0.18181818181818182,9
21402,Place Aimé Césaire,OUI,27,23,4,0,4,OUI,OUI,2025-03-13 09:01:27+00:00,"48.783194713067815, 2.2429127991199493",Clamart,92023,0.14814814814814814,9
41405,Place de l'Europe - Alfortville,OUI,24,6,18,16,2,OUI,OUI,2025-03-13 08:59:36+00:00,"48.78913702405837, 2.4284800887107854",Alfortville,94002,0.75,9
41403,Gare RER - Malleret-Joinville,OUI,20,6,14,12,2,OUI,OUI,2025-03-13 08:59:40+00:00,"48.802936, 2.42531",Alfortville,94002,0.7,9
8028,Arsène Houssaye - Champs-Elysées,OUI,28,4,24,3,21,OUI,OUI,2025-03-13 08:57:26+00:00,"48.873409276267, 2.2977904602885",Paris,75056,0.8571428571428571,9
21303,Jean Monnet - Iles,OUI,32,2,30,28,2,OUI,OUI,2025-03-13 09:01:12+00:00,"48.823393984057304, 2.2497073194874866",Issy-les-Moulineaux,92040,0.9375,9
10011,Bourse du Travail,OUI,17,4,13,13,0,OUI,OUI,2025-03-13 08:59:26+00:00,"48.868976638826, 2.3623438552022",Paris,75056,0.7647058823529411,9
33014,Parc Eli Lotar,OUI,19,14,5,4,1,OUI,OUI,2025-03-13 08:58:02+00:00,"48.91844993053703, 2.3727085813879967",Aubervilliers,93001,0.2631578947368421,9
14019,Sarrette - Général Leclerc,OUI,21,20,1,1,0,OUI,OUI,2025-03-13 09:00:56+00:00,"48.825030852925, 2.3264128693982",Paris,75056,0.047619047619047616,9
15127,Place Charles Michels,OUI,35,18,17,13,4,OUI,OUI,2025-03-13 08:58:15+00:00,"48.846401, 2.28502",Paris,75056,0.4857142857142857,9
3011,Turbigo - Réaumur,OUI,31,3,28,22,6,OUI,OUI,2025-03-13 09:00:32+00:00,"48.865574047531, 2.3564198613167",Paris,75056,0.9032258064516129,9
33103,Jean Jaurès - Jules Jacquemin,OUI,22,22,0,0,0,OUI,OUI,2025-03-13 08:54:22+00:00,"48.88433053604843, 2.4082902455152104",Le Pré-Saint-Gervais,93061,0.0,9
31709,Place de la Fraternité,OUI,22,21,1,0,1,OUI,OUI,2025-03-13 08:53:51+00:00,"48.85716405838368, 2.422847449779511",Montreuil,93048,0.045454545454545456,9
14011,Place des Droits de l'Enfant,OUI,39,39,0,0,0,OUI,OUI,2025-03-13 08:57:15+00:00,"48.8274804, 2.3319217",Paris,75056,0.0,9
10027,Dunkerque - Alsace,OUI,20,20,0,0,0,OUI,OUI,2025-03-13 08:58:42+00:00,"48.879355, 2.358379",Paris,75056,0.0,9
41401,Marne - Charles de Gaulle,OUI,26,14,12,12,0,OUI,OUI,2025-03-13 08:59:48+00:00,"48.815071719544434, 2.4121668934822087",Alfortville,94002,0.46153846153846156,9
10006,Petites Ecuries - Faubourg Saint-Denis,OUI,25,4,21,11,10,OUI,OUI,2025-03-13 08:58:32+00:00,"48.87287120589831, 2.3542150855064397",Paris,75056,0.84,9
6002,Saint-Benoît - Jacob,OUI,22,2,20,14,6,OUI,OUI,2025-03-13 08:59:19+00:00,"48.85545136013941, 2.3334722220897675",Paris,75056,0.9090909090909091,9
12002,Lacuée - Lyon,OUI,16,4,12,5,7,OUI,OUI,2025-03-13 08:57:33+00:00,"48.849268481958, 2.3704585433006",Paris,75056,0.75,9
16019,Porte de la Muette,OUI,34,10,24,4,20,OUI,OUI,2025-03-13 08:58:15+00:00,"48.86302317841182, 2.2687188170157406",Paris,75056,0.7058823529411765,9
3001,Beaumarchais - Saint-Gilles,OUI,44,37,7,7,0,OUI,OUI,2025-03-13 09:01:25+00:00,"48.8580378, 2.3679352",Paris,75056,0.1590909090909091,9
33012,Landy - Heurtault,OUI,28,25,3,2,1,OUI,OUI,2025-03-13 09:00:18+00:00,"48.915096534520316, 2.375951372087002",Aubervilliers,93001,0.10714285714285714,9
9037,Parme - Clichy,OUI,24,22,2,0,2,OUI,OUI,2025-03-13 09:01:13+00:00,"48.881266424227, 2.3281970934506",Paris,75056,0.08333333333333333,9
3102,Bourg l'Abbé - Saint-Martin,OUI,35,21,14,10,4,OUI,OUI,2025-03-13 08:59:50+00:00,"48.86393331949257, 2.352406270802021",Paris,75056,0.4,9
21026,Sèvres - Général Leclerc,OUI,29,4,25,14,11,OUI,OUI,2025-03-13 09:01:15+00:00,"48.830121559055, 2.2314262390137",Boulogne-Billancourt,92012,0.8620689655172413,9
41203,Stalingrad - Rigollots,OUI,49,49,0,0,0,OUI,OUI,2025-03-13 09:01:08+00:00,"48.84997403844251, 2.45557576417923",Fontenay-sous-Bois,94033,0.0,9
19129,Solitaires - Place des Fêtes,OUI,29,29,0,0,0,NON,NON,2025-02-23 09:26:05+00:00,"48.876601, 2.391769",Paris,75056,0.0,9
10033,Gare du Nord - Saint-Vincent de Paul,OUI,24,24,0,0,0,OUI,OUI,2025-03-13 08:59:53+00:00,"48.880955741648, 2.3524305148385",Paris,75056,0.0,9
1102,Française - Etienne Marcel,OUI,35,18,17,16,1,OUI,OUI,2025-03-13 09:01:19+00:00,"48.864053304653766, 2.347587011754513",Paris,75056,0.4857142857142857,9
18039,Jardins d'Eole,OUI,19,19,0,0,0,OUI,OUI,2025-03-13 08:58:36+00:00,"48.8869703, 2.3668488",Paris,75056,0.0,9
13017,Nationale - Vincent Auriol,OUI,33,30,3,0,3,OUI,OUI,2025-03-13 08:57:40+00:00,"48.83252708397293, 2.362354410392119",Paris,75056,0.09090909090909091,9
15111,Olivier de Serres - Leriche,OUI,24,16,8,3,5,OUI,OUI,2025-03-13 08:59:45+00:00,"48.83460221715206, 2.2957482933998112",Paris,75056,0.3333333333333333,9
20022,Porte de Bagnolet,OUI,33,32,1,0,1,OUI,OUI,2025-03-13 08:58:23+00:00,"48.864707139122984, 2.408344637349607",Paris,75056,0.030303030303030304,9
2021,Cléry - Montmartre,OUI,58,26,32,19,13,OUI,OUI,2025-03-13 09:01:19+00:00,"48.867458, 2.3445211",Paris,75056,0.5517241379310345,9
12036,Reuilly - Place Felix Eboue,OUI,40,36,4,2,2,OUI,OUI,2025-03-13 09:00:13+00:00,"48.84030274499962, 2.394630398715453",Paris,75056,0.1,9
14132,Bézout - Général Leclerc,OUI,29,27,2,0,2,OUI,OUI,2025-03-13 08:56:30+00:00,"48.82884804502439, 2.3285973072052",Paris,75056,0.06896551724137931,9
14026,Plantes - Moulin Vert,OUI,44,44,0,0,0,OUI,OUI,2025-03-13 08:57:39+00:00,"48.83005755305626, 2.3232302069664006",Paris,75056,0.0,9
3012,Square Emile - Chautemps,OUI,24,1,23,17,6,OUI,OUI,2025-03-13 09:00:03+00:00,"48.867433724231, 2.3536357283592",Paris,75056,0.9583333333333334,9
10008,Cité Riverin - Château d'Eau,OUI,18,6,12,8,4,OUI,OUI,2025-03-13 09:01:14+00:00,"48.870702423554306, 2.358739863900845",Paris,75056,0.6666666666666666,9
2002,Etienne Marcel - Montorgueil,OUI,24,11,13,12,1,OUI,OUI,2025-03-13 09:01:12+00:00,"48.86450567259199, 2.3461959511041637",Paris,75056,0.5416666666666666,9
16012,Flandrin - Longchamp,OUI,40,0,40,17,23,OUI,OUI,2025-03-13 08:59:05+00:00,"48.86877849178477, 2.274354539176829",Paris,75056,1.0,9
31001,Lagny - Auguste Blanqui,OUI,26,0,26,12,14,OUI,OUI,2025-03-13 09:01:15+00:00,"48.84922568052601, 2.4218603968620305",Montreuil,93048,1.0,9
16036,Porte Molitor,OUI,59,9,50,37,13,OUI,OUI,2025-03-13 09:01:00+00:00,"48.84524763511433, 2.2569015249609947",Paris,75056,0.847457627118644,9
22502,Kléber - National,OUI,20,11,9,6,3,OUI,OUI,2025-03-13 08:56:37+00:00,"48.906333898712234, 2.2393910586833954",La Garenne-Colombes,92035,0.45,9
42505,Charles Frérot - Albert Guilpin,OUI,29,22,7,4,3,OUI,OUI,2025-03-13 09:00:12+00:00,"48.8155839183714, 2.3505029082298283",Gentilly,94037,0.2413793103448276,9
3006,Mairie du 3ème,OUI,23,2,21,15,6,OUI,OUI,2025-03-13 08:55:30+00:00,"48.86446178139141, 2.361762821674347",Paris,75056,0.9130434782608695,9
48004,Maxime Gorki - Louis Aragon,OUI,19,12,7,0,7,OUI,OUI,2025-03-13 08:59:44+00:00,"48.78909814728443, 2.368387877941132",Villejuif,94076,0.3684210526315789,9
14001,Edgar Quinet - Gaité,OUI,27,26,1,0,1,OUI,OUI,2025-03-13 09:01:04+00:00,"48.841160928966, 2.324595451355",Paris,75056,0.037037037037037035,9
4015,Mairie du 4ème,OUI,41,29,12,10,2,OUI,OUI,2025-03-13 09:00:21+00:00,"48.855949910497, 2.3563823103905",Paris,75056,0.2926829268292683,9
26004,Gare RER les Grésillons,OUI,22,12,10,8,2,OUI,OUI,2025-03-13 08:59:30+00:00,"48.919898633572764, 2.31458459136273",Asnières-sur-Seine,92004,0.45454545454545453,9
3003,Fille du Calvaire - Turenne,OUI,26,5,21,14,7,OUI,OUI,2025-03-13 08:57:37+00:00,"48.86210505412563, 2.3649600148200993",Paris,75056,0.8076923076923077,9
16042,Murat - Porte de Saint-Cloud,OUI,37,7,30,29,1,OUI,OUI,2025-03-13 09:00:31+00:00,"48.83750862621299, 2.2577651962637906",Paris,75056,0.8108108108108109,9
9111,Victoire - Laffitte,OUI,19,1,18,17,1,OUI,OUI,2025-03-13 08:59:24+00:00,"48.87514373494672, 2.338118505144376",Paris,75056,0.9473684210526315,9
15008,Sèvres - Lecourbe,OUI,61,45,16,15,1,OUI,OUI,2025-03-13 09:01:23+00:00,"48.8447677, 2.3110086",Paris,75056,0.26229508196721313,9
13125,Gare d'Austerlitz - Pont Charles de Gaulle,OUI,55,9,46,25,21,OUI,OUI,2025-03-13 09:01:23+00:00,"48.842319830109, 2.3670300096273",Paris,75056,0.8363636363636363,9
19110,Square Claude Bernard,OUI,29,16,13,7,6,OUI,OUI,2025-03-13 08:59:40+00:00,"48.89876016219984, 2.375325746834278",Paris,75056,0.4482758620689655,9
21110,Parc Roger Salengro,OUI,31,2,29,23,6,OUI,OUI,2025-03-13 09:00:25+00:00,"48.905303858642, 2.31055945158",Clichy,92024,0.9354838709677419,9
22201,Henri Ravera - Gabriel Péri,OUI,27,27,0,0,0,OUI,OUI,2025-03-13 08:55:35+00:00,"48.79722273833844, 2.302115857601166",Bagneux,92007,0.0,9
8036,Lisbonne - Monceau,OUI,46,1,45,15,30,OUI,OUI,2025-03-13 09:01:17+00:00,"48.877455676814, 2.3096942214195",Paris,75056,0.9782608695652174,9
16105,Crevaux - Bugeaud,OUI,31,26,5,2,3,OUI,OUI,2025-03-13 08:54:41+00:00,"48.87080942867, 2.2811490076919",Paris,75056,0.16129032258064516,9
48005,Eugène Varlin - Place de la Paix,OUI,23,21,2,1,1,OUI,OUI,2025-03-13 08:51:47+00:00,"48.792862, 2.363093",Villejuif,94076,0.08695652173913043,9
4006,Bourdon - Pont Morland,OUI,49,26,23,19,4,OUI,OUI,2025-03-13 09:00:25+00:00,"48.8478103, 2.3659356",Paris,75056,0.46938775510204084,9
4012,Tiron - Rivoli,OUI,27,3,24,20,4,OUI,OUI,2025-03-13 09:00:06+00:00,"48.855692253233, 2.3579058051109",Paris,75056,0.8888888888888888,9
45002,Roger Salengro - Général de Gaulle,OUI,27,13,14,4,10,OUI,OUI,2025-03-13 08:58:04+00:00,"48.820029010376956, 2.4846760556101803",Champigny-sur-Marne,94017,0.5185185185185185,9
21215,Verdier - Jean Jaurès,OUI,33,32,1,0,1,OUI,OUI,2025-03-13 08:54:31+00:00,"48.81614048711214, 2.3123561963438988",Montrouge,92049,0.030303030303030304,9
12037,Reuilly - Daumesnil,OUI,36,34,2,0,2,OUI,OUI,2025-03-13 08:59:18+00:00,"48.8395385, 2.3972516",Paris,75056,0.05555555555555555,9
1014,Rivoli - Musée du Louvre,OUI,20,0,20,9,11,OUI,OUI,2025-03-13 09:00:54+00:00,"48.86364636851945, 2.33409583568573",Paris,75056,1.0,9
47003,Charentonneau - Maisons Alfort,OUI,20,16,4,4,0,OUI,OUI,2025-03-13 08:58:45+00:00,"48.809932980484355, 2.443288456496946",Maisons-Alfort,94046,0.2,9
4017,Place de l'Hôtel de Ville,OUI,13,0,13,11,2,OUI,OUI,2025-03-13 09:01:25+00:00,"48.8573314, 2.351458",Paris,75056,1.0,9
18004,Place des Abbesses,OUI,11,9,2,0,2,OUI,OUI,2025-03-13 08:53:32+00:00,"48.884542726149725, 2.3386867716908455",Paris,75056,0.18181818181818182,9
26006,Bas - Gabriel Péri,OUI,30,12,18,17,1,OUI,OUI,2025-03-13 09:01:14+00:00,"48.91585580539625, 2.2948095202445984",Asnières-sur-Seine,92004,0.6,9
16013,Mairie du 16ème,OUI,35,35,0,0,0,OUI,OUI,2025-03-13 08:57:21+00:00,"48.863936848471994, 2.2765953093767166",Paris,75056,0.0,9
3002,Saint-Gilles - Turenne,OUI,15,1,14,10,4,OUI,OUI,2025-03-13 09:00:25+00:00,"48.858158956779, 2.3647149920992",Paris,75056,0.9333333333333333,9
20001,Place de la Nation - Charonne,OUI,35,30,5,1,4,OUI,OUI,2025-03-13 09:01:01+00:00,"48.848364667777, 2.3997623859813",Paris,75056,0.14285714285714285,9
21509,Gardenat Lapostol - Franklin Roosevelt,OUI,24,23,1,0,1,OUI,OUI,2025-03-13 08:54:26+00:00,"48.871839, 2.222505",Suresnes,92073,0.041666666666666664,9
18034,Leibniz - Jean Dollfus,OUI,32,32,0,0,0,OUI,OUI,2025-03-13 08:55:12+00:00,"48.896328348515986, 2.333390423834684",Paris,75056,0.0,9
13054,Pau Casals - Neuve Tolbiac,OUI,53,2,51,20,31,OUI,OUI,2025-03-13 09:01:10+00:00,"48.8311602, 2.3774395",Paris,75056,0.9622641509433962,9
12019,Gare de Reuilly - Picpus,OUI,26,20,6,4,2,OUI,OUI,2025-03-13 08:59:10+00:00,"48.84267354116789, 2.3972943797707558",Paris,75056,0.23076923076923078,9
1012,Jean-Jacques Rousseau - Deux Ecus,OUI,21,0,21,16,5,OUI,OUI,2025-03-13 08:58:55+00:00,"48.86297805972131, 2.3414635285735126",Paris,75056,1.0,9
3010,Beaubourg - Michel-le-Comte,OUI,14,1,13,12,1,OUI,OUI,2025-03-13 08:55:51+00:00,"48.862534941806, 2.3543103039265",Paris,75056,0.9285714285714286,9
19130,Place Paul Delouvrier,OUI,26,23,3,1,2,OUI,OUI,2025-03-13 08:54:45+00:00,"48.89197621431365, 2.3851288855075836",Paris,75056,0.11538461538461539,9
12156,Niger - Soult,OUI,22,18,4,0,4,OUI,OUI,2025-03-13 08:59:42+00:00,"48.84369906369085, 2.410361237220498",Paris,75056,0.18181818181818182,9
21505,Édouard Vaillant - Place Jean Jaurès,OUI,20,19,1,0,1,OUI,OUI,2025-03-13 08:57:06+00:00,"48.86265537999924, 2.2089037319128613",Suresnes,92073,0.05,9
4018,Saint-Bon - Rivoli,OUI,15,1,14,10,4,OUI,OUI,2025-03-13 08:57:10+00:00,"48.857999643315, 2.3502172809763",Paris,75056,0.9333333333333333,9
9009,Square Montholon,OUI,19,11,8,2,6,OUI,OUI,2025-03-13 08:58:20+00:00,"48.876620377545024, 2.3457641154527664",Paris,75056,0.42105263157894735,9
44001,Quai Jules Guesde - Saint-Simon,OUI,30,3,27,27,0,OUI,OUI,2025-03-13 09:00:26+00:00,"48.80391487219, 2.4089661620274",Vitry-sur-Seine,94081,0.9,9
6104,Herschel - Observatoire,OUI,36,1,35,9,26,OUI,OUI,2025-03-13 09:01:24+00:00,"48.84342376221923, 2.3376645147800446",Paris,75056,0.9722222222222222,9
4007,Place de la Bastille - Bourdon,OUI,33,11,22,17,5,OUI,OUI,2025-03-13 09:01:06+00:00,"48.852364355271, 2.3681089282036",Paris,75056,0.6666666666666666,9
21309,Mairie d'Issy,OUI,39,29,10,8,2,OUI,OUI,2025-03-13 09:01:05+00:00,"48.823767792468, 2.2723111510277",Issy-les-Moulineaux,92040,0.2564102564102564,9
10041,Gare du Nord - La Chapelle,OUI,18,18,0,0,0,OUI,OUI,2025-03-13 09:01:01+00:00,"48.884178287286, 2.3561057075858",Paris,75056,0.0,9
20034,Sorbier - Ménilmontant,OUI,24,24,0,0,0,OUI,OUI,2025-03-13 08:58:51+00:00,"48.868542395661, 2.3897721245885",Paris,75056,0.0,9
33020,Waldeck Rochet - Germaine Tillon,OUI,30,6,24,11,13,OUI,OUI,2025-03-13 08:58:13+00:00,"48.91105960199651, 2.3676301538944244",Aubervilliers,93001,0.8,9
13005,Cordelières - Arago,OUI,45,19,26,25,1,OUI,OUI,2025-03-13 08:59:52+00:00,"48.83548071896613, 2.348572461702221",Paris,75056,0.5777777777777777,9
9039,Chaussée d'Antin - Haussmann,OUI,23,4,19,14,5,OUI,OUI,2025-03-13 09:01:08+00:00,"48.87243, 2.33359",Paris,75056,0.8260869565217391,9
19002,Centquatre,OUI,38,24,14,3,11,NON,NON,2025-03-13 09:00:09+00:00,"48.889333538455, 2.3707854375243",Paris,75056,0.3684210526315789,9
2008,Mairie du 2ème,OUI,28,7,21,11,10,OUI,OUI,2025-03-13 09:00:52+00:00,"48.8672190355135, 2.3404625437747044",Paris,75056,0.75,9
17019,Phalsbourg - Villiers,OUI,18,8,10,5,5,OUI,OUI,2025-03-13 08:51:40+00:00,"48.88242307900951, 2.3090453445911407",Paris,75056,0.5555555555555556,9
23101,Grande Rue - Europe,OUI,25,21,4,4,0,OUI,OUI,2025-03-13 09:00:24+00:00,"48.8218104687602, 2.205879874527455",Sèvres,92072,0.16,9
19201,Petit - Georges Thill,OUI,23,21,2,0,2,OUI,OUI,2025-03-13 09:00:25+00:00,"48.88603131999171, 2.3895753175020222",Paris,75056,0.08695652173913043,9
18015,Custine - Ramey,OUI,40,39,1,0,1,OUI,OUI,2025-03-13 08:59:21+00:00,"48.888735896947, 2.3469526693225",Paris,75056,0.025,9
10009,Mairie du 10ème,OUI,18,4,14,11,3,OUI,OUI,2025-03-13 09:00:34+00:00,"48.872089449907, 2.3575825989246",Paris,75056,0.7777777777777778,9
17106,Berthier - Porte de Clichy,OUI,24,12,12,10,2,OUI,OUI,2025-03-13 09:00:05+00:00,"48.894222687781, 2.3125872006816",Paris,75056,0.5,9
22301,Chausson - Gabriel Péri,OUI,20,9,11,11,0,OUI,OUI,2025-03-13 09:01:07+00:00,"48.921891003481115, 2.2952306270599365",Gennevilliers,92036,0.55,9
1116,Ventadour - Opéra,OUI,25,10,15,7,8,OUI,OUI,2025-03-13 09:00:50+00:00,"48.866810653323, 2.3343884482519",Paris,75056,0.6,9
15132,Bargue -  Dutot,OUI,21,17,4,2,2,OUI,OUI,2025-03-13 08:56:22+00:00,"48.837884, 2.308876",Paris,75056,0.19047619047619047,9
1017,Saint-Honoré - 29 juillet,OUI,18,4,14,8,6,OUI,OUI,2025-03-13 09:00:24+00:00,"48.86557114282421, 2.330567417577153",Paris,75056,0.7777777777777778,9
20006,Pyrénées - Plaine,OUI,12,10,2,1,1,OUI,OUI,2025-03-13 09:00:14+00:00,"48.85026702458, 2.4062821269035",Paris,75056,0.16666666666666666,9
15040,Saint-Amand - Labrouste,OUI,34,33,1,0,1,OUI,OUI,2025-03-13 09:01:22+00:00,"48.834097274832295, 2.3087677359581",Paris,75056,0.029411764705882353,9
21953,Gare de Bellevue,OUI,20,16,4,0,4,OUI,OUI,2025-03-13 08:55:31+00:00,"48.8192404685572, 2.2295309230685234",Meudon,92048,0.2,9
23107,Gare de Sèvres - Ville d'Avray,OUI,22,18,4,3,1,OUI,OUI,2025-03-13 08:53:28+00:00,"48.826262366227, 2.2001516849313",Sèvres,92072,0.18181818181818182,9
14137,Maurice d'Ocagne - General Maudhuy,OUI,28,26,2,0,2,OUI,OUI,2025-03-13 08:53:16+00:00,"48.82414282524159, 2.3158789426088333",Paris,75056,0.07142857142857142,9
6201,Saint Pères - Saint Germain,OUI,22,1,21,10,11,OUI,OUI,2025-03-13 09:00:07+00:00,"48.853729675265, 2.3300181032703",Paris,75056,0.9545454545454546,9
22401,Charles de Gaulle - Plateau de Vanves,OUI,32,20,12,7,5,OUI,OUI,2025-03-13 09:00:16+00:00,"48.82233088973263, 2.298571803412886",Malakoff,92046,0.375,9
22601,Marx Dormoy - Château Sainte-Barbe,OUI,20,19,1,0,1,OUI,OUI,2025-03-13 09:01:24+00:00,"48.791782341055324, 2.297856844961643",Fontenay-aux-Roses,92032,0.05,9
21506,Maurice Payret-Dortail,OUI,22,18,4,1,3,OUI,OUI,2025-03-13 08:59:57+00:00,"48.87811957063342, 2.2233625128865246",Suresnes,92073,0.18181818181818182,9
19202,Marseillaise - Grenade,OUI,43,43,0,0,0,OUI,OUI,2025-03-13 09:00:07+00:00,"48.889371092747, 2.3979396821544",Paris,75056,0.0,9
4103,Archives - Rivoli,OUI,18,3,15,7,8,OUI,OUI,2025-03-13 08:59:00+00:00,"48.857346707443, 2.3539767041802",Paris,75056,0.8333333333333334,9
14103,Maine - Liancourt,OUI,25,23,2,0,2,OUI,OUI,2025-03-13 09:00:45+00:00,"48.835064363954, 2.323731449974",Paris,75056,0.08,9
28005,Jean Jaurès - Paul Lafargue,OUI,25,3,22,7,15,OUI,OUI,2025-03-13 08:58:59+00:00,"48.884933177666, 2.2484488785267",Puteaux,92062,0.88,9
7021,Bosquet - Saint-Dominique,OUI,28,7,21,16,5,OUI,OUI,2025-03-13 09:00:06+00:00,"48.858651709526, 2.3037165802346",Paris,75056,0.75,9
35005,Quai de l'Aisne - Général Leclerc,OUI,25,18,7,0,7,OUI,OUI,2025-03-13 08:58:48+00:00,"48.895713, 2.400571",Pantin,93055,0.28,9
2015,Louis le Grand - Italiens,OUI,33,5,28,13,15,OUI,OUI,2025-03-13 09:01:14+00:00,"48.870508937204, 2.3340544619393",Paris,75056,0.8484848484848485,9
16139,Suresnes - Muette à Neuilly,OUI,26,21,5,3,2,OUI,OUI,2025-03-13 09:00:10+00:00,"48.868570404348, 2.266000919044",Paris,75056,0.19230769230769232,9
32013,Saint-Denis - Université,OUI,19,6,13,4,9,OUI,OUI,2025-03-13 09:01:21+00:00,"48.94563430946964, 2.3638297989964485",Saint-Denis,93066,0.6842105263157895,9
42028,Verdun - Carnot,OUI,28,26,2,1,1,OUI,OUI,2025-03-13 08:58:59+00:00,"48.808439376064946, 2.373795211315155",Ivry-sur-Seine,94041,0.07142857142857142,9
20029,Frères Flavien - Porte des Lilas,OUI,23,23,0,0,0,OUI,OUI,2025-03-13 08:54:45+00:00,"48.8780992764359, 2.41104629853209",Paris,75056,0.0,9
12113,Cardinal Lavigerie,OUI,46,10,36,30,6,OUI,OUI,2025-03-13 09:01:00+00:00,"48.832934193699835, 2.402636749399156",Paris,75056,0.782608695652174,9
2003,Saint-Denis - Réaumur,OUI,31,21,10,6,4,OUI,OUI,2025-03-13 09:00:23+00:00,"48.8661116315789, 2.3507790675507594",Paris,75056,0.3225806451612903,9
16010,Belles Feuilles - Place de Mexico,OUI,22,13,9,1,8,OUI,OUI,2025-03-13 08:57:49+00:00,"48.865804746474, 2.2829206287861",Paris,75056,0.4090909090909091,9
22503,Joffre - Aigle,OUI,19,14,5,2,3,OUI,OUI,2025-03-13 08:57:30+00:00,"48.904033, 2.245096",La Garenne-Colombes,92035,0.2631578947368421,9
12020,Cours de Vincennes - Soult,OUI,44,36,8,5,3,OUI,OUI,2025-03-13 09:01:07+00:00,"48.846918761569, 2.4105220288038",Paris,75056,0.18181818181818182,9
32020,Jules Guesdes - Carnot,OUI,14,14,0,0,0,OUI,OUI,2025-03-13 08:53:22+00:00,"48.93828169931872, 2.3508992046117783",Saint-Denis,93066,0.0,9
24006,Adolphe Lalyre - Armand Silvestre,OUI,39,32,7,1,6,OUI,OUI,2025-03-13 08:59:51+00:00,"48.90406266961591, 2.273416221141815",Courbevoie,92026,0.1794871794871795,9
27006,Victor Hugo - Gare,OUI,19,16,3,2,1,OUI,OUI,2025-03-13 08:54:46+00:00,"48.923133952658, 2.2600970417261",Colombes,92025,0.15789473684210525,9
3009,Temple - Haudriettes,OUI,19,2,17,13,4,OUI,OUI,2025-03-13 08:59:27+00:00,"48.861636880212, 2.3566960206458",Paris,75056,0.8947368421052632,9
1015,Place André Malraux,OUI,16,2,14,11,3,OUI,OUI,2025-03-13 09:00:48+00:00,"48.863925158727, 2.3356226831675",Paris,75056,0.875,9
4014,Blancs-Manteaux - Archives,OUI,28,3,25,22,3,OUI,OUI,2025-03-13 09:01:11+00:00,"48.85941800703, 2.3559471219778",Paris,75056,0.8928571428571429,9
44004,Place de l'Eglise - Vitry-sur-Seine,OUI,28,5,23,22,1,OUI,OUI,2025-03-13 09:00:11+00:00,"48.791922819921815, 2.395057752728462",Vitry-sur-Seine,94081,0.8214285714285714,9
2005,Montmartre - Etienne Marcel,OUI,15,6,9,6,3,OUI,OUI,2025-03-13 09:01:18+00:00,"48.86502194581, 2.3450684401448",Paris,75056,0.6,9
19046,Porte de Pantin.,OUI,33,28,5,1,4,OUI,OUI,2025-03-13 09:00:26+00:00,"48.889199725577, 2.3950181901455",Paris,75056,0.15151515151515152,9
23702,Hôtel de Ville de Chaville,OUI,20,19,1,0,1,OUI,OUI,2025-03-13 08:55:45+00:00,"48.80887149094033, 2.188134044408798",Chaville,92022,0.05,9
14022,Didot - Mariniers,OUI,35,33,2,0,2,OUI,OUI,2025-03-13 08:59:48+00:00,"48.82650543613106, 2.313136198271666",Paris,75056,0.05714285714285714,9
23301,Les Blagis,OUI,24,10,14,11,3,OUI,OUI,2025-03-13 09:01:18+00:00,"48.785205, 2.302526",Sceaux,92071,0.5833333333333334,9
19012,Lally-Tollendal - Armand Carrel,OUI,27,26,1,1,0,OUI,OUI,2025-03-13 08:59:06+00:00,"48.88270066221072, 2.374717555940151",Paris,75056,0.037037037037037035,9
42210,Victor Hugo - Paul Eluard,OUI,31,3,28,26,2,OUI,OUI,2025-03-13 09:00:18+00:00,"48.819602554907, 2.4114319673051",Charenton-le-Pont,94018,0.9032258064516129,9
21507,Gardenat-Lapostol - Velettes,OUI,20,14,6,1,5,OUI,OUI,2025-03-13 08:52:28+00:00,"48.87387, 2.224185",Suresnes,92073,0.3,9
34013,Blanqui - Docteur Bauer,OUI,21,7,14,7,7,OUI,OUI,2025-03-13 09:00:13+00:00,"48.907735489085, 2.3407192814591",Saint-Ouen-sur-Seine,93070,0.6666666666666666,9
22306,Place du 17 Octobre,OUI,16,10,6,2,4,OUI,OUI,2025-03-13 08:56:56+00:00,"48.91962690034779, 2.2978286134199792",Gennevilliers,92036,0.375,9
44008,Youri Gagarine - Commune de Paris,OUI,32,9,23,11,12,OUI,OUI,2025-03-13 08:59:54+00:00,"48.782427463041, 2.3939734697342",Vitry-sur-Seine,94081,0.71875,9
14023,Adolphe Pinard - Victor Hugo,OUI,51,50,1,0,1,OUI,OUI,2025-03-13 08:51:42+00:00,"48.8236825874564, 2.3077843710780144",Malakoff,92046,0.0196078431372549,9
23104,Quai de Sèvres - Manufacture Nationale,OUI,26,14,12,6,6,OUI,OUI,2025-03-13 09:01:23+00:00,"48.828688, 2.22499",Sèvres,92072,0.46153846153846156,9
19111,Cesaria Evora - Rosa Parks,OUI,35,28,7,5,2,OUI,OUI,2025-03-13 08:53:51+00:00,"48.89717672825043, 2.3745173960924144",Paris,75056,0.2,9
21011,Silly - Louis Blériot,OUI,23,4,19,6,13,OUI,OUI,2025-03-13 09:00:22+00:00,"48.83219045374266, 2.2340199351310734",Boulogne-Billancourt,92012,0.8260869565217391,9
5122,Saint-Michel - Luxembourg,OUI,27,0,27,10,17,OUI,OUI,2025-03-13 09:01:06+00:00,"48.84501507626, 2.3394941166043",Paris,75056,1.0,9
20140,Paganini - Davout,OUI,20,15,5,4,1,OUI,OUI,2025-03-13 09:00:33+00:00,"48.85135, 2.412021",Paris,75056,0.25,9
6031,Pierre Sarrazin - Saint-Michel,OUI,31,3,28,21,7,OUI,OUI,2025-03-13 09:01:20+00:00,"48.850908146398, 2.342130728066",Paris,75056,0.9032258064516129,9
23303,Gare de Robinson,OUI,29,29,0,0,0,OUI,OUI,2025-03-13 08:52:21+00:00,"48.7799259211605, 2.281828634440899",Sceaux,92071,0.0,9
14133,Froidevaux - Boulard,OUI,35,35,0,0,0,OUI,OUI,2025-03-13 09:00:20+00:00,"48.835147319625, 2.3294411972165",Paris,75056,0.0,9
42022,Gare RER - Maurice Grandcoing,OUI,36,0,36,34,2,OUI,OUI,2025-03-13 08:59:14+00:00,"48.813881, 2.392429",Ivry-sur-Seine,94041,1.0,9
41208,Alouettes - Maréchal de Lattre de Tassigny,OUI,21,13,8,1,7,OUI,OUI,2025-03-13 09:00:21+00:00,"48.85511009293948, 2.4930700287222862",Fontenay-sous-Bois,94033,0.38095238095238093,9
20048,Bagnolet - Place Saint-Blaise,OUI,27,27,0,0,0,OUI,OUI,2025-03-13 08:58:47+00:00,"48.85973, 2.40334",Paris,75056,0.0,9
42704,Mairie du Kremlin-Bicêtre,OUI,25,25,0,0,0,OUI,OUI,2025-03-13 08:57:55+00:00,"48.81191981537702, 2.3570189997553825",Le Kremlin-Bicêtre,94043,0.0,9
45004,République - Louis Loucheur,OUI,37,4,33,5,28,OUI,OUI,2025-03-13 09:00:35+00:00,"48.823549261189, 2.5101865455508",Champigny-sur-Marne,94017,0.8918918918918919,9
21706,Jean Bleuzen - Square du 11 Novembre,OUI,45,33,12,9,3,OUI,OUI,2025-03-13 08:59:33+00:00,"48.8232579, 2.2965213",Vanves,92075,0.26666666666666666,9
23202,Henri Barbusse - Gabriel Péri,OUI,14,14,0,0,0,OUI,OUI,2025-03-13 09:00:30+00:00,"48.801773795836, 2.2874166362216",Châtillon,92020,0.0,9
42211,Séminaire de Conflans - Liberté,OUI,24,2,22,10,12,OUI,OUI,2025-03-13 09:01:23+00:00,"48.823194, 2.404179",Charenton-le-Pont,94018,0.9166666666666666,9
13049,Vincent Auriol - Louise Weiss,OUI,22,2,20,13,7,OUI,OUI,2025-03-13 08:59:49+00:00,"48.834001935501, 2.3703888058662",Paris,75056,0.9090909090909091,9
42026,Barbès - Monique Maunoury,OUI,40,38,2,0,2,OUI,OUI,2025-03-13 08:59:39+00:00,"48.81552718820216, 2.3687169334905405",Ivry-sur-Seine,94041,0.05,9
6015,André Mazet - Saint-André des Arts,OUI,55,9,46,41,5,OUI,OUI,2025-03-13 09:01:22+00:00,"48.85375581057431, 2.3390958085656166",Paris,75056,0.8363636363636363,9
2012,Choiseul - Quatre Septembre,OUI,44,12,32,10,22,OUI,OUI,2025-03-13 09:00:29+00:00,"48.8699355331869, 2.3359975218772893",Paris,75056,0.7272727272727273,9
32605,Mairie,OUI,19,19,0,0,0,OUI,OUI,2025-03-13 09:01:11+00:00,"48.87914304162, 2.4163350908311",Les Lilas,93045,0.0,9
12163,Hippodrome Paris-Vincennes,OUI,42,40,2,1,1,OUI,OUI,2025-03-13 08:52:46+00:00,"48.82048387758518, 2.446271181106568",Paris,75056,0.047619047619047616,9
17202,Mariotte - Batignolles,OUI,18,15,3,0,3,OUI,OUI,2025-03-13 08:59:29+00:00,"48.884571659595, 2.321469503475",Paris,75056,0.16666666666666666,9
2004,Square Pierre Lazareff,OUI,17,2,15,7,8,OUI,OUI,2025-03-13 09:00:46+00:00,"48.867141720746, 2.3483933508396",Paris,75056,0.8823529411764706,9
17020,Jouffroy d'Abbans - Malesherbes,OUI,26,15,11,6,5,OUI,OUI,2025-03-13 09:00:31+00:00,"48.8850134, 2.3070717",Paris,75056,0.4230769230769231,9
35012,Candale - Mehul,OUI,25,22,3,0,3,OUI,OUI,2025-03-13 08:55:35+00:00,"48.8893935006175, 2.414379715919495",Pantin,93055,0.12,9
23206,Béranger - Félix Faure,OUI,26,26,0,0,0,OUI,OUI,2025-03-13 08:51:38+00:00,"48.80404828621485, 2.2848263373723436",Châtillon,92020,0.0,9
2016,Aboukir - Alexandrie,OUI,20,3,17,17,0,OUI,OUI,2025-03-13 09:01:22+00:00,"48.86868344444473, 2.3502043269474897",Paris,75056,0.85,9
8040,Pierre Charron - Champs-Elysées,OUI,30,0,30,14,16,OUI,OUI,2025-03-13 08:59:27+00:00,"48.870103359864, 2.3043501377106",Paris,75056,1.0,9
16044,Porte de Saint Cloud - Parc des Princes,OUI,31,22,9,7,2,OUI,OUI,2025-03-13 08:58:14+00:00,"48.838662757066, 2.2525164484978",Paris,75056,0.2903225806451613,9
8018,Saint-Augustin,OUI,28,0,28,11,17,OUI,OUI,2025-03-13 09:01:02+00:00,"48.8762009747008, 2.319786250591278",Paris,75056,1.0,9
5004,Saint-Jacques - Val de Grâce,OUI,18,4,14,4,10,OUI,OUI,2025-03-13 09:00:39+00:00,"48.8417514, 2.3413893",Paris,75056,0.7777777777777778,9
4009,Village Saint-Paul,OUI,27,5,22,17,5,OUI,OUI,2025-03-13 09:00:14+00:00,"48.852639866625, 2.3607301712036",Paris,75056,0.8148148148148148,9
20142,Mûriers - Père Lachaise,OUI,19,19,0,0,0,OUI,OUI,2025-03-13 08:53:57+00:00,"48.864130509668044, 2.39164982067019",Paris,75056,0.0,9
4101,Bastille - Beaumarchais,OUI,20,1,19,18,1,OUI,OUI,2025-03-13 09:00:14+00:00,"48.853833463852, 2.3685702681541",Paris,75056,0.95,9
48001,Chastenet de Géry - Marcel Paul,OUI,25,24,1,0,1,OUI,OUI,2025-03-13 08:56:56+00:00,"48.800123, 2.3567359",Villejuif,94076,0.04,9
32019,Place du 8 mai 1945.,OUI,28,23,5,4,1,OUI,OUI,2025-03-13 08:59:33+00:00,"48.938882272105, 2.3566243797541",Saint-Denis,93066,0.17857142857142858,9
51008,Martyrs de Châteaubriant - Jean Grandel,OUI,38,26,12,1,11,OUI,OUI,2025-03-13 08:54:25+00:00,"48.951432, 2.211214",Argenteuil,95018,0.3157894736842105,9
22506,Gare des Vallées,OUI,18,13,5,5,0,OUI,OUI,2025-03-13 08:55:00+00:00,"48.913179, 2.257726",La Garenne-Colombes,92035,0.2777777777777778,9
24101,Place Charles de Gaulle,OUI,24,22,2,0,2,OUI,OUI,2025-03-13 09:01:13+00:00,"48.826073335699, 2.1894485725692",Ville-d'Avray,92077,0.08333333333333333,9
1025,Oratoire - Rivoli,OUI,17,0,17,12,5,OUI,OUI,2025-03-13 09:01:25+00:00,"48.861342760889, 2.3400047421455",Paris,75056,1.0,9
21704,Place du Maréchal de Lattre de Tassigny,OUI,26,23,3,1,2,OUI,OUI,2025-03-13 08:55:27+00:00,"48.821707715257055, 2.2853431485432423",Vanves,92075,0.11538461538461539,9
1018,Alger - Rivoli,OUI,14,1,13,9,4,OUI,OUI,2025-03-13 08:53:29+00:00,"48.864773553495, 2.3294493936128",Paris,75056,0.9285714285714286,9
19121,Belleville -  Pré Saint-Gervais,OUI,21,19,2,0,2,OUI,OUI,2025-03-13 08:56:05+00:00,"48.875565910073, 2.3930460959673",Paris,75056,0.09523809523809523,9
1026,Place du Lieutenant Henri Karcher,OUI,29,6,23,19,4,OUI,OUI,2025-03-13 09:00:38+00:00,"48.863490871724466, 2.3400671035051346",Paris,75056,0.7931034482758621,9
25007,Bons Raisins - Voltaire,OUI,24,21,3,0,3,OUI,OUI,2025-03-13 08:58:34+00:00,"48.87282451461399, 2.1947155570850896",Rueil-Malmaison,92063,0.125,9
32024,Port - Confluence,OUI,22,15,7,4,3,OUI,OUI,2025-03-13 08:48:04+00:00,"48.936093926526, 2.3436167797955",Saint-Denis,93066,0.3181818181818182,9
13024,Bobillot - Tolbiac,OUI,33,25,8,7,1,OUI,OUI,2025-03-13 09:01:04+00:00,"48.8255961335041, 2.350204177200794",Paris,75056,0.24242424242424243,9
6026,Saint-Placide - Cherche Midi,OUI,66,49,17,6,11,OUI,OUI,2025-03-13 09:00:42+00:00,"48.8490535919234, 2.325317971408367",Paris,75056,0.25757575757575757,9
24004,Paix - Verdun,OUI,33,28,5,2,3,OUI,OUI,2025-03-13 08:52:19+00:00,"48.900504, 2.261173",Courbevoie,92026,0.15151515151515152,9
42018,Amédée Huon - Fort d'Ivry,OUI,30,26,4,4,0,OUI,OUI,2025-03-13 08:58:23+00:00,"48.805131376899986, 2.388489693403244",Ivry-sur-Seine,94041,0.13333333333333333,9
24005,Edith Cavell - Volta,OUI,32,29,3,0,3,OUI,OUI,2025-03-13 09:01:14+00:00,"48.901616564286975, 2.269354350864887",Courbevoie,92026,0.09375,9
12164,Stade Pershing,OUI,26,26,0,0,0,NON,NON,2025-02-26 05:58:32+00:00,"48.829107826857, 2.4583535268903",Paris,75056,0.0,6
31104,Mairie de Rosny-sous-Bois,OUI,26,10,16,10,6,OUI,OUI,2025-03-13 08:59:05+00:00,"48.871256519012, 2.4865807592869",Rosny-sous-Bois,93064,0.6153846153846154,9
1023,Saint-Honoré - Musée du Louvre,OUI,21,3,18,8,10,OUI,OUI,2025-03-13 09:00:37+00:00,"48.863443132848, 2.3348781846405",Paris,75056,0.8571428571428571,9
42024,Danielle Casanova - Ledru-Rollin,OUI,28,10,18,17,1,OUI,OUI,2025-03-13 09:00:58+00:00,"48.815783497876815, 2.383259721100331",Ivry-sur-Seine,94041,0.6428571428571429,9
48008,Guy Môquet - Parvis Georges Marchais,OUI,30,30,0,0,0,OUI,OUI,2025-03-13 08:59:54+00:00,"48.79518840095975, 2.35943466424942",Villejuif,94076,0.0,9
15203,Porte de Versailles,OUI,27,14,13,7,6,OUI,OUI,2025-03-13 08:59:05+00:00,"48.832324016657, 2.2875617349045",Paris,75056,0.48148148148148145,9
14201,Decrès - Alésia,OUI,30,30,0,0,0,OUI,OUI,2025-03-13 08:51:46+00:00,"48.832200060759, 2.3139070151575",Paris,75056,0.0,9
13116,Place du Docteur Yersin,OUI,50,43,7,5,2,OUI,OUI,2025-03-13 08:59:00+00:00,"48.82010494991975, 2.3725583776831627",Paris,75056,0.14,9
5003,Le Goff - Gay-Lussac,OUI,34,25,9,2,7,OUI,OUI,2025-03-13 08:55:12+00:00,"48.846102400979, 2.3412207886577",Paris,75056,0.2647058823529412,9
15012,Cambronne - Mademoiselle,OUI,66,61,5,4,1,OUI,OUI,2025-03-13 08:55:53+00:00,"48.843277330035214, 2.30230766886348",Paris,75056,0.07575757575757576,9
27001,Square Victor Basch,OUI,19,2,17,10,7,OUI,OUI,2025-03-13 08:59:49+00:00,"48.914304862261, 2.2289156913757",Colombes,92025,0.8947368421052632,9
18016,Francoeur - Caulaincourt,OUI,33,31,2,0,2,OUI,OUI,2025-03-13 09:01:27+00:00,"48.8899944409612, 2.342529706656933",Paris,75056,0.06060606060606061,9
17021,Jouffroy d'Abbans - Villiers,OUI,31,3,28,18,10,OUI,OUI,2025-03-13 08:59:30+00:00,"48.884215547037, 2.3056533560157",Paris,75056,0.9032258064516129,9
19117,Euryale Dehaynin - Loire,OUI,29,28,1,0,1,OUI,OUI,2025-03-13 08:59:53+00:00,"48.886248917304805, 2.3774591088294987",Paris,75056,0.034482758620689655,9
3007,Archives - Pastourelle,OUI,26,7,19,14,5,OUI,OUI,2025-03-13 09:00:22+00:00,"48.8623615, 2.3595041",Paris,75056,0.7307692307692307,9
20003,Pyrénées - Cours de Vincennes,OUI,19,10,9,2,7,OUI,OUI,2025-03-13 09:00:33+00:00,"48.847796779935, 2.4061721563339",Paris,75056,0.47368421052631576,9
31020,Résistance - Parmentier,OUI,32,29,3,2,1,OUI,OUI,2025-03-13 08:56:45+00:00,"48.85965138131299, 2.436705082654953",Montreuil,93048,0.09375,9
15041,Franquet - Labrouste,OUI,37,36,1,0,1,OUI,OUI,2025-03-13 08:56:20+00:00,"48.83287705011431, 2.306762784719467",Paris,75056,0.02702702702702703,9
18112,Arthur Ranc - Hôpital Bichat,OUI,23,15,8,6,2,OUI,OUI,2025-03-13 08:53:06+00:00,"48.8978712500682, 2.333521842956543",Paris,75056,0.34782608695652173,9
10003,Hauteville - Bonne Nouvelle,OUI,17,5,12,1,11,OUI,OUI,2025-03-13 09:01:23+00:00,"48.87077436024, 2.3496496368327",Paris,75056,0.7058823529411765,9
6007,Bréa - Raspail,OUI,24,15,9,1,8,OUI,OUI,2025-03-13 09:00:50+00:00,"48.842738478258, 2.3297942217634",Paris,75056,0.375,9
41103,Place de la vache noire,OUI,23,18,5,0,5,OUI,OUI,2025-03-13 08:58:52+00:00,"48.81040517059777, 2.327060401439667",Arcueil,94003,0.21739130434782608,9
12166,Parc Floral du Bel Air,OUI,23,12,11,6,5,OUI,OUI,2025-03-13 08:58:34+00:00,"48.839285711865735, 2.438560165464878",Paris,75056,0.4782608695652174,9
20012,Buzenval - Vignoles,OUI,17,17,0,0,0,OUI,OUI,2025-03-13 08:55:51+00:00,"48.853858171688, 2.4000040814281",Paris,75056,0.0,9
22603,Place de la Division Leclerc,OUI,33,31,2,0,2,OUI,OUI,2025-03-13 08:58:10+00:00,"48.793824988636516, 2.2731140430551027",Fontenay-aux-Roses,92032,0.06060606060606061,9
42303,Place Eustache Deschamps,OUI,20,14,6,3,3,OUI,OUI,2025-03-13 08:55:08+00:00,"48.793855, 2.336637",Cachan,94016,0.3,9
21119,Belfort - Victor Hugo,OUI,21,4,17,13,4,OUI,OUI,2025-03-13 09:01:25+00:00,"48.9018492, 2.3172724",Clichy,92024,0.8095238095238095,9
41605,Général De Gaulle - Vivien,OUI,21,20,1,1,0,OUI,OUI,2025-03-13 09:00:17+00:00,"48.83607420090204, 2.4189166724681854",Saint-Mandé,94067,0.047619047619047616,9
16201,Porte Dauphine,OUI,60,28,32,11,21,OUI,OUI,2025-03-13 08:58:32+00:00,"48.871139344351, 2.2749781616017",Paris,75056,0.5333333333333333,9
30003,Moscou - Edouard Vaillant,OUI,29,20,9,3,6,OUI,OUI,2025-03-13 08:59:32+00:00,"48.90755810177, 2.4689837335263",Bobigny,93008,0.3103448275862069,9
23042,André Theuriet - Blagis,OUI,30,18,12,8,4,OUI,OUI,2025-03-13 09:00:09+00:00,"48.77977325745441, 2.3130525648593903",Bourg-la-Reine,92014,0.4,9
35013,Guillaume Tell - Parc Henri Barbusse,OUI,20,15,5,1,4,OUI,OUI,2025-03-13 08:54:39+00:00,"48.88958925894009, 2.4198862910270695",Pantin,93055,0.25,9
42019,Lampes,OUI,42,4,38,36,2,OUI,OUI,2025-03-13 09:01:20+00:00,"48.81152481985875, 2.4017931148409843",Ivry-sur-Seine,94041,0.9047619047619048,9
13120,Pierre Joseph Desault,OUI,18,5,13,10,3,OUI,OUI,2025-03-13 08:59:32+00:00,"48.82110230800372, 2.378775402903557",Paris,75056,0.7222222222222222,9
1008,Les Halles - Saint-Eustache,OUI,32,17,15,4,11,OUI,OUI,2025-03-13 09:01:21+00:00,"48.86362695901683, 2.342623919248581",Paris,75056,0.46875,9
15024,Suffren - La Motte-Piquet,OUI,22,0,22,13,9,OUI,OUI,2025-03-13 09:01:26+00:00,"48.850881230919, 2.3012199997902",Paris,75056,1.0,9
2006,Place des Victoires,OUI,23,0,23,14,9,OUI,OUI,2025-03-13 08:59:12+00:00,"48.8660354, 2.3420333",Paris,75056,1.0,9
12119,Dom-Pérignon - Gravelle,OUI,46,26,20,18,2,OUI,OUI,2025-03-13 08:59:09+00:00,"48.825481574435, 2.409880310297",Paris,75056,0.43478260869565216,9
9019,Victor Massé - Jean-Baptiste Pigalle,OUI,18,17,1,0,1,OUI,OUI,2025-03-13 08:56:46+00:00,"48.8811043724, 2.3366955667734",Paris,75056,0.05555555555555555,9
16025,Jean de la Fontaine - Boulainvilliers,OUI,66,4,62,46,16,OUI,OUI,2025-03-13 09:00:59+00:00,"48.85264791461651, 2.2758664190769196",Paris,75056,0.9393939393939394,9
1024,Coquillière - Louvre,OUI,17,1,16,7,9,OUI,OUI,2025-03-13 09:01:20+00:00,"48.863795909662, 2.3425736278296",Paris,75056,0.9411764705882353,9
13036,Olympiades,OUI,36,30,6,3,3,OUI,OUI,2025-03-13 08:58:21+00:00,"48.826764665199, 2.3650860786438",Paris,75056,0.16666666666666666,9
2102,Saint-Marc - Feydeau,OUI,36,10,26,13,13,OUI,OUI,2025-03-13 09:00:30+00:00,"48.870326843044, 2.3418715826353",Paris,75056,0.7222222222222222,9
43004,Montreuil - République,OUI,23,17,6,2,4,OUI,OUI,2025-03-13 08:58:58+00:00,"48.85026349463687, 2.4345204234123234",Vincennes,94080,0.2608695652173913,9
2020,Danielle Casanova - Opéra,OUI,20,3,17,6,11,OUI,OUI,2025-03-13 09:00:50+00:00,"48.867643242297, 2.3333894088864",Paris,75056,0.85,9
14009,Tombe Issoire - René Coty,OUI,35,34,1,0,1,OUI,OUI,2025-03-13 08:58:26+00:00,"48.830512876709, 2.3343613743782",Paris,75056,0.02857142857142857,9
10201,Magenta - Chabrol,OUI,23,20,3,2,1,OUI,OUI,2025-03-13 08:59:13+00:00,"48.876495350882, 2.3560990020633",Paris,75056,0.13043478260869565,9
20013,Alexandre Dumas - Place de la Réunion,OUI,45,43,2,1,1,OUI,OUI,2025-03-13 09:01:21+00:00,"48.85533710742046, 2.3997703687646292",Paris,75056,0.044444444444444446,9
6029,Vaugirard - Monsieur le Prince,OUI,24,2,22,10,12,OUI,OUI,2025-03-13 09:01:06+00:00,"48.848951441614, 2.3411329463124",Paris,75056,0.9166666666666666,9
5033,Saint-Séverin - Saint-Michel,OUI,30,7,23,19,4,OUI,OUI,2025-03-13 09:00:53+00:00,"48.852731305488, 2.3440927639604",Paris,75056,0.7666666666666667,9
12016,Saint-Mande - Picpus,OUI,34,29,5,2,3,OUI,OUI,2025-03-13 08:59:38+00:00,"48.845127728278, 2.4015686296482",Paris,75056,0.14705882352941177,9
15045,Porte de la Plaine,OUI,35,30,5,5,0,OUI,OUI,2025-03-13 08:59:17+00:00,"48.82805169605981, 2.2924277186393742",Paris,75056,0.14285714285714285,9
48012,Stalingrad - Henri Luisette,OUI,26,25,1,0,1,OUI,OUI,2025-03-13 08:59:24+00:00,"48.78363092456589, 2.366935946761926",Villejuif,94076,0.038461538461538464,9
12022,Sahel - Général Michel Bizot,OUI,30,26,4,4,0,OUI,OUI,2025-03-13 08:58:36+00:00,"48.840872964793355, 2.4044444784522057",Paris,75056,0.13333333333333333,9
20010,Sorbier - Gasnier-Guy,OUI,34,34,0,0,0,OUI,OUI,2025-03-13 08:59:08+00:00,"48.865217631011, 2.3936596512794",Paris,75056,0.0,9
15027,Duhamel - André Gide,OUI,20,20,0,0,0,OUI,OUI,2025-03-13 08:52:13+00:00,"48.8365662244334, 2.312707121097412",Paris,75056,0.0,9
15018,Dutot - Place Alleray,OUI,56,52,4,0,4,OUI,OUI,2025-03-13 09:01:12+00:00,"48.836826091766, 2.3071701095578",Paris,75056,0.07142857142857142,9
42205,Place Aristide Briand,OUI,35,22,13,9,4,OUI,OUI,2025-03-13 08:54:21+00:00,"48.82189236575831, 2.413003742694855",Charenton-le-Pont,94018,0.37142857142857144,9
26012,Jardin Modèle - Pierre Boudou,OUI,15,12,3,1,2,OUI,OUI,2025-03-13 09:00:31+00:00,"48.914866710946, 2.3057010525935",Asnières-sur-Seine,92004,0.2,9
22701,Général Leclerc - République,OUI,28,8,20,18,2,OUI,OUI,2025-03-13 09:00:33+00:00,"48.915885074177, 2.2682306702811",Bois-Colombes,92009,0.7142857142857143,9
10166,Strasbourg - Saint-Denis,OUI,16,8,8,6,2,OUI,OUI,2025-03-13 08:59:50+00:00,"48.869601642433, 2.3542908579111",Paris,75056,0.5,9
17110,Legendre - Nollet,OUI,29,27,2,0,2,OUI,OUI,2025-03-13 09:00:54+00:00,"48.887742186754224, 2.320293079881375",Paris,75056,0.06896551724137931,9
8202,Londres - Europe,OUI,27,16,11,3,8,OUI,OUI,2025-03-13 08:59:50+00:00,"48.878618556803, 2.3248164693922",Paris,75056,0.4074074074074074,9
22404,Pierre Brossolette - 12 Février 1934,OUI,22,8,14,6,8,OUI,OUI,2025-03-13 09:00:16+00:00,"48.8176962416867, 2.3076123744249344",Malakoff,92046,0.6363636363636364,9
32011,Stade de France - Francis de Pressensé,OUI,43,2,41,4,37,OUI,OUI,2025-03-13 09:01:08+00:00,"48.919141953558, 2.3620655760169",Saint-Denis,93066,0.9534883720930233,9
30004,Jean Jaurès - Place de la Libération,OUI,28,2,26,11,15,OUI,OUI,2025-03-13 09:00:32+00:00,"48.90617751921, 2.4391458057475",Bobigny,93008,0.9285714285714286,9
12202,Charenton - Wattignies,OUI,40,38,2,1,1,OUI,OUI,2025-03-13 08:59:04+00:00,"48.836919119234, 2.3916775206425",Paris,75056,0.05,9
14035,Maine - Jean Zay,OUI,45,39,6,2,4,OUI,OUI,2025-03-13 08:57:43+00:00,"48.837925263898, 2.3225428909063",Paris,75056,0.13333333333333333,9
10202,Bichat - Grange aux Belles,OUI,29,25,4,1,3,OUI,OUI,2025-03-13 08:58:15+00:00,"48.873688, 2.365015",Paris,75056,0.13793103448275862,9
8046,Marceau - Président Wilson,OUI,29,3,26,16,10,OUI,OUI,2025-03-13 08:59:42+00:00,"48.8652359, 2.3002513",Paris,75056,0.896551724137931,9
42030,Stéphanie Bouvard - Gambetta,OUI,30,22,8,6,2,OUI,OUI,2025-03-13 08:58:23+00:00,"48.814548138856, 2.4024386957288",Ivry-sur-Seine,94041,0.26666666666666666,9
20110,Gambetta - Tourelles,OUI,20,20,0,0,0,OUI,OUI,2025-03-13 09:01:25+00:00,"48.875337902264, 2.4059921130538",Paris,75056,0.0,9
14005,René Coty - Place Denfert-Rochereau,OUI,36,31,5,1,4,OUI,OUI,2025-03-13 08:55:57+00:00,"48.833056477316, 2.3329411447048",Paris,75056,0.1388888888888889,9
18135,Ney - Porte de Montmartre,OUI,23,19,4,2,2,OUI,OUI,2025-03-13 08:47:18+00:00,"48.897918, 2.3364872",Paris,75056,0.17391304347826086,9
21207,Verdier - République,OUI,29,27,2,1,1,OUI,OUI,2025-03-13 08:57:53+00:00,"48.815403766277, 2.31739372015",Montrouge,92049,0.06896551724137931,9
34011,Clef des Champs - Albert Dhalenne,OUI,25,0,25,13,12,OUI,OUI,2025-03-13 08:59:25+00:00,"48.914938, 2.330665",Saint-Ouen-sur-Seine,93070,1.0,9
11016,Philippe-Auguste,OUI,48,39,9,3,6,OUI,OUI,2025-03-13 08:57:26+00:00,"48.851853488265, 2.3932945355773",Paris,75056,0.1875,9
21329,Gare - Aristide Briand,OUI,28,14,14,9,5,OUI,OUI,2025-03-13 08:58:25+00:00,"48.821410564722, 2.2555950104387",Issy-les-Moulineaux,92040,0.5,9
24007,Jean-Baptiste Charcot - Sainte-Geneviève,OUI,21,18,3,2,1,OUI,OUI,2025-03-13 08:59:38+00:00,"48.90310883721567, 2.278892956674099",Courbevoie,92026,0.14285714285714285,9
13015,Chevaleret - Louise Weiss,OUI,35,23,12,6,6,OUI,OUI,2025-03-13 08:58:40+00:00,"48.832586513351, 2.37121138812",Paris,75056,0.34285714285714286,9
6004,Regard - Rennes,OUI,46,28,18,6,12,OUI,OUI,2025-03-13 09:00:46+00:00,"48.847385404956, 2.3268555477262",Paris,75056,0.391304347826087,9
19114,Manin - Secrétan,OUI,20,19,1,0,1,OUI,OUI,2025-03-13 08:51:44+00:00,"48.8791665, 2.3787959",Paris,75056,0.05,9
15114,Pasteur - Cotentin,OUI,32,32,0,0,0,OUI,OUI,2025-03-13 08:59:20+00:00,"48.8389284, 2.316356",Paris,75056,0.0,9
12123,Château de Vincennes,OUI,49,41,8,5,3,OUI,OUI,2025-03-13 09:00:56+00:00,"48.84423193255657, 2.439209537709179",Paris,75056,0.16326530612244897,9
19014,Lorraine - Jean Jaurès,OUI,18,18,0,0,0,OUI,OUI,2025-03-13 08:57:38+00:00,"48.8863865, 2.3825772",Paris,75056,0.0,9
21002,Place Denfert-Rochereau,OUI,20,13,7,3,4,OUI,OUI,2025-03-13 09:00:27+00:00,"48.843252536286684, 2.245987951755524",Boulogne-Billancourt,92012,0.35,9
15014,Volontaires - Vaugirard,OUI,33,30,3,1,2,OUI,OUI,2025-03-13 09:01:19+00:00,"48.84132050184004, 2.30808901725357",Paris,75056,0.09090909090909091,9
23041,Général Leclerc - Bièvre,OUI,24,19,5,2,3,OUI,OUI,2025-03-13 09:00:26+00:00,"48.782414428747316, 2.3166695237159733",Bourg-la-Reine,92014,0.20833333333333334,9
13055,M.- A. Lagroua Weill-Hallé -  F. Dolto,OUI,59,3,56,24,32,OUI,OUI,2025-03-13 09:01:20+00:00,"48.828595283857425, 2.380220606266108",Paris,75056,0.9491525423728814,9
5027,Gobelins - Port-Royal,OUI,36,16,20,18,2,OUI,OUI,2025-03-13 09:00:35+00:00,"48.837135900263, 2.3515201359987",Paris,75056,0.5555555555555556,9
15044,Dantzig - Lefebvre,OUI,33,32,1,0,1,OUI,OUI,2025-03-13 08:55:36+00:00,"48.83013921586756, 2.295934036374092",Paris,75056,0.030303030303030304,9
11111,Léon Frot - Charonne,OUI,17,10,7,1,6,OUI,OUI,2025-03-13 08:56:01+00:00,"48.854963800335234, 2.387217085372007",Paris,75056,0.4117647058823529,9
15113,Arsonval - Falguière,OUI,24,24,0,0,0,OUI,OUI,2025-03-13 08:55:17+00:00,"48.84040040365445, 2.313117867297474",Paris,75056,0.0,9
48006,Maxime Gorki - Paul Vaillant-Couturier,OUI,19,18,1,0,1,OUI,OUI,2025-03-13 08:59:09+00:00,"48.79673508795443, 2.3683342337608337",Villejuif,94076,0.05263157894736842,9
20011,Pyrénées - Dagorno,OUI,20,19,1,1,0,OUI,OUI,2025-03-13 09:00:44+00:00,"48.855425770695085, 2.4051643162965775",Paris,75056,0.05,9
15053,Lecourbe - Convention,OUI,45,40,5,3,2,OUI,OUI,2025-03-13 09:00:29+00:00,"48.83923319241899, 2.2915197908878326",Paris,75056,0.1111111111111111,9
19001,Crimée - Ourcq,OUI,56,53,3,2,1,OUI,OUI,2025-03-13 08:57:38+00:00,"48.894104140316, 2.3729460884673",Paris,75056,0.05357142857142857,9
21022,Dôme - République,OUI,24,7,17,11,6,OUI,OUI,2025-03-13 09:01:18+00:00,"48.832681, 2.250257",Boulogne-Billancourt,92012,0.7083333333333334,9
11022,Roquette - Auguste Laurent,OUI,16,3,13,12,1,OUI,OUI,2025-03-13 09:00:29+00:00,"48.858001906023354, 2.381797702650783",Paris,75056,0.8125,9
12040,Porte de Charenton,OUI,66,54,12,6,6,OUI,OUI,2025-03-13 09:01:18+00:00,"48.831240105856, 2.3989107459784",Paris,75056,0.18181818181818182,9
41602,Place Charles Digeon,OUI,30,27,3,2,1,OUI,OUI,2025-03-13 08:56:37+00:00,"48.84354203133597, 2.418427169322968",Saint-Mandé,94067,0.1,9
6020,Place Saint-André des Arts,OUI,33,2,31,18,13,OUI,OUI,2025-03-13 08:59:45+00:00,"48.852886173881, 2.3426544293761",Paris,75056,0.9393939393939394,9
13028,Gouthière - Poterne des Peupliers,OUI,32,29,3,1,2,OUI,OUI,2025-03-13 08:58:11+00:00,"48.820507, 2.351342",Paris,75056,0.09375,9
21007,Rond-Point Rhin et Danube,OUI,53,36,17,5,12,OUI,OUI,2025-03-13 08:56:09+00:00,"48.840452820991764, 2.2280225157737736",Boulogne-Billancourt,92012,0.32075471698113206,9
15069,Félix Faure - Convention,OUI,44,29,15,13,2,OUI,OUI,2025-03-13 09:01:05+00:00,"48.841249336041, 2.2883866008495",Paris,75056,0.3409090909090909,9
5105,Geoffroy-Saint-Hilaire - Saint-Marcel,OUI,17,5,12,11,1,OUI,OUI,2025-03-13 08:59:47+00:00,"48.83907826424974, 2.356877340669728",Paris,75056,0.7058823529411765,9
14004,Port Royal - Hôpital Cochin,OUI,22,15,7,2,5,OUI,OUI,2025-03-13 09:01:16+00:00,"48.838608030238, 2.3406994164846",Paris,75056,0.3181818181818182,9
19123,Metz - Marne,OUI,30,25,5,3,2,OUI,OUI,2025-03-13 08:54:01+00:00,"48.891163, 2.3865705",Paris,75056,0.16666666666666666,9
14027,Gergovie - Alésia,OUI,54,53,1,1,0,OUI,OUI,2025-03-13 08:56:45+00:00,"48.83088717455243, 2.318882101207347",Paris,75056,0.018518518518518517,9
21107,Bertrand Sincholle - Henri Barbusse,OUI,18,7,11,10,1,OUI,OUI,2025-03-13 09:01:08+00:00,"48.89925982394349, 2.3042294383049016",Clichy,92024,0.6111111111111112,9
48002,LCL Campus - Place Oscar Niemeyer,OUI,37,36,1,0,1,OUI,OUI,2025-03-13 08:53:35+00:00,"48.805342480621576, 2.363983690738678",Villejuif,94076,0.02702702702702703,9
22007,Commandant Charcot - Bretteville,OUI,31,19,12,8,4,OUI,OUI,2025-03-13 09:00:36+00:00,"48.87530570765423, 2.2558460757136345",Neuilly-sur-Seine,92051,0.3870967741935484,9
20020,Pyrénées - Charles Renouvier,OUI,28,28,0,0,0,OUI,OUI,2025-03-13 08:55:42+00:00,"48.86095933229224, 2.400421852042113",Paris,75056,0.0,9
13037,Ivry - Baudricourt,OUI,20,13,7,4,3,OUI,OUI,2025-03-13 08:59:31+00:00,"48.824695995415006, 2.363106073577468",Paris,75056,0.35,9
12008,Hector Malot - Daumesnil,OUI,51,5,46,45,1,OUI,OUI,2025-03-13 09:01:03+00:00,"48.84693552991762, 2.3770876228809357",Paris,75056,0.9019607843137255,9
42027,Verdun - Pierre et Marie Curie,OUI,26,25,1,0,1,OUI,OUI,2025-03-13 08:58:31+00:00,"48.812822398263286, 2.3707106709480286",Ivry-sur-Seine,94041,0.038461538461538464,9
12102,Bercy - Traversiére,OUI,30,6,24,20,4,OUI,OUI,2025-03-13 09:01:09+00:00,"48.846192642574, 2.3703800886869",Paris,75056,0.8,9
16104,Paul Valery - Victor Hugo,OUI,33,27,6,1,5,OUI,OUI,2025-03-13 09:00:59+00:00,"48.87137406080164, 2.2887128591537476",Paris,75056,0.18181818181818182,9
13006,Duméril - Jeanne d'Arc,OUI,40,30,10,9,1,OUI,OUI,2025-03-13 08:59:47+00:00,"48.838151608087, 2.3571084495564",Paris,75056,0.25,9
43007,Hôtel de Ville de Vincennes,OUI,26,17,9,4,5,OUI,OUI,2025-03-13 08:56:05+00:00,"48.84827609706963, 2.4398955702781677",Vincennes,94080,0.34615384615384615,9
13013,Saint-Marcel - Hôpital,OUI,20,12,8,5,3,OUI,OUI,2025-03-13 08:57:32+00:00,"48.839504424583, 2.3609894170229",Paris,75056,0.4,9
15050,Dominique Pado - Croix Nivert,OUI,22,21,1,0,1,OUI,OUI,2025-03-13 08:54:44+00:00,"48.83648798164934, 2.2897250577807426",Paris,75056,0.045454545454545456,9
8044,Alfred de Vigny - Place du Général Brocard,OUI,32,8,24,8,16,OUI,OUI,2025-03-13 09:00:02+00:00,"48.87836138361425, 2.305254448220567",Paris,75056,0.75,9
17117,Pereire - Saussure,OUI,32,24,8,7,1,OUI,OUI,2025-03-13 09:00:10+00:00,"48.888229075478, 2.3101296275854",Paris,75056,0.25,9
51007,Résistance - Romain Rolland,OUI,28,25,3,0,3,OUI,OUI,2025-03-13 08:56:06+00:00,"48.950873482371, 2.2310190077797",Argenteuil,95018,0.10714285714285714,9
16017,Siam - La Pompe,OUI,16,14,2,0,2,OUI,OUI,2025-03-13 08:53:22+00:00,"48.861720329027264, 2.275346568555312",Paris,75056,0.125,9
17036,Place Tristan Bernard,OUI,28,26,2,1,1,OUI,OUI,2025-03-13 08:57:48+00:00,"48.8794936, 2.2915423",Paris,75056,0.07142857142857142,9
18021,Marcadet - Ramey,OUI,21,20,1,0,1,OUI,OUI,2025-03-13 08:57:43+00:00,"48.890875, 2.3449019",Paris,75056,0.047619047619047616,9
11040,Temple - Jean-Pierre Timbaud,OUI,32,17,15,13,2,OUI,OUI,2025-03-13 09:00:44+00:00,"48.86446597201, 2.3660597205162",Paris,75056,0.46875,9
16116,George Sand - Jean de La Fontaine,OUI,29,25,4,3,1,OUI,OUI,2025-03-13 09:00:39+00:00,"48.84986918764119, 2.268257387525699",Paris,75056,0.13793103448275862,9
11038,Temple - Charlot,OUI,41,4,37,32,5,OUI,OUI,2025-03-13 08:59:48+00:00,"48.865709343796, 2.3652737250724",Paris,75056,0.9024390243902439,9
25004,Marcel Pourtout - Édouard Manet,OUI,24,4,20,18,2,OUI,OUI,2025-03-13 09:01:26+00:00,"48.87555620763429, 2.1655967831611638",Rueil-Malmaison,92063,0.8333333333333334,9
21511,Marcel Monge - Marcel Dassault,OUI,46,9,37,33,4,OUI,OUI,2025-03-13 09:00:46+00:00,"48.86096384533371, 2.2246733296048142",Suresnes,92073,0.8043478260869565,9
21023,Ancienne Mairie - André Morizet,OUI,25,13,12,8,4,OUI,OUI,2025-03-13 08:58:17+00:00,"48.838311, 2.234077",Boulogne-Billancourt,92012,0.48,9
8003,Galilée - Vernet,OUI,47,31,16,3,13,OUI,OUI,2025-03-13 09:00:26+00:00,"48.871715878697, 2.2985444962978",Paris,75056,0.3404255319148936,9
31105,Lavoisier - Missak Manouchian,OUI,13,7,6,2,4,OUI,OUI,2025-03-13 08:55:27+00:00,"48.86286468896063, 2.495676465332508",Rosny-sous-Bois,93064,0.46153846153846156,9
22703,Place Jean Mermoz,OUI,27,24,3,1,2,OUI,OUI,2025-03-13 08:58:55+00:00,"48.9220937, 2.2718348",Bois-Colombes,92009,0.1111111111111111,9
31701,Mairie de Bagnolet,OUI,28,28,0,0,0,OUI,OUI,2025-03-13 08:59:20+00:00,"48.868421318555, 2.4179587885737",Bagnolet,93006,0.0,9
25009,Place des Arts - Jean Mermoz,OUI,20,6,14,12,2,OUI,OUI,2025-03-13 08:57:58+00:00,"48.880391139734, 2.1832160452221",Rueil-Malmaison,92063,0.7,9
20032,Square des Amandiers,OUI,26,25,1,0,1,OUI,OUI,2025-03-13 09:01:19+00:00,"48.86615630668046, 2.3891324177384377",Paris,75056,0.038461538461538464,9
41101,Paul Doumer - Stalingrad,OUI,24,22,2,1,1,OUI,OUI,2025-03-13 09:00:03+00:00,"48.806518992199, 2.3368880152702",Arcueil,94003,0.08333333333333333,9
20014,Charonne - Alexandre Dumas,OUI,34,29,5,3,2,OUI,OUI,2025-03-13 09:00:55+00:00,"48.856077415056, 2.3948693275452",Paris,75056,0.14705882352941177,9
20030,Ménilmontant - Père Lachaise,OUI,40,40,0,0,0,OUI,OUI,2025-03-13 09:00:53+00:00,"48.863287291502, 2.3869940266013",Paris,75056,0.0,9
8007,Rome - Provence,OUI,29,0,29,24,5,OUI,OUI,2025-03-13 08:59:12+00:00,"48.874230055580306, 2.325570111724113",Paris,75056,1.0,9
16140,Hippodrome de Longchamp,OUI,24,0,24,20,4,OUI,OUI,2025-03-13 09:00:46+00:00,"48.86413226532, 2.239905372262",Paris,75056,1.0,9
21218,Gabriel Péri - Place de la Libération,OUI,17,11,6,1,5,OUI,OUI,2025-03-13 09:00:57+00:00,"48.819828421929, 2.3117361743705",Montrouge,92049,0.35294117647058826,9
20037,Gambetta - Saint Fargeau,OUI,24,23,1,0,1,OUI,OUI,2025-03-13 08:55:07+00:00,"48.871244610447015, 2.4039056897163396",Paris,75056,0.041666666666666664,9
17006,Guy Môquet - Compoint,OUI,35,34,1,1,0,OUI,OUI,2025-03-13 08:55:18+00:00,"48.89213559044868, 2.32321947813034",Paris,75056,0.02857142857142857,9
19045,Macdonald - Césaria Evora,OUI,66,42,24,7,17,OUI,OUI,2025-03-13 09:01:27+00:00,"48.89883, 2.37933",Paris,75056,0.36363636363636365,9
18101,Championnet.,OUI,20,19,1,1,0,OUI,OUI,2025-03-13 08:59:18+00:00,"48.8953643, 2.3498166",Paris,75056,0.05,9
48011,Epi d'Or - Chevilly,OUI,20,15,5,0,5,OUI,OUI,2025-03-13 08:51:45+00:00,"48.781109786782, 2.3549050362061",Villejuif,94076,0.25,9
6028,Quatre Vents - Carrefour de l'Odéon,OUI,37,20,17,15,2,OUI,OUI,2025-03-13 08:59:55+00:00,"48.851751374458864, 2.338161695134053",Paris,75056,0.4594594594594595,9
41212,Nungesser - Santé,OUI,22,22,0,0,0,OUI,OUI,2025-03-13 08:57:52+00:00,"48.852335, 2.448967",Fontenay-sous-Bois,94033,0.0,9
20005,Reynaldo Hahn - Lagny,OUI,19,18,1,0,1,OUI,OUI,2025-03-13 08:59:47+00:00,"48.849266043601794, 2.412330328844772",Paris,75056,0.05263157894736842,9
34009,Dora Maar - Nadia Guendouz,OUI,27,2,25,19,6,OUI,OUI,2025-03-13 09:00:28+00:00,"48.905452421305, 2.3220406472683",Saint-Ouen-sur-Seine,93070,0.9259259259259259,9
12122,Bois de Vincennes - Polygone,OUI,51,45,6,2,4,OUI,OUI,2025-03-13 08:58:17+00:00,"48.83544491617421, 2.431421081436563",Paris,75056,0.11764705882352941,9
41304,Port - Maurice Chevalier,OUI,30,4,26,23,3,OUI,OUI,2025-03-13 08:58:04+00:00,"48.832474421632, 2.490257616467",Nogent-sur-Marne,94052,0.8666666666666667,9
15120,Colonel Pierre Avia,OUI,29,10,19,16,3,OUI,OUI,2025-03-13 08:58:37+00:00,"48.8296843300915, 2.275342586850291",Paris,75056,0.6551724137931034,9
10151,Gare du Nord - Faubourg Saint-Denis,OUI,28,24,4,1,3,OUI,OUI,2025-03-13 08:52:49+00:00,"48.879612765504, 2.3568402975798",Paris,75056,0.14285714285714285,9
16033,Marché d'Auteuil,OUI,31,1,30,25,5,OUI,OUI,2025-03-13 09:00:18+00:00,"48.84842761367387, 2.265253821160005",Paris,75056,0.967741935483871,9
7007,Musée d'Orsay,OUI,63,2,61,42,19,OUI,OUI,2025-03-13 09:01:27+00:00,"48.859726157909, 2.3258604481816",Paris,75056,0.9682539682539683,9
21205,Arthur Auger - Jean Jaurès,OUI,23,13,10,7,3,OUI,OUI,2025-03-13 09:00:36+00:00,"48.813736445585235, 2.3069277405738835",Montrouge,92049,0.43478260869565216,9
22208,Stalingrad - Barbara,OUI,19,18,1,0,1,OUI,OUI,2025-03-13 09:00:11+00:00,"48.809223658808, 2.3175904558822",Bagneux,92007,0.05263157894736842,9
16023,Passy - Place du Costa Rica,OUI,30,25,5,1,4,OUI,OUI,2025-03-13 09:00:59+00:00,"48.8584893, 2.2839655",Paris,75056,0.16666666666666666,9
18018,Carpeaux - Place Jacques Froment,OUI,17,16,1,0,1,OUI,OUI,2025-03-13 08:55:00+00:00,"48.8906542, 2.3309428",Paris,75056,0.058823529411764705,9
11029,Ménilmontant - Oberkampf,OUI,39,37,2,0,2,OUI,OUI,2025-03-13 08:57:56+00:00,"48.866617658681, 2.3830134404158",Paris,75056,0.05128205128205128,9
32305,Saint-Germain - Verdun,OUI,29,29,0,0,0,OUI,OUI,2025-03-13 08:57:04+00:00,"48.882877330093, 2.4331868384644",Romainville,93063,0.0,9
11028,Guillaume Bertrand - République,OUI,38,30,8,1,7,OUI,OUI,2025-03-13 08:56:20+00:00,"48.863825174341, 2.380906377155",Paris,75056,0.21052631578947367,9
22305,Jean Jaurès - Place du Dr Roux,OUI,34,23,11,9,2,OUI,OUI,2025-03-13 08:56:26+00:00,"48.927567032796, 2.2947337017374",Gennevilliers,92036,0.3235294117647059,9
22014,Victor Hugo - Bineau,OUI,24,11,13,6,7,OUI,OUI,2025-03-13 09:01:22+00:00,"48.88758225888669, 2.2783890366554265",Neuilly-sur-Seine,92051,0.5416666666666666,9
21954,Val-Fleury,OUI,23,18,5,3,2,OUI,OUI,2025-03-13 08:56:14+00:00,"48.807671407991, 2.2407217696309",Meudon,92048,0.21739130434782608,9
21027,Fief - République,OUI,24,1,23,18,5,OUI,OUI,2025-03-13 09:01:26+00:00,"48.83170888166024, 2.255771979689598",Boulogne-Billancourt,92012,0.9583333333333334,9
23205,Parc des Pierrettes,OUI,22,22,0,0,0,OUI,OUI,2025-03-13 08:56:21+00:00,"48.7973062, 2.2909969",Châtillon,92020,0.0,9
25002,Hôtel de Ville de Rueil-Malmaison,OUI,19,5,14,10,4,OUI,OUI,2025-03-13 08:59:12+00:00,"48.878194, 2.181724",Rueil-Malmaison,92063,0.7368421052631579,9
32023,Guy Môquet - Jean Moulin,OUI,27,3,24,12,12,OUI,OUI,2025-03-13 09:01:21+00:00,"48.940931521020836, 2.363948999931771",Saint-Denis,93066,0.8888888888888888,9
6005,Montparnasse -  Square Ozanam,OUI,49,18,31,18,13,OUI,OUI,2025-03-13 09:00:55+00:00,"48.843310567822, 2.3265242949128",Paris,75056,0.6326530612244898,9
25010,Maréchal Leclerc de Hauteclocque - Marché Buzenval,OUI,30,23,7,4,3,OUI,OUI,2025-03-13 08:56:59+00:00,"48.858446, 2.192077",Rueil-Malmaison,92063,0.23333333333333334,9
16022,Jean Bologne - Passy,OUI,19,17,2,1,1,OUI,OUI,2025-03-13 09:00:07+00:00,"48.857566889784465, 2.280027395306772",Paris,75056,0.10526315789473684,9
12165,Champs de Manoeuvre - Cartoucherie,OUI,32,14,18,10,8,OUI,OUI,2025-03-13 08:58:50+00:00,"48.835261, 2.447974",Paris,75056,0.5625,9
13023,Bobillot - Moulin des Prés,OUI,28,27,1,0,1,OUI,OUI,2025-03-13 08:59:16+00:00,"48.828657346203, 2.353020646317",Paris,75056,0.03571428571428571,9
22018,Charles de Gaulle - Les Sablons,OUI,35,12,23,11,12,OUI,OUI,2025-03-13 09:01:21+00:00,"48.880987514929, 2.2715748726513",Neuilly-sur-Seine,92051,0.6571428571428571,9
20106,Mairie du 20ème,OUI,27,26,1,0,1,OUI,OUI,2025-03-13 08:54:36+00:00,"48.865302324275, 2.3990669846535",Paris,75056,0.037037037037037035,9
21320,Président Roosevelt - Rouget de Lisle,OUI,40,0,40,23,17,OUI,OUI,2025-03-13 09:00:48+00:00,"48.83047518749, 2.2616135525345",Issy-les-Moulineaux,92040,1.0,9
19007,Flandre - Ourcq,OUI,29,25,4,1,3,OUI,OUI,2025-03-13 08:59:18+00:00,"48.89260159189023, 2.3790915682911873",Paris,75056,0.13793103448275862,9
11001,Richard Lenoir - Place de la Bastille,OUI,46,3,43,29,14,OUI,OUI,2025-03-13 08:59:54+00:00,"48.8538327, 2.3697222",Paris,75056,0.9347826086956522,9
21016,Point du Jour - Jean Jaurès,OUI,39,28,11,8,3,OUI,OUI,2025-03-13 09:00:25+00:00,"48.828753141436465, 2.245911467014621",Boulogne-Billancourt,92012,0.28205128205128205,9
19018,Cité de la Musique,OUI,52,33,19,13,6,OUI,OUI,2025-03-13 09:00:27+00:00,"48.888796556487, 2.3925811931922",Paris,75056,0.36538461538461536,9
11018,Saint-Maur - République,OUI,35,31,4,2,2,OUI,OUI,2025-03-13 09:01:01+00:00,"48.864185861455, 2.3783174157143",Paris,75056,0.11428571428571428,9
17126,Hélène et François Missoffe - Emile Borel,OUI,28,7,21,19,2,OUI,OUI,2025-03-13 09:01:21+00:00,"48.89990653843488, 2.321543991674844",Paris,75056,0.75,9
12039,Général Michel Bizot - Claude Decaen,OUI,35,32,3,1,2,OUI,OUI,2025-03-13 09:01:16+00:00,"48.83481262982544, 2.400927788127704",Paris,75056,0.08571428571428572,9
34005,Adrien Lesesne - Docteur Bauer,OUI,29,28,1,0,1,OUI,OUI,2025-03-13 08:56:46+00:00,"48.90263867304635, 2.348248063431511",Saint-Ouen-sur-Seine,93070,0.034482758620689655,9
5031,Lacépède - Linné,OUI,52,39,13,9,4,OUI,OUI,2025-03-13 08:55:36+00:00,"48.8437035476636, 2.354651279747486",Paris,75056,0.25,9
17127,Porte de Clichy - Place des Nations Unies,OUI,36,2,34,32,2,OUI,OUI,2025-03-13 09:00:11+00:00,"48.896737263309504, 2.310542999196392",Paris,75056,0.9444444444444444,9
12017,Saint-Mandé - Docteur Arnold Netter,OUI,36,17,19,14,5,OUI,OUI,2025-03-13 08:59:34+00:00,"48.84462585769668, 2.404946386814118",Paris,75056,0.5277777777777778,9
26008,Henri Barbusse - Bourguignons,OUI,32,25,7,1,6,OUI,OUI,2025-03-13 09:01:22+00:00,"48.91301722799713, 2.2734212270774417",Asnières-sur-Seine,92004,0.21875,9
14025,Jacquier - Didot,OUI,30,30,0,0,0,OUI,OUI,2025-03-13 09:00:12+00:00,"48.82953336292279, 2.318179272115231",Paris,75056,0.0,9
26009,Marceau Delorme - Pierre Brossolette,OUI,26,21,5,3,2,OUI,OUI,2025-03-13 08:56:02+00:00,"48.91206062860357, 2.295897423568745",Asnières-sur-Seine,92004,0.19230769230769232,9
6009,Guynemer - Jardin du Luxembourg,OUI,34,14,20,10,10,OUI,OUI,2025-03-13 09:00:52+00:00,"48.8466127, 2.3325478",Paris,75056,0.5882352941176471,9
34008,Garibaldi - Gabriel Péri,OUI,29,19,10,4,6,OUI,OUI,2025-03-13 08:59:51+00:00,"48.905741911394, 2.3316044208059",Saint-Ouen-sur-Seine,93070,0.3448275862068966,9
20033,Etienne Dolet - Place Maurice Chevalier,OUI,47,47,0,0,0,OUI,OUI,2025-03-13 09:00:34+00:00,"48.86798303359366, 2.3851405311143026",Paris,75056,0.0,9
31301,Gare RER,OUI,25,15,10,2,8,OUI,OUI,2025-03-13 08:58:18+00:00,"48.896280181078, 2.4581568985227",Noisy-le-Sec,93053,0.4,9
30005,Convention - Campus de Bobigny,OUI,29,14,15,4,11,OUI,OUI,2025-03-13 08:59:53+00:00,"48.914920058264, 2.4172238067445",Bobigny,93008,0.5172413793103449,9
31303,Simone Signoret - Paris,OUI,26,18,8,4,4,OUI,OUI,2025-03-13 08:56:28+00:00,"48.903600624712865, 2.465406596265139",Noisy-le-Sec,93053,0.3076923076923077,9
17050,Batignolles - Abel Truchet,OUI,26,23,3,1,2,OUI,OUI,2025-03-13 09:01:16+00:00,"48.883103904582, 2.3238347490884",Paris,75056,0.11538461538461539,9
5107,Pontoise - La Tournelle,OUI,22,6,16,14,2,OUI,OUI,2025-03-13 08:59:14+00:00,"48.850458009188, 2.3524542754922",Paris,75056,0.7272727272727273,9
1201,Perrault - Place du Louvre,OUI,27,6,21,14,7,OUI,OUI,2025-03-13 09:00:55+00:00,"48.860273568996, 2.3412468419093",Paris,75056,0.7777777777777778,9
18023,Ordener - Poissonniers,OUI,34,33,1,0,1,OUI,OUI,2025-03-13 09:01:24+00:00,"48.891213890844654, 2.351288666219873",Paris,75056,0.029411764705882353,9
21510,Fontaine du Tertre - Calvaire,OUI,23,21,2,0,2,OUI,OUI,2025-03-13 08:55:11+00:00,"48.8702539, 2.2187778",Suresnes,92073,0.08695652173913043,9
18026,Ruisseau - Ordener,OUI,31,30,1,0,1,OUI,OUI,2025-03-13 08:56:06+00:00,"48.89299462568024, 2.340144887566567",Paris,75056,0.03225806451612903,9
13008,Place d'Italie - Soeur Rosalie,OUI,52,40,12,1,11,OUI,OUI,2025-03-13 08:59:15+00:00,"48.831908520394, 2.3546943448098",Paris,75056,0.23076923076923078,9
16006,Lauriston - Copernic,OUI,19,11,8,0,8,OUI,OUI,2025-03-13 09:00:42+00:00,"48.86926, 2.289918",Paris,75056,0.42105263157894735,9
21033,Sèvres - Maréchal Juin,OUI,17,2,15,10,5,OUI,OUI,2025-03-13 09:00:09+00:00,"48.8324305, 2.2292812",Boulogne-Billancourt,92012,0.8823529411764706,9
8008,Joseph Sansboeuf - Saint Lazare,OUI,31,20,11,4,7,OUI,OUI,2025-03-13 09:00:06+00:00,"48.875315630653, 2.3229019716382",Paris,75056,0.3548387096774194,9
21112,Claude Debussy - Marc Bloch,OUI,52,34,18,12,6,OUI,OUI,2025-03-13 09:00:53+00:00,"48.910388180512, 2.3117771744728",Clichy,92024,0.34615384615384615,9
7201,Place De Fontenoy - Saxe,OUI,18,0,18,12,6,OUI,OUI,2025-03-13 08:57:29+00:00,"48.850270554523, 2.3069813815839",Paris,75056,1.0,9
24010,Charles de Gaulle - Rue de l'Alma,OUI,27,4,23,7,16,OUI,OUI,2025-03-13 09:00:51+00:00,"48.896620592993, 2.252313240191",Courbevoie,92026,0.8518518518518519,9
15013,Volontaires - Lecourbe,OUI,29,27,2,2,0,OUI,OUI,2025-03-13 08:56:58+00:00,"48.84351378799, 2.3065522313118",Paris,75056,0.06896551724137931,9
26010,Louis Armand - Bernard Palissy,OUI,16,9,7,7,0,OUI,OUI,2025-03-13 08:53:03+00:00,"48.916974, 2.313384",Asnières-sur-Seine,92004,0.4375,9
3201,Payenne - Square George Caïn,OUI,22,0,22,16,6,OUI,OUI,2025-03-13 09:01:23+00:00,"48.8578329, 2.3622643",Paris,75056,1.0,9
13204,Tolbiac - Boussingault,OUI,41,38,3,2,1,OUI,OUI,2025-03-13 09:00:22+00:00,"48.826177754027, 2.3420378552202",Paris,75056,0.07317073170731707,9
20035,Pyrénées - Ménilmontant,OUI,25,24,1,0,1,OUI,OUI,2025-03-13 09:01:18+00:00,"48.8693268535238, 2.395084574818611",Paris,75056,0.04,9
15062,Convention - Lourmel,OUI,35,9,26,22,4,OUI,OUI,2025-03-13 08:59:28+00:00,"48.842055041656, 2.2859910875559",Paris,75056,0.7428571428571429,9
23106,Pavé des Gardes - Charles Vaillant,OUI,20,12,8,8,0,OUI,OUI,2025-03-13 09:01:15+00:00,"48.81168551728, 2.2111820107205",Sèvres,92072,0.4,9
10114,Granges aux Belles - Hôpital Saint-Louis,OUI,59,53,6,2,4,OUI,OUI,2025-03-13 08:58:51+00:00,"48.874794994841, 2.366669436985",Paris,75056,0.1016949152542373,9
21508,Georges Pompidou - Verdun,OUI,24,2,22,10,12,OUI,OUI,2025-03-13 09:01:26+00:00,"48.875481, 2.232443",Suresnes,92073,0.9166666666666666,9
13203,Square de Choisy - Eastman,OUI,23,19,4,1,3,OUI,OUI,2025-03-13 09:00:45+00:00,"48.828543456283, 2.3583075090494",Paris,75056,0.17391304347826086,9
15032,Félix Faure - Lourmel,OUI,54,29,25,24,1,OUI,OUI,2025-03-13 09:00:49+00:00,"48.83868901709515, 2.2818081825971603",Paris,75056,0.46296296296296297,9
47007,Liberté - Vert-de-Maisons,OUI,20,2,18,14,4,OUI,OUI,2025-03-13 08:58:01+00:00,"48.790147809608, 2.4328628182411",Maisons-Alfort,94046,0.9,9
22302,Gare RER - Général de Gaulle,OUI,38,19,19,14,5,OUI,OUI,2025-03-13 08:57:52+00:00,"48.933548439566, 2.3064726536317",Gennevilliers,92036,0.5,9
8038,François 1er - Montaigne,OUI,51,13,38,19,19,OUI,OUI,2025-03-13 08:59:37+00:00,"48.866887649978, 2.3066755757207",Paris,75056,0.7450980392156863,9
13053,Chevaleret - Tolbiac,OUI,21,8,13,10,3,OUI,OUI,2025-03-13 08:55:54+00:00,"48.82941, 2.375934",Paris,75056,0.6190476190476191,9
5201,Saint-Jacques - Soufflot,OUI,16,7,9,2,7,OUI,OUI,2025-03-13 08:57:31+00:00,"48.846280383395, 2.3430785379567",Paris,75056,0.5625,9
9029,Saint-Lazare - Place d'Estienne d'Orves,OUI,39,10,29,17,12,OUI,OUI,2025-03-13 08:59:00+00:00,"48.8768345, 2.3329067",Paris,75056,0.7435897435897436,9
11037,Faubourg Du Temple - Republique,OUI,38,0,38,36,2,OUI,OUI,2025-03-13 09:01:07+00:00,"48.867872484749, 2.3648982158072",Paris,75056,1.0,9
18041,Rochechouart - Martyrs,OUI,17,13,4,0,4,OUI,OUI,2025-03-13 09:00:42+00:00,"48.882193779572, 2.3405495658517",Paris,75056,0.23529411764705882,9
8031,Jean Mermoz - Champs-Elysées,OUI,44,2,42,18,24,OUI,OUI,2025-03-13 09:00:06+00:00,"48.869689856852, 2.3107324540615",Paris,75056,0.9545454545454546,9
8039,Colisée - Champs-Elysées,OUI,15,1,14,3,11,OUI,OUI,2025-03-13 09:00:36+00:00,"48.870475399387, 2.3076190799475",Paris,75056,0.9333333333333333,9
26011,Ménil - Argenteuil,OUI,18,13,5,3,2,OUI,OUI,2025-03-13 09:00:37+00:00,"48.925901818305, 2.2741496502338",Asnières-sur-Seine,92004,0.2777777777777778,9
12157,Fabre d'Eglantine - Place de la Nation,OUI,66,52,14,4,10,OUI,OUI,2025-03-13 08:59:58+00:00,"48.8471116, 2.3956204",Paris,75056,0.21212121212121213,9
22209,Verdun - Henri Barbusse,OUI,23,21,2,0,2,OUI,OUI,2025-03-13 08:56:43+00:00,"48.802056061754, 2.3159965061736",Bagneux,92007,0.08695652173913043,9
21213,Vanne - Général de Gaulle,OUI,25,23,2,0,2,OUI,OUI,2025-03-13 09:00:06+00:00,"48.815007, 2.328318",Montrouge,92049,0.08,9
45005,Stalingrad - Général de Gaulle,OUI,26,10,16,4,12,OUI,OUI,2025-03-13 09:00:38+00:00,"48.823450589614, 2.4965062363218",Champigny-sur-Marne,94017,0.6153846153846154,9
11046,Place de la République - Voltaire,OUI,16,2,14,14,0,OUI,OUI,2025-03-13 09:00:37+00:00,"48.866830968942, 2.3654810339212",Paris,75056,0.875,9
35021,Cartier Bresson - Denis Papin,OUI,31,26,5,2,3,OUI,OUI,2025-03-13 08:56:49+00:00,"48.902616, 2.397814",Pantin,93055,0.16129032258064516,9
15060,Place de la Montagne du Goulet,OUI,20,3,17,13,4,OUI,OUI,2025-03-13 08:57:52+00:00,"48.8443415, 2.2773844",Paris,75056,0.85,9
18045,Pierre Ginier - Clichy,OUI,15,13,2,1,1,OUI,OUI,2025-03-13 08:57:12+00:00,"48.8867667, 2.326228",Paris,75056,0.13333333333333333,9
11011,Richard Lenoir - Voltaire,OUI,25,11,14,10,4,OUI,OUI,2025-03-13 09:00:50+00:00,"48.86164273878, 2.3727491497993",Paris,75056,0.56,9
14110,Abbé Carton - Plantes,OUI,25,24,1,1,0,OUI,OUI,2025-03-13 08:58:23+00:00,"48.827673823166, 2.3209181427956",Paris,75056,0.04,9
15105,Fédération - Suffren,OUI,24,12,12,10,2,OUI,OUI,2025-03-13 09:00:05+00:00,"48.852828153442, 2.2978776320815",Paris,75056,0.5,9
10025,Jemmapes - Ecluses Saint-Martin,OUI,12,6,6,1,5,OUI,OUI,2025-03-13 08:58:36+00:00,"48.87748519186726, 2.3660067468881607",Paris,75056,0.5,9
18205,Mauroy - Cheminots,OUI,30,27,3,1,2,OUI,OUI,2025-03-13 08:59:04+00:00,"48.897715198403, 2.357895075822",Paris,75056,0.1,9
22507,Châteaudun - Place de la Liberté,OUI,25,22,3,2,1,OUI,OUI,2025-03-13 08:58:54+00:00,"48.90970830301211, 2.2454486480600626",La Garenne-Colombes,92035,0.12,9
7023,Bourdonnais - Tour Eiffel,OUI,54,18,36,26,10,OUI,OUI,2025-03-13 09:01:11+00:00,"48.860897797941, 2.295599598447",Paris,75056,0.6666666666666666,9
11201,Faubourg St-Antoine - Place de la Nation,OUI,16,12,4,1,3,OUI,OUI,2025-03-13 08:59:28+00:00,"48.8487726, 2.393606",Paris,75056,0.25,9
7025,Octave Gréard - Tour Eiffel,OUI,32,2,30,24,6,OUI,OUI,2025-03-13 09:01:04+00:00,"48.856502977696, 2.2931787543289",Paris,75056,0.9375,9
22602,Place Henri Dunant - Gare RER,OUI,30,27,3,2,1,OUI,OUI,2025-03-13 08:55:43+00:00,"48.788093281931, 2.2909234046643",Fontenay-aux-Roses,92032,0.1,9
4108,Quai de Béthune - Pont de la Tournelle,OUI,25,13,12,10,2,OUI,OUI,2025-03-13 09:00:46+00:00,"48.85097433194, 2.3563072085381",Paris,75056,0.48,9
12106,Gare de Lyon - Roland Barthes,OUI,68,0,68,62,6,OUI,OUI,2025-03-13 09:00:35+00:00,"48.84395729494058, 2.3790882155299187",Paris,75056,1.0,9
40007,Préfecture de Créteil,OUI,27,4,23,14,9,OUI,OUI,2025-03-13 09:00:38+00:00,"48.783680285918, 2.4544713672215",Créteil,94028,0.8518518518518519,9
23201,Avenir,OUI,41,36,5,3,2,OUI,OUI,2025-03-13 09:00:47+00:00,"48.8103438, 2.3003776",Châtillon,92020,0.12195121951219512,9
40010,Haut du Mont-Mesly,OUI,21,15,6,3,3,OUI,OUI,2025-03-13 08:54:11+00:00,"48.780191921646, 2.4685737495183",Créteil,94028,0.2857142857142857,9
12001,Bastille - Biscornet,OUI,59,1,58,44,14,OUI,OUI,2025-03-13 09:00:37+00:00,"48.851355779579, 2.369220033288",Paris,75056,0.9830508474576272,9
40012,Stade de la Habette,OUI,16,16,0,0,0,OUI,OUI,2025-03-13 09:00:07+00:00,"48.774397033806, 2.4668785263921",Créteil,94028,0.0,9
21327,Jean Bouin - Gouverneur Général Eboué,OUI,31,3,28,26,2,OUI,OUI,2025-03-13 08:59:16+00:00,"48.824792734266, 2.2651904328524",Issy-les-Moulineaux,92040,0.9032258064516129,9
12107,Diderot - Pierre Bourdan,OUI,21,0,21,10,11,OUI,OUI,2025-03-13 08:59:39+00:00,"48.847648620797, 2.3902582749724",Paris,75056,1.0,9
23203,Division Leclerc - Kléber,OUI,25,17,8,3,5,OUI,OUI,2025-03-13 08:58:56+00:00,"48.798666226364, 2.2833752789972",Châtillon,92020,0.32,9
26005,Hôtel de Ville d'Asnières sur Seine,OUI,25,23,2,1,1,OUI,OUI,2025-03-13 08:59:59+00:00,"48.90999330025577, 2.288238108158112",Asnières-sur-Seine,92004,0.08,9
9035,Gare Saint-Lazare - Place de Budapest,OUI,43,21,22,9,13,OUI,OUI,2025-03-13 08:59:52+00:00,"48.877753, 2.327339",Paris,75056,0.5116279069767442,9
23703,Gare de Chaville Rive Gauche,OUI,18,17,1,1,0,OUI,OUI,2025-03-13 08:57:10+00:00,"48.805160304345, 2.188277207315",Chaville,92022,0.05555555555555555,9
34012,Bateliers - Quai de Seine,OUI,21,11,10,6,4,OUI,OUI,2025-03-13 08:56:33+00:00,"48.915817585516, 2.3239533298594",Saint-Ouen-sur-Seine,93070,0.47619047619047616,9
14021,Place de la Porte de Châtillon,OUI,59,56,3,0,3,OUI,OUI,2025-03-13 08:57:20+00:00,"48.8242469, 2.3186306",Paris,75056,0.05084745762711865,9
23204,Roland Garros - Jean Bouin,OUI,27,25,2,1,1,OUI,OUI,2025-03-13 08:59:31+00:00,"48.809460857173, 2.2853198638301",Châtillon,92020,0.07407407407407407,9
13106,Bobillot - Paulin Mery,OUI,21,15,6,2,4,OUI,OUI,2025-03-13 08:58:04+00:00,"48.829899841747, 2.3543356766749",Paris,75056,0.2857142857142857,9
21514,Place de la Paix - Abbé Saint-Pierre,OUI,24,21,3,3,0,OUI,OUI,2025-03-13 08:55:46+00:00,"48.86462724459225, 2.2047570338469806",Suresnes,92073,0.125,9
51005,Yves Farges - Route d'Enghien,OUI,33,16,17,6,11,OUI,OUI,2025-03-13 08:59:34+00:00,"48.95756799268, 2.2834496977978",Argenteuil,95018,0.5151515151515151,9
10026,Gare de l'Est - Chateau Landon,OUI,54,51,3,1,2,OUI,OUI,2025-03-13 08:59:19+00:00,"48.879305, 2.362424",Paris,75056,0.05555555555555555,9
17010,Jonquière - Docteur Paul Brousse,OUI,38,33,5,4,1,OUI,OUI,2025-03-13 08:59:41+00:00,"48.894799816683985, 2.318705212173216",Paris,75056,0.13157894736842105,9
35014,Charles de Gaulle - Jean Lolive,OUI,26,20,6,3,3,OUI,OUI,2025-03-13 08:59:27+00:00,"48.8932644350857, 2.4126765131950383",Pantin,93055,0.23076923076923078,9
18024,Clignancourt - Ordener,OUI,35,35,0,0,0,OUI,OUI,2025-03-13 08:57:09+00:00,"48.891457726153774, 2.348636478060487",Paris,75056,0.0,9
31708,Noisy le Sec - Jean-Baptiste Clément,OUI,19,18,1,0,1,OUI,OUI,2025-03-13 09:00:08+00:00,"48.874515389637, 2.4152836203575",Bagnolet,93006,0.05263157894736842,9
13205,Choisy - Pointe d'Ivry,OUI,24,20,4,3,1,OUI,OUI,2025-03-13 09:01:14+00:00,"48.822154170359, 2.3633708034878",Paris,75056,0.16666666666666666,9
10013,Alibert - Jemmapes,OUI,57,49,8,4,4,OUI,OUI,2025-03-13 09:01:22+00:00,"48.871044051984, 2.3661044619878",Paris,75056,0.14035087719298245,9
31202,Gabriel Péri - Jules Ferry,OUI,28,6,22,15,7,OUI,OUI,2025-03-13 09:00:44+00:00,"48.926182814311, 2.3912295762525",La Courneuve,93027,0.7857142857142857,9
15026,Bir Hakeim,OUI,31,4,27,21,6,OUI,OUI,2025-03-13 09:01:27+00:00,"48.853844054334, 2.289705348222",Paris,75056,0.8709677419354839,9
31201,Suzanne Masson,OUI,33,3,30,12,18,OUI,OUI,2025-03-13 08:58:31+00:00,"48.923306888013, 2.3847292397611",La Courneuve,93027,0.9090909090909091,9
1003,Saint-Denis - Rivoli,OUI,42,14,28,22,6,OUI,OUI,2025-03-13 09:01:16+00:00,"48.859059340842, 2.3476943001151",Paris,75056,0.6666666666666666,9
13035,Choisy - Tolbiac,OUI,20,17,3,2,1,OUI,OUI,2025-03-13 08:59:49+00:00,"48.82591155587, 2.3602393269539",Paris,75056,0.15,9
34014,Michelet - Dr Bauer,OUI,29,27,2,0,2,OUI,OUI,2025-03-13 09:01:01+00:00,"48.906125424194, 2.3440374449846",Saint-Ouen-sur-Seine,93070,0.06896551724137931,9
27004,Gare de la Garenne-Colombes,OUI,27,18,9,6,3,OUI,OUI,2025-03-13 08:58:18+00:00,"48.909752, 2.239145",Colombes,92025,0.3333333333333333,9
18134,Ney - Porte de Clignancourt,OUI,24,21,3,2,1,OUI,OUI,2025-03-13 08:53:27+00:00,"48.8978867, 2.3458001",Paris,75056,0.125,9
6001,Institut de France,OUI,17,1,16,10,6,OUI,OUI,2025-03-13 08:59:39+00:00,"48.857615678565, 2.3358313530377",Paris,75056,0.9411764705882353,9
13202,Place Farhat Hached,OUI,28,3,25,10,15,OUI,OUI,2025-03-13 09:00:19+00:00,"48.825487045602, 2.3816306985827",Paris,75056,0.8928571428571429,9
1002,Victoria - Place du Chatelet,OUI,19,3,16,6,10,OUI,OUI,2025-03-13 08:58:35+00:00,"48.857992591527, 2.3469167947769",Paris,75056,0.8421052631578947,9
13051,Halle Freyssinet - Parvis Alan Turing,OUI,23,6,17,9,8,OUI,OUI,2025-03-13 08:59:50+00:00,"48.832846814471, 2.3711421713233",Paris,75056,0.7391304347826086,9
8052,Balzac - Champs Elysées,OUI,30,20,10,4,6,OUI,OUI,2025-03-13 09:00:26+00:00,"48.872699639621, 2.3001953959465",Paris,75056,0.3333333333333333,9
21501,Pont de Suresnes,OUI,17,13,4,2,2,OUI,OUI,2025-03-13 08:54:32+00:00,"48.867415092322, 2.2258946679617",Suresnes,92073,0.23529411764705882,9
4104,Sebastopol - Rambuteau,OUI,15,2,13,10,3,OUI,OUI,2025-03-13 09:01:06+00:00,"48.86181809267, 2.3501381278038",Paris,75056,0.8666666666666667,9
19204,Rampal - Belleville,OUI,19,19,0,0,0,OUI,OUI,2025-03-13 08:58:10+00:00,"48.873114661405, 2.3798409114805",Paris,75056,0.0,9
32001,Proudhon - Président Wilson,OUI,30,10,20,9,11,OUI,OUI,2025-03-13 09:01:06+00:00,"48.906442763495, 2.3584905266762",Saint-Denis,93066,0.6666666666666666,9
18042,Place Pigalle,OUI,20,20,0,0,0,OUI,OUI,2025-03-13 08:59:36+00:00,"48.8827555, 2.3361566",Paris,75056,0.0,9
33019,Madeleine Vionnet,OUI,50,0,50,15,35,OUI,OUI,2025-03-13 09:00:43+00:00,"48.902519074064, 2.3740895837545",Aubervilliers,93001,1.0,9
11014,Place de la Nation - Taillebourg,OUI,46,30,16,15,1,OUI,OUI,2025-03-13 09:01:23+00:00,"48.8488408, 2.3973043",Paris,75056,0.34782608695652173,9
21302,Aristide Briand - Place de la Résistance,OUI,40,0,40,33,7,OUI,OUI,2025-03-13 08:59:42+00:00,"48.82124248401006, 2.2511002421379094",Issy-les-Moulineaux,92040,1.0,9
35002,Jean Jaurès - Presles,OUI,31,28,3,1,2,OUI,OUI,2025-03-13 08:59:39+00:00,"48.907134414988, 2.3960057280531",Pantin,93055,0.0967741935483871,9
12127,Tremblay - Lac des Minimes,OUI,49,2,47,16,31,OUI,OUI,2025-03-13 09:00:43+00:00,"48.834131261494, 2.4547516554594",Paris,75056,0.9591836734693877,9
11020,Belfort - Voltaire,OUI,38,25,13,9,4,OUI,OUI,2025-03-13 09:00:52+00:00,"48.8563358, 2.3829901",Paris,75056,0.34210526315789475,9
15056,Place Balard,OUI,29,4,25,23,2,OUI,OUI,2025-03-13 08:59:20+00:00,"48.836395736424, 2.2784192115068",Paris,75056,0.8620689655172413,9
11102,Alexandre Dumas - Voltaire,OUI,58,49,9,6,3,OUI,OUI,2025-03-13 08:59:29+00:00,"48.852888670365, 2.3891476408096",Paris,75056,0.15517241379310345,9
8004,Malesherbes - Place de la Madeleine,OUI,78,13,65,24,41,OUI,OUI,2025-03-13 09:00:08+00:00,"48.870406028483, 2.323243509808",Paris,75056,0.8333333333333334,9
18044,Clichy - Douai,OUI,32,28,4,1,3,OUI,OUI,2025-03-13 08:58:46+00:00,"48.883687771522, 2.328063700029",Paris,75056,0.125,9
16103,Traktir - Foch,OUI,20,11,9,3,6,OUI,OUI,2025-03-13 08:59:07+00:00,"48.872755334614, 2.2915497802487",Paris,75056,0.45,9
3004,Place de la République - Temple,OUI,16,0,16,12,4,OUI,OUI,2025-03-13 09:01:26+00:00,"48.867211201859, 2.3635464370545",Paris,75056,1.0,9
11009,Boulets - Voltaire,OUI,24,15,9,6,3,OUI,OUI,2025-03-13 08:55:39+00:00,"48.85218705621, 2.3890301585197",Paris,75056,0.375,9
35001,Jean Jaurès - Ouvrières Pivéreuses,OUI,21,20,1,0,1,OUI,OUI,2025-03-13 08:57:04+00:00,"48.910423437526, 2.3995766043663",Pantin,93055,0.047619047619047616,9
7111,Ecole Militaire - Place Joffre,OUI,24,15,9,5,4,OUI,OUI,2025-03-13 08:58:47+00:00,"48.852060203583, 2.3017993569374",Paris,75056,0.375,9
11012,Montreuil - Voltaire,OUI,33,32,1,0,1,OUI,OUI,2025-03-13 09:01:19+00:00,"48.850507011842, 2.3930755582745",Paris,75056,0.030303030303030304,9
8057,Hoche - Tilsitt,OUI,31,21,10,2,8,OUI,OUI,2025-03-13 08:59:28+00:00,"48.874836457837, 2.2971323132515",Paris,75056,0.3225806451612903,9
9025,Taitbout - Châteaudun,OUI,53,9,44,36,8,OUI,OUI,2025-03-13 09:01:02+00:00,"48.876383969379, 2.3353566779335",Paris,75056,0.8301886792452831,9
7109,Place Joffre - Frédéric le Play,OUI,37,28,9,7,2,OUI,OUI,2025-03-13 08:56:59+00:00,"48.853754486938, 2.3044242337346",Paris,75056,0.24324324324324326,9
40013,Hôtel de Ville de Créteil,OUI,36,17,19,13,6,OUI,OUI,2025-03-13 08:59:55+00:00,"48.77699496201, 2.4552552404284",Créteil,94028,0.5277777777777778,9
40014,Créteil Pointe du Lac,OUI,28,2,26,9,17,OUI,OUI,2025-03-13 09:01:26+00:00,"48.769807356177, 2.4623027310281",Créteil,94028,0.9285714285714286,9
23011,Bineau - Louise Michel,OUI,26,21,5,4,1,OUI,OUI,2025-03-13 09:00:29+00:00,"48.88666162207, 2.2843274474144",Levallois-Perret,92044,0.19230769230769232,9
16005,Raymond Poincaré - Place Victor Hugo,OUI,22,19,3,1,2,OUI,OUI,2025-03-13 08:59:55+00:00,"48.87030612437, 2.2850745414202",Paris,75056,0.13636363636363635,9
12201,Dugommier,OUI,52,48,4,2,2,OUI,OUI,2025-03-13 09:00:52+00:00,"48.838811048815, 2.3896577954292",Paris,75056,0.07692307692307693,9
12105,Bercy - Villot,OUI,38,3,35,22,13,OUI,OUI,2025-03-13 08:57:58+00:00,"48.841795009027, 2.3767850184816",Paris,75056,0.9210526315789473,9
40003,Centre Hospitalier Intercommunal de Créteil,OUI,17,17,0,0,0,OUI,OUI,2025-03-13 08:58:05+00:00,"48.797078298909, 2.463801423807",Créteil,94028,0.0,9
23801,Place de la Gare,OUI,20,17,3,1,2,OUI,OUI,2025-03-13 08:53:18+00:00,"48.838513582184, 2.1866139007512",Garches,92033,0.15,9
40004,Créteil Village,OUI,25,4,21,7,14,OUI,OUI,2025-03-13 09:00:53+00:00,"48.79122395576, 2.4642198533952",Créteil,94028,0.84,9
40008,Créteil Pompadour,OUI,44,15,29,12,17,OUI,OUI,2025-03-13 09:01:23+00:00,"48.773011623355, 2.435166164893",Créteil,94028,0.6590909090909091,9
40015,Iles de Loisirs de Créteil,OUI,24,4,20,10,10,OUI,OUI,2025-03-13 09:00:44+00:00,"48.780258200618, 2.4455094301232",Créteil,94028,0.8333333333333334,9
10031,Louis Blanc - Aqueduc,OUI,36,33,3,2,1,OUI,OUI,2025-03-13 08:59:06+00:00,"48.882030182599, 2.363561578095",Paris,75056,0.08333333333333333,9
32004,Wilson - Landy,OUI,38,20,18,12,6,OUI,OUI,2025-03-13 09:00:48+00:00,"48.91516726221354, 2.357633225619793",Saint-Denis,93066,0.47368421052631576,9
20137,Borrégo - Gambetta,OUI,25,25,0,0,0,OUI,OUI,2025-03-13 08:53:35+00:00,"48.87330497045532, 2.4014145880937576",Paris,75056,0.0,9
15103,Cauchy - Cévennes,OUI,50,5,45,42,3,OUI,OUI,2025-03-13 09:01:04+00:00,"48.843372571022, 2.2751328349113",Paris,75056,0.9,9
1022,Danielle Casanova - Place Vendôme,OUI,37,0,37,19,18,OUI,OUI,2025-03-13 09:00:16+00:00,"48.868266498223, 2.3304839059711",Paris,75056,1.0,9
41301,Bois de Vincennes - Gare,OUI,50,43,7,6,1,OUI,OUI,2025-03-13 08:57:07+00:00,"48.836022242887, 2.470833995083",Nogent-sur-Marne,94052,0.14,9
19203,Pailleron - Bouret,OUI,27,25,2,1,1,OUI,OUI,2025-03-13 09:01:24+00:00,"48.880516995482, 2.3763902374411",Paris,75056,0.07407407407407407,9
18043,Clichy - Place Blanche,OUI,18,13,5,2,3,OUI,OUI,2025-03-13 09:00:21+00:00,"48.883601088297, 2.3332237824798",Paris,75056,0.2777777777777778,9
32012,Carrefour Pleyel,OUI,65,21,44,14,30,OUI,OUI,2025-03-13 08:59:27+00:00,"48.92034156960326, 2.3438543826341625",Saint-Denis,93066,0.676923076923077,9
21404,Jean Jaurès - Gare de Clamart,OUI,20,19,1,0,1,OUI,OUI,2025-03-13 08:52:24+00:00,"48.81321981219, 2.2716768079163",Clamart,92023,0.05,9
17123,Mstislav Rostropovitch - Berthier,OUI,18,15,3,2,1,OUI,OUI,2025-03-13 08:58:41+00:00,"48.892120821173975, 2.309234105050564",Paris,75056,0.16666666666666666,9
17038,Grande Armée - Brunel,OUI,60,34,26,13,13,OUI,OUI,2025-03-13 08:58:39+00:00,"48.876116, 2.288124",Paris,75056,0.43333333333333335,9
12010,Daumesnil - Picpus,OUI,19,15,4,1,3,OUI,OUI,2025-03-13 08:56:41+00:00,"48.8374688, 2.401765",Paris,75056,0.21052631578947367,9
13123,BNF - Bibliothèque Nationale de France,OUI,43,12,31,21,10,OUI,OUI,2025-03-13 09:01:07+00:00,"48.8350268238, 2.3760157451034",Paris,75056,0.7209302325581395,9
40002,Bleuets - Bordières,OUI,21,17,4,2,2,OUI,OUI,2025-03-13 08:58:01+00:00,"48.802117531472, 2.4543687905029",Créteil,94028,0.19047619047619047,9
8002,Gare Saint-Lazare - Cour du Havre,OUI,42,30,12,6,6,OUI,OUI,2025-03-13 08:58:06+00:00,"48.875674400851, 2.3265598341823",Paris,75056,0.2857142857142857,9
21021,Enfants du Paradis - Peupliers,OUI,51,1,50,24,26,OUI,OUI,2025-03-13 09:01:07+00:00,"48.833122686454, 2.2571459412575",Boulogne-Billancourt,92012,0.9803921568627451,9
9104,Caumartin - Provence,OUI,22,1,21,15,6,OUI,OUI,2025-03-13 09:01:23+00:00,"48.874422773426545, 2.3284685611724854",Paris,75056,0.9545454545454546,9
16107,Benjamin Godard - Victor Hugo,OUI,32,28,4,1,3,OUI,OUI,2025-03-13 10:01:10+00:00,"48.865983, 2.275725",Paris,75056,0.125,10
40001,Hôpital Mondor,OUI,28,10,18,9,9,OUI,OUI,2025-03-13 10:00:21+00:00,"48.798922410229, 2.4537451531298",Créteil,94028,0.6428571428571429,10
44015,Rouget de L'isle - Watteau,OUI,20,8,12,0,12,OUI,OUI,2025-03-13 09:56:43+00:00,"48.778192750803, 2.3963020229163",Vitry-sur-Seine,94081,0.6,10
9020,Toudouze - Clauzel,OUI,21,19,2,0,2,OUI,OUI,2025-03-13 09:57:53+00:00,"48.87929591733507, 2.3373600840568547",Paris,75056,0.09523809523809523,10
14014,Jourdan - Stade Charléty,OUI,59,54,5,3,2,OUI,OUI,2025-03-13 09:59:33+00:00,"48.819428333369, 2.3433353751898",Paris,75056,0.0847457627118644,10
14111,Cassini - Denfert-Rochereau,OUI,23,11,12,4,8,OUI,OUI,2025-03-13 10:00:00+00:00,"48.837525839067, 2.3360354080796",Paris,75056,0.5217391304347826,10
32017,Basilique,OUI,20,11,9,2,7,OUI,OUI,2025-03-13 09:55:14+00:00,"48.93626891059109, 2.3588666820200914",Saint-Denis,93066,0.45,10
11104,Charonne - Robert et Sonia Delaunay,OUI,20,20,0,0,0,OUI,OUI,2025-03-13 09:53:17+00:00,"48.855907555969, 2.3925706744194",Paris,75056,0.0,10
6003,Saint-Sulpice,OUI,21,10,11,8,3,OUI,OUI,2025-03-13 10:01:03+00:00,"48.85165383178419, 2.3308077827095985",Paris,75056,0.5238095238095238,10
8026,Messine - Place Du Pérou,OUI,12,0,12,11,1,OUI,OUI,2025-03-13 09:59:42+00:00,"48.875448033960744, 2.315508019010038",Paris,75056,1.0,10
7002,Vaneau - Sèvres,OUI,35,15,20,15,5,OUI,OUI,2025-03-13 10:00:06+00:00,"48.848563233059, 2.3204218259346",Paris,75056,0.5714285714285714,10
13007,Le Brun - Gobelins,OUI,47,31,16,13,3,OUI,OUI,2025-03-13 10:00:05+00:00,"48.835092787824, 2.3534681351338",Paris,75056,0.3404255319148936,10
5110,Lacépède - Monge,OUI,23,21,2,0,2,OUI,OUI,2025-03-13 10:01:22+00:00,"48.84389286531899, 2.3519663885235786",Paris,75056,0.08695652173913043,10
42016,Pierre et Marie Curie - Maurice Thorez,OUI,26,23,3,1,2,OUI,OUI,2025-03-13 09:56:47+00:00,"48.81580226360801, 2.376804985105991",Ivry-sur-Seine,94041,0.11538461538461539,10
6108,Saint-Romain - Cherche-Midi,OUI,16,10,6,4,2,OUI,OUI,2025-03-13 09:59:34+00:00,"48.84708159081946, 2.321374788880348",Paris,75056,0.375,10
21010,Silly - Galliéni,OUI,25,17,8,5,3,OUI,OUI,2025-03-13 10:00:27+00:00,"48.835583838706, 2.2325500845909",Boulogne-Billancourt,92012,0.32,10
33006,André Karman - République,OUI,30,22,8,4,4,OUI,OUI,2025-03-13 10:00:33+00:00,"48.91039875761846, 2.3851355910301213",Aubervilliers,93001,0.26666666666666666,10
32304,Charcot - Benfleet,OUI,28,27,1,0,1,NON,NON,2025-03-13 09:51:45+00:00,"48.878370277021, 2.440523876268",Romainville,93063,0.03571428571428571,10
40011,Bas du Mont-Mesly,OUI,26,18,8,5,3,OUI,OUI,2025-03-13 10:01:22+00:00,"48.779035118572, 2.4609763908985",Créteil,94028,0.3076923076923077,10
7003,Square Boucicaut,OUI,59,21,38,18,20,OUI,OUI,2025-03-13 09:59:36+00:00,"48.851296433665276, 2.325061820447445",Paris,75056,0.6440677966101694,10
25006,Place Nelson Mandela,OUI,22,20,2,2,0,OUI,OUI,2025-03-13 09:59:24+00:00,"48.862453313908, 2.1961666225454",Rueil-Malmaison,92063,0.09090909090909091,10
17041,Guersant - Gouvion-Saint-Cyr,OUI,33,24,9,5,4,OUI,OUI,2025-03-13 09:58:09+00:00,"48.88287775178599, 2.287667370814871",Paris,75056,0.2727272727272727,10
30002,Jean Rostand - Paul Vaillant Couturier,OUI,39,27,12,7,5,OUI,OUI,2025-03-13 10:01:04+00:00,"48.908168131015, 2.4530601033354",Bobigny,93008,0.3076923076923077,10
11025,Froment - Bréguet,OUI,43,24,19,8,11,OUI,OUI,2025-03-13 10:00:10+00:00,"48.8570414504784, 2.37289470306807",Paris,75056,0.4418604651162791,10
5016,Thouin - Cardinal Lemoine,OUI,16,4,12,0,12,OUI,OUI,2025-03-13 10:01:19+00:00,"48.84504716661511, 2.3494647851273465",Paris,75056,0.75,10
15047,Morillons - Dantzig,OUI,51,51,0,0,0,OUI,OUI,2025-03-13 09:53:05+00:00,"48.83310149953933, 2.299380004405976",Paris,75056,0.0,10
17026,Jouffroy d'Abbans - Wagram,OUI,39,20,19,11,8,OUI,OUI,2025-03-13 09:57:32+00:00,"48.881973298352, 2.301132157445",Paris,75056,0.48717948717948717,10
15202,Bracion - Périphérique,OUI,30,21,9,4,5,OUI,OUI,2025-03-13 10:01:06+00:00,"48.826103771275, 2.3004549373748",Paris,75056,0.3,10
6021,Beaux-Arts - Bonaparte,OUI,20,2,18,11,7,OUI,OUI,2025-03-13 10:00:06+00:00,"48.856451985396, 2.3348518833518",Paris,75056,0.9,10
2022,Saint-Fiacre - Poissonière,OUI,33,4,29,16,13,OUI,OUI,2025-03-13 10:00:56+00:00,"48.870828911558, 2.3459213599563",Paris,75056,0.8787878787878788,10
12109,Mairie du 12ème,OUI,29,27,2,2,0,OUI,OUI,2025-03-13 10:00:01+00:00,"48.840855311763, 2.3875549435616",Paris,75056,0.06896551724137931,10
20143,Ramponeau - Belleville,OUI,44,42,2,2,0,OUI,OUI,2025-03-13 10:01:21+00:00,"48.871031137596, 2.379056852114",Paris,75056,0.045454545454545456,10
8050,Boétie - Ponthieu,OUI,43,2,41,11,30,OUI,OUI,2025-03-13 10:01:00+00:00,"48.871417284355, 2.3076787590981",Paris,75056,0.9534883720930233,10
15068,Général Martial Valin - Pont du Garigliano,OUI,14,1,13,5,8,OUI,OUI,2025-03-13 09:54:25+00:00,"48.83823094269141, 2.270506024360657",Paris,75056,0.9285714285714286,10
13101,Croulebarde - Corvisart,OUI,33,25,8,6,2,OUI,OUI,2025-03-13 10:01:12+00:00,"48.830981659316855, 2.3481646925210953",Paris,75056,0.24242424242424243,10
19027,Serrurier,OUI,18,18,0,0,0,OUI,OUI,2025-03-13 09:57:33+00:00,"48.880493403246, 2.398064173758",Paris,75056,0.0,10
14108,Le Brix et Mesmin - Jourdan,OUI,19,18,1,1,0,OUI,OUI,2025-03-13 09:58:36+00:00,"48.82234096593411, 2.327861653302471",Paris,75056,0.05263157894736842,10
44017,Jules Guesde - Pont du Port à l'Anglais,OUI,26,1,25,24,1,OUI,OUI,2025-03-13 09:59:16+00:00,"48.79628807093802, 2.417212128639221",Vitry-sur-Seine,94081,0.9615384615384616,10
31024,Romainville - Vaillant-Couturier,OUI,36,35,1,0,1,OUI,OUI,2025-03-13 10:00:03+00:00,"48.86785, 2.446748",Montreuil,93048,0.027777777777777776,10
9008,Tour d'Auvergne - Rodier,OUI,16,15,1,0,1,OUI,OUI,2025-03-13 10:00:55+00:00,"48.879161, 2.343698",Paris,75056,0.0625,10
17044,Porte de Saint-Ouen - Bessières,OUI,42,34,8,3,5,OUI,OUI,2025-03-13 09:59:08+00:00,"48.89792240854517, 2.32851451022192",Paris,75056,0.19047619047619047,10
14013,Liard - Amiral Mouchez,OUI,26,23,3,1,2,OUI,OUI,2025-03-13 09:58:10+00:00,"48.8214169, 2.342167",Paris,75056,0.11538461538461539,10
19033,Cambrai - Benjamin Constant,OUI,40,33,7,2,5,OUI,OUI,2025-03-13 09:59:14+00:00,"48.89594736851349, 2.381133802246315",Paris,75056,0.175,10
15112,Vigée-Lebrun - Anselme Payen,OUI,23,20,3,3,0,OUI,OUI,2025-03-13 10:00:24+00:00,"48.838683941628375, 2.3110422492027287",Paris,75056,0.13043478260869565,10
17025,Chazelles - Courcelles,OUI,33,14,19,3,16,OUI,OUI,2025-03-13 10:00:43+00:00,"48.879406604954, 2.3034455627202988",Paris,75056,0.5757575757575758,10
9002,Abbeville - Faubourg Poissonnière,OUI,13,11,2,2,0,OUI,OUI,2025-03-13 09:55:53+00:00,"48.879223, 2.349147",Paris,75056,0.15384615384615385,10
21326,Moulin de Pierre - Abbé Grégoire,OUI,20,18,2,0,2,OUI,OUI,2025-03-13 09:55:47+00:00,"48.822036188382, 2.2754641655975",Issy-les-Moulineaux,92040,0.1,10
16110,Octave Feuillet - Albéric Magnard,OUI,21,2,19,3,16,OUI,OUI,2025-03-13 09:59:32+00:00,"48.86106902949534, 2.2730283066630363",Paris,75056,0.9047619047619048,10
43002,Lagny - Victor Basch,OUI,24,17,7,5,2,OUI,OUI,2025-03-13 09:59:13+00:00,"48.84884147189881, 2.426325418925233",Vincennes,94080,0.2916666666666667,10
43009,Place Jean-Spire-Lemaître,OUI,48,48,0,0,0,OUI,OUI,2025-03-13 09:52:39+00:00,"48.8468428626593, 2.452062070369721",Vincennes,94080,0.0,10
16138,Saint-Cloud - Hippodrome,OUI,30,22,8,3,5,OUI,OUI,2025-03-13 09:55:29+00:00,"48.85772148887421, 2.2549109905958176",Paris,75056,0.26666666666666666,10
17032,Jean Oestreicher - Porte de Champerret,OUI,21,4,17,9,8,OUI,OUI,2025-03-13 10:01:12+00:00,"48.88655580065981, 2.288640439510346",Paris,75056,0.8095238095238095,10
21216,Louis Lejeune - Barbès,OUI,24,23,1,0,1,OUI,OUI,2025-03-13 09:51:48+00:00,"48.81807418981508, 2.3267009854316716",Montrouge,92049,0.041666666666666664,10
10115,Granges aux Belles,OUI,27,25,2,2,0,OUI,OUI,2025-03-13 10:00:45+00:00,"48.8761373390584, 2.3680844979417",Paris,75056,0.07407407407407407,10
22207,Rond-point du Dr Albert Schweitzer,OUI,21,16,5,3,2,OUI,OUI,2025-03-13 09:57:00+00:00,"48.78980918988166, 2.3143940046429634",Bagneux,92007,0.23809523809523808,10
12031,Gabriel Lamé,OUI,34,26,8,6,2,OUI,OUI,2025-03-13 10:00:35+00:00,"48.8351212784276, 2.385534569621086",Paris,75056,0.23529411764705882,10
92002,Théâtre des Amandiers - Palais des sports,OUI,23,5,18,8,10,OUI,OUI,2025-03-13 10:00:18+00:00,"48.892648526839, 2.2136941552162",Nanterre,92050,0.782608695652174,10
1001,Quai de l'Horloge - Pont Neuf,OUI,16,1,15,12,3,OUI,OUI,2025-03-13 10:01:14+00:00,"48.857058739111, 2.3417982839439",Paris,75056,0.9375,10
31028,Raspail Barbès,OUI,28,26,2,1,1,OUI,OUI,2025-03-13 10:01:28+00:00,"48.8529945, 2.4247387",Montreuil,93048,0.07142857142857142,10
5022,Boulangers - Cardinal Lemoine,OUI,18,4,14,9,5,OUI,OUI,2025-03-13 09:59:23+00:00,"48.8462904, 2.3521495",Paris,75056,0.7777777777777778,10
17048,De Toqueville - Terrasse,OUI,30,27,3,3,0,OUI,OUI,2025-03-13 09:59:29+00:00,"48.882428, 2.314002",Paris,75056,0.1,10
17040,Pereire - Ternes,OUI,48,46,2,1,1,OUI,OUI,2025-03-13 09:56:49+00:00,"48.87973954830735, 2.288012132048607",Paris,75056,0.041666666666666664,10
9038,Douai - Bruxelles,OUI,26,21,5,0,5,OUI,OUI,2025-03-13 09:59:04+00:00,"48.88320784122797, 2.3308449949028507",Paris,75056,0.19230769230769232,10
16118,Michel-Ange - Parent de Rosan,OUI,24,19,5,1,4,OUI,OUI,2025-03-13 10:01:00+00:00,"48.840579923690115, 2.2584119439125065",Paris,75056,0.20833333333333334,10
17008,Porte Pouchet-Bessières,OUI,23,12,11,9,2,OUI,OUI,2025-03-13 09:59:08+00:00,"48.8978765, 2.3230632",Paris,75056,0.4782608695652174,10
2017,Caire - Dussoubs,OUI,39,3,36,27,9,OUI,OUI,2025-03-13 10:01:08+00:00,"48.86785342111862, 2.349364310503006",Paris,75056,0.9230769230769231,10
7018,Ségur - d'Estrées,OUI,19,1,18,8,10,OUI,OUI,2025-03-13 10:00:35+00:00,"48.851419978983, 2.3097044974566",Paris,75056,0.9473684210526315,10
8103,Artois - Berri,OUI,22,2,20,9,11,OUI,OUI,2025-03-13 10:00:44+00:00,"48.87393521240818, 2.3064258322119713",Paris,75056,0.9090909090909091,10
21323,Charlot - Stade Gabriel Voisin,OUI,31,1,30,26,4,OUI,OUI,2025-03-13 10:01:26+00:00,"48.827228120536, 2.268122527474",Issy-les-Moulineaux,92040,0.967741935483871,10
8048,Marceau - Chaillot,OUI,19,5,14,4,10,OUI,OUI,2025-03-13 09:59:34+00:00,"48.868834023334, 2.2986030816809",Paris,75056,0.7368421052631579,10
8053,Place Georges Guillaumin,OUI,27,11,16,6,10,OUI,OUI,2025-03-13 09:58:53+00:00,"48.874750203957, 2.301771435326",Paris,75056,0.5925925925925926,10
13118,Regnault - Patay,OUI,62,10,52,41,11,OUI,OUI,2025-03-13 09:59:12+00:00,"48.82435782216384, 2.377065159380436",Paris,75056,0.8387096774193549,10
9014,Faubourg Montmartre - La Fayette,OUI,32,1,31,17,14,OUI,OUI,2025-03-13 10:00:33+00:00,"48.875254549053, 2.3408536612988",Paris,75056,0.96875,10
13030,Italie - Tolbiac,OUI,21,19,2,2,0,OUI,OUI,2025-03-13 10:00:22+00:00,"48.82557229464416, 2.3576171323657036",Paris,75056,0.09523809523809523,10
31706,Château - République,OUI,25,19,6,2,4,OUI,OUI,2025-03-13 10:01:13+00:00,"48.862923800596, 2.4155035614967",Bagnolet,93006,0.24,10
18111,Félix Ziem - Armand Gauthier,OUI,21,21,0,0,0,OUI,OUI,2025-03-13 09:56:54+00:00,"48.88949630486821, 2.333393658804396",Paris,75056,0.0,10
19015,Thionville - Ourcq,OUI,22,22,0,0,0,OUI,OUI,2025-03-13 09:56:34+00:00,"48.88917613743794, 2.3833653330802917",Paris,75056,0.0,10
48003,Youri Gagarine - Karl Marx,OUI,22,18,4,2,2,OUI,OUI,2025-03-13 09:55:29+00:00,"48.78448485079149, 2.35908430069685",Villejuif,94076,0.18181818181818182,10
17004,Legendre - Clichy,OUI,39,35,4,1,3,OUI,OUI,2025-03-13 09:58:56+00:00,"48.88896161855884, 2.322528975094376",Paris,75056,0.10256410256410256,10
9001,Bellefond - Poissonnière,OUI,14,11,3,2,1,OUI,OUI,2025-03-13 09:59:32+00:00,"48.87759897050706, 2.348463758826256",Paris,75056,0.21428571428571427,10
19003,Quai de la Seine,OUI,24,23,1,0,1,OUI,OUI,2025-03-13 09:59:24+00:00,"48.884492238407525, 2.3703941702842717",Paris,75056,0.041666666666666664,10
8016,Square Louis XVI,OUI,29,2,27,15,12,OUI,OUI,2025-03-13 09:59:02+00:00,"48.87320440102894, 2.323658830743138",Paris,75056,0.9310344827586207,10
5020,Institut du Monde Arabe - Saint-Germain,OUI,38,3,35,32,3,OUI,OUI,2025-03-13 10:00:41+00:00,"48.849063299501, 2.3558086529374",Paris,75056,0.9210526315789473,10
10029,Dunkerque - Rocroy,OUI,24,23,1,0,1,OUI,OUI,2025-03-13 09:57:26+00:00,"48.880726, 2.351464",Paris,75056,0.041666666666666664,10
92007,Pesaro - Préfecture,OUI,21,12,9,2,7,OUI,OUI,2025-03-13 10:01:26+00:00,"48.89577046284005, 2.223908342421055",Nanterre,92050,0.42857142857142855,10
10161,Gare de l'Est - Faubourg-Saint-Martin,OUI,32,25,7,2,5,OUI,OUI,2025-03-13 09:56:52+00:00,"48.875642647477, 2.3594588041306",Paris,75056,0.21875,10
26002,Redoute - Les Courtilles,OUI,37,14,23,16,7,OUI,OUI,2025-03-13 10:01:10+00:00,"48.929867194519, 2.2836696356535",Asnières-sur-Seine,92004,0.6216216216216216,10
41303,Gare de Nogent-le-Perreux,OUI,30,18,12,10,2,OUI,OUI,2025-03-13 09:58:56+00:00,"48.83842553348809, 2.493693307042122",Nogent-sur-Marne,94052,0.4,10
11023,Saint-Maur - Roquette,OUI,46,43,3,0,3,OUI,OUI,2025-03-13 10:00:21+00:00,"48.858688774062955, 2.383553994571467",Paris,75056,0.06521739130434782,10
21328,Verger - Colonel Guichard,OUI,29,27,2,0,2,OUI,OUI,2025-03-13 10:00:59+00:00,"48.816376985087, 2.2670380088932",Issy-les-Moulineaux,92040,0.06896551724137931,10
45003,11 Novembre 1918 - 8 Mai 1945,OUI,36,13,23,14,9,OUI,OUI,2025-03-13 09:55:31+00:00,"48.80889533774377, 2.5382421165704727",Champigny-sur-Marne,94017,0.6388888888888888,10
13104,Gare d'Austerlitz - Quai Saint-Bernard,OUI,26,4,22,16,6,OUI,OUI,2025-03-13 10:00:15+00:00,"48.84369030864, 2.3657163977623",Paris,75056,0.8461538461538461,10
11047,Amelot - Saint-Sébastien,OUI,29,13,16,10,6,OUI,OUI,2025-03-13 10:01:25+00:00,"48.861142162761, 2.3677996181077",Paris,75056,0.5517241379310345,10
8009,Gare Saint-Lazare - Isly,OUI,25,11,14,9,5,OUI,OUI,2025-03-13 10:01:03+00:00,"48.874777677621296, 2.326515804784655",Paris,75056,0.56,10
5032,Panthéon - Valette,OUI,39,0,39,6,33,OUI,OUI,2025-03-13 09:58:56+00:00,"48.847020571652, 2.3464982619671",Paris,75056,1.0,10
31103,Gare Rosny-Bois-Perrier,OUI,32,14,18,0,18,OUI,OUI,2025-03-13 09:59:26+00:00,"48.88115023337061, 2.480436824262142",Rosny-sous-Bois,93064,0.5625,10
20042,Pyrénées - Emmery,OUI,39,37,2,0,2,OUI,OUI,2025-03-13 09:56:02+00:00,"48.872010281270974, 2.392039597034455",Paris,75056,0.05128205128205128,10
18203,Lamarck - Saint-Ouen,OUI,40,40,0,0,0,NON,NON,2025-03-13 09:57:16+00:00,"48.891334555236, 2.3272445342326",Paris,75056,0.0,10
15067,Desaix - Edgar Faure,OUI,11,3,8,5,3,OUI,OUI,2025-03-13 09:57:55+00:00,"48.852804604940296, 2.293077029857222",Paris,75056,0.7272727272727273,10
5005,Gay Lussac - Saint-Jacques,OUI,24,1,23,6,17,OUI,OUI,2025-03-13 09:54:05+00:00,"48.844730256132, 2.3419239448664",Paris,75056,0.9583333333333334,10
17030,Pereire - Rennequin,OUI,22,21,1,0,1,OUI,OUI,2025-03-13 09:57:42+00:00,"48.88364782887555, 2.2952447086572647",Paris,75056,0.045454545454545456,10
9106,Boudreau - Auber,OUI,27,7,20,7,13,OUI,OUI,2025-03-13 09:59:26+00:00,"48.87219, 2.329423",Paris,75056,0.7407407407407407,10
6006,Notre-Dame-des-Champs - Stanislas,OUI,19,1,18,12,6,OUI,OUI,2025-03-13 09:57:20+00:00,"48.84479928858768, 2.329337755887181",Paris,75056,0.9473684210526315,10
19105,Ambroise Rendu - Porte Brunet,OUI,17,14,3,2,1,OUI,OUI,2025-03-13 10:00:33+00:00,"48.883667, 2.395733",Paris,75056,0.17647058823529413,10
11027,Saint-Ambroise - Parmentier,OUI,34,18,16,11,5,OUI,OUI,2025-03-13 10:00:38+00:00,"48.862147844548, 2.3772348091006",Paris,75056,0.47058823529411764,10
22409,Henri Barbusse - Stalingrad,OUI,15,15,0,0,0,OUI,OUI,2025-03-13 09:54:13+00:00,"48.814183748660554, 2.2872862592339516",Malakoff,92046,0.0,10
8010,Liège - Moscou,OUI,15,13,2,0,2,OUI,OUI,2025-03-13 10:00:14+00:00,"48.8795431, 2.3264628",Paris,75056,0.13333333333333333,10
9022,Rossini - Laffitte,OUI,33,2,31,18,13,OUI,OUI,2025-03-13 10:00:49+00:00,"48.87334627510507, 2.337980867701675",Paris,75056,0.9393939393939394,10
41302,Charles de Gaulle - Beauté,OUI,48,48,0,0,0,OUI,OUI,2025-03-13 09:59:31+00:00,"48.83649602312711, 2.479562651149885",Nogent-sur-Marne,94052,0.0,10
26003,Argenteuil - Voltaire,OUI,16,14,2,1,1,OUI,OUI,2025-03-13 09:57:26+00:00,"48.91864865955558, 2.2814112156629562",Asnières-sur-Seine,92004,0.125,10
14020,Cimetière de Montrouge,OUI,58,54,4,1,3,OUI,OUI,2025-03-13 09:54:18+00:00,"48.821466904768, 2.3215785772007",Paris,75056,0.06896551724137931,10
12151,Gare de Lyon - Place Louis Armand,OUI,58,4,54,44,10,OUI,OUI,2025-03-13 10:01:26+00:00,"48.845515089794, 2.3726498446286",Paris,75056,0.9310344827586207,10
21212,Marne - Germain Dardan,OUI,21,18,3,2,1,OUI,OUI,2025-03-13 09:59:40+00:00,"48.81217465201, 2.3035024699104",Montrouge,92049,0.14285714285714285,10
16026,Ranelagh - Mozart,OUI,7,5,2,1,1,OUI,OUI,2025-03-13 10:00:06+00:00,"48.8554439, 2.2704418",Paris,75056,0.2857142857142857,10
44006,Concorde - Stalingrad,OUI,35,31,4,1,3,OUI,OUI,2025-03-13 09:56:52+00:00,"48.7985844, 2.3821302",Vitry-sur-Seine,94081,0.11428571428571428,10
9028,Moncey - Blanche,OUI,17,10,7,5,2,OUI,OUI,2025-03-13 09:58:34+00:00,"48.88006587474148, 2.3310810327529907",Paris,75056,0.4117647058823529,10
19120,Carducci - Place Hannah Arendt,OUI,27,26,1,0,1,OUI,OUI,2025-03-13 10:00:55+00:00,"48.877436681515796, 2.3860743641853337",Paris,75056,0.037037037037037035,10
10107,Gare du Nord - Hôpital Lariboisière,OUI,49,48,1,0,1,OUI,OUI,2025-03-13 09:58:29+00:00,"48.881949, 2.352339",Paris,75056,0.02040816326530612,10
11113,Richard Lenoir - Republique,OUI,57,18,39,37,2,OUI,OUI,2025-03-13 10:00:59+00:00,"48.8667175, 2.3692541",Paris,75056,0.6842105263157895,10
17043,Belidor - Gouvion-Saint-Cyr,OUI,38,26,12,11,1,OUI,OUI,2025-03-13 10:01:17+00:00,"48.88022154052015, 2.2854680567979813",Paris,75056,0.3157894736842105,10
14003,Schoelcher - Raspail,OUI,48,43,5,1,4,OUI,OUI,2025-03-13 09:56:05+00:00,"48.83681733526843, 2.3312794080411474",Paris,75056,0.10416666666666667,10
19026,Place de Rhin et Danube,OUI,14,14,0,0,0,OUI,OUI,2025-03-13 09:53:32+00:00,"48.88192765861766, 2.392586767673493",Paris,75056,0.0,10
43008,Fontenay - Libération,OUI,25,20,5,0,5,OUI,OUI,2025-03-13 09:59:42+00:00,"48.847803063647, 2.4451419711113",Vincennes,94080,0.2,10
16039,Exelmans - Versailles,OUI,47,15,32,23,9,OUI,OUI,2025-03-13 09:59:52+00:00,"48.84097491091973, 2.264390252530575",Paris,75056,0.6808510638297872,10
19101,Square Simon Bolivar,OUI,23,20,3,1,2,OUI,OUI,2025-03-13 10:01:10+00:00,"48.875089888322, 2.3826304078102",Paris,75056,0.13043478260869565,10
11002,Roquette - Thiéré,OUI,22,1,21,16,5,OUI,OUI,2025-03-13 10:01:27+00:00,"48.85507930579506, 2.3733686318721463",Paris,75056,0.9545454545454546,10
14138,Porte de Vanves,OUI,29,25,4,1,3,OUI,OUI,2025-03-13 09:55:31+00:00,"48.828012849445, 2.3056878894567",Paris,75056,0.13793103448275862,10
12111,Claude Decaen - Cannebière,OUI,27,25,2,0,2,OUI,OUI,2025-03-13 09:59:45+00:00,"48.83761417037952, 2.397253782195704",Paris,75056,0.07407407407407407,10
46003,Conservatoire de Musique,OUI,24,2,22,19,3,OUI,OUI,2025-03-13 10:01:27+00:00,"48.77093586667601, 2.4034014344215398",Choisy-le-Roi,94022,0.9166666666666666,10
8034,Berri - Haussmann,OUI,34,3,31,11,20,OUI,OUI,2025-03-13 09:59:24+00:00,"48.874746047357135, 2.3082953318953514",Paris,75056,0.9117647058823529,10
41209,Cimetière de Fontenay-sous-Bois,OUI,15,15,0,0,0,OUI,OUI,2025-03-13 09:59:14+00:00,"48.84706173362218, 2.4787822365760808",Fontenay-sous-Bois,94033,0.0,10
19043,Delphine Seyrig - Général Leclerc,OUI,51,45,6,2,4,OUI,OUI,2025-03-13 09:57:52+00:00,"48.893923963057865, 2.39790290594101",Pantin,93055,0.11764705882352941,10
13001,Port-Royal - Hôpital du Val-de-Grâce,OUI,17,13,4,0,4,OUI,OUI,2025-03-13 10:00:10+00:00,"48.837668272811, 2.3448138346607",Paris,75056,0.23529411764705882,10
18107,Chartres - La Charbonnière,OUI,34,34,0,0,0,OUI,OUI,2025-03-13 09:57:34+00:00,"48.8847601, 2.3534657",Paris,75056,0.0,10
15054,Lecourbe - Jean Maridor,OUI,18,15,3,2,1,OUI,OUI,2025-03-13 10:01:15+00:00,"48.83796366147599, 2.2877392172813416",Paris,75056,0.16666666666666666,10
12128,Pyramide - Ecole du Breuil,OUI,33,27,6,2,4,OUI,OUI,2025-03-13 09:58:24+00:00,"48.82237977153955, 2.4586871266365056",Paris,75056,0.18181818181818182,10
15106,Grenelle - Violet,OUI,34,18,16,14,2,OUI,OUI,2025-03-13 09:55:03+00:00,"48.84993035512154, 2.294612042605877",Paris,75056,0.47058823529411764,10
31022,Mairie de Montreuil,OUI,51,49,2,2,0,OUI,OUI,2025-03-13 09:58:36+00:00,"48.86131452758348, 2.440614402294159",Montreuil,93048,0.0392156862745098,10
2111,Chabanais - Petits Champs,OUI,29,1,28,22,6,OUI,OUI,2025-03-13 09:58:10+00:00,"48.86703740186721, 2.336716018617153",Paris,75056,0.9655172413793104,10
46002,Rouget de Lisle,OUI,35,3,32,16,16,OUI,OUI,2025-03-13 09:55:42+00:00,"48.764615483395254, 2.4071189761161804",Choisy-le-Roi,94022,0.9142857142857143,10
18022,Marcadet - Barbès,OUI,34,33,1,0,1,OUI,OUI,2025-03-13 10:00:36+00:00,"48.890451120965, 2.3490573929687",Paris,75056,0.029411764705882353,10
10016,Récollets - Square Villemin,OUI,17,13,4,2,2,OUI,OUI,2025-03-13 10:00:10+00:00,"48.875034655883944, 2.359801238597928",Paris,75056,0.23529411764705882,10
14012,Sibelle - Alésia,OUI,37,36,1,0,1,OUI,OUI,2025-03-13 09:58:57+00:00,"48.826701758539215, 2.3384983465075493",Paris,75056,0.02702702702702703,10
31009,Place Du Général De Gaulle,OUI,25,24,1,0,1,OUI,OUI,2025-03-13 09:58:11+00:00,"48.8687591, 2.4329931",Montreuil,93048,0.04,10
10042,Enghien - Faubourg Poissonnière,OUI,32,6,26,16,10,OUI,OUI,2025-03-13 09:55:29+00:00,"48.872420063053, 2.3483952362828",Paris,75056,0.8125,10
33017,Anatole France - President Roosevelt,OUI,25,17,8,5,3,OUI,OUI,2025-03-13 10:00:52+00:00,"48.9155156, 2.3814103",Aubervilliers,93001,0.32,10
17203,Place de la Porte de Champeret,OUI,28,9,19,18,1,OUI,OUI,2025-03-13 10:00:01+00:00,"48.886062068226, 2.2917001576821",Paris,75056,0.6785714285714286,10
15042,Henry Farman,OUI,16,3,13,11,2,OUI,OUI,2025-03-13 09:56:58+00:00,"48.83372430280548, 2.2713854536414146",Paris,75056,0.8125,10
4016,Lobau - Hôtel de Ville,OUI,59,2,57,47,10,OUI,OUI,2025-03-13 10:01:22+00:00,"48.8562118, 2.3532536",Paris,75056,0.9661016949152542,10
18011,Pajol - Place Herbert,OUI,39,39,0,0,0,OUI,OUI,2025-03-13 09:58:25+00:00,"48.8927825, 2.3635598",Paris,75056,0.0,10
8045,Place de la Reine Astrid,OUI,56,21,35,16,19,OUI,OUI,2025-03-13 10:00:00+00:00,"48.864920982538, 2.3025491823859",Paris,75056,0.625,10
33102,Gabriel Péri - Francisco Ferrer,OUI,17,16,1,0,1,OUI,OUI,2025-03-13 09:53:01+00:00,"48.88633710236977, 2.407338917255402",Le Pré-Saint-Gervais,93061,0.058823529411764705,10
15133,Saint Lambert - Blomet,OUI,25,19,6,4,2,OUI,OUI,2025-03-13 09:58:33+00:00,"48.83659148147257, 2.2930556908249855",Paris,75056,0.24,10
42706,Roger Salengro - Fontainebleau,OUI,25,24,1,0,1,OUI,OUI,2025-03-13 10:00:41+00:00,"48.814548697325, 2.3611663654447",Le Kremlin-Bicêtre,94043,0.04,10
15110,Place Robert Guillemard,OUI,22,3,19,18,1,OUI,OUI,2025-03-13 09:59:05+00:00,"48.836191728066666, 2.2811267160086417",Paris,75056,0.8636363636363636,10
18003,Cimetière de Montmartre,OUI,43,41,2,0,2,OUI,OUI,2025-03-13 09:54:01+00:00,"48.886472466142, 2.3328901827335",Paris,75056,0.046511627906976744,10
15104,Hôpital Européen Georges Pompidou,OUI,64,6,58,49,9,OUI,OUI,2025-03-13 10:00:59+00:00,"48.837695319163, 2.2753742337227",Paris,75056,0.90625,10
20131,Repos - Cimetière du Père Lachaise,OUI,33,32,1,1,0,OUI,OUI,2025-03-13 09:53:59+00:00,"48.859358523593, 2.3896131366845",Paris,75056,0.030303030303030304,10
5018,Mutualité,OUI,37,10,27,21,6,OUI,OUI,2025-03-13 09:59:37+00:00,"48.848225572724, 2.3502873256803",Paris,75056,0.7297297297297297,10
21015,Nationale - Place Jules Guesde,OUI,23,4,19,10,9,OUI,OUI,2025-03-13 10:00:27+00:00,"48.82753962462998, 2.2416052222251897",Boulogne-Billancourt,92012,0.8260869565217391,10
19103,Manin - Carrières d'Amérique,OUI,17,16,1,0,1,OUI,OUI,2025-03-13 09:59:09+00:00,"48.88467214209463, 2.3919698596000676",Paris,75056,0.058823529411764705,10
5028,Censier - Jardin des Plantes,OUI,28,4,24,21,3,OUI,OUI,2025-03-13 09:57:32+00:00,"48.84107178161383, 2.355475388467312",Paris,75056,0.8571428571428571,10
12114,Victor Hugo - Jeanne Jugan,OUI,28,25,3,1,2,OUI,OUI,2025-03-13 09:54:59+00:00,"48.843949064031825, 2.415081394834419",Paris,75056,0.10714285714285714,10
22203,Tertres - Fontaine,OUI,27,26,1,0,1,OUI,OUI,2025-03-13 09:59:52+00:00,"48.787553654715644, 2.306235730648041",Bagneux,92007,0.037037037037037035,10
21312,Lucie Aubrac - Fort,OUI,30,30,0,0,0,OUI,OUI,2025-03-13 09:53:01+00:00,"48.818144834008976, 2.271184623241425",Issy-les-Moulineaux,92040,0.0,10
1119,Cossonnerie - Sébastopol,OUI,23,10,13,7,6,OUI,OUI,2025-03-13 09:57:09+00:00,"48.86132665908402, 2.349419631063938",Paris,75056,0.5652173913043478,10
14008,Mouton Duvernet - Général Leclerc,OUI,26,24,2,0,2,OUI,OUI,2025-03-13 10:01:02+00:00,"48.831632518293, 2.3293121159077",Paris,75056,0.07692307692307693,10
1020,Cambon - Rivoli,OUI,34,3,31,17,14,OUI,OUI,2025-03-13 10:00:27+00:00,"48.866143390992, 2.3251800647137",Paris,75056,0.9117647058823529,10
18028,Championnet - Vauvenargues,OUI,31,30,1,0,1,OUI,OUI,2025-03-13 09:59:49+00:00,"48.89401874744574, 2.3319872841238976",Paris,75056,0.03225806451612903,10
20115,Louis Lumière - Porte de Bagnolet,OUI,20,20,0,0,0,OUI,OUI,2025-03-13 09:53:28+00:00,"48.86431136000005, 2.4105210229754443",Paris,75056,0.0,10
8017,Rocher - Laborde,OUI,65,51,14,9,5,OUI,OUI,2025-03-13 10:00:17+00:00,"48.87590240712654, 2.322616316378116",Paris,75056,0.2153846153846154,10
22402,Jean Jaurès - Salvador Allende,OUI,42,39,3,0,3,OUI,OUI,2025-03-13 09:59:54+00:00,"48.821475594736775, 2.3026576638221745",Malakoff,92046,0.07142857142857142,10
5124,Erasme - Ulm,OUI,22,2,20,0,20,OUI,OUI,2025-03-13 10:01:16+00:00,"48.84264375274712, 2.3445946723222733",Paris,75056,0.9090909090909091,10
9116,Victoire - Chaussée d'Antin,OUI,24,1,23,9,14,OUI,OUI,2025-03-13 09:59:23+00:00,"48.875065791004396, 2.3316738009452824",Paris,75056,0.9583333333333334,10
14106,Marc Sangnier - Porte de Vanves,OUI,20,20,0,0,0,OUI,OUI,2025-03-13 10:01:27+00:00,"48.825218683556734, 2.3107116669416428",Paris,75056,0.0,10
17013,Legendre - Dulong,OUI,23,22,1,0,1,OUI,OUI,2025-03-13 09:57:16+00:00,"48.885325169402904, 2.316423766314984",Paris,75056,0.043478260869565216,10
18046,Etienne Jodelle - Saint Ouen,OUI,32,31,1,0,1,OUI,OUI,2025-03-13 09:52:17+00:00,"48.88794016394694, 2.326124420314341",Paris,75056,0.03125,10
11026,Chemin Vert - Saint-Maur,OUI,44,42,2,0,2,OUI,OUI,2025-03-13 09:57:00+00:00,"48.86112461407359, 2.381299026310444",Paris,75056,0.045454545454545456,10
22406,Guy Môquet - Etienne Dolet,OUI,22,21,1,0,1,OUI,OUI,2025-03-13 09:58:03+00:00,"48.81527009991819, 2.298078276995073",Malakoff,92046,0.045454545454545456,10
32604,Square du Théâtre du Garde-Chasse,OUI,50,48,2,0,2,OUI,OUI,2025-03-13 09:56:10+00:00,"48.881287375060616, 2.420119643211365",Les Lilas,93045,0.04,10
31102,Boissière - Etienne Dolet,OUI,20,19,1,1,0,OUI,OUI,2025-03-13 10:01:13+00:00,"48.876111, 2.4677312",Montreuil,93048,0.05,10
23006,Jules Guesde - Alsace,OUI,23,3,20,10,10,OUI,OUI,2025-03-13 09:58:34+00:00,"48.890566275506, 2.2950777411461",Levallois-Perret,92044,0.8695652173913043,10
8054,Bertie Albrecht - Hoche,OUI,32,12,20,8,12,OUI,OUI,2025-03-13 09:56:18+00:00,"48.87614039826388, 2.301303138307601",Paris,75056,0.625,10
17105,Place Madeleine Daniélou,OUI,42,16,26,19,7,OUI,OUI,2025-03-13 10:01:00+00:00,"48.883498, 2.282015",Paris,75056,0.6190476190476191,10
15109,Cevennes - Bergers,OUI,28,20,8,5,3,OUI,OUI,2025-03-13 10:01:25+00:00,"48.84240765130395, 2.281037718057633",Paris,75056,0.2857142857142857,10
9010,Rochechouart lamartine,OUI,23,18,5,0,5,OUI,OUI,2025-03-13 09:57:55+00:00,"48.876719895109, 2.344393021854",Paris,75056,0.21739130434782608,10
21209,Molière - République,OUI,30,28,2,0,2,OUI,OUI,2025-03-13 09:54:21+00:00,"48.81111581390707, 2.3145738624448158",Montrouge,92049,0.06666666666666667,10
11105,Parmentier - République,OUI,21,16,5,1,4,OUI,OUI,2025-03-13 09:59:46+00:00,"48.8644954, 2.3750124",Paris,75056,0.23809523809523808,10
21005,Hôtel de Ville de Boulogne Billancourt,OUI,25,6,19,9,10,OUI,OUI,2025-03-13 09:54:41+00:00,"48.83495885166784, 2.2416803240776066",Boulogne-Billancourt,92012,0.76,10
16108,Sablons - Georges Mandel,OUI,38,35,3,1,2,OUI,OUI,2025-03-13 09:54:17+00:00,"48.863875, 2.28189",Paris,75056,0.07894736842105263,10
35010,Hoche - Jean Lolive,OUI,20,15,5,3,2,OUI,OUI,2025-03-13 09:59:30+00:00,"48.89110239200789, 2.402843534946442",Pantin,93055,0.25,10
17125,Marie-Georges Picquart - Pereire,OUI,31,25,6,2,4,OUI,OUI,2025-03-13 09:58:48+00:00,"48.88863669349711, 2.3111706599593163",Paris,75056,0.1935483870967742,10
42014,Place Marcel Cachin,OUI,32,3,29,25,4,OUI,OUI,2025-03-13 09:58:45+00:00,"48.81411442356866, 2.39090770483017",Ivry-sur-Seine,94041,0.90625,10
16136,Théophile Gautier - François Millet,OUI,27,22,5,2,3,OUI,OUI,2025-03-13 10:01:07+00:00,"48.85034821320644, 2.273029983043671",Paris,75056,0.18518518518518517,10
14124,David Weill - Parc Montsouris,OUI,22,19,3,1,2,OUI,OUI,2025-03-13 10:01:08+00:00,"48.821092374256104, 2.333725690841675",Paris,75056,0.13636363636363635,10
19032,Villette - Belleville,OUI,39,36,3,2,1,OUI,OUI,2025-03-13 09:59:08+00:00,"48.8726877314, 2.376461327076",Paris,75056,0.07692307692307693,10
21006,Marcelin Berthelot,OUI,27,20,7,4,3,OUI,OUI,2025-03-13 10:01:20+00:00,"48.8415473058801, 2.233161628246308",Boulogne-Billancourt,92012,0.25925925925925924,10
19022,Marché Secrétan,OUI,25,21,4,2,2,OUI,OUI,2025-03-13 10:01:23+00:00,"48.88125496379482, 2.373463287949562",Paris,75056,0.16,10
44013,Edouard Tremblay - Julian Grimaux,OUI,30,27,3,2,1,OUI,OUI,2025-03-13 09:53:49+00:00,"48.781383825117, 2.3723508417606",Vitry-sur-Seine,94081,0.1,10
22003,Beffroy,OUI,26,5,21,4,17,OUI,OUI,2025-03-13 09:59:41+00:00,"48.886591074488, 2.2613945603371",Neuilly-sur-Seine,92051,0.8076923076923077,10
6025,Assas - Rennes,OUI,32,11,21,11,10,OUI,OUI,2025-03-13 10:00:45+00:00,"48.8492084999386, 2.32851454623001",Paris,75056,0.65625,10
44003,Gabriel Péri - Danielle Casanova,OUI,20,5,15,9,6,OUI,OUI,2025-03-13 09:58:17+00:00,"48.790114, 2.4025777",Vitry-sur-Seine,94081,0.75,10
21008,Victor Hugo - Galliéni,OUI,33,20,13,13,0,OUI,OUI,2025-03-13 09:57:33+00:00,"48.838020154411, 2.2460845112801",Boulogne-Billancourt,92012,0.3939393939393939,10
15034,Lakanal - Commerce,OUI,48,11,37,36,1,OUI,OUI,2025-03-13 09:57:54+00:00,"48.84442462786544, 2.294059172272682",Paris,75056,0.7708333333333334,10
20134,Lieutenant Chauré - Etienne Marey,OUI,19,19,0,0,0,OUI,OUI,2025-03-13 10:00:38+00:00,"48.86746195408435, 2.405970990657807",Paris,75056,0.0,10
48010,Karl Marx,OUI,16,2,14,4,10,OUI,OUI,2025-03-13 09:53:47+00:00,"48.784527937293184, 2.3646667979455587",Villejuif,94076,0.875,10
24001,Arche - Léonard de Vinci,OUI,28,14,14,8,6,OUI,OUI,2025-03-13 09:53:27+00:00,"48.89790972494496, 2.2383723043644914",Courbevoie,92026,0.5,10
41202,Gare Rer de Fontenay sous Bois,OUI,59,51,8,2,6,OUI,OUI,2025-03-13 10:00:57+00:00,"48.8436279, 2.4630465",Fontenay-sous-Bois,94033,0.13559322033898305,10
22016,Charles de Gaulle - Sablonville,OUI,26,11,15,7,8,OUI,OUI,2025-03-13 10:01:25+00:00,"48.87991924860035, 2.2763770446181297",Neuilly-sur-Seine,92051,0.5769230769230769,10
42021,Raspail - Manufacture des Oeillets,OUI,29,5,24,24,0,OUI,OUI,2025-03-13 10:01:22+00:00,"48.8094458, 2.3903009",Ivry-sur-Seine,94041,0.8275862068965517,10
14136,Auguste Cain - Jean Moulin,OUI,40,39,1,0,1,OUI,OUI,2025-03-13 09:57:52+00:00,"48.82577028927573, 2.3210415244102482",Paris,75056,0.025,10
35020,Marcelle - Thalie,OUI,20,20,0,0,0,OUI,OUI,2025-03-13 09:58:18+00:00,"48.8835462, 2.4137883",Pantin,93055,0.0,10
32302,Chemin Vert - Fraternité,OUI,20,17,3,1,2,OUI,OUI,2025-03-13 09:58:25+00:00,"48.877141208359035, 2.4461565166711807",Romainville,93063,0.15,10
25003,Henri Ste-Claire Déville - Paul Héroult,OUI,21,7,14,6,8,OUI,OUI,2025-03-13 10:01:16+00:00,"48.892663, 2.172411",Rueil-Malmaison,92063,0.6666666666666666,10
10014,Marseille - Beaurepaire,OUI,46,4,42,30,12,OUI,OUI,2025-03-13 09:58:46+00:00,"48.871624306962985, 2.3639265082738348",Paris,75056,0.9130434782608695,10
31003,Paris - Emile Zola,OUI,29,29,0,0,0,OUI,OUI,2025-03-13 10:01:11+00:00,"48.854898095789295, 2.4186685681343083",Montreuil,93048,0.0,10
11035,Parmentier - Abel Rabaud,OUI,49,49,0,0,0,OUI,OUI,2025-03-13 10:01:04+00:00,"48.86921273836114, 2.371688821240712",Paris,75056,0.0,10
11030,Oberkampf - République,OUI,21,19,2,0,2,OUI,OUI,2025-03-13 10:01:26+00:00,"48.86531608707, 2.37611478491",Paris,75056,0.09523809523809523,10
16040,Exelmans - Michel-Ange,OUI,31,12,19,15,4,OUI,OUI,2025-03-13 10:01:23+00:00,"48.84309486651855, 2.2597770800669053",Paris,75056,0.6129032258064516,10
11039,Richard Lenoir - Jean-Pierre Timbaud,OUI,35,16,19,19,0,OUI,OUI,2025-03-13 10:00:59+00:00,"48.865804276686, 2.3693370749669",Paris,75056,0.5428571428571428,10
22006,Pierret - Madrid,OUI,27,2,25,14,11,OUI,OUI,2025-03-13 09:59:32+00:00,"48.882976576876565, 2.260125767248034",Neuilly-sur-Seine,92051,0.9259259259259259,10
19024,Botzaris - Parc des Buttes Chaumont,OUI,20,18,2,0,2,OUI,OUI,2025-03-13 09:53:24+00:00,"48.877951, 2.381464",Paris,75056,0.1,10
17028,Reims - Raymond Pitet,OUI,36,17,19,16,3,OUI,OUI,2025-03-13 10:00:34+00:00,"48.8888, 2.296319",Paris,75056,0.5277777777777778,10
41601,Général De Gaulle - Alouette,OUI,23,20,3,1,2,OUI,OUI,2025-03-13 10:01:05+00:00,"48.839109, 2.4175664",Saint-Mandé,94067,0.13043478260869565,10
42302,Aristide Briand - Gare de Bagneux,OUI,20,18,2,1,1,OUI,OUI,2025-03-13 09:57:31+00:00,"48.79387269664978, 2.321148812770844",Cachan,94016,0.1,10
15021,Joseph Liouville - Croix Nivert,OUI,63,41,22,22,0,OUI,OUI,2025-03-13 10:00:59+00:00,"48.844835471244416, 2.297508493065834",Paris,75056,0.3492063492063492,10
19029,Seine - Flandre,OUI,18,17,1,0,1,OUI,OUI,2025-03-13 09:57:19+00:00,"48.886785741479684, 2.3746193200349808",Paris,75056,0.05555555555555555,10
18009,Jean-François Lépine - Stephenson,OUI,22,20,2,0,2,OUI,OUI,2025-03-13 09:51:06+00:00,"48.88611466796807, 2.356855627529275",Paris,75056,0.09090909090909091,10
32003,Wilson - Métallurgie,OUI,28,10,18,11,7,OUI,OUI,2025-03-13 09:59:58+00:00,"48.909423010092326, 2.3584435880184174",Saint-Denis,93066,0.6428571428571429,10
43005,Gare RER de Vincennes,OUI,48,25,23,7,16,OUI,OUI,2025-03-13 10:00:20+00:00,"48.847563015126106, 2.433383166790009",Vincennes,94080,0.4791666666666667,10
21104,Madame de Sanzillon - Mozart,OUI,22,1,21,11,10,OUI,OUI,2025-03-13 10:00:54+00:00,"48.90379820774301, 2.3187401890754704",Clichy,92024,0.9545454545454546,10
21701,Larmeroux - Baudelaire,OUI,28,28,0,0,0,OUI,OUI,2025-03-13 09:56:42+00:00,"48.816939911292, 2.2809894804846",Vanves,92075,0.0,10
42504,Gare RER de Gentilly,OUI,30,27,3,1,2,OUI,OUI,2025-03-13 09:59:44+00:00,"48.814280450380224, 2.3410347104072575",Gentilly,94037,0.1,10
16008,Galilée - Kléber,OUI,30,13,17,3,14,OUI,OUI,2025-03-13 09:58:55+00:00,"48.867411865714, 2.2907813801148",Paris,75056,0.5666666666666667,10
26013,Quai du docteur Dervaux,OUI,26,16,10,9,1,OUI,OUI,2025-03-13 09:57:20+00:00,"48.910482, 2.297998",Asnières-sur-Seine,92004,0.38461538461538464,10
11024,Mairie du 11ème,OUI,51,32,19,17,2,OUI,OUI,2025-03-13 09:59:31+00:00,"48.858925, 2.3789759",Paris,75056,0.37254901960784315,10
20111,Villiers de l'Isle Adam - Pyrénées,OUI,20,20,0,0,0,OUI,OUI,2025-03-13 09:52:11+00:00,"48.867362, 2.396222",Paris,75056,0.0,10
13050,Quai Panhard et Levassor,OUI,57,1,56,29,27,OUI,OUI,2025-03-13 09:59:49+00:00,"48.828374828097, 2.3842737458056",Paris,75056,0.9824561403508771,10
32016,Place de la Porte de Paris,OUI,37,26,11,4,7,OUI,OUI,2025-03-13 10:00:40+00:00,"48.93009363207303, 2.3564037680625916",Saint-Denis,93066,0.2972972972972973,10
42010,Mairie d'Ivry-sur-Seine,OUI,51,24,27,24,3,OUI,OUI,2025-03-13 09:59:51+00:00,"48.81057120969284, 2.3842826485633855",Ivry-sur-Seine,94041,0.5294117647058824,10
15201,Place Amédée Gordini - Lefebvre,OUI,36,29,7,3,4,OUI,OUI,2025-03-13 09:55:07+00:00,"48.83061737745, 2.2920634208276",Paris,75056,0.19444444444444445,10
15046,Parc Georges Brassens - Brancion,OUI,28,27,1,0,1,OUI,OUI,2025-03-13 10:00:47+00:00,"48.83227829269761, 2.3022570088505745",Paris,75056,0.03571428571428571,10
19008,Flandre - Alphonse Karr,OUI,26,23,3,0,3,OUI,OUI,2025-03-13 09:56:59+00:00,"48.89465, 2.381868",Paris,75056,0.11538461538461539,10
46001,Place Paul Eluard,OUI,19,5,14,9,5,OUI,OUI,2025-03-13 09:56:59+00:00,"48.7672039733195, 2.4144977331161503",Choisy-le-Roi,94022,0.7368421052631579,10
11004,Charonne - Faubourg Saint-Antoine,OUI,32,2,30,25,5,OUI,OUI,2025-03-13 10:01:02+00:00,"48.852191909696, 2.3740932717919",Paris,75056,0.9375,10
21301,Saint-Vincent - Verdun,OUI,33,3,30,28,2,OUI,OUI,2025-03-13 09:59:38+00:00,"48.819211549234495, 2.254007756710053",Issy-les-Moulineaux,92040,0.9090909090909091,10
92008,Hôtel de Ville de Nanterre,OUI,35,11,24,13,11,OUI,OUI,2025-03-13 10:01:05+00:00,"48.892371898250424, 2.205548956990242",Nanterre,92050,0.6857142857142857,10
9032,Mathurins - Auber,OUI,35,6,29,18,11,OUI,OUI,2025-03-13 10:00:36+00:00,"48.872988840744, 2.3294984212276",Paris,75056,0.8285714285714286,10
51004,Général Delambre - Prebuard,OUI,28,16,12,2,10,OUI,OUI,2025-03-13 09:54:37+00:00,"48.93870344444, 2.2234171606307",Argenteuil,95018,0.42857142857142855,10
19016,Hautpoul - Jean Jaurès,OUI,30,29,1,0,1,OUI,OUI,2025-03-13 09:56:45+00:00,"48.886393679436, 2.3865414544355",Paris,75056,0.03333333333333333,10
19205,Simon Bolivar - Henri Turot,OUI,23,23,0,0,0,OUI,OUI,2025-03-13 09:56:00+00:00,"48.877475489801, 2.3739709492211",Paris,75056,0.0,10
11042,Grand Prieuré - Crussol,OUI,46,18,28,27,1,OUI,OUI,2025-03-13 09:59:41+00:00,"48.864660627935, 2.3692265531829",Paris,75056,0.6086956521739131,10
5123,Saint-Germain - Thenard,OUI,29,5,24,17,7,OUI,OUI,2025-03-13 10:01:24+00:00,"48.850571, 2.3471015",Paris,75056,0.8275862068965517,10
32026,Leroy des Barres - Médiathèque,OUI,27,4,23,9,14,OUI,OUI,2025-03-13 10:00:51+00:00,"48.928253687082, 2.3681719727966",Saint-Denis,93066,0.8518518518518519,10
43003,Hôpital Bégin,OUI,26,26,0,0,0,NON,NON,2025-03-13 09:58:04+00:00,"48.84571672113, 2.4272462725639",Vincennes,94080,0.0,10
9005,Square d'Anvers,OUI,31,29,2,1,1,OUI,OUI,2025-03-13 09:57:36+00:00,"48.882633484311, 2.3448844062122",Paris,75056,0.06451612903225806,10
23009,Anatole France - Louise Michel,OUI,47,43,4,3,1,OUI,OUI,2025-03-13 09:59:46+00:00,"48.88873214926474, 2.2881576418876652",Levallois-Perret,92044,0.0851063829787234,10
1013,Place du Palais Royal,OUI,65,2,63,43,20,OUI,OUI,2025-03-13 10:00:51+00:00,"48.862382970647, 2.3384822532535",Paris,75056,0.9692307692307692,10
17102,Alfred Roll - Berthier,OUI,28,20,8,7,1,OUI,OUI,2025-03-13 10:00:13+00:00,"48.887808570529, 2.3000952981763",Paris,75056,0.2857142857142857,10
8025,Miromesnil - La Boétie,OUI,32,3,29,9,20,OUI,OUI,2025-03-13 10:01:10+00:00,"48.873722412917, 2.3158480972052",Paris,75056,0.90625,10
18110,Departement - Pajol,OUI,16,14,2,1,1,OUI,OUI,2025-03-13 10:01:14+00:00,"48.886674849730184, 2.3613611608743668",Paris,75056,0.125,10
7102,Mairie du 7ème,OUI,48,4,44,26,18,OUI,OUI,2025-03-13 10:00:49+00:00,"48.8577967, 2.3192664",Paris,75056,0.9166666666666666,10
10113,Parmentier - Hôpital Saint-Louis,OUI,39,34,5,3,2,OUI,OUI,2025-03-13 09:58:42+00:00,"48.871379874257, 2.3698963836667",Paris,75056,0.1282051282051282,10
13002,Arago - Glacière,OUI,26,21,5,4,1,OUI,OUI,2025-03-13 10:01:27+00:00,"48.83486054775774, 2.3445770524322067",Paris,75056,0.19230769230769232,10
41606,Pasteur - Gambetta,OUI,19,7,12,9,3,OUI,OUI,2025-03-13 10:00:30+00:00,"48.84572797384512, 2.4236011505126953",Saint-Mandé,94067,0.631578947368421,10
20121,Boyer - Ménilmontant,OUI,19,19,0,0,0,OUI,OUI,2025-03-13 09:51:54+00:00,"48.868895162679, 2.3919824145635",Paris,75056,0.0,10
6013,Jacques Callot - Mazarine,OUI,27,0,27,25,2,OUI,OUI,2025-03-13 10:01:03+00:00,"48.855280175332, 2.3375743255019",Paris,75056,1.0,10
19013,Laumière - Petit,OUI,32,31,1,0,1,OUI,OUI,2025-03-13 10:00:27+00:00,"48.88467368538326, 2.380039058625698",Paris,75056,0.03125,10
12115,Porte de Vincennes,OUI,32,30,2,1,1,OUI,OUI,2025-03-13 09:57:33+00:00,"48.846454, 2.415514",Paris,75056,0.0625,10
42301,Gare Arcueil - Cachan,OUI,25,10,15,2,13,OUI,OUI,2025-03-13 10:01:04+00:00,"48.799824, 2.328171",Arcueil,94003,0.6,10
8033,Commandant Rivière,OUI,39,3,36,24,12,OUI,OUI,2025-03-13 10:00:53+00:00,"48.872933, 2.309796",Paris,75056,0.9230769230769231,10
20043,Charonne - Avron,OUI,26,25,1,1,0,OUI,OUI,2025-03-13 10:01:28+00:00,"48.851602665222, 2.3984030470379",Paris,75056,0.038461538461538464,10
16121,Jardin d'Acclimatation,OUI,30,19,11,7,4,OUI,OUI,2025-03-13 10:00:33+00:00,"48.878772242510465, 2.270772233605385",Paris,75056,0.36666666666666664,10
42015,Place Jean Ferrat,OUI,23,23,0,0,0,OUI,OUI,2025-03-13 09:59:07+00:00,"48.8184945213025, 2.3744174838066106",Ivry-sur-Seine,94041,0.0,10
41102,Gare de Laplace,OUI,43,42,1,1,0,OUI,OUI,2025-03-13 09:54:53+00:00,"48.80893199114179, 2.3349460959434514",Arcueil,94003,0.023255813953488372,10
31010,Stalingrad - Désiré Chevalier,OUI,41,39,2,1,1,OUI,OUI,2025-03-13 09:54:54+00:00,"48.85670169739857, 2.445072233676911",Montreuil,93048,0.04878048780487805,10
17037,Bayen - Pereire,OUI,21,17,4,3,1,OUI,OUI,2025-03-13 10:00:19+00:00,"48.881804409079656, 2.2921088710427284",Paris,75056,0.19047619047619047,10
18201,Tristan Tzara -  Tchaïkovski,OUI,32,29,3,1,2,OUI,OUI,2025-03-13 10:01:21+00:00,"48.89490221746837, 2.3648490384221077",Paris,75056,0.09375,10
16124,Route de Sèvres - Porte de Bagatelle,OUI,65,10,55,51,4,OUI,OUI,2025-03-13 09:59:34+00:00,"48.87525984132485, 2.249415814876557",Paris,75056,0.8461538461538461,10
41402,Victor Hugo - Ecoles,OUI,22,14,8,6,2,OUI,OUI,2025-03-13 09:54:44+00:00,"48.80476007936134, 2.4180373930262093",Alfortville,94002,0.36363636363636365,10
33003,Bordier - Félix Faure,OUI,43,39,4,4,0,OUI,OUI,2025-03-13 09:59:53+00:00,"48.90390751882016, 2.3830059170722966",Aubervilliers,93001,0.09302325581395349,10
18012,Stephenson - Doudeauville,OUI,35,34,1,0,1,OUI,OUI,2025-03-13 09:58:48+00:00,"48.888537048944826, 2.3561610281467438",Paris,75056,0.02857142857142857,10
25005,18 juin 1940 - Buzenval,OUI,25,17,8,4,4,OUI,OUI,2025-03-13 10:00:07+00:00,"48.868807, 2.185428",Rueil-Malmaison,92063,0.32,10
12009,Charenton - Diderot,OUI,18,11,7,2,5,OUI,OUI,2025-03-13 09:58:28+00:00,"48.846171461187, 2.3793068155646",Paris,75056,0.3888888888888889,10
13045,Jean Colly - Tolbiac,OUI,36,34,2,1,1,OUI,OUI,2025-03-13 10:01:08+00:00,"48.827817291597846, 2.3705490678548813",Paris,75056,0.05555555555555555,10
19125,Place de l'Édit de Nantes,OUI,27,20,7,3,4,OUI,OUI,2025-03-13 10:00:36+00:00,"48.88879, 2.3785",Paris,75056,0.25925925925925924,10
14034,Ouest - Château,OUI,23,23,0,0,0,OUI,OUI,2025-03-13 09:57:50+00:00,"48.83617286014242, 2.319392143923804",Paris,75056,0.0,10
14036,Boulard - Daguerre,OUI,43,41,2,0,2,OUI,OUI,2025-03-13 09:57:38+00:00,"48.83446472680611, 2.3293386027216907",Paris,75056,0.046511627906976744,10
16018,Flandrin - Henri Martin,OUI,18,12,6,0,6,OUI,OUI,2025-03-13 10:00:11+00:00,"48.8643275, 2.2724174",Paris,75056,0.3333333333333333,10
12034,Pirogues de Bercy - Libourne,OUI,48,28,20,6,14,OUI,OUI,2025-03-13 09:59:21+00:00,"48.832308, 2.38637",Paris,75056,0.4166666666666667,10
11036,Jules Ferry - Faubourg du Temple Paris,OUI,56,39,17,17,0,OUI,OUI,2025-03-13 09:59:29+00:00,"48.868397, 2.3678933",Paris,75056,0.30357142857142855,10
25008,Place du 8 Mai 1945,OUI,18,12,6,5,1,OUI,OUI,2025-03-13 09:59:45+00:00,"48.871552174017, 2.2025031970585",Rueil-Malmaison,92063,0.3333333333333333,10
9021,Saint Georges - d'Aumale,OUI,23,22,1,1,0,OUI,OUI,2025-03-13 10:01:29+00:00,"48.87778639599673, 2.337429821491241",Paris,75056,0.043478260869565216,10
19044,Grands Moulins de Pantin,OUI,50,34,16,4,12,OUI,OUI,2025-03-13 10:00:12+00:00,"48.89738369720229, 2.3959985375404362",Paris,75056,0.32,10
12027,Montgallet - Charenton,OUI,15,12,3,3,0,OUI,OUI,2025-03-13 09:58:22+00:00,"48.842647778701, 2.3861649278137",Paris,75056,0.2,10
24002,Gare de Courbevoie,OUI,32,25,7,5,2,OUI,OUI,2025-03-13 09:57:43+00:00,"48.8993867, 2.2506506",Courbevoie,92026,0.21875,10
42029,Stalingrad - Germaine Tailleferre,OUI,28,23,5,0,5,OUI,OUI,2025-03-13 10:00:36+00:00,"48.80257200481316, 2.3786691203713417",Ivry-sur-Seine,94041,0.17857142857142858,10
33001,Victor Hugo - Magasins Généraux,OUI,34,23,11,4,7,OUI,OUI,2025-03-13 09:56:58+00:00,"48.903281401126755, 2.368072383105755",Aubervilliers,93001,0.3235294117647059,10
8035,Bienfaisance - Place de Narvik,OUI,34,2,32,17,15,OUI,OUI,2025-03-13 10:00:05+00:00,"48.87660163459077, 2.3129771277308464",Paris,75056,0.9411764705882353,10
16034,Porte d'Auteuil,OUI,32,30,2,2,0,OUI,OUI,2025-03-13 09:55:37+00:00,"48.8479394142243, 2.2608396783471107",Paris,75056,0.0625,10
21313,Guynemer - Séverine,OUI,24,3,21,18,3,OUI,OUI,2025-03-13 09:55:40+00:00,"48.83091743371036, 2.2790706530213356",Issy-les-Moulineaux,92040,0.875,10
7009,Assemblée Nationale,OUI,74,8,66,28,38,OUI,OUI,2025-03-13 09:57:39+00:00,"48.861411014652, 2.3201214185208",Paris,75056,0.8918918918918919,10
28001,Richard Wallace - Place du 8 Mai 1945,OUI,29,16,13,11,2,OUI,OUI,2025-03-13 10:00:58+00:00,"48.87866794788021, 2.2420343756675725",Puteaux,92062,0.4482758620689655,10
20132,Réunion - Avron,OUI,26,25,1,1,0,OUI,OUI,2025-03-13 09:52:10+00:00,"48.852566752033766, 2.403928068708116",Paris,75056,0.038461538461538464,10
26007,Square Gilbert Thomain,OUI,19,13,6,6,0,OUI,OUI,2025-03-13 09:53:06+00:00,"48.90717373809284, 2.2695400938391685",Asnières-sur-Seine,92004,0.3157894736842105,10
5119,Jussieu - Guy de la Brosse,OUI,40,1,39,26,13,OUI,OUI,2025-03-13 10:01:00+00:00,"48.845665, 2.355653",Paris,75056,0.975,10
16111,Faustin Hélie - Desbordes-Valmore,OUI,27,25,2,0,2,OUI,OUI,2025-03-13 09:57:03+00:00,"48.859403, 2.276522",Paris,75056,0.07407407407407407,10
35009,Jean Lolive - Parc Stalingrad,OUI,22,18,4,2,2,OUI,OUI,2025-03-13 09:56:34+00:00,"48.89206174403158, 2.4091735482215886",Pantin,93055,0.18181818181818182,10
11007,Jean Macé - Faidherbe,OUI,58,51,7,3,4,OUI,OUI,2025-03-13 10:00:20+00:00,"48.85337548426, 2.3828620836139",Paris,75056,0.1206896551724138,10
21109,Guichet - Jean Jaurès,OUI,23,21,2,1,1,OUI,OUI,2025-03-13 09:56:40+00:00,"48.905169868129036, 2.3023840785026555",Clichy,92024,0.08695652173913043,10
15025,Dupleix - du Guesclin,OUI,46,18,28,23,5,OUI,OUI,2025-03-13 09:59:15+00:00,"48.85147910413369, 2.296709530055523",Paris,75056,0.6086956521739131,10
23701,Parvis Robert Schuman - Roger Salengro,OUI,24,12,12,3,9,OUI,OUI,2025-03-13 09:56:20+00:00,"48.812657470558754, 2.1921751275658607",Chaville,92022,0.5,10
35018,Ancien Canal - Hélène Brion,OUI,23,23,0,0,0,OUI,OUI,2025-03-13 09:55:51+00:00,"48.89484799296163, 2.4188338592648506",Pantin,93055,0.0,10
17007,Navier - Epinettes,OUI,36,36,0,0,0,OUI,OUI,2025-03-13 10:01:26+00:00,"48.89587780769155, 2.3226776719093327",Paris,75056,0.0,10
19005,Flandre - Riquet,OUI,19,18,1,1,0,OUI,OUI,2025-03-13 09:56:23+00:00,"48.888013281448, 2.3737595955229",Paris,75056,0.05263157894736842,10
31012,Place Carnot,OUI,23,21,2,0,2,OUI,OUI,2025-03-13 09:55:57+00:00,"48.85593932186797, 2.441531717777252",Montreuil,93048,0.08695652173913043,10
17011,Fragonard - Porte de Clichy,OUI,55,21,34,29,5,OUI,OUI,2025-03-13 09:59:27+00:00,"48.894155633419, 2.3143893107772",Paris,75056,0.6181818181818182,10
12024,Gare de Bercy,OUI,35,15,20,18,2,OUI,OUI,2025-03-13 09:59:22+00:00,"48.839794573906, 2.3826066032052",Paris,75056,0.5714285714285714,10
17045,Place des Ternes.,OUI,44,43,1,1,0,OUI,OUI,2025-03-13 09:55:35+00:00,"48.878438631226516, 2.297727763652802",Paris,75056,0.022727272727272728,10
35019,Anatole France - Jean Lolive,OUI,27,23,4,3,1,OUI,OUI,2025-03-13 09:59:41+00:00,"48.8949922, 2.4253764",Pantin,93055,0.14814814814814814,10
43402,Place de Verdun,OUI,40,18,22,20,2,OUI,OUI,2025-03-13 09:59:42+00:00,"48.8202823, 2.473775",Joinville-le-Pont,94042,0.55,10
20113,Piat - Parc de Belleville,OUI,21,19,2,0,2,OUI,OUI,2025-03-13 10:00:55+00:00,"48.87195626635528, 2.384981390278095",Paris,75056,0.09523809523809523,10
33018,Edouard Poisson - Victor Hugo,OUI,26,22,4,2,2,OUI,OUI,2025-03-13 09:54:09+00:00,"48.91118557052621, 2.379864752692811",Aubervilliers,93001,0.15384615384615385,10
23802,Raymond Poincaré - Allée de la Marche,OUI,22,13,9,7,2,OUI,OUI,2025-03-13 09:56:56+00:00,"48.838634069623, 2.1724102640451",Garches,92033,0.4090909090909091,10
12013,Montgallet - Reuilly,OUI,14,6,8,3,5,OUI,OUI,2025-03-13 09:56:32+00:00,"48.844291, 2.3896481",Paris,75056,0.5714285714285714,10
41604,Lagny - Joffre,OUI,30,8,22,19,3,OUI,OUI,2025-03-13 10:01:23+00:00,"48.84930687084088, 2.417949736118317",Saint-Mandé,94067,0.7333333333333333,10
21305,Place Jacques Madaule,OUI,23,4,19,18,1,OUI,OUI,2025-03-13 10:01:11+00:00,"48.823933787309, 2.2606918215752",Issy-les-Moulineaux,92040,0.8260869565217391,10
15017,Place Falguière,OUI,22,22,0,0,0,OUI,OUI,2025-03-13 10:00:44+00:00,"48.83629973941847, 2.3104464635252953",Paris,75056,0.0,10
11115,Montreuil - Gonnet,OUI,24,18,6,0,6,OUI,OUI,2025-03-13 10:00:56+00:00,"48.850500564921, 2.3890856287864",Paris,75056,0.25,10
18005,Tardieu - Chappe,OUI,16,16,0,0,0,OUI,OUI,2025-03-13 10:00:11+00:00,"48.884146759782, 2.341845408082",Paris,75056,0.0,10
7015,Varenne,OUI,44,15,29,18,11,OUI,OUI,2025-03-13 10:01:07+00:00,"48.857202661803, 2.3152771219611",Paris,75056,0.6590909090909091,10
10005,Petites Ecuries - Faubourg Poissonnière,OUI,17,7,10,9,1,OUI,OUI,2025-03-13 09:59:01+00:00,"48.87397217237368, 2.348388757504776",Paris,75056,0.5882352941176471,10
5021,Jussieu - Fossés Saint-Bernard,OUI,38,0,38,35,3,OUI,OUI,2025-03-13 10:00:17+00:00,"48.847185510023, 2.3534858599305",Paris,75056,1.0,10
20136,Henri Chevreau - Couronnes,OUI,26,25,1,0,1,OUI,OUI,2025-03-13 09:56:34+00:00,"48.87033205312931, 2.388777695596218",Paris,75056,0.038461538461538464,10
23001,Paul Vaillant Couturier - Chaptal,OUI,36,5,31,22,9,OUI,OUI,2025-03-13 10:01:15+00:00,"48.893479576183, 2.2775253653526",Levallois-Perret,92044,0.8611111111111112,10
5026,Pascal - Claude Bernard,OUI,47,2,45,36,9,OUI,OUI,2025-03-13 10:01:13+00:00,"48.839061952159746, 2.3499782010912895",Paris,75056,0.9574468085106383,10
15010,Square Cambronne,OUI,59,6,53,48,5,OUI,OUI,2025-03-13 09:57:57+00:00,"48.84756654526, 2.3025691509247",Paris,75056,0.8983050847457628,10
43006,Vignerons - Minimes,OUI,29,20,9,5,4,OUI,OUI,2025-03-13 10:00:54+00:00,"48.841486, 2.430793",Vincennes,94080,0.3103448275862069,10
18141,Clignancourt - Sofia,OUI,19,16,3,0,3,OUI,OUI,2025-03-13 10:00:08+00:00,"48.88511992309783, 2.34719488842051",Paris,75056,0.15789473684210525,10
31702,Pierre et Marie Curie - Julien Grimau,OUI,18,17,1,0,1,OUI,OUI,2025-03-13 09:54:50+00:00,"48.870714014863225, 2.424097023904324",Bagnolet,93006,0.05555555555555555,10
33009,Félix Faure - Sadi Carnot,OUI,33,23,10,6,4,OUI,OUI,2025-03-13 09:57:17+00:00,"48.90812110228388, 2.378623187541962",Aubervilliers,93001,0.30303030303030304,10
7004,Raspail - Varenne,OUI,17,1,16,9,7,OUI,OUI,2025-03-13 10:01:03+00:00,"48.853147816545, 2.3263905197382",Paris,75056,0.9411764705882353,10
5106,Cujas - Saint-Michel,OUI,19,1,18,2,16,OUI,OUI,2025-03-13 10:01:21+00:00,"48.848191348584, 2.341831654854",Paris,75056,0.9473684210526315,10
42503,Vladimir Ilitch Lénine - Andrée Chedid,OUI,31,27,4,0,4,OUI,OUI,2025-03-13 09:57:47+00:00,"48.813240124373, 2.3319716067039",Gentilly,94037,0.12903225806451613,10
22505,Mairie de La Garenne Colombes,OUI,22,18,4,4,0,OUI,OUI,2025-03-13 09:52:31+00:00,"48.90663823468682, 2.24679596722126",La Garenne-Colombes,92035,0.18181818181818182,10
21111,Professeur René Leriche - Général Leclerc,OUI,50,20,30,25,5,OUI,OUI,2025-03-13 09:58:02+00:00,"48.90782845483013, 2.307887971401215",Clichy,92024,0.6,10
19115,Porte de la Villette,OUI,26,19,7,3,4,OUI,OUI,2025-03-13 10:01:22+00:00,"48.89835196548483, 2.386150136590004",Paris,75056,0.2692307692307692,10
11114,Ledru-Rollin - Charonne,OUI,31,16,15,11,4,OUI,OUI,2025-03-13 09:58:32+00:00,"48.85345855607243, 2.3772463581947094",Paris,75056,0.4838709677419355,10
32010,Place aux Étoiles,OUI,37,7,30,7,23,OUI,OUI,2025-03-13 10:00:06+00:00,"48.91835629408464, 2.3523425683379173",Saint-Denis,93066,0.8108108108108109,10
20040,Parc de Belleville - Julien Lacroix,OUI,26,25,1,0,1,OUI,OUI,2025-03-13 09:55:27+00:00,"48.8703459, 2.3842214",Paris,75056,0.038461538461538464,10
15033,Place Violet,OUI,29,23,6,6,0,OUI,OUI,2025-03-13 09:58:42+00:00,"48.84487893836502, 2.2905756533145905",Paris,75056,0.20689655172413793,10
10023,Gare de l'Est - Verdun,OUI,13,9,4,2,2,OUI,OUI,2025-03-13 09:57:21+00:00,"48.876156054271, 2.3609149083206",Paris,75056,0.3076923076923077,10
41404,Carnot - Pâquerettes,OUI,24,2,22,20,2,OUI,OUI,2025-03-13 10:00:56+00:00,"48.79592939432515, 2.4261841177940373",Alfortville,94002,0.9166666666666666,10
13026,Place Jean Delay,OUI,33,29,4,2,2,OUI,OUI,2025-03-13 09:59:34+00:00,"48.823316, 2.354336",Paris,75056,0.12121212121212122,10
15122,Place Charles Vallin,OUI,26,24,2,0,2,OUI,OUI,2025-03-13 10:00:56+00:00,"48.835523812041, 2.3025986552238",Paris,75056,0.07692307692307693,10
23002,Pont de Levallois-bécon,OUI,49,9,40,13,27,OUI,OUI,2025-03-13 10:01:14+00:00,"48.8984179, 2.2791311",Levallois-Perret,92044,0.8163265306122449,10
42707,Place Jean-Baptiste Clément,OUI,23,22,1,0,1,OUI,OUI,2025-03-13 09:51:48+00:00,"48.81240466867336, 2.3617091774940495",Le Kremlin-Bicêtre,94043,0.043478260869565216,10
14139,Pierre Larousse - Raymond Losserand,OUI,30,29,1,0,1,OUI,OUI,2025-03-13 09:58:59+00:00,"48.83059564231877, 2.3119183257222176",Paris,75056,0.03333333333333333,10
92003,Chanzy - Sud-Est,OUI,25,25,0,0,0,OUI,OUI,2025-03-13 09:58:21+00:00,"48.888912037698766, 2.195632159709931",Nanterre,92050,0.0,10
13102,Pitié-Salpêtrière,OUI,49,10,39,20,19,OUI,OUI,2025-03-13 10:01:04+00:00,"48.83748810318667, 2.365213818848133",Paris,75056,0.7959183673469388,10
19019,Petit - Manin,OUI,22,22,0,0,0,NON,NON,2025-03-13 09:54:59+00:00,"48.886506875343, 2.3938155401308",Paris,75056,0.0,10
11101,Charles Delescluze,OUI,48,18,30,23,7,OUI,OUI,2025-03-13 10:00:18+00:00,"48.85242200848887, 2.380632497370243",Paris,75056,0.625,10
8055,Courcelles - Place des Ternes,OUI,28,25,3,2,1,OUI,OUI,2025-03-13 10:01:13+00:00,"48.878199928923124, 2.2992860188665043",Paris,75056,0.10714285714285714,10
15055,Vasco de Gama,OUI,54,20,34,26,8,OUI,OUI,2025-03-13 10:00:44+00:00,"48.83671783466264, 2.283664085650799",Paris,75056,0.6296296296296297,10
27002,Parc Pierre Lagravère,OUI,30,12,18,9,9,OUI,OUI,2025-03-13 09:59:56+00:00,"48.92650488131725, 2.239069678491417",Colombes,92025,0.6,10
10015,Lucien Sampaix - Récollets,OUI,41,37,4,3,1,OUI,OUI,2025-03-13 10:00:10+00:00,"48.874330377560476, 2.3621229082345963",Paris,75056,0.0975609756097561,10
21502,Verdun - Place Henri IV,OUI,25,5,20,14,6,OUI,OUI,2025-03-13 10:01:09+00:00,"48.870797375639214, 2.2277003154158592",Suresnes,92073,0.8,10
41207,Place du Général de Gaulle,OUI,28,13,15,1,14,OUI,OUI,2025-03-13 09:56:52+00:00,"48.8525288, 2.4877332",Fontenay-sous-Bois,94033,0.5357142857142857,10
16129,Ceinture du Lac Inferieure - Saint-Cloud,OUI,41,37,4,0,4,OUI,OUI,2025-03-13 10:01:25+00:00,"48.86218070933143, 2.2617871686816216",Paris,75056,0.0975609756097561,10
12032,Porte Dorée,OUI,35,7,28,16,12,OUI,OUI,2025-03-13 10:00:06+00:00,"48.8354337, 2.4077132",Paris,75056,0.8,10
14104,Boyer-Barret - Raymond Losserand,OUI,22,22,0,0,0,OUI,OUI,2025-03-13 10:00:52+00:00,"48.83329880233322, 2.3173383995890617",Paris,75056,0.0,10
21032,Sèvres-Gallieni,OUI,25,3,22,16,6,OUI,OUI,2025-03-13 09:58:49+00:00,"48.837809408957, 2.2281519323587",Boulogne-Billancourt,92012,0.88,10
20119,Square des Saint-Simoniens,OUI,25,25,0,0,0,OUI,OUI,2025-03-13 09:56:51+00:00,"48.8701796, 2.3967273",Paris,75056,0.0,10
7005,Raspail - Bac,OUI,51,3,48,23,25,OUI,OUI,2025-03-13 09:59:42+00:00,"48.855628721101, 2.3256602883339",Paris,75056,0.9411764705882353,10
31705,Champeaux - Gallieni,OUI,47,45,2,1,1,OUI,OUI,2025-03-13 09:59:03+00:00,"48.864459134684644, 2.4161778017878532",Bagnolet,93006,0.0425531914893617,10
32014,Place du Cornillon - Stade de France,OUI,33,18,15,7,8,OUI,OUI,2025-03-13 10:01:28+00:00,"48.92540695835961, 2.3644426837563515",Saint-Denis,93066,0.45454545454545453,10
6030,Assas - Vaugirard,OUI,34,14,20,10,10,OUI,OUI,2025-03-13 10:00:38+00:00,"48.848274111398, 2.3292413726449",Paris,75056,0.5882352941176471,10
17124,Porte de Saint-Ouen - Henri Huchard,OUI,26,10,16,14,2,OUI,OUI,2025-03-13 09:54:22+00:00,"48.898708366365064, 2.3295360803604126",Paris,75056,0.6153846153846154,10
12126,Gravelle - Route du Bac,OUI,51,43,8,6,2,OUI,OUI,2025-03-13 09:58:44+00:00,"48.824407, 2.418455",Paris,75056,0.1568627450980392,10
17027,Place du Maréchal Juin - Péreire,OUI,44,20,24,19,5,OUI,OUI,2025-03-13 10:00:37+00:00,"48.885263, 2.298286",Paris,75056,0.5454545454545454,10
20036,Ménilmontant - Pelleport,OUI,31,31,0,0,0,OUI,OUI,2025-03-13 09:58:41+00:00,"48.870682633845, 2.3989596023316",Paris,75056,0.0,10
31016,Lucie Aubrac - Franklin,OUI,35,34,1,1,0,OUI,OUI,2025-03-13 10:01:07+00:00,"48.86223916006812, 2.4435862898826604",Montreuil,93048,0.02857142857142857,10
15029,Emeriau - Place de Brazzaville,OUI,51,1,50,40,10,OUI,OUI,2025-03-13 10:00:56+00:00,"48.850785261674964, 2.2871585190296173",Paris,75056,0.9803921568627451,10
51003,Hôtel de Ville d'Argenteuil,OUI,29,12,17,11,6,OUI,OUI,2025-03-13 10:00:35+00:00,"48.946504, 2.2496396",Argenteuil,95018,0.5862068965517241,10
17018,Parc Monceau,OUI,18,3,15,9,6,OUI,OUI,2025-03-13 09:55:52+00:00,"48.881077914129, 2.3095492646098",Paris,75056,0.8333333333333334,10
13016,Primo Levi - Frigos,OUI,33,0,33,20,13,OUI,OUI,2025-03-13 10:01:23+00:00,"48.83094844846017, 2.37965351592796",Paris,75056,1.0,10
26001,Gare d'Asnières sur Seine,OUI,21,8,13,9,4,OUI,OUI,2025-03-13 09:59:47+00:00,"48.90636459217474, 2.2835066914558415",Asnières-sur-Seine,92004,0.6190476190476191,10
8051,Batignolles - Rome,OUI,11,9,2,2,0,OUI,OUI,2025-03-13 09:57:20+00:00,"48.881823370566806, 2.3202589899301524",Paris,75056,0.18181818181818182,10
92004,Nanterre - Université,OUI,19,9,10,7,3,OUI,OUI,2025-03-13 09:54:05+00:00,"48.901365, 2.212693",Nanterre,92050,0.5263157894736842,10
2009,Filles Saint-Thomas - Place de la Bourse,OUI,58,13,45,21,24,OUI,OUI,2025-03-13 09:59:38+00:00,"48.868899890853, 2.3397543845203",Paris,75056,0.7758620689655172,10
18020,Francoeur - Marcadet,OUI,20,19,1,0,1,OUI,OUI,2025-03-13 10:00:25+00:00,"48.89104123261663, 2.340014585442034",Paris,75056,0.05,10
44102,Verdun - Adrien Damalix,OUI,25,14,11,10,1,OUI,OUI,2025-03-13 09:57:46+00:00,"48.8222334178559, 2.4215328320860863",Saint-Maurice,94069,0.44,10
5002,Sommerard - Saint-Jacques,OUI,34,4,30,25,5,OUI,OUI,2025-03-13 10:00:12+00:00,"48.850310432924466, 2.345015835298588",Paris,75056,0.8823529411764706,10
22001,Château - Bineau,OUI,21,1,20,8,12,OUI,OUI,2025-03-13 10:01:20+00:00,"48.890404028589806, 2.270106375217438",Neuilly-sur-Seine,92051,0.9523809523809523,10
15028,Grenelle - Dr Finlay,OUI,71,11,60,54,6,OUI,OUI,2025-03-13 10:01:24+00:00,"48.851315406715976, 2.2919502854347233",Paris,75056,0.8450704225352113,10
18025,Mairie du 18ème,OUI,40,39,1,0,1,OUI,OUI,2025-03-13 10:01:24+00:00,"48.892939296937605, 2.3445510864257812",Paris,75056,0.025,10
8102,Lamennais - Washington,OUI,25,2,23,11,12,OUI,OUI,2025-03-13 10:00:12+00:00,"48.87352990026496, 2.303444892168045",Paris,75056,0.92,10
17122,Bridaine - Lamandé,OUI,28,27,1,1,0,OUI,OUI,2025-03-13 09:59:18+00:00,"48.8862074, 2.3206239",Paris,75056,0.03571428571428571,10
14018,Porte d'Orléans,OUI,45,44,1,0,1,OUI,OUI,2025-03-13 09:59:01+00:00,"48.8227639, 2.3249313",Paris,75056,0.022222222222222223,10
20027,Porte de Ménilmontant,OUI,15,14,1,0,1,OUI,OUI,2025-03-13 10:00:50+00:00,"48.8691543609174, 2.40932246879487",Paris,75056,0.06666666666666667,10
21013,Pierre Grenier - Pont de Billancourt,OUI,21,18,3,3,0,OUI,OUI,2025-03-13 09:51:56+00:00,"48.8258020742942, 2.2487989068031315",Boulogne-Billancourt,92012,0.14285714285714285,10
14122,Colonel Monteil - Brune,OUI,19,18,1,1,0,OUI,OUI,2025-03-13 09:55:41+00:00,"48.82650293311, 2.3092747998272",Paris,75056,0.05263157894736842,10
2010,Uzès - Montmartre,OUI,26,2,24,13,11,OUI,OUI,2025-03-13 10:00:31+00:00,"48.870790980240706, 2.3431010171771054",Paris,75056,0.9230769230769231,10
16123,Mahatma Gandhi,OUI,24,2,22,14,8,OUI,OUI,2025-03-13 09:58:04+00:00,"48.876356, 2.264205",Paris,75056,0.9166666666666666,10
5116,Place Valhubert,OUI,51,0,51,46,5,OUI,OUI,2025-03-13 09:59:19+00:00,"48.844182577315, 2.3640366643667",Paris,75056,1.0,10
31007,Paris - Désiré Préaux,OUI,44,44,0,0,0,OUI,OUI,2025-03-13 09:58:02+00:00,"48.85742876694898, 2.4323049187660217",Montreuil,93048,0.0,10
7006,Quai Voltaire,OUI,32,3,29,27,2,OUI,OUI,2025-03-13 10:00:46+00:00,"48.858942986179, 2.3314182047146",Paris,75056,0.90625,10
17046,Mac-Mahon - Brey,OUI,25,20,5,2,3,OUI,OUI,2025-03-13 09:55:27+00:00,"48.877532084130166, 2.294512536052928",Paris,75056,0.2,10
7014,Saint-François-Xavier,OUI,42,0,42,19,23,OUI,OUI,2025-03-13 10:01:02+00:00,"48.85154484769, 2.3146149516106",Paris,75056,1.0,10
19038,Lassus - Delouvain,OUI,19,18,1,0,1,OUI,OUI,2025-03-13 09:57:45+00:00,"48.8755044846, 2.3890327325519",Paris,75056,0.05263157894736842,10
8012,Batignolles - Place de Clichy,OUI,46,45,1,0,1,OUI,OUI,2025-03-13 10:00:10+00:00,"48.883474535757, 2.326493114233",Paris,75056,0.021739130434782608,10
18029,Emile Blemont - Poteau,OUI,39,37,2,1,1,OUI,OUI,2025-03-13 10:01:05+00:00,"48.8943782, 2.3415122",Paris,75056,0.05128205128205128,10
17017,Gare de Pont-Cardinet,OUI,31,27,4,1,3,OUI,OUI,2025-03-13 10:00:46+00:00,"48.88713901475306, 2.314494143994255",Paris,75056,0.12903225806451613,10
35017,Toffier Decaux - Cartier Bresson,OUI,17,13,4,1,3,OUI,OUI,2025-03-13 09:57:05+00:00,"48.90165072551549, 2.4017545580863957",Pantin,93055,0.23529411764705882,10
34002,Capitaine Glarner - Gabriel Péri,OUI,23,18,5,4,1,OUI,OUI,2025-03-13 10:01:14+00:00,"48.902449900418745, 2.3304807533425724",Saint-Ouen-sur-Seine,93070,0.21739130434782608,10
20118,Orteaux - Mouraud,OUI,24,24,0,0,0,OUI,OUI,2025-03-13 09:51:49+00:00,"48.85558642847872, 2.408762907764669",Paris,75056,0.0,10
14130,Jonquoy - Didot,OUI,30,28,2,0,2,OUI,OUI,2025-03-13 09:55:55+00:00,"48.82890454823947, 2.31648076325655",Paris,75056,0.06666666666666667,10
15035,Place Etienne Pernet,OUI,42,10,32,31,1,OUI,OUI,2025-03-13 10:00:41+00:00,"48.84243457133779, 2.2921819612383847",Paris,75056,0.7619047619047619,10
12011,Charenton - Place du Col Bourgoin,OUI,35,23,12,12,0,OUI,OUI,2025-03-13 10:01:17+00:00,"48.844867319554, 2.3825789350545",Paris,75056,0.34285714285714286,10
18049,Porte d'Aubervilliers,OUI,53,41,12,6,6,OUI,OUI,2025-03-13 10:01:23+00:00,"48.89859661942376, 2.3689722642302513",Paris,75056,0.22641509433962265,10
21308,Bara - Henri Farman,OUI,58,1,57,35,22,OUI,OUI,2025-03-13 10:00:32+00:00,"48.833218027457846, 2.2677567601203923",Issy-les-Moulineaux,92040,0.9827586206896551,10
18113,Lepic - Armée d'Orient,OUI,24,24,0,0,0,OUI,OUI,2025-03-13 09:52:43+00:00,"48.887536403814, 2.3343077301979",Paris,75056,0.0,10
19037,Belleville - Porte des Lilas,OUI,29,27,2,0,2,OUI,OUI,2025-03-13 09:53:27+00:00,"48.87660391892763, 2.404769691129476",Paris,75056,0.06896551724137931,10
35003,Gabrielle Josserand - Edouard Vaillant,OUI,23,20,3,2,1,OUI,OUI,2025-03-13 10:00:40+00:00,"48.90271566255436, 2.3933270573616032",Pantin,93055,0.13043478260869565,10
6103,Mézières - Rennes,OUI,53,46,7,4,3,OUI,OUI,2025-03-13 09:46:15+00:00,"48.85023459321703, 2.3303819820284843",Paris,75056,0.1320754716981132,10
11006,Ledru-Rollin - Place du Père Chaillet,OUI,37,23,14,10,4,OUI,OUI,2025-03-13 10:00:13+00:00,"48.856433706943704, 2.379020587761426",Paris,75056,0.3783783783783784,10
15038,Place Adolphe Cherioux - Vaugirard,OUI,62,57,5,3,2,OUI,OUI,2025-03-13 09:59:00+00:00,"48.83959442800459, 2.3010657727718353",Paris,75056,0.08064516129032258,10
19127,Aubervilliers - Curial,OUI,23,18,5,3,2,OUI,OUI,2025-03-13 09:59:37+00:00,"48.89088305227546, 2.3688579350709915",Paris,75056,0.21739130434782608,10
20021,Indre - Prairies,OUI,38,38,0,0,0,OUI,OUI,2025-03-13 09:52:29+00:00,"48.86254398506782, 2.403290458023548",Paris,75056,0.0,10
1120,Lavandieres Sainte Opportune - Rivoli,OUI,22,6,16,13,3,OUI,OUI,2025-03-13 10:01:04+00:00,"48.859279702476, 2.3466217517853",Paris,75056,0.7272727272727273,10
6018,Michelet - Assas,OUI,17,1,16,1,15,OUI,OUI,2025-03-13 10:01:10+00:00,"48.842741502832, 2.3350211977959",Paris,75056,0.9411764705882353,10
14112,Méchain - Faubourg Saint-Jacques,OUI,15,10,5,1,4,OUI,OUI,2025-03-13 10:01:26+00:00,"48.83586772099485, 2.33798034198275",Paris,75056,0.3333333333333333,10
21019,Edouard Vaillant - Paul-Adolphe Souriau,OUI,26,0,26,17,9,OUI,OUI,2025-03-13 09:59:39+00:00,"48.834845858829, 2.2479459643364",Boulogne-Billancourt,92012,1.0,10
47004,Stade Auguste Delaune,OUI,21,5,16,15,1,OUI,OUI,2025-03-13 10:00:17+00:00,"48.80896378683884, 2.4345204234123234",Maisons-Alfort,94046,0.7619047619047619,10
21105,Morice - Général Leclerc,OUI,25,16,9,9,0,OUI,OUI,2025-03-13 10:01:14+00:00,"48.90245471981591, 2.3128929734230046",Clichy,92024,0.36,10
11010,Boulets - Faubourg Saint-Antoine,OUI,42,37,5,0,5,OUI,OUI,2025-03-13 09:58:27+00:00,"48.849259262115, 2.3917546141943",Paris,75056,0.11904761904761904,10
19109,Tanger - Place du Maroc,OUI,19,15,4,3,1,OUI,OUI,2025-03-13 09:54:40+00:00,"48.8862524447104, 2.3689296841621403",Paris,75056,0.21052631578947367,10
16122,Route de la Muette - Porte de Neuilly,OUI,49,44,5,4,1,OUI,OUI,2025-03-13 10:00:35+00:00,"48.8798926, 2.2587671",Paris,75056,0.10204081632653061,10
31019,Vincennes - Douy-Delcupe,OUI,37,35,2,1,1,OUI,OUI,2025-03-13 09:55:03+00:00,"48.85493692155721, 2.436049282550812",Montreuil,93048,0.05405405405405406,10
15002,Maine - Antoine Bourdelle,OUI,17,15,2,1,1,OUI,OUI,2025-03-13 09:59:11+00:00,"48.84308531746595, 2.320263946784738",Paris,75056,0.11764705882352941,10
18032,Porte de Clignancourt.,OUI,55,51,4,0,4,OUI,OUI,2025-03-13 09:53:45+00:00,"48.897488, 2.343996",Paris,75056,0.07272727272727272,10
23007,Président Wilson - Jean Jaures,OUI,25,19,6,5,1,OUI,OUI,2025-03-13 09:58:50+00:00,"48.89034054052266, 2.2920683026313786",Levallois-Perret,92044,0.24,10
44012,Génie - Mozart,OUI,18,18,0,0,0,OUI,OUI,2025-03-13 09:50:04+00:00,"48.794902381218904, 2.3734183609485626",Vitry-sur-Seine,94081,0.0,10
16027,Mozart - Jasmin,OUI,62,60,2,2,0,OUI,OUI,2025-03-13 09:56:26+00:00,"48.85286124871689, 2.268483570651513",Paris,75056,0.03225806451612903,10
22101,Gare Routière de Saint Cloud,OUI,28,5,23,17,6,OUI,OUI,2025-03-13 10:01:02+00:00,"48.84288183896324, 2.222245037555695",Saint-Cloud,92064,0.8214285714285714,10
20116,Haies - Réunion,OUI,20,20,0,0,0,OUI,OUI,2025-03-13 10:01:17+00:00,"48.85386896766491, 2.402426162238911",Paris,75056,0.0,10
13043,Dunois - Clisson,OUI,51,49,2,1,1,OUI,OUI,2025-03-13 09:57:17+00:00,"48.832294, 2.3674523",Paris,75056,0.0392156862745098,10
42004,Westermeyer - Paul Vaillant-Couturier,OUI,30,1,29,25,4,OUI,OUI,2025-03-13 10:01:26+00:00,"48.819116181578764, 2.3966637253761296",Ivry-sur-Seine,94041,0.9666666666666667,10
9115,Milton - Manuel,OUI,21,20,1,1,0,OUI,OUI,2025-03-13 09:53:04+00:00,"48.878249, 2.341181",Paris,75056,0.047619047619047616,10
6107,Place Alphonse Deville,OUI,22,0,22,13,9,OUI,OUI,2025-03-13 10:00:46+00:00,"48.850188262662, 2.3275961726904",Paris,75056,1.0,10
19039,Edouard Pailleron - Simon Bolivar,OUI,23,23,0,0,0,OUI,OUI,2025-03-13 09:58:16+00:00,"48.87979886049996, 2.374839261174202",Paris,75056,0.0,10
8019,Naples - Rome,OUI,26,23,3,0,3,OUI,OUI,2025-03-13 09:56:17+00:00,"48.879960700846226, 2.321358695626259",Paris,75056,0.11538461538461539,10
16032,Eglise d'Auteuil,OUI,20,8,12,7,5,OUI,OUI,2025-03-13 09:56:38+00:00,"48.84749841771691, 2.26848387135299",Paris,75056,0.6,10
9017,Lallier - Trudaine,OUI,28,27,1,0,1,OUI,OUI,2025-03-13 09:57:49+00:00,"48.88109246617963, 2.3408224806189537",Paris,75056,0.03571428571428571,10
21003,Jean Jaurès - Jean Baptiste Clément,OUI,38,16,22,11,11,OUI,OUI,2025-03-13 09:55:34+00:00,"48.84576261454011, 2.2369650006294255",Boulogne-Billancourt,92012,0.5789473684210527,10
7008,Villersexel - Saint-Germain,OUI,16,2,14,10,4,OUI,OUI,2025-03-13 10:00:59+00:00,"48.858297001218, 2.3237934708595",Paris,75056,0.875,10
9023,Laffitte - Italiens,OUI,31,1,30,17,13,OUI,OUI,2025-03-13 09:58:16+00:00,"48.871815737396, 2.3372015478451",Paris,75056,0.967741935483871,10
16112,Chernoviz - Raynouard,OUI,37,35,2,0,2,OUI,OUI,2025-03-13 09:59:56+00:00,"48.8569864146289, 2.282173218142987",Paris,75056,0.05405405405405406,10
15108,Lourmel - Marie Skobtsov,OUI,22,18,4,2,2,OUI,OUI,2025-03-13 10:00:31+00:00,"48.844974, 2.287283",Paris,75056,0.18181818181818182,10
14030,Pernety - Raymond Losserand,OUI,32,31,1,0,1,OUI,OUI,2025-03-13 10:01:01+00:00,"48.834254627953, 2.317609339387",Paris,75056,0.03125,10
19040,Belleville - Télégraphe,OUI,40,40,0,0,0,OUI,OUI,2025-03-13 09:59:22+00:00,"48.8756045, 2.3995549",Paris,75056,0.0,10
20201,Eugène Reisz - Davout,OUI,20,19,1,0,1,OUI,OUI,2025-03-13 10:01:24+00:00,"48.85631874632638, 2.410396970808506",Paris,75056,0.05,10
17047,Courcelles - Pierre Demours,OUI,26,10,16,12,4,OUI,OUI,2025-03-13 10:00:55+00:00,"48.883769733273496, 2.29858466343129",Paris,75056,0.6153846153846154,10
4110,Neuve Saint-Pierre - Beautreillis,OUI,19,0,19,13,6,OUI,OUI,2025-03-13 10:01:11+00:00,"48.85355351439652, 2.3639122769236565",Paris,75056,1.0,10
6016,Danton - Serpente,OUI,21,1,20,15,5,OUI,OUI,2025-03-13 10:01:02+00:00,"48.852297362582, 2.3414132371545",Paris,75056,0.9523809523809523,10
6032,Sabot - Rennes,OUI,26,2,24,18,6,OUI,OUI,2025-03-13 09:57:05+00:00,"48.852575112948415, 2.331552766263485",Paris,75056,0.9230769230769231,10
41204,République - Danton,OUI,19,17,2,0,2,OUI,OUI,2025-03-13 10:00:56+00:00,"48.85249172181667, 2.462034523487091",Fontenay-sous-Bois,94033,0.10526315789473684,10
17022,Pereire - Place de Wagram,OUI,45,41,4,1,3,OUI,OUI,2025-03-13 09:59:35+00:00,"48.887070607581215, 2.304111124531457",Paris,75056,0.08888888888888889,10
17121,Square des Epinettes,OUI,20,18,2,0,2,OUI,OUI,2025-03-13 09:57:14+00:00,"48.89383909781389, 2.325953990221024",Paris,75056,0.1,10
10036,Aqueduc - Villette,OUI,24,22,2,1,1,OUI,OUI,2025-03-13 09:54:02+00:00,"48.883886063895, 2.367198803315",Paris,75056,0.08333333333333333,10
19009,Cité des Sciences et de l'Industrie,OUI,28,22,6,1,5,OUI,OUI,2025-03-13 09:58:11+00:00,"48.89659571178903, 2.384599149227142",Paris,75056,0.21428571428571427,10
23304,Mairie de Sceaux,OUI,33,27,6,1,5,OUI,OUI,2025-03-13 09:59:15+00:00,"48.778916905132, 2.2887361764861",Sceaux,92071,0.18181818181818182,10
18109,Pajol - Riquet,OUI,46,45,1,0,1,OUI,OUI,2025-03-13 10:01:03+00:00,"48.88960028134536, 2.3628534749150276",Paris,75056,0.021739130434782608,10
13103,Hôpital Pitié Salpêtrière,OUI,48,32,16,13,3,OUI,OUI,2025-03-13 09:58:40+00:00,"48.8377016, 2.3604946",Paris,75056,0.3333333333333333,10
21703,Square du Carrefour de l'Insurrection,OUI,20,16,4,1,3,OUI,OUI,2025-03-13 10:01:13+00:00,"48.820864559770676, 2.291113436222077",Vanves,92075,0.2,10
12161,Diderot - Reuilly,OUI,44,7,37,35,2,OUI,OUI,2025-03-13 09:59:36+00:00,"48.847208456061, 2.3861273378134",Paris,75056,0.8409090909090909,10
16021,François Ponsard - La Muette,OUI,23,22,1,0,1,OUI,OUI,2025-03-13 09:55:44+00:00,"48.8583666, 2.2744515",Paris,75056,0.043478260869565216,10
15107,Palais des Sports,OUI,21,1,20,18,2,OUI,OUI,2025-03-13 10:01:20+00:00,"48.833468517426, 2.2858720645308",Paris,75056,0.9523809523809523,10
9031,Provence - Chaussée d'Antin,OUI,25,1,24,14,10,OUI,OUI,2025-03-13 10:00:31+00:00,"48.87428447542072, 2.332976511564311",Paris,75056,0.96,10
9101,Cadet - La Fayette,OUI,18,8,10,6,4,OUI,OUI,2025-03-13 09:58:27+00:00,"48.875601632672, 2.3435704037547",Paris,75056,0.5555555555555556,10
9117,Bellefond - Maubeuge,OUI,28,25,3,0,3,OUI,OUI,2025-03-13 10:00:06+00:00,"48.878255397645, 2.3452642187476",Paris,75056,0.10714285714285714,10
18017,Caulaincourt - Place Constantin Pecqueur,OUI,42,40,2,0,2,OUI,OUI,2025-03-13 09:59:22+00:00,"48.889677905028, 2.3381787144261",Paris,75056,0.047619047619047616,10
20023,Pelleport - Belgrand,OUI,14,14,0,0,0,OUI,OUI,2025-03-13 09:57:21+00:00,"48.86500081847653, 2.403980836377493",Paris,75056,0.0,10
19041,Belleville - Pyrénées,OUI,38,37,1,1,0,OUI,OUI,2025-03-13 09:57:39+00:00,"48.8741908, 2.3860039",Paris,75056,0.02631578947368421,10
14002,Edgar Quinet - Raspail,OUI,44,35,9,3,6,OUI,OUI,2025-03-13 10:01:25+00:00,"48.83940266673835, 2.32971478253603",Paris,75056,0.20454545454545456,10
23903,Stade Gaston Bouillant,OUI,29,22,7,3,4,OUI,OUI,2025-03-13 09:59:03+00:00,"48.939958667023, 2.3279571813836",Villeneuve-la-Garenne,92078,0.2413793103448276,10
10020,Chabrol - d'Hauteville,OUI,11,6,5,2,3,OUI,OUI,2025-03-13 10:00:11+00:00,"48.877018388033, 2.3513179644942",Paris,75056,0.45454545454545453,10
13010,Place d'Italie - Vincent Auriol,OUI,40,15,25,7,18,OUI,OUI,2025-03-13 09:58:58+00:00,"48.831481874467, 2.3567550292319",Paris,75056,0.625,10
17201,Porte Maillot - Perreire,OUI,50,28,22,9,13,OUI,OUI,2025-03-13 10:00:45+00:00,"48.878021154637, 2.2842371277102",Paris,75056,0.44,10
11041,Square Saint-Ambroise,OUI,39,4,35,30,5,OUI,OUI,2025-03-13 10:01:15+00:00,"48.860934, 2.375841",Paris,75056,0.8974358974358975,10
15059,Parc André Citroën,OUI,64,7,57,54,3,OUI,OUI,2025-03-13 10:01:18+00:00,"48.840639944296655, 2.2780618071556096",Paris,75056,0.890625,10
31703,Sadi Carnot - François Mitterrand,OUI,26,25,1,0,1,OUI,OUI,2025-03-13 09:58:31+00:00,"48.87532687671517, 2.4241617321968083",Bagnolet,93006,0.038461538461538464,10
23403,Chateau,OUI,21,16,5,3,2,OUI,OUI,2025-03-13 09:58:40+00:00,"48.774661399959, 2.3135878035462",Bourg-la-Reine,92014,0.23809523809523808,10
15031,Théâtre - Lourmel,OUI,52,8,44,36,8,OUI,OUI,2025-03-13 10:00:27+00:00,"48.8482070397636, 2.2898658737540245",Paris,75056,0.8461538461538461,10
4013,Vieille du Temple - Francs Bourgeois,OUI,28,3,25,18,7,OUI,OUI,2025-03-13 09:59:16+00:00,"48.858256413365815, 2.35821794718504",Paris,75056,0.8928571428571429,10
21014,Hameau Fleuri - Marché,OUI,20,6,14,5,9,OUI,OUI,2025-03-13 10:00:23+00:00,"48.831448892608314, 2.2412404417991643",Boulogne-Billancourt,92012,0.7,10
45001,Hôtel de Ville de Champigny sur Marne,OUI,21,1,20,9,11,OUI,OUI,2025-03-13 10:01:24+00:00,"48.813810628405, 2.5096759200096",Champigny-sur-Marne,94017,0.9523809523809523,10
5121,Square René Viviani - Montebello,OUI,33,3,30,30,0,OUI,OUI,2025-03-13 10:01:13+00:00,"48.851904891406, 2.3478421568871",Paris,75056,0.9090909090909091,10
31023,Place François Mitterand,OUI,34,34,0,0,0,OUI,OUI,2025-03-13 09:52:02+00:00,"48.86492782016328, 2.442958317697048",Montreuil,93048,0.0,10
47005,Ecole Vétérinaire,OUI,35,10,25,17,8,OUI,OUI,2025-03-13 10:01:05+00:00,"48.81488859822486, 2.4224362157778994",Maisons-Alfort,94046,0.7142857142857143,10
9118,Faubourg Poissonniere - Delta,OUI,36,34,2,1,1,OUI,OUI,2025-03-13 09:57:16+00:00,"48.882555807626765, 2.3497482016682625",Paris,75056,0.05555555555555555,10
16015,Bassano -  Iéna,OUI,15,3,12,4,8,OUI,OUI,2025-03-13 10:01:17+00:00,"48.868144510482075, 2.296149600985935",Paris,75056,0.8,10
21024,Billancourt - Général Leclerc,OUI,22,6,16,14,2,OUI,OUI,2025-03-13 10:00:51+00:00,"48.8322649, 2.2380413",Boulogne-Billancourt,92012,0.7272727272727273,10
15070,Balard - Montagne de la Fage,OUI,35,3,32,27,5,OUI,OUI,2025-03-13 10:00:50+00:00,"48.83850740333351, 2.2782871127128606",Paris,75056,0.9142857142857143,10
2001,Greneta - Sebastopol,OUI,32,1,31,19,12,OUI,OUI,2025-03-13 09:59:51+00:00,"48.865242333228, 2.3516669869423",Paris,75056,0.96875,10
9026,Jean-Baptiste Pigalle - La Bruyere,OUI,17,9,8,5,3,OUI,OUI,2025-03-13 09:58:04+00:00,"48.87939826447722, 2.333709173337285",Paris,75056,0.47058823529411764,10
20019,Place du Maquis du Vercors,OUI,30,30,0,0,0,OUI,OUI,2025-03-13 09:51:45+00:00,"48.877321579493575, 2.4083782732486725",Paris,75056,0.0,10
21001,Transvaal - Charles de Gaulle,OUI,27,3,24,10,14,OUI,OUI,2025-03-13 10:01:25+00:00,"48.848280403628806, 2.2373420120857195",Boulogne-Billancourt,92012,0.8888888888888888,10
18137,Poissonniers - Nord,OUI,28,26,2,2,0,OUI,OUI,2025-03-13 10:00:03+00:00,"48.892511213520656, 2.3522228747606277",Paris,75056,0.07142857142857142,10
18033,Belliard - Damrémont,OUI,34,30,4,2,2,OUI,OUI,2025-03-13 09:52:56+00:00,"48.89669238777841, 2.338023450388167",Paris,75056,0.11764705882352941,10
7101,Raspail - Chomel,OUI,49,0,49,24,25,OUI,OUI,2025-03-13 09:59:20+00:00,"48.852233164303, 2.3266580700874",Paris,75056,1.0,10
21310,Kléber - Gouverneur Général Eboué,OUI,22,5,17,9,8,OUI,OUI,2025-03-13 09:56:57+00:00,"48.826885843069796, 2.2723413258790965",Issy-les-Moulineaux,92040,0.7727272727272727,10
18138,Station Paris Basketball - Ney - Charles Hermite,OUI,20,9,11,7,4,OUI,OUI,2025-03-13 10:00:35+00:00,"48.898748039775, 2.3645754531026",Paris,75056,0.55,10
20016,Pyrénées - Maraîchers,OUI,32,32,0,0,0,OUI,OUI,2025-03-13 09:59:45+00:00,"48.85714001395299, 2.4043509364128113",Paris,75056,0.0,10
7016,Surcouf - Université,OUI,55,5,50,37,13,OUI,OUI,2025-03-13 10:01:19+00:00,"48.861273016278, 2.3094535509142",Paris,75056,0.9090909090909091,10
32015,Gare RER de Saint-Denis,OUI,36,26,10,7,3,OUI,OUI,2025-03-13 09:59:01+00:00,"48.93554324248177, 2.3471488058567047",Saint-Denis,93066,0.2777777777777778,10
4011,Hôtel de Ville - Pont-Marie,OUI,33,2,31,25,6,OUI,OUI,2025-03-13 10:01:00+00:00,"48.853899645527, 2.3569472506642",Paris,75056,0.9393939393939394,10
10010,Place Jacques Bonsergent,OUI,33,11,22,16,6,OUI,OUI,2025-03-13 10:00:40+00:00,"48.870948218595, 2.3612049221992",Paris,75056,0.6666666666666666,10
12041,Bois de Vincennes.,OUI,58,35,23,7,16,OUI,OUI,2025-03-13 10:00:05+00:00,"48.8338064, 2.4132221",Saint-Mandé,94067,0.39655172413793105,10
16043,Place de Passy,OUI,11,9,2,0,2,OUI,OUI,2025-03-13 09:59:31+00:00,"48.85780291711202, 2.277500546942199",Paris,75056,0.18181818181818182,10
7013,Duroc - Place de Breteuil,OUI,46,22,24,20,4,OUI,OUI,2025-03-13 09:59:54+00:00,"48.847460641142, 2.3126140236855",Paris,75056,0.5217391304347826,10
16029,Maison de Radio - France,OUI,42,2,40,40,0,OUI,OUI,2025-03-13 10:01:21+00:00,"48.85132886434057, 2.277785539627075",Paris,75056,0.9523809523809523,10
20202,Dupont de l'Eure - Gambetta,OUI,29,27,2,1,1,OUI,OUI,2025-03-13 09:54:00+00:00,"48.8679385, 2.4003649",Paris,75056,0.06896551724137931,10
18008,Square Léon,OUI,33,32,1,0,1,OUI,OUI,2025-03-13 09:57:19+00:00,"48.88667396788626, 2.353205569088459",Paris,75056,0.030303030303030304,10
18019,Square Raymond Souplex,OUI,51,50,1,0,1,OUI,OUI,2025-03-13 09:58:04+00:00,"48.89183721478911, 2.335426103165901",Paris,75056,0.0196078431372549,10
42703,Fontainebleau - Edmond Michelet,OUI,45,42,3,1,2,OUI,OUI,2025-03-13 09:59:19+00:00,"48.80956436844049, 2.3626908659935",Le Kremlin-Bicêtre,94043,0.06666666666666667,10
11034,Parmentier - Fontaine au Roi,OUI,45,41,4,1,3,OUI,OUI,2025-03-13 09:56:40+00:00,"48.86787670551736, 2.372705978671471",Paris,75056,0.08888888888888889,10
13046,Eugène Oudiné - Dessous Des Berges,OUI,44,24,20,14,6,OUI,OUI,2025-03-13 09:59:50+00:00,"48.8256423, 2.3750226",Paris,75056,0.45454545454545453,10
15020,Mairie du 15ème,OUI,30,29,1,1,0,OUI,OUI,2025-03-13 09:57:05+00:00,"48.8417762, 2.2986539",Paris,75056,0.03333333333333333,10
22102,Mont Valérien - Michel Salles,OUI,24,10,14,11,3,OUI,OUI,2025-03-13 09:58:29+00:00,"48.8561915, 2.2152966",Saint-Cloud,92064,0.5833333333333334,10
13114,Nationale - Marcel Duchamp,OUI,23,12,11,9,2,OUI,OUI,2025-03-13 10:00:53+00:00,"48.82463749337136, 2.3678014799952507",Paris,75056,0.4782608695652174,10
15003,Gare Montparnasse - Vaugirard,OUI,66,61,5,1,4,OUI,OUI,2025-03-13 09:56:20+00:00,"48.8418071798797, 2.31951002690117",Paris,75056,0.07575757575757576,10
15061,Square Desnouettes,OUI,21,6,15,11,4,OUI,OUI,2025-03-13 09:57:38+00:00,"48.83476837934194, 2.284142297394666",Paris,75056,0.7142857142857143,10
7020,Champ de Mars - Cler,OUI,39,12,27,21,6,OUI,OUI,2025-03-13 10:00:53+00:00,"48.856691550115315, 2.306646779179573",Paris,75056,0.6923076923076923,10
20017,Saint-Blaise - Mouraud,OUI,27,26,1,0,1,OUI,OUI,2025-03-13 09:59:06+00:00,"48.85696177597818, 2.40869477391243",Paris,75056,0.037037037037037035,10
6017,Sénat - Condé,OUI,32,7,25,20,5,OUI,OUI,2025-03-13 10:00:20+00:00,"48.84954227788459, 2.337939441204071",Paris,75056,0.78125,10
8015,Roquépine - Malesherbes,OUI,50,2,48,25,23,OUI,OUI,2025-03-13 09:58:43+00:00,"48.87345073390807, 2.320404499769211",Paris,75056,0.96,10
11043,Place Pasdeloup,OUI,18,0,18,15,3,OUI,OUI,2025-03-13 09:59:56+00:00,"48.862654215631, 2.3670325062844",Paris,75056,1.0,10
21108,Mairie de Clichy,OUI,44,39,5,2,3,OUI,OUI,2025-03-13 10:00:05+00:00,"48.903653634661, 2.3059353232384",Clichy,92024,0.11363636363636363,10
1117,Pont Neuf - Rivoli,OUI,24,2,22,15,7,OUI,OUI,2025-03-13 09:58:38+00:00,"48.860089892617, 2.344057559967",Paris,75056,0.9166666666666666,10
31018,Gambetta - Michelet,OUI,30,29,1,1,0,OUI,OUI,2025-03-13 10:00:00+00:00,"48.85273792380526, 2.429966032505036",Montreuil,93048,0.03333333333333333,10
31704,Jeanne Hornet - Girardot,OUI,28,26,2,0,2,OUI,OUI,2025-03-13 10:01:05+00:00,"48.873802681432146, 2.427820265293122",Bagnolet,93006,0.07142857142857142,10
33005,République - Henri Barbusse,OUI,31,16,15,11,4,OUI,OUI,2025-03-13 10:00:31+00:00,"48.90661553626751, 2.389432489871979",Aubervilliers,93001,0.4838709677419355,10
32603,Calmette,OUI,31,30,1,1,0,OUI,OUI,2025-03-13 10:01:16+00:00,"48.88104925098552, 2.424993216991425",Les Lilas,93045,0.03225806451612903,10
1016,Thérèse - Opéra,OUI,24,5,19,12,7,OUI,OUI,2025-03-13 10:00:12+00:00,"48.866483514509, 2.3344334212238",Paris,75056,0.7916666666666666,10
21311,Parvis Corentin Celton,OUI,52,5,47,40,7,OUI,OUI,2025-03-13 09:57:40+00:00,"48.82747252522725, 2.2784319519996648",Issy-les-Moulineaux,92040,0.9038461538461539,10
14007,Ferrus - Saint-Jacques,OUI,33,21,12,5,7,OUI,OUI,2025-03-13 09:59:15+00:00,"48.8313878, 2.3408563",Paris,75056,0.36363636363636365,10
10163,Gare du Nord - Demarquay,OUI,28,27,1,0,1,OUI,OUI,2025-03-13 10:00:01+00:00,"48.881154, 2.358411",Paris,75056,0.03571428571428571,10
11107,Faidherbe - Dahomey,OUI,40,15,25,23,2,OUI,OUI,2025-03-13 09:59:46+00:00,"48.851358329771806, 2.383823134795429",Paris,75056,0.625,10
19023,Manin - Simon Bolivar,OUI,24,22,2,1,1,OUI,OUI,2025-03-13 10:00:21+00:00,"48.876499654127, 2.3794073625991",Paris,75056,0.08333333333333333,10
2014,Daunou - Louis le Grand,OUI,30,7,23,7,16,OUI,OUI,2025-03-13 10:00:08+00:00,"48.869113, 2.332515",Paris,75056,0.7666666666666667,10
8056,Beaujon - Wagram,OUI,28,25,3,1,2,OUI,OUI,2025-03-13 10:00:50+00:00,"48.875352455985, 2.2964416444302",Paris,75056,0.10714285714285714,10
15058,Place du Moulin de Javel,OUI,60,3,57,39,18,OUI,OUI,2025-03-13 10:00:59+00:00,"48.84021670922, 2.2716060653329",Paris,75056,0.95,10
17116,Reims - Porte d'Asnières,OUI,26,16,10,4,6,OUI,OUI,2025-03-13 10:00:36+00:00,"48.891834448210986, 2.300144659954865",Paris,75056,0.38461538461538464,10
11048,Place Mireille Havet,OUI,42,8,34,28,6,OUI,OUI,2025-03-13 09:59:36+00:00,"48.850533, 2.383756",Paris,75056,0.8095238095238095,10
13041,Porte d'Ivry,OUI,50,41,9,6,3,OUI,OUI,2025-03-13 09:59:47+00:00,"48.821768747596, 2.3688706755638",Paris,75056,0.18,10
8049,Georges V - François 1er,OUI,20,0,20,8,12,OUI,OUI,2025-03-13 10:01:02+00:00,"48.87034, 2.30082",Paris,75056,1.0,10
12108,Bercy.,OUI,63,2,61,45,16,OUI,OUI,2025-03-13 09:59:00+00:00,"48.839966914994, 2.3788625746965",Paris,75056,0.9682539682539683,10
22017,Charles de Gaulle - Louis Philippe,OUI,27,12,15,9,6,OUI,OUI,2025-03-13 09:58:32+00:00,"48.881742142181, 2.2710045335353",Neuilly-sur-Seine,92051,0.5555555555555556,10
14006,Saint-Jacques - Tombe Issoire,OUI,21,17,4,0,4,OUI,OUI,2025-03-13 10:01:28+00:00,"48.833206330538864, 2.3369108140468597",Paris,75056,0.19047619047619047,10
22002,Argenson - Château,OUI,24,1,23,14,9,OUI,OUI,2025-03-13 09:58:54+00:00,"48.888559314669514, 2.2642001509666447",Neuilly-sur-Seine,92051,0.9583333333333334,10
21114,Gustave Eiffel - Parc des Impressionnistes,OUI,30,29,1,1,0,OUI,OUI,2025-03-13 09:54:17+00:00,"48.90390619651018, 2.2946908324956894",Clichy,92024,0.03333333333333333,10
35008,Place de l'Eglise - Pantin,OUI,28,27,1,0,1,OUI,OUI,2025-03-13 10:00:10+00:00,"48.892809461520265, 2.4124351143836975",Pantin,93055,0.03571428571428571,10
31013,Centenaire - Sorins,OUI,42,39,3,1,2,OUI,OUI,2025-03-13 09:55:33+00:00,"48.85853523359734, 2.4273508787155156",Montreuil,93048,0.07142857142857142,10
20045,Louis Ganne - Davout,OUI,30,30,0,0,0,OUI,OUI,2025-03-13 09:56:44+00:00,"48.86338720692607, 2.409725748002529",Paris,75056,0.0,10
32018,Franciade - Gabriel Péri,OUI,25,11,14,11,3,OUI,OUI,2025-03-13 10:00:32+00:00,"48.93261499331498, 2.355954498052597",Saint-Denis,93066,0.56,10
5030,Sorbonne - Ecoles,OUI,47,4,43,16,27,OUI,OUI,2025-03-13 10:01:16+00:00,"48.849686566191, 2.3434996604919",Paris,75056,0.9148936170212766,10
17016,Brochant - Square des Batignolles,OUI,31,29,2,1,1,OUI,OUI,2025-03-13 09:56:28+00:00,"48.88818698581028, 2.316861143151153",Paris,75056,0.06451612903225806,10
16041,Versailles - Claude Terrasse,OUI,45,17,28,27,1,OUI,OUI,2025-03-13 09:59:42+00:00,"48.840219338074, 2.263834191153",Paris,75056,0.6222222222222222,10
8029,Place du Canada,OUI,56,3,53,25,28,OUI,OUI,2025-03-13 10:01:08+00:00,"48.865346269363, 2.3101937879648",Paris,75056,0.9464285714285714,10
11003,Keller - La Roquette,OUI,34,24,10,7,3,OUI,OUI,2025-03-13 09:59:05+00:00,"48.8555508, 2.3752778",Paris,75056,0.29411764705882354,10
11110,Roquette - Folie Regnault,OUI,50,43,7,2,5,OUI,OUI,2025-03-13 09:58:05+00:00,"48.859246959155485, 2.386553623578705",Paris,75056,0.14,10
9012,Rougemont - Poissonnière,OUI,30,1,29,20,9,OUI,OUI,2025-03-13 10:00:16+00:00,"48.871611569354755, 2.345873080193996",Paris,75056,0.9666666666666667,10
16031,Vignes - Boulainvilliers,OUI,20,17,3,1,2,OUI,OUI,2025-03-13 09:53:58+00:00,"48.856399483950504, 2.275240458548069",Paris,75056,0.15,10
41206,Place des Larris,OUI,34,29,5,1,4,OUI,OUI,2025-03-13 09:56:55+00:00,"48.8568363, 2.4780236",Fontenay-sous-Bois,94033,0.14705882352941177,10
12153,Terroirs de France - Lheureux,OUI,55,11,44,21,23,OUI,OUI,2025-03-13 10:00:57+00:00,"48.83212027074841, 2.388618104159832",Paris,75056,0.8,10
13113,Vistule - Choisy,OUI,33,26,7,7,0,OUI,OUI,2025-03-13 10:00:54+00:00,"48.82365543660611, 2.3615723848342896",Paris,75056,0.21212121212121213,10
17005,Brochant - Clichy,OUI,52,51,1,0,1,OUI,OUI,2025-03-13 09:57:18+00:00,"48.89032998912038, 2.319730559929781",Paris,75056,0.019230769230769232,10
19031,Manin - Crimée,OUI,21,21,0,0,0,OUI,OUI,2025-03-13 09:58:11+00:00,"48.8831217743719, 2.3863670602440834",Paris,75056,0.0,10
21017,Place Marcel Sembat,OUI,55,0,55,46,9,OUI,OUI,2025-03-13 10:00:33+00:00,"48.83328865030686, 2.2441747784614567",Boulogne-Billancourt,92012,1.0,10
11019,Charonne - Philippe-Auguste,OUI,31,29,2,1,1,OUI,OUI,2025-03-13 09:56:37+00:00,"48.855603162026, 2.39054639062",Paris,75056,0.06451612903225806,10
14016,René Coty - Parc Montsouris,OUI,54,54,0,0,0,OUI,OUI,2025-03-13 10:01:07+00:00,"48.82479134498032, 2.336124926805496",Paris,75056,0.0,10
23008,Hôtel de Ville de Levallois Perret,OUI,26,18,8,3,5,OUI,OUI,2025-03-13 10:01:02+00:00,"48.89314451997415, 2.2888818383216862",Levallois-Perret,92044,0.3076923076923077,10
22012,Madeleine Michelis - Roule,OUI,24,15,9,7,2,OUI,OUI,2025-03-13 10:01:03+00:00,"48.88260431301364, 2.2773634269833565",Neuilly-sur-Seine,92051,0.375,10
6014,Pont de Lodi - Dauphine,OUI,21,11,10,3,7,OUI,OUI,2025-03-13 09:58:44+00:00,"48.855296898603285, 2.339947307565249",Paris,75056,0.47619047619047616,10
18142,Jessaint - Marx Dormoy,OUI,30,30,0,0,0,OUI,OUI,2025-03-13 10:00:39+00:00,"48.88484543106364, 2.358930408954621",Paris,75056,0.0,10
14116,Romain Rolland,OUI,25,25,0,0,0,OUI,OUI,2025-03-13 09:57:27+00:00,"48.820215229662765, 2.3234144234418346",Montrouge,92049,0.0,10
4010,Saint-Antoine Sévigné,OUI,28,4,24,16,8,OUI,OUI,2025-03-13 10:01:27+00:00,"48.8550222, 2.3612322",Paris,75056,0.8571428571428571,10
47002,Les Juilliottes,OUI,21,8,13,12,1,OUI,OUI,2025-03-13 10:01:21+00:00,"48.8043072, 2.4437362",Maisons-Alfort,94046,0.6190476190476191,10
15009,Suffren - Pérignon,OUI,44,4,40,30,10,OUI,OUI,2025-03-13 09:59:25+00:00,"48.84717561492764, 2.307052147596786",Paris,75056,0.9090909090909091,10
2110,Jeûneurs - Mulhouse,OUI,27,14,13,9,4,OUI,OUI,2025-03-13 09:56:47+00:00,"48.868997, 2.346925",Paris,75056,0.48148148148148145,10
23005,Gare de Clichy-Levallois,OUI,26,3,23,18,5,OUI,OUI,2025-03-13 10:01:27+00:00,"48.89679827481989, 2.2984680533409123",Levallois-Perret,92044,0.8846153846153846,10
7026,Place de Finlande,OUI,24,1,23,21,2,OUI,OUI,2025-03-13 10:00:21+00:00,"48.862408335967, 2.3113624379039",Paris,75056,0.9583333333333334,10
48009,République - Auguste Perret,OUI,30,30,0,0,0,OUI,OUI,2025-03-13 09:55:06+00:00,"48.78695280952244, 2.3518594354391094",Villejuif,94076,0.0,10
5019,Poissy - Saint-Germain,OUI,24,1,23,18,5,OUI,OUI,2025-03-13 09:57:59+00:00,"48.84969649427, 2.3529685288668",Paris,75056,0.9583333333333334,10
14125,Dareau - Broussais,OUI,22,19,3,0,3,OUI,OUI,2025-03-13 09:59:12+00:00,"48.8307758, 2.3361804",Paris,75056,0.13636363636363635,10
17033,Carnot - Général Lanrezac,OUI,29,27,2,1,1,OUI,OUI,2025-03-13 09:51:51+00:00,"48.875443870736, 2.2938242935036",Paris,75056,0.06896551724137931,10
13047,Boutroux - Porte de Vitry,OUI,49,28,21,18,3,OUI,OUI,2025-03-13 09:58:40+00:00,"48.822632, 2.377738",Paris,75056,0.42857142857142855,10
10164,Claude Vellefaux - Sambre et Meuse,OUI,32,28,4,1,3,OUI,OUI,2025-03-13 10:01:03+00:00,"48.875022, 2.370478",Paris,75056,0.125,10
44103,Pont De Charenton,OUI,18,6,12,12,0,OUI,OUI,2025-03-13 10:01:01+00:00,"48.8179685, 2.4199531",Saint-Maurice,94069,0.6666666666666666,10
9113,Bleue - Trévise,OUI,26,15,11,6,5,OUI,OUI,2025-03-13 09:59:20+00:00,"48.87578906564573, 2.347289621829987",Paris,75056,0.4230769230769231,10
22403,Pierre Brossolette - Adolphe Pinard,OUI,23,23,0,0,0,OUI,OUI,2025-03-13 09:58:47+00:00,"48.821772279548, 2.3131558299065",Malakoff,92046,0.0,10
20103,Le Vau - Maurice Bertaux,OUI,23,23,0,0,0,OUI,OUI,2025-03-13 09:52:32+00:00,"48.86803439043193, 2.411030612453627",Paris,75056,0.0,10
42011,Quai Marcel Boyer - Victor Hugo,OUI,29,0,29,20,9,OUI,OUI,2025-03-13 09:58:21+00:00,"48.822556366667, 2.3920395970345",Ivry-sur-Seine,94041,1.0,10
4109,Mornay - Sully,OUI,13,6,7,4,3,OUI,OUI,2025-03-13 09:58:37+00:00,"48.84970399548416, 2.364460788667202",Paris,75056,0.5384615384615384,10
9013,Mairie du 9ème,OUI,24,0,24,18,6,OUI,OUI,2025-03-13 09:59:46+00:00,"48.873267137583, 2.3407534480528",Paris,75056,1.0,10
3101,Porte Saint-Martin,OUI,31,10,21,13,8,OUI,OUI,2025-03-13 10:01:28+00:00,"48.86860172112996, 2.35570102930069",Paris,75056,0.6774193548387096,10
92005,Gare de Nanterre Ville,OUI,42,17,25,20,5,OUI,OUI,2025-03-13 10:00:31+00:00,"48.8950295, 2.1957932",Nanterre,92050,0.5952380952380952,10
8105,François 1er - Lincoln,OUI,29,2,27,3,24,OUI,OUI,2025-03-13 10:01:13+00:00,"48.869517979344, 2.3024262188416",Paris,75056,0.9310344827586207,10
19036,Hôpital Robert Debré,OUI,33,30,3,0,3,OUI,OUI,2025-03-13 09:56:24+00:00,"48.88005222200894, 2.4008650346327003",Paris,75056,0.09090909090909091,10
2101,Bachaumont - Montmartre,OUI,33,4,29,26,3,OUI,OUI,2025-03-13 09:58:06+00:00,"48.86617395079137, 2.3449775576591496",Paris,75056,0.8787878787878788,10
31101,Jules Guesde - Laennec,OUI,19,15,4,0,4,OUI,OUI,2025-03-13 09:54:46+00:00,"48.87628983900398, 2.5006942078471184",Rosny-sous-Bois,93064,0.21052631578947367,10
12154,Square Georges Melies,OUI,37,28,9,4,5,OUI,OUI,2025-03-13 09:55:54+00:00,"48.84070239213081, 2.409667745232582",Paris,75056,0.24324324324324326,10
17001,Guy Môquet - Saint-Ouen,OUI,44,38,6,4,2,OUI,OUI,2025-03-13 10:01:16+00:00,"48.892777719023975, 2.3270335793495183",Paris,75056,0.13636363636363635,10
19021,Mairie du 19ème,OUI,24,24,0,0,0,OUI,OUI,2025-03-13 10:00:09+00:00,"48.88256264247959, 2.3812624812126164",Paris,75056,0.0,10
12129,Bois de Vincennes - Porte Jaune,OUI,35,32,3,2,1,OUI,OUI,2025-03-13 09:52:32+00:00,"48.838751246689455, 2.4605489149689674",Paris,75056,0.08571428571428572,10
17104,Jardin Marguerite Long,OUI,21,15,6,2,4,OUI,OUI,2025-03-13 09:59:59+00:00,"48.8816985773914, 2.2836575657129288",Paris,75056,0.2857142857142857,10
35004,Place du Président Salvador Allende,OUI,59,43,16,1,15,OUI,OUI,2025-03-13 10:01:24+00:00,"48.897307310356055, 2.40079153681279",Pantin,93055,0.2711864406779661,10
19030,Melun - Jean Jaurès,OUI,27,25,2,1,1,OUI,OUI,2025-03-13 09:53:29+00:00,"48.8837796723475, 2.376477420330048",Paris,75056,0.07407407407407407,10
31707,Edouard Vaillant - Galliéni,OUI,48,47,1,1,0,OUI,OUI,2025-03-13 09:54:53+00:00,"48.858462881661, 2.4147954583168",Bagnolet,93006,0.020833333333333332,10
21004,Jean Jaurès - Reine,OUI,31,1,30,26,4,OUI,OUI,2025-03-13 10:01:12+00:00,"48.84009622558849, 2.239872515201569",Boulogne-Billancourt,92012,0.967741935483871,10
7010,Constantine - Université,OUI,59,2,57,42,15,OUI,OUI,2025-03-13 10:00:47+00:00,"48.860680473738, 2.3148481955842",Paris,75056,0.9661016949152542,10
13022,Butte aux Cailles - Esperance,OUI,30,27,3,1,2,OUI,OUI,2025-03-13 10:01:04+00:00,"48.82758774190948, 2.3492151126265526",Paris,75056,0.1,10
14113,Santé - Arago,OUI,37,23,14,7,7,OUI,OUI,2025-03-13 10:00:47+00:00,"48.83507657562064, 2.3415737262044938",Paris,75056,0.3783783783783784,10
13019,Fernand Braudel - Vincent Auriol,OUI,36,19,17,11,6,OUI,OUI,2025-03-13 10:00:36+00:00,"48.83637852318147, 2.3723404482007027",Paris,75056,0.4722222222222222,10
32021,Place du Front Populaire - George Sand,OUI,64,40,24,23,1,OUI,OUI,2025-03-13 10:00:37+00:00,"48.90680713698062, 2.364541214992642",Saint-Denis,93066,0.375,10
11044,Square du Bataclan,OUI,16,7,9,8,1,OUI,OUI,2025-03-13 09:58:51+00:00,"48.8633762, 2.3711327",Paris,75056,0.5625,10
15019,Paul Barruel - Vaugirard,OUI,36,33,3,1,2,OUI,OUI,2025-03-13 10:00:07+00:00,"48.84014918546239, 2.3044332861900334",Paris,75056,0.08333333333333333,10
21952,Place Tony de Graaff,OUI,42,18,24,20,4,OUI,OUI,2025-03-13 10:00:12+00:00,"48.8181645, 2.2458109",Meudon,92048,0.5714285714285714,10
7024,Rapp - Place du Général Gouraud,OUI,29,12,17,12,5,OUI,OUI,2025-03-13 10:00:54+00:00,"48.858102885107, 2.3004072904587",Paris,75056,0.5862068965517241,10
9015,Lamartine - Faubourg Montmartre,OUI,30,15,15,5,10,OUI,OUI,2025-03-13 09:59:39+00:00,"48.876613982891, 2.3397656902671",Paris,75056,0.5,10
20004,Commandant l'Herminier - Gallieni,OUI,17,16,1,1,0,OUI,OUI,2025-03-13 10:01:26+00:00,"48.847040552603, 2.4160453677177",Paris,75056,0.058823529411764705,10
14127,Odessa - Départ,OUI,39,31,8,2,6,OUI,OUI,2025-03-13 09:57:12+00:00,"48.842885590081, 2.3244281485677",Paris,75056,0.20512820512820512,10
11031,Jacquard - Ternaux,OUI,39,23,16,14,2,OUI,OUI,2025-03-13 10:00:21+00:00,"48.8646605, 2.373162",Paris,75056,0.41025641025641024,10
12033,François Truffaut - Saint Emilion,OUI,66,20,46,40,6,OUI,OUI,2025-03-13 10:00:35+00:00,"48.83372354344807, 2.386601903271428",Paris,75056,0.696969696969697,10
12125,Pyramide - Parc Floral,OUI,49,38,11,3,8,OUI,OUI,2025-03-13 09:58:53+00:00,"48.837442, 2.440452",Paris,75056,0.22448979591836735,10
12120,Lac Daumesnil - Saint-Maurice,OUI,49,35,14,12,2,OUI,OUI,2025-03-13 09:53:24+00:00,"48.82774555743318, 2.4183654785156246",Paris,75056,0.2857142857142857,10
13515,Auguste Blanqui - Glacière,OUI,59,57,2,1,1,OUI,OUI,2025-03-13 10:01:01+00:00,"48.831151602964, 2.343822196126",Paris,75056,0.03389830508474576,10
18035,René Binet - Porte de Montmartre,OUI,36,25,11,1,10,OUI,OUI,2025-03-13 09:56:22+00:00,"48.89905109950848, 2.3365534096956253",Paris,75056,0.3055555555555556,10
9016,Choron - Martyrs,OUI,17,14,3,2,1,OUI,OUI,2025-03-13 09:51:44+00:00,"48.877851443503, 2.3396701365709",Paris,75056,0.17647058823529413,10
13110,Moulin de la Pointe,OUI,20,18,2,0,2,OUI,OUI,2025-03-13 09:57:02+00:00,"48.82092946051445, 2.3563179373741145",Paris,75056,0.1,10
15125,Parc Suzanne Lenglen,OUI,51,8,43,39,4,OUI,OUI,2025-03-13 10:01:02+00:00,"48.833250690537874, 2.2765403240919113",Paris,75056,0.8431372549019608,10
23105,Sèvres Rive Gauche,OUI,33,20,13,13,0,OUI,OUI,2025-03-13 09:53:01+00:00,"48.821443218278, 2.2150785306885",Sèvres,92072,0.3939393939393939,10
13027,Mazagran - Pierre de Coubertin,OUI,15,10,5,1,4,OUI,OUI,2025-03-13 10:00:51+00:00,"48.816218640260445, 2.344226874411106",Paris,75056,0.3333333333333333,10
21120,Docteur Calmette - Martre,OUI,30,12,18,18,0,OUI,OUI,2025-03-13 09:59:11+00:00,"48.898969358483, 2.3086513252383",Clichy,92024,0.6,10
17029,Pierre Demours - Laugier,OUI,36,34,2,0,2,OUI,OUI,2025-03-13 09:51:16+00:00,"48.8813072, 2.294846",Paris,75056,0.05555555555555555,10
20117,Saint-Fargeau - Mortier,OUI,31,31,0,0,0,OUI,OUI,2025-03-13 10:01:25+00:00,"48.87266656122256, 2.407912909984589",Paris,75056,0.0,10
20039,Belleville - Couronnes,OUI,48,47,1,0,1,OUI,OUI,2025-03-13 09:58:29+00:00,"48.868831082877, 2.3809862136841",Paris,75056,0.020833333333333332,10
21009,Le Corbusier - Jean Jaurès,OUI,45,27,18,9,9,OUI,OUI,2025-03-13 10:01:22+00:00,"48.83780830557548, 2.2408381104469304",Boulogne-Billancourt,92012,0.4,10
21203,Place Jules Ferry,OUI,28,25,3,3,0,OUI,OUI,2025-03-13 09:59:28+00:00,"48.812107928414775, 2.325837314128876",Montrouge,92049,0.10714285714285714,10
31017,Jean Moulin - Paul Doumer,OUI,17,14,3,0,3,OUI,OUI,2025-03-13 10:01:26+00:00,"48.8622179854695, 2.45533436536789",Montreuil,93048,0.17647058823529413,10
5034,Censier - Santeuil,OUI,66,14,52,40,12,OUI,OUI,2025-03-13 10:00:22+00:00,"48.840658921385234, 2.3537524044513702",Paris,75056,0.7878787878787878,10
18114,Véron - Lepic,OUI,22,21,1,1,0,OUI,OUI,2025-03-13 09:58:47+00:00,"48.88526123395252, 2.334559857845307",Paris,75056,0.045454545454545456,10
19025,Botzaris - Crimée,OUI,20,19,1,0,1,OUI,OUI,2025-03-13 09:59:15+00:00,"48.87959698690176, 2.3887913337477067",Paris,75056,0.05,10
4107,Beaumarchais - Pas de la Mule,OUI,17,1,16,9,7,OUI,OUI,2025-03-13 10:01:23+00:00,"48.855580507049, 2.3684333673431",Paris,75056,0.9411764705882353,10
10153,Gare du Nord - Denain,OUI,20,15,5,1,4,OUI,OUI,2025-03-13 10:01:28+00:00,"48.879595787608, 2.3544725775719",Paris,75056,0.25,10
20047,Cours de Vincennes - Davout,OUI,48,33,15,8,7,OUI,OUI,2025-03-13 10:01:12+00:00,"48.847238029966, 2.4107042336225",Paris,75056,0.3125,10
16003,André Maurois - Joseph et Marie Hackin,OUI,27,11,16,12,4,OUI,OUI,2025-03-13 09:58:41+00:00,"48.8778983, 2.2789591",Paris,75056,0.5925925925925926,10
21951,Place Centrale,OUI,22,20,2,1,1,OUI,OUI,2025-03-13 09:51:44+00:00,"48.78740167690531, 2.2278830409049992",Meudon,92048,0.09090909090909091,10
16014,Eylau - Trocadéro,OUI,22,7,15,0,15,OUI,OUI,2025-03-13 10:00:20+00:00,"48.863354122371, 2.2864209115505",Paris,75056,0.6818181818181818,10
22103,Senard - Charles Blum,OUI,24,6,18,5,13,OUI,OUI,2025-03-13 09:58:52+00:00,"48.857315824799, 2.221091687679291",Saint-Cloud,92064,0.75,10
21708,Marcel Yol - Jullien,OUI,29,14,15,7,8,OUI,OUI,2025-03-13 10:00:47+00:00,"48.82537611802588, 2.287235018058929",Vanves,92075,0.5172413793103449,10
19113,Pré Saint-Gervais - Lilas,OUI,27,27,0,0,0,OUI,OUI,2025-03-13 09:56:17+00:00,"48.877870626988, 2.3959073424339",Paris,75056,0.0,10
21702,Gare SNCF Vanves-Malakoff,OUI,49,48,1,1,0,OUI,OUI,2025-03-13 10:00:22+00:00,"48.819002163836444, 2.292150005103606",Vanves,92075,0.02040816326530612,10
14128,Gergovie - Vercingétorix,OUI,29,28,1,0,1,OUI,OUI,2025-03-13 10:00:32+00:00,"48.83453413883994, 2.313154547426182",Paris,75056,0.034482758620689655,10
11109,Pierre Levée - Fontaine Timbaud,OUI,22,18,4,0,4,OUI,OUI,2025-03-13 09:59:05+00:00,"48.86632723374305, 2.3711163550615306",Paris,75056,0.18181818181818182,10
10039,Sambre et Meuse - Villette,OUI,24,21,3,2,1,OUI,OUI,2025-03-13 10:00:34+00:00,"48.874405666217, 2.3738072379951",Paris,75056,0.125,10
31021,Résistance - Hoche,OUI,28,28,0,0,0,OUI,OUI,2025-03-13 09:59:01+00:00,"48.864273423741956, 2.435784414410591",Montreuil,93048,0.0,10
31026,Demi-Lune - Aristide Briand,OUI,20,20,0,0,0,OUI,OUI,2025-03-13 09:58:47+00:00,"48.87626381919953, 2.4562818557024",Montreuil,93048,0.0,10
44002,Paul Vaillant-Couturier - Gare RER,OUI,25,0,25,18,7,OUI,OUI,2025-03-13 10:01:24+00:00,"48.80108159069614, 2.402097210288048",Vitry-sur-Seine,94081,1.0,10
8011,Clapeyron - Moscou,OUI,15,13,2,0,2,OUI,OUI,2025-03-13 09:59:36+00:00,"48.88078819514121, 2.324815057218075",Paris,75056,0.13333333333333333,10
13039,Ivry - Simone Weil,OUI,18,14,4,3,1,OUI,OUI,2025-03-13 10:01:29+00:00,"48.823283932030755, 2.3659095168113713",Paris,75056,0.2222222222222222,10
13020,Paul Klee - Place Augusta Holmes,OUI,43,15,28,6,22,OUI,OUI,2025-03-13 09:58:34+00:00,"48.838946417408025, 2.3704235663952966",Paris,75056,0.6511627906976745,10
21030,Fessart - Château,OUI,20,0,20,17,3,OUI,OUI,2025-03-13 10:00:52+00:00,"48.84245, 2.23989",Boulogne-Billancourt,92012,1.0,10
19124,Alexander Fleming - Belvédère,OUI,31,29,2,1,1,OUI,OUI,2025-03-13 09:52:34+00:00,"48.88179064200294, 2.4030599377642674",Paris,75056,0.06451612903225806,10
16024,Ranelagh - Maison de la Radio,OUI,19,4,15,10,5,OUI,OUI,2025-03-13 09:56:32+00:00,"48.85293603169479, 2.280449643731117",Paris,75056,0.7894736842105263,10
35015,Averroès - Aimé Césaire,OUI,17,10,7,5,2,OUI,OUI,2025-03-13 09:53:30+00:00,"48.91405323432864, 2.412636950612068",Pantin,93055,0.4117647058823529,10
15043,Brancion - Lefebvre,OUI,9,9,0,0,0,OUI,OUI,2025-03-13 09:56:04+00:00,"48.82900222785569, 2.301431038163409",Paris,75056,0.0,10
20203,Evariste Galois,OUI,20,19,1,1,0,OUI,OUI,2025-03-13 10:01:20+00:00,"48.873341356228, 2.4133544409574",Paris,75056,0.05,10
22604,Hôtel de Ville de Fontenay-aux-Roses,OUI,32,30,2,1,1,OUI,OUI,2025-03-13 10:00:47+00:00,"48.790844603480856, 2.2871455930319455",Fontenay-aux-Roses,92032,0.0625,10
12150,Bastille - Quai de la Rapée,OUI,27,2,25,22,3,OUI,OUI,2025-03-13 09:59:59+00:00,"48.84682410855, 2.3669364675879",Paris,75056,0.9259259259259259,10
11032,Jean-Pierre Timbaud - Vaucouleurs,OUI,45,39,6,2,4,OUI,OUI,2025-03-13 09:58:40+00:00,"48.867937, 2.377885",Paris,75056,0.13333333333333333,10
10152,Gare du Nord - Place de Valenciennes,OUI,24,21,3,1,2,OUI,OUI,2025-03-13 10:00:43+00:00,"48.879089, 2.354235",Paris,75056,0.125,10
16101,Malakoff - Place de la Porte Maillot,OUI,26,11,15,5,10,OUI,OUI,2025-03-13 09:58:25+00:00,"48.876733496638, 2.2834577411413",Paris,75056,0.5769230769230769,10
15131,Charles Lecocq - Lecourbe,OUI,28,24,4,3,1,OUI,OUI,2025-03-13 09:57:01+00:00,"48.84044, 2.294867",Paris,75056,0.14285714285714285,10
21307,Victor Cresson - Telles de la Poterie,OUI,29,17,12,10,2,OUI,OUI,2025-03-13 10:00:16+00:00,"48.822698842979, 2.2686498274964",Issy-les-Moulineaux,92040,0.41379310344827586,10
10037,Quai de Valmy,OUI,26,23,3,2,1,OUI,OUI,2025-03-13 09:57:01+00:00,"48.88126951579429, 2.368186041712761",Paris,75056,0.11538461538461539,10
10012,Vinaigriers - Magenta,OUI,24,15,9,5,4,OUI,OUI,2025-03-13 09:57:03+00:00,"48.8731167, 2.3593052",Paris,75056,0.375,10
9036,Athènes - Clichy,OUI,18,10,8,2,6,OUI,OUI,2025-03-13 10:01:01+00:00,"48.878113787876, 2.32956021945824",Paris,75056,0.4444444444444444,10
21028,Pierre Lefaucheux - Traversière,OUI,34,9,25,15,10,OUI,OUI,2025-03-13 10:00:56+00:00,"48.82435208303827, 2.2417913004755974",Boulogne-Billancourt,92012,0.7352941176470589,10
13117,Stade Georges Carpentier,OUI,39,29,10,2,8,OUI,OUI,2025-03-13 10:00:29+00:00,"48.820482438381, 2.3668321967125",Paris,75056,0.2564102564102564,10
4003,Quai aux Fleurs - Pont Saint-Louis,OUI,21,3,18,18,0,OUI,OUI,2025-03-13 09:56:05+00:00,"48.852915956209, 2.3521957173944",Paris,75056,0.8571428571428571,10
10004,Metz - Faubourg Saint-Denis,OUI,44,22,22,11,11,OUI,OUI,2025-03-13 09:59:02+00:00,"48.870893, 2.353521",Paris,75056,0.5,10
32301,Mairie de Romainville,OUI,17,17,0,0,0,OUI,OUI,2025-03-13 09:53:28+00:00,"48.885109, 2.435679",Romainville,93063,0.0,10
21118,Neuilly - Petit,OUI,14,10,4,2,2,OUI,OUI,2025-03-13 10:01:20+00:00,"48.898965361341254, 2.29627937078476",Clichy,92024,0.2857142857142857,10
21219,Amaury Duval - Gabriel Péri,OUI,36,35,1,0,1,OUI,OUI,2025-03-13 09:53:26+00:00,"48.81718759671675, 2.323841750621796",Montrouge,92049,0.027777777777777776,10
11103,Pelée - Alphonse Baudin,OUI,35,19,16,11,5,OUI,OUI,2025-03-13 10:01:12+00:00,"48.8600265, 2.3710541",Paris,75056,0.45714285714285713,10
5014,Jean Calvin - Tournefort,OUI,28,4,24,9,15,OUI,OUI,2025-03-13 10:01:22+00:00,"48.84158856925782, 2.348489575088024",Paris,75056,0.8571428571428571,10
10017,Gare de l'Est - Fidélité,OUI,13,5,8,3,5,OUI,OUI,2025-03-13 09:56:18+00:00,"48.874575, 2.356796",Paris,75056,0.6153846153846154,10
20007,Buzenval - Avron,OUI,49,46,3,0,3,OUI,OUI,2025-03-13 09:44:49+00:00,"48.851617204999, 2.4015135973077",Paris,75056,0.061224489795918366,10
22013,Mairie de Neuilly sur Seine,OUI,30,25,5,3,2,OUI,OUI,2025-03-13 09:58:18+00:00,"48.88494728765838, 2.2677031159400944",Neuilly-sur-Seine,92051,0.16666666666666666,10
13033,Porte d'Italie,OUI,13,10,3,0,3,OUI,OUI,2025-03-13 10:01:27+00:00,"48.817161987718954, 2.360236309468746",Paris,75056,0.23076923076923078,10
21316,Cimetière d'Issy-les-Moulineaux,OUI,23,22,1,1,0,OUI,OUI,2025-03-13 10:00:51+00:00,"48.817699773925, 2.2609312087297",Issy-les-Moulineaux,92040,0.043478260869565216,10
20122,Vitruve - Davout,OUI,23,23,0,0,0,OUI,OUI,2025-03-13 09:57:47+00:00,"48.86053161154489, 2.4091592812626543",Paris,75056,0.0,10
16009,Saint-Didier - Raymond Poincaré,OUI,17,10,7,0,7,OUI,OUI,2025-03-13 09:56:44+00:00,"48.86642312020962, 2.285863497192411",Paris,75056,0.4117647058823529,10
8020,Batignolles - Beudant,OUI,43,41,2,0,2,OUI,OUI,2025-03-13 09:55:58+00:00,"48.88216401466375, 2.319852970540523",Paris,75056,0.046511627906976744,10
21029,Cours de l'Ile Seguin - Parc Billancourt,OUI,28,7,21,9,12,OUI,OUI,2025-03-13 10:01:12+00:00,"48.82714055843935, 2.234234511852265",Boulogne-Billancourt,92012,0.75,10
17015,Place de Lévis,OUI,48,41,7,4,3,OUI,OUI,2025-03-13 09:57:24+00:00,"48.883546851533254, 2.3131933808326726",Paris,75056,0.14583333333333334,10
15072,Place Fernand Forest,OUI,28,3,25,22,3,OUI,OUI,2025-03-13 10:00:28+00:00,"48.849269143836, 2.281863167882",Paris,75056,0.8928571428571429,10
22501,Théâtre de La Garenne,OUI,20,18,2,1,1,OUI,OUI,2025-03-13 09:56:40+00:00,"48.905658361454, 2.2345951981176",La Garenne-Colombes,92035,0.1,10
12006,Gare de Lyon - Van Gogh,OUI,41,3,38,27,11,OUI,OUI,2025-03-13 09:59:56+00:00,"48.843839785643, 2.3704450240357",Paris,75056,0.926829268292683,10
42003,Place de l'Insurrection d'Août 1944,OUI,30,0,30,26,4,OUI,OUI,2025-03-13 09:58:33+00:00,"48.81477852751594, 2.398074567317963",Ivry-sur-Seine,94041,1.0,10
16007,Longchamp - Place d'Iéna,OUI,25,4,21,4,17,OUI,OUI,2025-03-13 10:00:58+00:00,"48.864917233434, 2.2926748171449",Paris,75056,0.84,10
40009,Lycée Saint Exupéry - Juliette Savar,OUI,29,19,10,8,2,OUI,OUI,2025-03-13 09:58:24+00:00,"48.783021513972, 2.4637357216879",Créteil,94028,0.3448275862068966,10
10110,Louis Blanc - Jemmapes,OUI,31,22,9,1,8,OUI,OUI,2025-03-13 10:00:44+00:00,"48.879330755297, 2.3684485629201",Paris,75056,0.2903225806451613,10
12043,Daumesnil - Hébrard,OUI,39,18,21,20,1,OUI,OUI,2025-03-13 09:58:59+00:00,"48.8429, 2.38474",Paris,75056,0.5384615384615384,10
21115,Chancé Milly - Cimetière Communal Sud,OUI,32,15,17,11,6,OUI,OUI,2025-03-13 09:58:21+00:00,"48.89687189382465, 2.303922325372696",Clichy,92024,0.53125,10
13048,Wurtz - Tolbiac,OUI,28,28,0,0,0,NON,NON,2025-03-13 09:57:53+00:00,"48.82631195621, 2.344585955143",Paris,75056,0.0,10
23003,Président Wilson - Baudin,OUI,28,10,18,13,5,OUI,OUI,2025-03-13 10:01:06+00:00,"48.89826887103676, 2.2849336266517644",Levallois-Perret,92044,0.6428571428571429,10
41210,Hôtel de ville de Fontenay-sous-Bois,OUI,19,18,1,0,1,OUI,OUI,2025-03-13 09:51:47+00:00,"48.84949749106274, 2.4750164151191716",Fontenay-sous-Bois,94033,0.05263157894736842,10
19108,Gaston Tessier - Rosa Parks RER,OUI,37,23,14,11,3,OUI,OUI,2025-03-13 09:57:05+00:00,"48.8963765, 2.3743692",Paris,75056,0.3783783783783784,10
42304,Marc Sangnier - Division Leclerc,OUI,21,5,16,13,3,OUI,OUI,2025-03-13 10:01:06+00:00,"48.78599652305309, 2.329955510795116",Cachan,94016,0.7619047619047619,10
44007,Camille Groult - Guy Môquet,OUI,21,7,14,11,3,OUI,OUI,2025-03-13 10:00:48+00:00,"48.787482746521306, 2.3976725712418556",Vitry-sur-Seine,94081,0.6666666666666666,10
15052,Convention - Vaugirard,OUI,43,35,8,5,3,OUI,OUI,2025-03-13 10:00:57+00:00,"48.83767682233156, 2.295586926020252",Paris,75056,0.18604651162790697,10
10105,Mazagran - Bonne Nouvelle,OUI,25,15,10,5,5,OUI,OUI,2025-03-13 10:01:26+00:00,"48.870047123655, 2.3511248454452",Paris,75056,0.4,10
16115,Raffet - Montmorency,OUI,40,37,3,0,3,OUI,OUI,2025-03-13 10:01:19+00:00,"48.85258670812, 2.2629252456151954",Paris,75056,0.075,10
17003,Jacques Kellner - Saint-Ouen,OUI,43,43,0,0,0,OUI,OUI,2025-03-13 09:57:18+00:00,"48.895809485802886, 2.327897409164145",Paris,75056,0.0,10
15123,Commerce - Letellier,OUI,44,26,18,11,7,OUI,OUI,2025-03-13 09:58:50+00:00,"48.84797660373612, 2.2966245196598805",Paris,75056,0.4090909090909091,10
42501,Raspail - Albert Schweitzer,OUI,27,9,18,18,0,OUI,OUI,2025-03-13 10:00:45+00:00,"48.81031545, 2.34395871",Gentilly,94037,0.6666666666666666,10
21031,Cimetière de Boulogne-Billancourt,OUI,40,13,27,24,3,OUI,OUI,2025-03-13 09:59:07+00:00,"48.830764, 2.252024",Boulogne-Billancourt,92012,0.675,10
13109,Brillat-Savarin - Küss,OUI,21,17,4,2,2,OUI,OUI,2025-03-13 10:01:20+00:00,"48.822203, 2.350422",Paris,75056,0.19047619047619047,10
17039,Place Saint-Ferdinand,OUI,38,29,9,2,7,OUI,OUI,2025-03-13 09:56:10+00:00,"48.87815529789739, 2.288518047864942",Paris,75056,0.23684210526315788,10
22206,Louis Pasteur - Albert Petit,OUI,30,28,2,0,2,OUI,OUI,2025-03-13 10:00:25+00:00,"48.796261, 2.317289",Bagneux,92007,0.06666666666666667,10
20009,Docteurs Déjérine - Pte de Montreuil,OUI,19,19,0,0,0,OUI,OUI,2025-03-13 09:54:14+00:00,"48.85398448133697, 2.41208288897222",Paris,75056,0.0,10
21217,Louis Rolland - République,OUI,26,21,5,0,5,OUI,OUI,2025-03-13 10:00:01+00:00,"48.81710889740748, 2.3193106434955717",Montrouge,92049,0.19230769230769232,10
42305,Vanne - Saussaies,OUI,20,18,2,0,2,OUI,OUI,2025-03-13 10:00:36+00:00,"48.786404, 2.338848",Cachan,94016,0.1,10
12007,Gare de Lyon - Chalon,OUI,45,31,14,10,4,OUI,OUI,2025-03-13 09:55:06+00:00,"48.845666194202, 2.3741452395916",Paris,75056,0.3111111111111111,10
21955,Vaugirard - Verrerie,OUI,24,1,23,17,6,OUI,OUI,2025-03-13 09:58:19+00:00,"48.820881336842, 2.2367222622987",Meudon,92048,0.9583333333333334,10
25001,Colmar - Victor Hugo,OUI,31,6,25,12,13,OUI,OUI,2025-03-13 09:53:10+00:00,"48.88652251096166, 2.173960916697979",Rueil-Malmaison,92063,0.8064516129032258,10
8001,Petit Palais,OUI,42,12,30,18,12,OUI,OUI,2025-03-13 10:01:28+00:00,"48.8667692, 2.3157655",Paris,75056,0.7142857142857143,10
35007,Benjamin Delessert - Jean Lolive,OUI,20,20,0,0,0,OUI,OUI,2025-03-13 09:57:33+00:00,"48.89392043619345, 2.417981922626496",Pantin,93055,0.0,10
13121,Bruneseau - Quai d'Ivry,OUI,46,1,45,42,3,OUI,OUI,2025-03-13 10:01:10+00:00,"48.824945637583, 2.3885661363602",Ivry-sur-Seine,94041,0.9782608695652174,10
47001,Place de la Gare,OUI,45,5,40,35,5,OUI,OUI,2025-03-13 10:00:33+00:00,"48.80253358011283, 2.4275037646293645",Maisons-Alfort,94046,0.8888888888888888,10
10018,Square Alban Satragne,OUI,29,20,9,1,8,OUI,OUI,2025-03-13 10:00:10+00:00,"48.875388227727, 2.3559567333359",Paris,75056,0.3103448275862069,10
13032,Italie - Jardin Joan Miro,OUI,24,21,3,0,3,OUI,OUI,2025-03-13 09:59:50+00:00,"48.81990914045756, 2.3592948541045193",Paris,75056,0.125,10
20108,Jardin de l'Hospice Debrousse,OUI,23,23,0,0,0,OUI,OUI,2025-03-13 10:01:20+00:00,"48.861451061938, 2.40568600595",Paris,75056,0.0,10
10165,Gare de l'Est - Place du 11 Novembre 1918,OUI,38,33,5,3,2,OUI,OUI,2025-03-13 09:58:50+00:00,"48.876327, 2.3585464",Paris,75056,0.13157894736842105,10
13011,Hôpital - Campo-Formio,OUI,11,6,5,5,0,OUI,OUI,2025-03-13 09:58:59+00:00,"48.835405, 2.358218",Paris,75056,0.45454545454545453,10
15064,Javel - André Citroën,OUI,44,6,38,36,2,OUI,OUI,2025-03-13 09:59:54+00:00,"48.846276485475, 2.2786368057132",Paris,75056,0.8636363636363636,10
31025,Paul Signac - Aristide Briand,OUI,33,31,2,0,2,OUI,OUI,2025-03-13 09:52:27+00:00,"48.86950262156371, 2.4502260982990265",Montreuil,93048,0.06060606060606061,10
15057,Lucien Bossoutrot - Général Martial Vallin,OUI,38,4,34,18,16,OUI,OUI,2025-03-13 10:00:53+00:00,"48.836956046311, 2.2741072252393",Paris,75056,0.8947368421052632,10
8549,George V - Christophe Colomb,OUI,22,3,19,7,12,OUI,OUI,2025-03-13 10:00:29+00:00,"48.87046, 2.30104",Paris,75056,0.8636363636363636,10
16002,Pergolèse - Malakoff,OUI,37,28,9,3,6,OUI,OUI,2025-03-13 09:58:48+00:00,"48.87521088779225, 2.2842781618237495",Paris,75056,0.24324324324324326,10
23902,Gallieni - Lycée Charles Petitet,OUI,44,22,22,14,8,OUI,OUI,2025-03-13 09:59:56+00:00,"48.927640283627, 2.3308986340524",Villeneuve-la-Garenne,92078,0.5,10
15004,Vaugirard - Pasteur,OUI,21,19,2,1,1,OUI,OUI,2025-03-13 10:00:50+00:00,"48.84040868803496, 2.3154367133975033",Paris,75056,0.09523809523809523,10
42701,Charles Gide - Fort de Bicêtre,OUI,29,15,14,3,11,OUI,OUI,2025-03-13 10:00:21+00:00,"48.8071937956922, 2.353984415531159",Le Kremlin-Bicêtre,94043,0.4827586206896552,10
23010,Voltaire - Anatole France,OUI,26,8,18,10,8,OUI,OUI,2025-03-13 09:59:09+00:00,"48.891999360256904, 2.284262739121914",Levallois-Perret,92044,0.6923076923076923,10
16020,Place de la Porte de Passy,OUI,34,29,5,2,3,OUI,OUI,2025-03-13 09:51:55+00:00,"48.857341095470794, 2.2644165538827115",Paris,75056,0.14705882352941177,10
13044,Place Jeanne d'Arc,OUI,36,35,1,0,1,OUI,OUI,2025-03-13 09:52:48+00:00,"48.829575, 2.369126",Paris,75056,0.027777777777777776,10
13126,Place Nationale - Château-des-Rentiers,OUI,18,3,15,9,6,OUI,OUI,2025-03-13 10:00:27+00:00,"48.829268, 2.365212",Paris,75056,0.8333333333333334,10
9027,Douai - Pierre Fontaine,OUI,23,21,2,1,1,OUI,OUI,2025-03-13 10:00:30+00:00,"48.88229101148092, 2.33324121683836",Paris,75056,0.08695652173913043,10
14101,Gare Montparnasse - Edgar Quinet,OUI,33,26,7,1,6,OUI,OUI,2025-03-13 09:57:19+00:00,"48.841487851079, 2.3233232282801",Paris,75056,0.21212121212121213,10
4020,Place Edmond Michelet,OUI,22,10,12,8,4,OUI,OUI,2025-03-13 09:57:51+00:00,"48.860134890542, 2.3500636965036",Paris,75056,0.5454545454545454,10
15023,La Motte-Picquet - Grenelle,OUI,33,4,29,26,3,OUI,OUI,2025-03-13 10:00:57+00:00,"48.84858321339195, 2.299347817897797",Paris,75056,0.8787878787878788,10
23004,Paul Vaillant-Couturier - Victor Hugo,OUI,34,7,27,23,4,OUI,OUI,2025-03-13 10:00:47+00:00,"48.89819702263572, 2.293848017974069",Levallois-Perret,92044,0.7941176470588235,10
4001,Arcole - Notre-Dame,OUI,27,11,16,3,13,OUI,OUI,2025-03-13 10:00:39+00:00,"48.853883541328, 2.3493797332048",Paris,75056,0.5925925925925926,10
22408,Place du 14 Juillet,OUI,22,22,0,0,0,OUI,OUI,2025-03-13 10:00:27+00:00,"48.819266959525, 2.3011998832226",Malakoff,92046,0.0,10
14131,Jourdan - Monticelli,OUI,30,27,3,1,2,OUI,OUI,2025-03-13 09:59:13+00:00,"48.822032, 2.329095",Paris,75056,0.1,10
8037,Monceau - Malesherbes,OUI,37,25,12,5,7,OUI,OUI,2025-03-13 10:00:12+00:00,"48.8795079, 2.3145456",Paris,75056,0.32432432432432434,10
17023,Porte d'Asnières,OUI,34,28,6,6,0,OUI,OUI,2025-03-13 10:01:26+00:00,"48.89035817610495, 2.3036286234855656",Paris,75056,0.17647058823529413,10
21306,Place Lafayette,OUI,61,5,56,47,9,OUI,OUI,2025-03-13 10:00:41+00:00,"48.829654975522, 2.2638675570488",Issy-les-Moulineaux,92040,0.9180327868852459,10
4002,Marché aux fleurs,OUI,21,1,20,11,9,OUI,OUI,2025-03-13 10:01:19+00:00,"48.855258115391, 2.3473754525185",Paris,75056,0.9523809523809523,10
33015,Charles Tillon - Cimetière Communal,OUI,26,3,23,6,17,OUI,OUI,2025-03-13 10:00:04+00:00,"48.91844023641836, 2.3935630917549138",Aubervilliers,93001,0.8846153846153846,10
6008,Assas - Luxembourg,OUI,32,2,30,9,21,OUI,OUI,2025-03-13 10:00:40+00:00,"48.843734468779, 2.3334283818759",Paris,75056,0.9375,10
44016,Balzac - Olympes de Gouges,OUI,28,12,16,8,8,OUI,OUI,2025-03-13 09:57:35+00:00,"48.77850332486751, 2.4006786569952965",Vitry-sur-Seine,94081,0.5714285714285714,10
21204,Estienne d'Orves - Henri Ginoux,OUI,31,28,3,1,2,OUI,OUI,2025-03-13 09:55:55+00:00,"48.815388220397274, 2.320886790760933",Montrouge,92049,0.0967741935483871,10
17119,Toqueville - Cardinet,OUI,30,25,5,2,3,OUI,OUI,2025-03-13 09:55:03+00:00,"48.88490187110713, 2.3109393194317818",Paris,75056,0.16666666666666666,10
42209,Place de l'Europe - Quai de Bercy,OUI,16,3,13,10,3,OUI,OUI,2025-03-13 09:59:19+00:00,"48.82529858840266, 2.3945679143071175",Charenton-le-Pont,94018,0.8125,10
51002,Placette Grégoire Collas,OUI,25,14,11,5,6,OUI,OUI,2025-03-13 10:01:26+00:00,"48.94342014002797, 2.2487476095557213",Argenteuil,95018,0.44,10
43001,Paris - Laitières,OUI,22,6,16,4,12,OUI,OUI,2025-03-13 10:00:31+00:00,"48.84630274151258, 2.4207553267478947",Vincennes,94080,0.7272727272727273,10
10162,Alexandre Parodi - Quai de Valmy,OUI,24,22,2,0,2,OUI,OUI,2025-03-13 09:57:20+00:00,"48.879359419425, 2.3665961623192",Paris,75056,0.08333333333333333,10
11021,Charonne - Pierre Bayle,OUI,23,22,1,0,1,OUI,OUI,2025-03-13 09:59:40+00:00,"48.858445054262, 2.3903981223891",Paris,75056,0.043478260869565216,10
13009,Auguste Blanqui - Corvisart,OUI,25,13,12,5,7,OUI,OUI,2025-03-13 10:00:17+00:00,"48.8300989, 2.3502726",Paris,75056,0.48,10
15030,Emeriau - Beaugrenelle,OUI,73,13,60,55,5,OUI,OUI,2025-03-13 10:00:41+00:00,"48.84791249714942, 2.2843059897422795",Paris,75056,0.821917808219178,10
9024,Taitbout - La Fayette,OUI,51,3,48,21,27,OUI,OUI,2025-03-13 10:00:21+00:00,"48.8733298892, 2.3352625966072",Paris,75056,0.9411764705882353,10
9114,Faubourg Poissonnière - Dunkerque,OUI,30,24,6,2,4,OUI,OUI,2025-03-13 10:01:05+00:00,"48.880883445404436, 2.349934279918671",Paris,75056,0.2,10
8116,Champs-Elysees - Bassano,OUI,25,25,0,0,0,NON,NON,2021-02-21 19:09:18+00:00,"48.871811807816, 2.300238981843",Paris,75056,0.0,19
16011,Victor Hugo - La Pompe,OUI,40,18,22,0,22,OUI,OUI,2025-03-13 10:01:24+00:00,"48.86795222470859, 2.28146318346262",Paris,75056,0.55,10
18030,Joseph Dijon - Ornano,OUI,36,35,1,1,0,OUI,OUI,2025-03-13 09:58:28+00:00,"48.89374453351521, 2.3476678133010864",Paris,75056,0.027777777777777776,10
44101,Place Mongolfier,OUI,37,16,21,12,9,OUI,OUI,2025-03-13 09:59:57+00:00,"48.815160030060376, 2.4592879414558415",Saint-Maurice,94069,0.5675675675675675,10
5024,Place Monge,OUI,21,16,5,2,3,OUI,OUI,2025-03-13 10:01:02+00:00,"48.842761803051, 2.3524079471827",Paris,75056,0.23809523809523808,10
14010,Jean Moulin - Place Victor et Hélène Basch,OUI,38,35,3,1,2,OUI,OUI,2025-03-13 10:01:04+00:00,"48.82764910241, 2.3261967301369",Paris,75056,0.07894736842105263,10
12005,Crozatier - Faubourg Saint-Antoine,OUI,41,19,22,15,7,OUI,OUI,2025-03-13 10:01:16+00:00,"48.850440013405, 2.378901366211",Paris,75056,0.5365853658536586,10
13128,Quai de la Gare - Pont de Bercy,OUI,30,0,30,26,4,OUI,OUI,2025-03-13 10:00:38+00:00,"48.83730787972, 2.3740861260598",Paris,75056,1.0,10
13516,Glacière - Soeur Catherine Marie,OUI,40,34,6,1,5,OUI,OUI,2025-03-13 09:57:51+00:00,"48.829522989420596, 2.343570403754711",Paris,75056,0.15,10
22303,Lucien Lanternier - Le Luth,OUI,25,9,16,12,4,OUI,OUI,2025-03-13 10:00:47+00:00,"48.93159430558871, 2.2889783978462224",Gennevilliers,92036,0.64,10
12155,Rottembourg - Général Michel Bizot,OUI,43,29,14,11,3,OUI,OUI,2025-03-13 10:01:03+00:00,"48.83787825992554, 2.4044052511453633",Paris,75056,0.32558139534883723,10
92001,Mairie de quartier du Plateau - Mont-Valérien,OUI,20,14,6,4,2,OUI,OUI,2025-03-13 09:52:34+00:00,"48.8799933, 2.2072437",Nanterre,92050,0.3,10
12028,Vivaldi - Antoine-Julien Hénard,OUI,27,26,1,1,0,OUI,OUI,2025-03-13 09:57:09+00:00,"48.841923663276546, 2.389728979467376",Paris,75056,0.037037037037037035,10
43010,La Jarry - Place Diderot,OUI,25,24,1,0,1,OUI,OUI,2025-03-13 09:53:24+00:00,"48.849726940367326, 2.452013790607453",Vincennes,94080,0.04,10
10021,Marché Saint-Quentin,OUI,14,12,2,1,1,OUI,OUI,2025-03-13 09:59:51+00:00,"48.877356057652, 2.3545114456374",Paris,75056,0.14285714285714285,10
17107,Berthier - Place Stuart Merril,OUI,36,21,15,12,3,OUI,OUI,2025-03-13 09:59:51+00:00,"48.885927922355044, 2.2933450341224675",Paris,75056,0.4166666666666667,10
5115,Buffon - Jardin des Plantes,OUI,28,8,20,16,4,OUI,OUI,2025-03-13 10:01:14+00:00,"48.842668466104875, 2.3618587106466293",Paris,75056,0.7142857142857143,10
6027,Blaise-Desgoffe - Vaugirard,OUI,32,16,16,7,9,OUI,OUI,2025-03-13 10:00:15+00:00,"48.846128877747, 2.3242672160268",Paris,75056,0.5,10
41211,Louis Xavier de Ricard - Ancienne Mairie,OUI,34,32,2,1,1,OUI,OUI,2025-03-13 09:57:18+00:00,"48.84629899065091, 2.472420372068882",Fontenay-sous-Bois,94033,0.058823529411764705,10
18007,Goutte d'or - Barbès,OUI,20,17,3,0,3,OUI,OUI,2025-03-13 09:56:57+00:00,"48.885124323627, 2.3496962338686",Paris,75056,0.15,10
2108,Vivienne - Montmartre,OUI,37,3,34,14,20,OUI,OUI,2025-03-13 10:01:12+00:00,"48.871347597383, 2.3414588347077",Paris,75056,0.918918918918919,10
19128,Quai de l'Oise - Aisne,OUI,28,26,2,1,1,OUI,OUI,2025-03-13 09:59:53+00:00,"48.8906231, 2.3833701",Paris,75056,0.07142857142857142,10
12101,Charenton - Prague,OUI,28,9,19,16,3,OUI,OUI,2025-03-13 10:01:12+00:00,"48.848175129981, 2.3763584494312",Paris,75056,0.6785714285714286,10
15005,Place Jacques et Thérèse Tréfouël,OUI,42,18,24,15,9,OUI,OUI,2025-03-13 10:00:16+00:00,"48.842726498317, 2.3125657439232",Paris,75056,0.5714285714285714,10
21707,Square Etienne Jarousse,OUI,22,22,0,0,0,OUI,OUI,2025-03-13 10:01:24+00:00,"48.82485182597129, 2.2925933450460434",Vanves,92075,0.0,10
18006,Square Louise Michel,OUI,35,34,1,0,1,OUI,OUI,2025-03-13 10:00:59+00:00,"48.884687354509, 2.3441386967897",Paris,75056,0.02857142857142857,10
4019,Cloître Saint-Merri - Renard,OUI,29,1,28,19,9,OUI,OUI,2025-03-13 10:01:26+00:00,"48.858835448898, 2.3518279194832",Paris,75056,0.9655172413793104,10
21401,Mairie de Clamart,OUI,31,26,5,0,5,OUI,OUI,2025-03-13 09:59:43+00:00,"48.800612, 2.262151",Clamart,92023,0.16129032258064516,10
5001,Harpe - Saint-Germain,OUI,43,34,9,7,2,OUI,OUI,2025-03-13 10:00:41+00:00,"48.851518815017, 2.3436703160405",Paris,75056,0.20930232558139536,10
17108,Bessières - Porte de Clichy,OUI,30,13,17,12,5,OUI,OUI,2025-03-13 09:55:25+00:00,"48.89611762451474, 2.31790903955698",Paris,75056,0.5666666666666667,10
15129,Hôpital Necker,OUI,38,13,25,20,5,OUI,OUI,2025-03-13 09:58:02+00:00,"48.846043490118454, 2.313245013356209",Paris,75056,0.6578947368421053,10
51001,Gare d'Argenteuil,OUI,37,20,17,3,14,OUI,OUI,2025-03-13 09:57:02+00:00,"48.947022436806705, 2.256898172199726",Argenteuil,95018,0.4594594594594595,10
15022,Emile Zola - Fondary,OUI,41,11,30,28,2,OUI,OUI,2025-03-13 10:00:18+00:00,"48.847051143113745, 2.2953405976295476",Paris,75056,0.7317073170731707,10
21315,Jules Guesdes - Général de Gaulle,OUI,24,23,1,0,1,OUI,OUI,2025-03-13 09:57:40+00:00,"48.81930581291959, 2.278934195637703",Issy-les-Moulineaux,92040,0.041666666666666664,10
5012,Estrapade - Ulm,OUI,16,1,15,3,12,OUI,OUI,2025-03-13 10:00:59+00:00,"48.84512772828, 2.3454568170362",Paris,75056,0.9375,10
23102,Hôtel de Ville de Sèvres,OUI,31,14,17,14,3,OUI,OUI,2025-03-13 10:00:22+00:00,"48.824363561289, 2.2131047397852",Sèvres,92072,0.5483870967741935,10
11017,Charonne - Bureau,OUI,44,43,1,0,1,OUI,OUI,2025-03-13 09:57:47+00:00,"48.854176, 2.396093",Paris,75056,0.022727272727272728,10
15006,Cherche-Midi - Hôpital Necker,OUI,36,24,12,7,5,OUI,OUI,2025-03-13 10:00:37+00:00,"48.84461063309956, 2.317914068698883",Paris,75056,0.3333333333333333,10
1021,Halles - Bourdonnais,OUI,18,1,17,13,4,OUI,OUI,2025-03-13 09:59:25+00:00,"48.860448992575, 2.3460162431002",Paris,75056,0.9444444444444444,10
21402,Place Aimé Césaire,OUI,27,22,5,1,4,OUI,OUI,2025-03-13 09:51:53+00:00,"48.783194713067815, 2.2429127991199493",Clamart,92023,0.18518518518518517,10
7017,La Motte-Picquet - La Tour Maubourg,OUI,40,20,20,16,4,OUI,OUI,2025-03-13 10:00:41+00:00,"48.856926701847, 2.3096215831203",Paris,75056,0.5,10
33014,Parc Eli Lotar,OUI,19,16,3,3,0,OUI,OUI,2025-03-13 09:58:44+00:00,"48.91844993053703, 2.3727085813879967",Aubervilliers,93001,0.15789473684210525,10
15311,Quai du Président Roosevelt - Pont Aval,OUI,30,0,30,21,9,OUI,OUI,2025-03-13 09:57:53+00:00,"48.8343883676388, 2.2656820714473724",Paris,75056,1.0,10
9007,Condorcet - Turgot,OUI,19,18,1,0,1,OUI,OUI,2025-03-13 10:00:33+00:00,"48.87985155789093, 2.345232367515564",Paris,75056,0.05263157894736842,10
35006,Delizy - Louis Nadot,OUI,21,17,4,2,2,OUI,OUI,2025-03-13 09:56:10+00:00,"48.896212845581346, 2.4094578623771667",Pantin,93055,0.19047619047619047,10
15127,Place Charles Michels,OUI,35,13,22,16,6,OUI,OUI,2025-03-13 09:57:30+00:00,"48.846401, 2.28502",Paris,75056,0.6285714285714286,10
41205,Maréchal Joffre - Verdun,OUI,20,20,0,0,0,OUI,OUI,2025-03-13 10:00:06+00:00,"48.85385, 2.470307",Fontenay-sous-Bois,94033,0.0,10
20105,Benoît Frachon - République,OUI,28,18,10,7,3,OUI,OUI,2025-03-13 10:00:59+00:00,"48.85230729014318, 2.415605485439301",Paris,75056,0.35714285714285715,10
22015,Île de la Jatte,OUI,23,10,13,8,5,OUI,OUI,2025-03-13 10:01:07+00:00,"48.894036161302104, 2.2666339203715324",Neuilly-sur-Seine,92051,0.5652173913043478,10
14032,Mairie du 14ème,OUI,32,29,3,2,1,OUI,OUI,2025-03-13 09:57:29+00:00,"48.83254578123, 2.3254923149943",Paris,75056,0.09375,10
12018,Saint-Mandé - Fabre d'Eglantine,OUI,33,27,6,1,5,OUI,OUI,2025-03-13 10:01:08+00:00,"48.8453579, 2.3965022",Paris,75056,0.18181818181818182,10
41401,Marne - Charles de Gaulle,OUI,26,13,13,12,1,OUI,OUI,2025-03-13 09:57:32+00:00,"48.815071719544434, 2.4121668934822087",Alfortville,94002,0.5,10
44005,Place Saint-Just,OUI,21,16,5,5,0,OUI,OUI,2025-03-13 09:57:04+00:00,"48.790379518724265, 2.3895226791501045",Vitry-sur-Seine,94081,0.23809523809523808,10
6002,Saint-Benoît - Jacob,OUI,22,0,22,13,9,OUI,OUI,2025-03-13 09:57:50+00:00,"48.85545136013941, 2.3334722220897675",Paris,75056,1.0,10
15011,Cambronne - Villa Croix Nivert,OUI,62,49,13,13,0,OUI,OUI,2025-03-13 10:00:13+00:00,"48.845847561366, 2.3017574474216",Paris,75056,0.20967741935483872,10
14031,Didot - Place de Moro-Giafferi,OUI,20,19,1,0,1,OUI,OUI,2025-03-13 09:57:52+00:00,"48.8337, 2.3215",Paris,75056,0.05,10
9004,Gérando - Rochechouart,OUI,21,18,3,0,3,OUI,OUI,2025-03-13 09:59:02+00:00,"48.88294340845, 2.3464846238494",Paris,75056,0.14285714285714285,10
20044,Davout - Volga,OUI,27,26,1,0,1,OUI,OUI,2025-03-13 09:58:16+00:00,"48.852919679957296, 2.410522909779111",Paris,75056,0.037037037037037035,10
32601,Porte des Lilas - Faidherbe,OUI,39,37,2,1,1,OUI,OUI,2025-03-13 09:52:40+00:00,"48.87861855668978, 2.4120327830314636",Les Lilas,93045,0.05128205128205128,10
16019,Porte de la Muette,OUI,34,9,25,3,22,OUI,OUI,2025-03-13 09:58:47+00:00,"48.86302317841182, 2.2687188170157406",Paris,75056,0.7352941176470589,10
33016,Fort d'Aubervilliers,OUI,21,14,7,5,2,OUI,OUI,2025-03-13 09:59:01+00:00,"48.91502382370325, 2.4035281687974925",Aubervilliers,93001,0.3333333333333333,10
11033,Bréguet - Sabin,OUI,29,6,23,21,2,OUI,OUI,2025-03-13 10:00:47+00:00,"48.856931678257, 2.3706749462105",Paris,75056,0.7931034482758621,10
12026,Place Ginette Hamelin,OUI,50,25,25,23,2,OUI,OUI,2025-03-13 09:56:48+00:00,"48.837853, 2.382064",Paris,75056,0.5,10
41203,Stalingrad - Rigollots,OUI,49,49,0,0,0,OUI,OUI,2025-03-13 09:56:56+00:00,"48.84997403844251, 2.45557576417923",Fontenay-sous-Bois,94033,0.0,10
6012,Saint-Germain - Ciseaux,OUI,18,9,9,8,1,OUI,OUI,2025-03-13 10:01:17+00:00,"48.853305277595, 2.3344654618827",Paris,75056,0.5,10
18039,Jardins d'Eole,OUI,19,18,1,1,0,OUI,OUI,2025-03-13 09:58:18+00:00,"48.8869703, 2.3668488",Paris,75056,0.05263157894736842,10
27005,Gare du Stade,OUI,18,12,6,2,4,OUI,OUI,2025-03-13 09:54:09+00:00,"48.9312676, 2.2603778",Colombes,92025,0.3333333333333333,10
15071,Suffren - Champ de Mars,OUI,23,7,16,16,0,OUI,OUI,2025-03-13 09:59:24+00:00,"48.8547194, 2.2952168",Paris,75056,0.6956521739130435,10
12036,Reuilly - Place Felix Eboue,OUI,40,36,4,1,3,OUI,OUI,2025-03-13 09:55:57+00:00,"48.84030274499962, 2.394630398715453",Paris,75056,0.1,10
8201,Arsène Houssaye - Friedland,OUI,29,22,7,1,6,OUI,OUI,2025-03-13 09:54:17+00:00,"48.874510616163, 2.2994716674148",Paris,75056,0.2413793103448276,10
10008,Cité Riverin - Château d'Eau,OUI,18,2,16,10,6,OUI,OUI,2025-03-13 10:01:25+00:00,"48.870702423554306, 2.358739863900845",Paris,75056,0.8888888888888888,10
17111,Lemercier - Cardinet,OUI,24,23,1,1,0,OUI,OUI,2025-03-13 09:51:57+00:00,"48.890097168851746, 2.317377626895905",Paris,75056,0.041666666666666664,10
16012,Flandrin - Longchamp,OUI,40,3,37,15,22,OUI,OUI,2025-03-13 09:59:47+00:00,"48.86877849178477, 2.274354539176829",Paris,75056,0.925,10
21319,Esplanade du Foncet - Camille Desmoulins,OUI,27,1,26,24,2,OUI,OUI,2025-03-13 10:01:02+00:00,"48.827090233494964, 2.2606857866048813",Issy-les-Moulineaux,92040,0.9629629629629629,10
42505,Charles Frérot - Albert Guilpin,OUI,29,24,5,2,3,OUI,OUI,2025-03-13 10:00:14+00:00,"48.8155839183714, 2.3505029082298283",Gentilly,94037,0.1724137931034483,10
9102,Londres - Place d'Estienne d'Orves,OUI,24,0,24,13,11,OUI,OUI,2025-03-13 10:00:25+00:00,"48.876693805756986, 2.3305362090468407",Paris,75056,1.0,10
10032,Claude Vellefaux - Hôpital Saint-Louis,OUI,31,28,3,2,1,OUI,OUI,2025-03-13 09:58:01+00:00,"48.872859139003, 2.3700717069851",Paris,75056,0.0967741935483871,10
9006,Dunkerque - Trudaine,OUI,16,14,2,0,2,OUI,OUI,2025-03-13 09:56:19+00:00,"48.88215166773376, 2.3463253676891327",Paris,75056,0.125,10
12015,Place de la Nation - Picpus,OUI,36,33,3,1,2,OUI,OUI,2025-03-13 10:00:35+00:00,"48.846821681548, 2.4001130461693",Paris,75056,0.08333333333333333,10
92006,Place Nelson Mandela,OUI,30,19,11,2,9,OUI,OUI,2025-03-13 09:57:50+00:00,"48.897874318180556, 2.2182820737361912",Nanterre,92050,0.36666666666666664,10
14001,Edgar Quinet - Gaité,OUI,27,24,3,0,3,OUI,OUI,2025-03-13 10:01:19+00:00,"48.841160928966, 2.324595451355",Paris,75056,0.1111111111111111,10
31005,Square Denise Buisson,OUI,45,45,0,0,0,OUI,OUI,2025-03-13 09:58:38+00:00,"48.8562322730982, 2.426436245441437",Montreuil,93048,0.0,10
18139,Poissonniers - Championnet,OUI,28,27,1,0,1,OUI,OUI,2025-03-13 10:00:34+00:00,"48.89543299733937, 2.3530178144574165",Paris,75056,0.03571428571428571,10
21314,Chemin de Bretagne,OUI,28,3,25,17,8,OUI,OUI,2025-03-13 10:01:22+00:00,"48.824753068884, 2.2588385956052",Issy-les-Moulineaux,92040,0.8928571428571429,10
16042,Murat - Porte de Saint-Cloud,OUI,38,10,28,28,0,OUI,OUI,2025-03-13 10:00:40+00:00,"48.83750862621299, 2.2577651962637906",Paris,75056,0.7368421052631579,10
12038,Picpus - Louis Braille,OUI,43,43,0,0,0,OUI,OUI,2025-03-13 09:58:36+00:00,"48.839988788912, 2.4005256685521",Paris,75056,0.0,10
15001,Gare Montparnasse - Arrivée,OUI,42,32,10,3,7,OUI,OUI,2025-03-13 09:59:22+00:00,"48.843827994315, 2.3225811123848",Paris,75056,0.23809523809523808,10
9011,Geoffroy - Marie,OUI,18,3,15,14,1,OUI,OUI,2025-03-13 09:57:48+00:00,"48.873781940593325, 2.344513876337893",Paris,75056,0.8333333333333334,10
15008,Sèvres - Lecourbe,OUI,61,42,19,18,1,OUI,OUI,2025-03-13 10:01:06+00:00,"48.8447677, 2.3110086",Paris,75056,0.3114754098360656,10
9034,Godot de Mauroy - Madeleine,OUI,21,0,21,6,15,OUI,OUI,2025-03-13 10:00:42+00:00,"48.869789, 2.326347",Paris,75056,1.0,10
22201,Henri Ravera - Gabriel Péri,OUI,28,27,1,0,1,OUI,OUI,2025-03-13 09:56:13+00:00,"48.79722273833844, 2.302115857601166",Bagneux,92007,0.03571428571428571,10
12035,Madagascar - Meuniers,OUI,32,31,1,0,1,OUI,OUI,2025-03-13 10:01:01+00:00,"48.83460464474706, 2.3970650508999825",Paris,75056,0.03125,10
11112,Jules Vallès - Charonne,OUI,23,20,3,3,0,OUI,OUI,2025-03-13 10:01:11+00:00,"48.854284379935, 2.3847674578428",Paris,75056,0.13043478260869565,10
44011,Lebrun - Colonel Fabien,OUI,27,26,1,0,1,OUI,OUI,2025-03-13 10:00:39+00:00,"48.78266870733145, 2.381317801773548",Vitry-sur-Seine,94081,0.037037037037037035,10
5007,Ecoles - Carmes,OUI,34,0,34,16,18,OUI,OUI,2025-03-13 10:01:15+00:00,"48.848904447989405, 2.3473486304283147",Paris,75056,1.0,10
8027,Mairie du 8ème,OUI,14,0,14,9,5,OUI,OUI,2025-03-13 10:00:06+00:00,"48.877932, 2.318264",Paris,75056,1.0,10
16105,Crevaux - Bugeaud,OUI,31,27,4,2,2,OUI,OUI,2025-03-13 09:54:51+00:00,"48.87080942867, 2.2811490076919",Paris,75056,0.12903225806451613,10
15039,Abbé Groult - Convention,OUI,12,12,0,0,0,OUI,OUI,2025-03-13 09:58:57+00:00,"48.83596927866069, 2.302064039509349",Paris,75056,0.0,10
4006,Bourdon - Pont Morland,OUI,49,28,21,18,3,OUI,OUI,2025-03-13 10:00:34+00:00,"48.8478103, 2.3659356",Paris,75056,0.42857142857142855,10
15036,Croix Nivert - Square Saint-Lambert,OUI,47,47,0,0,0,NON,NON,2025-03-03 09:03:43+00:00,"48.843051521591, 2.2952004522085",Paris,75056,0.0,9
3008,Perle - Vieille du Temple,OUI,35,2,33,22,11,OUI,OUI,2025-03-13 10:00:02+00:00,"48.8601346, 2.3611206",Paris,75056,0.9428571428571428,10
6022,Marché Saint-Germain,OUI,18,13,5,2,3,OUI,OUI,2025-03-13 10:01:12+00:00,"48.85165625855281, 2.335500307381153",Paris,75056,0.2777777777777778,10
6010,Chevreuse - Montparnasse,OUI,15,3,12,2,10,OUI,OUI,2025-03-13 10:00:14+00:00,"48.841739161231, 2.3315522167367",Paris,75056,0.8,10
41403,Gare RER - Malleret-Joinville,OUI,20,6,14,11,3,OUI,OUI,2025-03-13 09:59:49+00:00,"48.802936, 2.42531",Alfortville,94002,0.7,10
44014,Camille Risch - Paul Armangot,OUI,25,14,11,5,6,OUI,OUI,2025-03-13 09:52:36+00:00,"48.774703, 2.373685",Vitry-sur-Seine,94081,0.44,10
13018,Bruant - Vincent Auriol,OUI,24,5,19,15,4,OUI,OUI,2025-03-13 10:00:50+00:00,"48.834848452929, 2.3668264996271",Paris,75056,0.7916666666666666,10
12037,Reuilly - Daumesnil,OUI,36,34,2,1,1,OUI,OUI,2025-03-13 09:59:51+00:00,"48.8395385, 2.3972516",Paris,75056,0.05555555555555555,10
21303,Jean Monnet - Iles,OUI,32,2,30,27,3,OUI,OUI,2025-03-13 09:58:18+00:00,"48.823393984057304, 2.2497073194874866",Issy-les-Moulineaux,92040,0.9375,10
1007,Turbigo - Française,OUI,16,1,15,10,5,OUI,OUI,2025-03-13 10:01:25+00:00,"48.86358858111446, 2.3477794602513313",Paris,75056,0.9375,10
13052,Leredde - Tolbiac,OUI,43,20,23,9,14,OUI,OUI,2025-03-13 10:01:20+00:00,"48.82887629664, 2.3744382709265",Paris,75056,0.5348837209302325,10
16013,Mairie du 16ème,OUI,35,33,2,0,2,OUI,OUI,2025-03-13 09:56:14+00:00,"48.863936848471994, 2.2765953093767166",Paris,75056,0.05714285714285714,10
17024,Villiers - Batignolles,OUI,23,18,5,1,4,OUI,OUI,2025-03-13 09:57:57+00:00,"48.88125253846116, 2.31653843075037",Paris,75056,0.21739130434782608,10
8110,Gare Saint-Lazare - Stockholm,OUI,29,22,7,4,3,OUI,OUI,2025-03-13 09:52:41+00:00,"48.877127316667654, 2.322417162358761",Paris,75056,0.2413793103448276,10
33103,Jean Jaurès - Jules Jacquemin,OUI,22,21,1,0,1,OUI,OUI,2025-03-13 09:54:59+00:00,"48.88433053604843, 2.4082902455152104",Le Pré-Saint-Gervais,93061,0.045454545454545456,10
20024,Gambetta - Père Lachaise,OUI,27,26,1,0,1,OUI,OUI,2025-03-13 10:00:45+00:00,"48.864295696165875, 2.398228667282044",Paris,75056,0.037037037037037035,10
14011,Place des Droits de l'Enfant,OUI,39,39,0,0,0,OUI,OUI,2025-03-13 09:57:55+00:00,"48.8274804, 2.3319217",Paris,75056,0.0,10
3010,Beaubourg - Michel-le-Comte,OUI,14,2,12,10,2,OUI,OUI,2025-03-13 09:56:35+00:00,"48.862534941806, 2.3543103039265",Paris,75056,0.8571428571428571,10
33012,Landy - Heurtault,OUI,29,26,3,2,1,OUI,OUI,2025-03-13 09:57:32+00:00,"48.915096534520316, 2.375951372087002",Aubervilliers,93001,0.10344827586206896,10
2013,Favart - Italiens,OUI,17,1,16,6,10,OUI,OUI,2025-03-13 10:00:17+00:00,"48.871446353921, 2.3382901058508",Paris,75056,0.9411764705882353,10
6104,Herschel - Observatoire,OUI,36,4,32,9,23,OUI,OUI,2025-03-13 10:01:21+00:00,"48.84342376221923, 2.3376645147800446",Paris,75056,0.8888888888888888,10
3102,Bourg l'Abbé - Saint-Martin,OUI,36,14,22,12,10,OUI,OUI,2025-03-13 10:00:30+00:00,"48.86393331949257, 2.352406270802021",Paris,75056,0.6111111111111112,10
21309,Mairie d'Issy,OUI,39,30,9,5,4,OUI,OUI,2025-03-13 09:56:56+00:00,"48.823767792468, 2.2723111510277",Issy-les-Moulineaux,92040,0.23076923076923078,10
10019,Paradis - Hauteville,OUI,31,1,30,22,8,OUI,OUI,2025-03-13 10:01:14+00:00,"48.874999954666755, 2.3522757401923404",Paris,75056,0.967741935483871,10
19002,Centquatre,OUI,38,25,13,4,9,NON,NON,2025-03-13 10:00:28+00:00,"48.889333538455, 2.3707854375243",Paris,75056,0.34210526315789475,10
10033,Gare du Nord - Saint-Vincent de Paul,OUI,24,24,0,0,0,OUI,OUI,2025-03-13 10:00:56+00:00,"48.880955741648, 2.3524305148385",Paris,75056,0.0,10
17019,Phalsbourg - Villiers,OUI,19,7,12,4,8,OUI,OUI,2025-03-13 09:59:49+00:00,"48.88242307900951, 2.3090453445911407",Paris,75056,0.631578947368421,10
19010,Emile Reynaud - Porte de la Villette,OUI,22,20,2,0,2,OUI,OUI,2025-03-13 09:56:44+00:00,"48.90098953630053, 2.3887022584676743",Paris,75056,0.09090909090909091,10
20022,Porte de Bagnolet,OUI,33,32,1,0,1,OUI,OUI,2025-03-13 09:59:00+00:00,"48.864707139122984, 2.408344637349607",Paris,75056,0.030303030303030304,10
10009,Mairie du 10ème,OUI,18,4,14,11,3,OUI,OUI,2025-03-13 09:59:32+00:00,"48.872089449907, 2.3575825989246",Paris,75056,0.7777777777777778,10
14026,Plantes - Moulin Vert,OUI,44,44,0,0,0,OUI,OUI,2025-03-13 09:58:07+00:00,"48.83005755305626, 2.3232302069664006",Paris,75056,0.0,10
22301,Chausson - Gabriel Péri,OUI,20,11,9,9,0,OUI,OUI,2025-03-13 10:01:26+00:00,"48.921891003481115, 2.2952306270599365",Gennevilliers,92036,0.45,10
16036,Porte Molitor,OUI,59,5,54,42,12,OUI,OUI,2025-03-13 10:01:26+00:00,"48.84524763511433, 2.2569015249609947",Paris,75056,0.9152542372881356,10
41405,Place de l'Europe - Alfortville,OUI,24,4,20,18,2,OUI,OUI,2025-03-13 10:00:20+00:00,"48.78913702405837, 2.4284800887107854",Alfortville,94002,0.8333333333333334,10
8117,Place de la Madeleine - Royale,OUI,41,0,41,23,18,OUI,OUI,2025-03-13 10:00:44+00:00,"48.869228052648, 2.324421107769",Paris,75056,1.0,10
8028,Arsène Houssaye - Champs-Elysées,OUI,28,4,24,3,21,OUI,OUI,2025-03-13 10:00:49+00:00,"48.873409276267, 2.2977904602885",Paris,75056,0.8571428571428571,10
48004,Maxime Gorki - Louis Aragon,OUI,19,14,5,0,5,OUI,OUI,2025-03-13 10:00:29+00:00,"48.78909814728443, 2.368387877941132",Villejuif,94076,0.2631578947368421,10
10011,Bourse du Travail,OUI,17,7,10,10,0,OUI,OUI,2025-03-13 09:58:03+00:00,"48.868976638826, 2.3623438552022",Paris,75056,0.5882352941176471,10
26004,Gare RER les Grésillons,OUI,22,14,8,8,0,OUI,OUI,2025-03-13 09:57:23+00:00,"48.919898633572764, 2.31458459136273",Asnières-sur-Seine,92004,0.36363636363636365,10
21953,Gare de Bellevue,OUI,20,16,4,0,4,OUI,OUI,2025-03-13 09:56:08+00:00,"48.8192404685572, 2.2295309230685234",Meudon,92048,0.2,10
1006,Grande Truanderie - Saint-Denis,OUI,28,12,16,12,4,OUI,OUI,2025-03-13 09:58:39+00:00,"48.8626302, 2.3498075",Paris,75056,0.5714285714285714,10
14137,Maurice d'Ocagne - General Maudhuy,OUI,28,25,3,0,3,OUI,OUI,2025-03-13 09:58:20+00:00,"48.82414282524159, 2.3158789426088333",Paris,75056,0.10714285714285714,10
19110,Square Claude Bernard,OUI,29,14,15,8,7,OUI,OUI,2025-03-13 10:00:44+00:00,"48.89876016219984, 2.375325746834278",Paris,75056,0.5172413793103449,10
10027,Dunkerque - Alsace,OUI,20,20,0,0,0,OUI,OUI,2025-03-13 09:59:20+00:00,"48.879355, 2.358379",Paris,75056,0.0,10
18202,Diane Arbus,OUI,37,35,2,1,1,OUI,OUI,2025-03-13 09:53:48+00:00,"48.898800717199, 2.3524022474885",Paris,75056,0.05405405405405406,10
12002,Lacuée - Lyon,OUI,16,2,14,7,7,OUI,OUI,2025-03-13 10:01:07+00:00,"48.849268481958, 2.3704585433006",Paris,75056,0.875,10
5015,Epée de Bois - Mouffetard,OUI,63,58,5,1,4,OUI,OUI,2025-03-13 09:59:04+00:00,"48.841508690388835, 2.350066713988781",Paris,75056,0.07936507936507936,10
21506,Maurice Payret-Dortail,OUI,22,19,3,1,2,OUI,OUI,2025-03-13 10:01:05+00:00,"48.87811957063342, 2.2233625128865246",Suresnes,92073,0.13636363636363635,10
45002,Roger Salengro - Général de Gaulle,OUI,27,13,14,4,10,OUI,OUI,2025-03-13 09:58:14+00:00,"48.820029010376956, 2.4846760556101803",Champigny-sur-Marne,94017,0.5185185185185185,10
3001,Beaumarchais - Saint-Gilles,OUI,44,26,18,8,10,OUI,OUI,2025-03-13 10:01:26+00:00,"48.8580378, 2.3679352",Paris,75056,0.4090909090909091,10
15128,Cadix - Hameau,OUI,36,34,2,1,1,OUI,OUI,2025-03-13 09:58:01+00:00,"48.8340107632249, 2.289516180753708",Paris,75056,0.05555555555555555,10
9037,Parme - Clichy,OUI,24,20,4,1,3,OUI,OUI,2025-03-13 10:00:33+00:00,"48.881266424227, 2.3281970934506",Paris,75056,0.16666666666666666,10
47003,Charentonneau - Maisons Alfort,OUI,20,15,5,5,0,OUI,OUI,2025-03-13 09:59:29+00:00,"48.809932980484355, 2.443288456496946",Maisons-Alfort,94046,0.25,10
7021,Bosquet - Saint-Dominique,OUI,28,11,17,13,4,OUI,OUI,2025-03-13 09:59:14+00:00,"48.858651709526, 2.3037165802346",Paris,75056,0.6071428571428571,10
18004,Place des Abbesses,OUI,11,10,1,0,1,OUI,OUI,2025-03-13 09:54:09+00:00,"48.884542726149725, 2.3386867716908455",Paris,75056,0.09090909090909091,10
2015,Louis le Grand - Italiens,OUI,33,5,28,14,14,OUI,OUI,2025-03-13 10:01:22+00:00,"48.870508937204, 2.3340544619393",Paris,75056,0.8484848484848485,10
7012,Cité Vaneau,OUI,24,3,21,12,9,OUI,OUI,2025-03-13 09:59:31+00:00,"48.8542210666207, 2.319614924490452",Paris,75056,0.875,10
21026,Sèvres - Général Leclerc,OUI,29,5,24,14,10,OUI,OUI,2025-03-13 10:00:41+00:00,"48.830121559055, 2.2314262390137",Boulogne-Billancourt,92012,0.8275862068965517,10
20001,Place de la Nation - Charonne,OUI,35,33,2,0,2,OUI,OUI,2025-03-13 09:52:41+00:00,"48.848364667777, 2.3997623859813",Paris,75056,0.05714285714285714,10
32013,Saint-Denis - Université,OUI,19,4,15,4,11,OUI,OUI,2025-03-13 09:54:13+00:00,"48.94563430946964, 2.3638297989964485",Saint-Denis,93066,0.7894736842105263,10
20008,Pyrénées - Avron,OUI,31,31,0,0,0,OUI,OUI,2025-03-13 10:01:06+00:00,"48.853246898211985, 2.405871044529538",Paris,75056,0.0,10
2021,Cléry - Montmartre,OUI,58,22,36,21,15,OUI,OUI,2025-03-13 09:59:45+00:00,"48.867458, 2.3445211",Paris,75056,0.6206896551724138,10
18034,Leibniz - Jean Dollfus,OUI,32,31,1,0,1,OUI,OUI,2025-03-13 09:55:50+00:00,"48.896328348515986, 2.333390423834684",Paris,75056,0.03125,10
3009,Temple - Haudriettes,OUI,19,2,17,13,4,OUI,OUI,2025-03-13 09:59:36+00:00,"48.861636880212, 2.3566960206458",Paris,75056,0.8947368421052632,10
12019,Gare de Reuilly - Picpus,OUI,26,18,8,4,4,OUI,OUI,2025-03-13 09:59:46+00:00,"48.84267354116789, 2.3972943797707558",Paris,75056,0.3076923076923077,10
23702,Hôtel de Ville de Chaville,OUI,20,19,1,0,1,OUI,OUI,2025-03-13 09:56:26+00:00,"48.80887149094033, 2.188134044408798",Chaville,92022,0.05,10
20104,Louis Lumière.,OUI,22,22,0,0,0,OUI,OUI,2025-03-13 09:55:57+00:00,"48.86216198070008, 2.41112578185621",Paris,75056,0.0,10
14022,Didot - Mariniers,OUI,35,32,3,1,2,OUI,OUI,2025-03-13 10:01:12+00:00,"48.82650543613106, 2.313136198271666",Paris,75056,0.08571428571428572,10
14135,Jourdan - Cité Universitaire,OUI,39,36,3,3,0,OUI,OUI,2025-03-13 10:00:09+00:00,"48.819897343156676, 2.3397007964124366",Paris,75056,0.07692307692307693,10
19012,Lally-Tollendal - Armand Carrel,OUI,27,27,0,0,0,OUI,OUI,2025-03-13 09:59:45+00:00,"48.88270066221072, 2.374717555940151",Paris,75056,0.0,10
12156,Niger - Soult,OUI,23,20,3,0,3,OUI,OUI,2025-03-13 09:59:52+00:00,"48.84369906369085, 2.410361237220498",Paris,75056,0.13043478260869565,10
21507,Gardenat-Lapostol - Velettes,OUI,20,14,6,1,5,OUI,OUI,2025-03-13 09:53:09+00:00,"48.87387, 2.224185",Suresnes,92073,0.3,10
18140,Porte de Clignancourt - Ney,OUI,37,34,3,2,1,OUI,OUI,2025-03-13 10:01:02+00:00,"48.899641123987095, 2.344321422278881",Paris,75056,0.08108108108108109,10
22306,Place du 17 Octobre,OUI,16,12,4,1,3,OUI,OUI,2025-03-13 09:56:24+00:00,"48.91962690034779, 2.2978286134199792",Gennevilliers,92036,0.25,10
9009,Square Montholon,OUI,19,8,11,3,8,OUI,OUI,2025-03-13 09:59:39+00:00,"48.876620377545024, 2.3457641154527664",Paris,75056,0.5789473684210527,10
14023,Adolphe Pinard - Victor Hugo,OUI,51,50,1,0,1,OUI,OUI,2025-03-13 09:52:19+00:00,"48.8236825874564, 2.3077843710780144",Malakoff,92046,0.0196078431372549,10
10034,Louis Blanc - La Chapelle,OUI,21,21,0,0,0,OUI,OUI,2025-03-13 10:01:29+00:00,"48.884008964514, 2.3599335551262",Paris,75056,0.0,10
3003,Fille du Calvaire - Turenne,OUI,26,0,26,20,6,OUI,OUI,2025-03-13 09:55:38+00:00,"48.86210505412563, 2.3649600148200993",Paris,75056,1.0,10
16102,Pergolèse - Marbeau,OUI,26,23,3,0,3,OUI,OUI,2025-03-13 09:59:35+00:00,"48.873568706869, 2.2815125225299",Paris,75056,0.11538461538461539,10
19111,Cesaria Evora - Rosa Parks,OUI,35,29,6,5,1,OUI,OUI,2025-03-13 09:54:36+00:00,"48.89717672825043, 2.3745173960924144",Paris,75056,0.17142857142857143,10
4021,Centre Georges Pompidou,OUI,24,7,17,12,5,OUI,OUI,2025-03-13 09:59:49+00:00,"48.861419, 2.352581",Paris,75056,0.7083333333333334,10
13125,Gare d'Austerlitz - Pont Charles de Gaulle,OUI,55,12,43,23,20,OUI,OUI,2025-03-13 10:01:04+00:00,"48.842319830109, 2.3670300096273",Paris,75056,0.7818181818181819,10
20034,Sorbier - Ménilmontant,OUI,24,24,0,0,0,OUI,OUI,2025-03-13 09:59:27+00:00,"48.868542395661, 2.3897721245885",Paris,75056,0.0,10
21110,Parc Roger Salengro,OUI,31,4,27,23,4,OUI,OUI,2025-03-13 10:01:03+00:00,"48.905303858642, 2.31055945158",Clichy,92024,0.8709677419354839,10
13005,Cordelières - Arago,OUI,45,19,26,24,2,OUI,OUI,2025-03-13 10:00:07+00:00,"48.83548071896613, 2.348572461702221",Paris,75056,0.5777777777777777,10
6031,Pierre Sarrazin - Saint-Michel,OUI,31,1,30,22,8,OUI,OUI,2025-03-13 10:01:28+00:00,"48.850908146398, 2.342130728066",Paris,75056,0.967741935483871,10
19201,Petit - Georges Thill,OUI,23,21,2,0,2,OUI,OUI,2025-03-13 10:01:09+00:00,"48.88603131999171, 2.3895753175020222",Paris,75056,0.08695652173913043,10
48005,Eugène Varlin - Place de la Paix,OUI,23,21,2,1,1,OUI,OUI,2025-03-13 09:52:27+00:00,"48.792862, 2.363093",Villejuif,94076,0.08695652173913043,10
15132,Bargue -  Dutot,OUI,21,18,3,2,1,OUI,OUI,2025-03-13 09:56:59+00:00,"48.837884, 2.308876",Paris,75056,0.14285714285714285,10
14133,Froidevaux - Boulard,OUI,35,34,1,0,1,OUI,OUI,2025-03-13 09:54:15+00:00,"48.835147319625, 2.3294411972165",Paris,75056,0.02857142857142857,10
20006,Pyrénées - Plaine,OUI,12,11,1,0,1,OUI,OUI,2025-03-13 10:00:56+00:00,"48.85026702458, 2.4062821269035",Paris,75056,0.08333333333333333,10
21215,Verdier - Jean Jaurès,OUI,33,32,1,0,1,OUI,OUI,2025-03-13 09:54:44+00:00,"48.81614048711214, 2.3123561963438988",Montrouge,92049,0.030303030303030304,10
14019,Sarrette - Général Leclerc,OUI,22,19,3,0,3,OUI,OUI,2025-03-13 09:56:07+00:00,"48.825030852925, 2.3264128693982",Paris,75056,0.13636363636363635,10
42704,Mairie du Kremlin-Bicêtre,OUI,25,23,2,0,2,OUI,OUI,2025-03-13 09:55:38+00:00,"48.81191981537702, 2.3570189997553825",Le Kremlin-Bicêtre,94043,0.08,10
3011,Turbigo - Réaumur,OUI,31,3,28,24,4,OUI,OUI,2025-03-13 10:00:41+00:00,"48.865574047531, 2.3564198613167",Paris,75056,0.9032258064516129,10
1014,Rivoli - Musée du Louvre,OUI,20,0,20,9,11,OUI,OUI,2025-03-13 10:01:03+00:00,"48.86364636851945, 2.33409583568573",Paris,75056,1.0,10
31709,Place de la Fraternité,OUI,22,22,0,0,0,OUI,OUI,2025-03-13 09:57:22+00:00,"48.85716405838368, 2.422847449779511",Montreuil,93048,0.0,10
2012,Choiseul - Quatre Septembre,OUI,44,9,35,11,24,OUI,OUI,2025-03-13 10:00:39+00:00,"48.8699355331869, 2.3359975218772893",Paris,75056,0.7954545454545454,10
10006,Petites Ecuries - Faubourg Saint-Denis,OUI,25,9,16,11,5,OUI,OUI,2025-03-13 09:55:56+00:00,"48.87287120589831, 2.3542150855064397",Paris,75056,0.64,10
12163,Hippodrome Paris-Vincennes,OUI,42,40,2,1,1,OUI,OUI,2025-03-13 09:53:23+00:00,"48.82048387758518, 2.446271181106568",Paris,75056,0.047619047619047616,10
22401,Charles de Gaulle - Plateau de Vanves,OUI,32,22,10,6,4,OUI,OUI,2025-03-13 10:00:52+00:00,"48.82233088973263, 2.298571803412886",Malakoff,92046,0.3125,10
3002,Saint-Gilles - Turenne,OUI,15,1,14,10,4,OUI,OUI,2025-03-13 10:01:15+00:00,"48.858158956779, 2.3647149920992",Paris,75056,0.9333333333333333,10
4103,Archives - Rivoli,OUI,18,2,16,11,5,OUI,OUI,2025-03-13 09:57:47+00:00,"48.857346707443, 2.3539767041802",Paris,75056,0.8888888888888888,10
13054,Pau Casals - Neuve Tolbiac,OUI,53,1,52,21,31,OUI,OUI,2025-03-13 10:01:20+00:00,"48.8311602, 2.3774395",Paris,75056,0.9811320754716981,10
14103,Maine - Liancourt,OUI,25,23,2,0,2,OUI,OUI,2025-03-13 10:01:01+00:00,"48.835064363954, 2.323731449974",Paris,75056,0.08,10
2004,Square Pierre Lazareff,OUI,17,2,15,6,9,OUI,OUI,2025-03-13 09:58:14+00:00,"48.867141720746, 2.3483933508396",Paris,75056,0.8823529411764706,10
19129,Solitaires - Place des Fêtes,OUI,29,29,0,0,0,NON,NON,2025-02-23 09:26:05+00:00,"48.876601, 2.391769",Paris,75056,0.0,9
19130,Place Paul Delouvrier,OUI,26,24,2,0,2,OUI,OUI,2025-03-13 09:55:22+00:00,"48.89197621431365, 2.3851288855075836",Paris,75056,0.07692307692307693,10
20029,Frères Flavien - Porte des Lilas,OUI,23,23,0,0,0,OUI,OUI,2025-03-13 09:54:33+00:00,"48.8780992764359, 2.41104629853209",Paris,75056,0.0,10
35012,Candale - Mehul,OUI,25,23,2,0,2,OUI,OUI,2025-03-13 09:55:45+00:00,"48.8893935006175, 2.414379715919495",Pantin,93055,0.08,10
2003,Saint-Denis - Réaumur,OUI,31,17,14,7,7,OUI,OUI,2025-03-13 10:00:02+00:00,"48.8661116315789, 2.3507790675507594",Paris,75056,0.45161290322580644,10
4018,Saint-Bon - Rivoli,OUI,15,0,15,12,3,OUI,OUI,2025-03-13 09:59:02+00:00,"48.857999643315, 2.3502172809763",Paris,75056,1.0,10
22503,Joffre - Aigle,OUI,19,13,6,2,4,OUI,OUI,2025-03-13 09:58:11+00:00,"48.904033, 2.245096",La Garenne-Colombes,92035,0.3157894736842105,10
16044,Porte de Saint Cloud - Parc des Princes,OUI,31,23,8,7,1,OUI,OUI,2025-03-13 09:58:47+00:00,"48.838662757066, 2.2525164484978",Paris,75056,0.25806451612903225,10
1102,Française - Etienne Marcel,OUI,35,18,17,17,0,OUI,OUI,2025-03-13 10:01:27+00:00,"48.864053304653766, 2.347587011754513",Paris,75056,0.4857142857142857,10
44001,Quai Jules Guesde - Saint-Simon,OUI,30,3,27,26,1,OUI,OUI,2025-03-13 10:00:34+00:00,"48.80391487219, 2.4089661620274",Vitry-sur-Seine,94081,0.9,10
13017,Nationale - Vincent Auriol,OUI,33,31,2,0,2,OUI,OUI,2025-03-13 09:56:20+00:00,"48.83252708397293, 2.362354410392119",Paris,75056,0.06060606060606061,10
4007,Place de la Bastille - Bourdon,OUI,33,11,22,13,9,OUI,OUI,2025-03-13 10:00:30+00:00,"48.852364355271, 2.3681089282036",Paris,75056,0.6666666666666666,10
15111,Olivier de Serres - Leriche,OUI,24,18,6,3,3,OUI,OUI,2025-03-13 10:00:47+00:00,"48.83460221715206, 2.2957482933998112",Paris,75056,0.25,10
10041,Gare du Nord - La Chapelle,OUI,18,17,1,0,1,OUI,OUI,2025-03-13 09:51:36+00:00,"48.884178287286, 2.3561057075858",Paris,75056,0.05555555555555555,10
12020,Cours de Vincennes - Soult,OUI,44,35,9,6,3,OUI,OUI,2025-03-13 10:01:12+00:00,"48.846918761569, 2.4105220288038",Paris,75056,0.20454545454545456,10
33020,Waldeck Rochet - Germaine Tillon,OUI,30,4,26,15,11,OUI,OUI,2025-03-13 09:59:47+00:00,"48.91105960199651, 2.3676301538944244",Aubervilliers,93001,0.8666666666666667,10
24006,Adolphe Lalyre - Armand Silvestre,OUI,39,31,8,1,7,OUI,OUI,2025-03-13 10:01:10+00:00,"48.90406266961591, 2.273416221141815",Courbevoie,92026,0.20512820512820512,10
32019,Place du 8 mai 1945.,OUI,28,22,6,4,2,OUI,OUI,2025-03-13 09:56:31+00:00,"48.938882272105, 2.3566243797541",Saint-Denis,93066,0.21428571428571427,10
14132,Bézout - Général Leclerc,OUI,29,26,3,1,2,OUI,OUI,2025-03-13 09:57:09+00:00,"48.82884804502439, 2.3285973072052",Paris,75056,0.10344827586206896,10
9039,Chaussée d'Antin - Haussmann,OUI,23,2,21,14,7,OUI,OUI,2025-03-13 09:59:44+00:00,"48.87243, 2.33359",Paris,75056,0.9130434782608695,10
4014,Blancs-Manteaux - Archives,OUI,28,1,27,23,4,OUI,OUI,2025-03-13 10:00:22+00:00,"48.85941800703, 2.3559471219778",Paris,75056,0.9642857142857143,10
22506,Gare des Vallées,OUI,18,11,7,6,1,OUI,OUI,2025-03-13 09:55:59+00:00,"48.913179, 2.257726",La Garenne-Colombes,92035,0.3888888888888889,10
2005,Montmartre - Etienne Marcel,OUI,16,9,7,6,1,OUI,OUI,2025-03-13 09:58:05+00:00,"48.86502194581, 2.3450684401448",Paris,75056,0.4375,10
1018,Alger - Rivoli,OUI,14,1,13,9,4,OUI,OUI,2025-03-13 09:58:44+00:00,"48.864773553495, 2.3294493936128",Paris,75056,0.9285714285714286,10
3012,Square Emile - Chautemps,OUI,24,2,22,16,6,OUI,OUI,2025-03-13 10:00:45+00:00,"48.867433724231, 2.3536357283592",Paris,75056,0.9166666666666666,10
23101,Grande Rue - Europe,OUI,25,21,4,4,0,OUI,OUI,2025-03-13 09:51:39+00:00,"48.8218104687602, 2.205879874527455",Sèvres,92072,0.16,10
2002,Etienne Marcel - Montorgueil,OUI,24,9,15,13,2,OUI,OUI,2025-03-13 10:00:43+00:00,"48.86450567259199, 2.3461959511041637",Paris,75056,0.625,10
1017,Saint-Honoré - 29 juillet,OUI,18,1,17,9,8,OUI,OUI,2025-03-13 10:00:30+00:00,"48.86557114282421, 2.330567417577153",Paris,75056,0.9444444444444444,10
31001,Lagny - Auguste Blanqui,OUI,26,1,25,14,11,OUI,OUI,2025-03-13 09:59:36+00:00,"48.84922568052601, 2.4218603968620305",Montreuil,93048,0.9615384615384616,10
23107,Gare de Sèvres - Ville d'Avray,OUI,22,17,5,3,2,OUI,OUI,2025-03-13 09:54:07+00:00,"48.826262366227, 2.2001516849313",Sèvres,92072,0.22727272727272727,10
22502,Kléber - National,OUI,20,11,9,6,3,OUI,OUI,2025-03-13 09:57:15+00:00,"48.906333898712234, 2.2393910586833954",La Garenne-Colombes,92035,0.45,10
6201,Saint Pères - Saint Germain,OUI,22,6,16,7,9,OUI,OUI,2025-03-13 10:00:06+00:00,"48.853729675265, 2.3300181032703",Paris,75056,0.7272727272727273,10
3006,Mairie du 3ème,OUI,23,1,22,15,7,OUI,OUI,2025-03-13 09:55:55+00:00,"48.86446178139141, 2.361762821674347",Paris,75056,0.9565217391304348,10
6026,Saint-Placide - Cherche Midi,OUI,66,51,15,7,8,OUI,OUI,2025-03-13 09:59:38+00:00,"48.8490535919234, 2.325317971408367",Paris,75056,0.22727272727272727,10
42018,Amédée Huon - Fort d'Ivry,OUI,31,28,3,2,1,OUI,OUI,2025-03-13 09:59:55+00:00,"48.805131376899986, 2.388489693403244",Ivry-sur-Seine,94041,0.0967741935483871,10
4015,Mairie du 4ème,OUI,41,16,25,16,9,OUI,OUI,2025-03-13 09:57:57+00:00,"48.855949910497, 2.3563823103905",Paris,75056,0.6097560975609756,10
12164,Stade Pershing,OUI,26,26,0,0,0,NON,NON,2025-02-26 05:58:32+00:00,"48.829107826857, 2.4583535268903",Paris,75056,0.0,6
9111,Victoire - Laffitte,OUI,19,1,18,17,1,OUI,OUI,2025-03-13 09:59:35+00:00,"48.87514373494672, 2.338118505144376",Paris,75056,0.9473684210526315,10
19202,Marseillaise - Grenade,OUI,43,40,3,0,3,OUI,OUI,2025-03-13 10:00:46+00:00,"48.889371092747, 2.3979396821544",Paris,75056,0.06976744186046512,10
5122,Saint-Michel - Luxembourg,OUI,26,1,25,7,18,OUI,OUI,2025-03-13 10:01:17+00:00,"48.84501507626, 2.3394941166043",Paris,75056,0.9615384615384616,10
18112,Arthur Ranc - Hôpital Bichat,OUI,23,13,10,5,5,OUI,OUI,2025-03-13 09:54:01+00:00,"48.8978712500682, 2.333521842956543",Paris,75056,0.43478260869565216,10
8036,Lisbonne - Monceau,OUI,46,1,45,14,31,OUI,OUI,2025-03-13 09:59:09+00:00,"48.877455676814, 2.3096942214195",Paris,75056,0.9782608695652174,10
22603,Place de la Division Leclerc,OUI,33,32,1,0,1,OUI,OUI,2025-03-13 09:58:46+00:00,"48.793824988636516, 2.2731140430551027",Fontenay-aux-Roses,92032,0.030303030303030304,10
4012,Tiron - Rivoli,OUI,27,1,26,21,5,OUI,OUI,2025-03-13 09:57:35+00:00,"48.855692253233, 2.3579058051109",Paris,75056,0.9629629629629629,10
12113,Cardinal Lavigerie,OUI,46,7,39,30,9,OUI,OUI,2025-03-13 10:01:09+00:00,"48.832934193699835, 2.402636749399156",Paris,75056,0.8478260869565217,10
41208,Alouettes - Maréchal de Lattre de Tassigny,OUI,21,12,9,1,8,OUI,OUI,2025-03-13 10:00:31+00:00,"48.85511009293948, 2.4930700287222862",Fontenay-sous-Bois,94033,0.42857142857142855,10
16010,Belles Feuilles - Place de Mexico,OUI,22,13,9,2,7,OUI,OUI,2025-03-13 09:59:55+00:00,"48.865804746474, 2.2829206287861",Paris,75056,0.4090909090909091,10
21706,Jean Bleuzen - Square du 11 Novembre,OUI,45,34,11,9,2,OUI,OUI,2025-03-13 09:59:38+00:00,"48.8232579, 2.2965213",Vanves,92075,0.24444444444444444,10
16201,Porte Dauphine,OUI,60,21,39,11,28,OUI,OUI,2025-03-13 09:59:24+00:00,"48.871139344351, 2.2749781616017",Paris,75056,0.65,10
4017,Place de l'Hôtel de Ville,OUI,13,0,13,12,1,OUI,OUI,2025-03-13 09:58:33+00:00,"48.8573314, 2.351458",Paris,75056,1.0,10
42019,Lampes,OUI,43,7,36,36,0,OUI,OUI,2025-03-13 10:01:28+00:00,"48.81152481985875, 2.4017931148409843",Ivry-sur-Seine,94041,0.8372093023255814,10
26006,Bas - Gabriel Péri,OUI,30,15,15,15,0,OUI,OUI,2025-03-13 10:01:02+00:00,"48.91585580539625, 2.2948095202445984",Asnières-sur-Seine,92004,0.5,10
27006,Victor Hugo - Gare,OUI,19,15,4,3,1,OUI,OUI,2025-03-13 09:54:55+00:00,"48.923133952658, 2.2600970417261",Colombes,92025,0.21052631578947367,10
42211,Séminaire de Conflans - Liberté,OUI,24,6,18,10,8,OUI,OUI,2025-03-13 10:01:26+00:00,"48.823194, 2.404179",Charenton-le-Pont,94018,0.75,10
1015,Place André Malraux,OUI,16,1,15,9,6,OUI,OUI,2025-03-13 10:00:46+00:00,"48.863925158727, 2.3356226831675",Paris,75056,0.9375,10
42026,Barbès - Monique Maunoury,OUI,40,40,0,0,0,OUI,OUI,2025-03-13 10:00:19+00:00,"48.81552718820216, 2.3687169334905405",Ivry-sur-Seine,94041,0.0,10
2006,Place des Victoires,OUI,23,1,22,14,8,OUI,OUI,2025-03-13 09:59:48+00:00,"48.8660354, 2.3420333",Paris,75056,0.9565217391304348,10
21509,Gardenat Lapostol - Franklin Roosevelt,OUI,24,23,1,0,1,OUI,OUI,2025-03-13 09:45:17+00:00,"48.871839, 2.222505",Suresnes,92073,0.041666666666666664,10
44004,Place de l'Eglise - Vitry-sur-Seine,OUI,28,7,21,20,1,OUI,OUI,2025-03-13 10:00:16+00:00,"48.791922819921815, 2.395057752728462",Vitry-sur-Seine,94081,0.75,10
1012,Jean-Jacques Rousseau - Deux Ecus,OUI,21,5,16,12,4,OUI,OUI,2025-03-13 10:00:58+00:00,"48.86297805972131, 2.3414635285735126",Paris,75056,0.7619047619047619,10
1024,Coquillière - Louvre,OUI,17,3,14,6,8,OUI,OUI,2025-03-13 10:01:19+00:00,"48.863795909662, 2.3425736278296",Paris,75056,0.8235294117647058,10
21505,Édouard Vaillant - Place Jean Jaurès,OUI,20,19,1,0,1,OUI,OUI,2025-03-13 09:55:05+00:00,"48.86265537999924, 2.2089037319128613",Suresnes,92073,0.05,10
2102,Saint-Marc - Feydeau,OUI,36,8,28,15,13,OUI,OUI,2025-03-13 10:00:50+00:00,"48.870326843044, 2.3418715826353",Paris,75056,0.7777777777777778,10
2016,Aboukir - Alexandrie,OUI,21,2,19,18,1,OUI,OUI,2025-03-13 09:57:46+00:00,"48.86868344444473, 2.3502043269474897",Paris,75056,0.9047619047619048,10
2020,Danielle Casanova - Opéra,OUI,20,1,19,9,10,OUI,OUI,2025-03-13 10:00:58+00:00,"48.867643242297, 2.3333894088864",Paris,75056,0.95,10
5004,Saint-Jacques - Val de Grâce,OUI,19,3,16,5,11,OUI,OUI,2025-03-13 09:58:42+00:00,"48.8417514, 2.3413893",Paris,75056,0.8421052631578947,10
10201,Magenta - Chabrol,OUI,23,22,1,0,1,OUI,OUI,2025-03-13 10:00:49+00:00,"48.876495350882, 2.3560990020633",Paris,75056,0.043478260869565216,10
4009,Village Saint-Paul,OUI,27,2,25,17,8,OUI,OUI,2025-03-13 10:01:04+00:00,"48.852639866625, 2.3607301712036",Paris,75056,0.9259259259259259,10
6029,Vaugirard - Monsieur le Prince,OUI,24,1,23,11,12,OUI,OUI,2025-03-13 10:01:16+00:00,"48.848951441614, 2.3411329463124",Paris,75056,0.9583333333333334,10
4101,Bastille - Beaumarchais,OUI,20,1,19,18,1,OUI,OUI,2025-03-13 10:00:24+00:00,"48.853833463852, 2.3685702681541",Paris,75056,0.95,10
23301,Les Blagis,OUI,24,10,14,10,4,OUI,OUI,2025-03-13 10:00:51+00:00,"48.785205, 2.302526",Sceaux,92071,0.5833333333333334,10
1025,Oratoire - Rivoli,OUI,17,0,17,13,4,OUI,OUI,2025-03-13 09:59:50+00:00,"48.861342760889, 2.3400047421455",Paris,75056,1.0,10
34013,Blanqui - Docteur Bauer,OUI,21,7,14,7,7,OUI,OUI,2025-03-13 10:00:52+00:00,"48.907735489085, 2.3407192814591",Saint-Ouen-sur-Seine,93070,0.6666666666666666,10
2008,Mairie du 2ème,OUI,28,5,23,11,12,OUI,OUI,2025-03-13 10:01:02+00:00,"48.8672190355135, 2.3404625437747044",Paris,75056,0.8214285714285714,10
20140,Paganini - Davout,OUI,21,17,4,3,1,OUI,OUI,2025-03-13 09:54:30+00:00,"48.85135, 2.412021",Paris,75056,0.19047619047619047,10
1026,Place du Lieutenant Henri Karcher,OUI,29,1,28,24,4,OUI,OUI,2025-03-13 10:00:38+00:00,"48.863490871724466, 2.3400671035051346",Paris,75056,0.9655172413793104,10
48012,Stalingrad - Henri Luisette,OUI,26,25,1,0,1,OUI,OUI,2025-03-13 10:00:04+00:00,"48.78363092456589, 2.366935946761926",Villejuif,94076,0.038461538461538464,10
18015,Custine - Ramey,OUI,40,40,0,0,0,OUI,OUI,2025-03-13 10:00:07+00:00,"48.888735896947, 2.3469526693225",Paris,75056,0.0,10
23303,Gare de Robinson,OUI,29,29,0,0,0,OUI,OUI,2025-03-13 09:53:00+00:00,"48.7799259211605, 2.281828634440899",Sceaux,92071,0.0,10
17106,Berthier - Porte de Clichy,OUI,24,14,10,10,0,OUI,OUI,2025-03-13 09:59:07+00:00,"48.894222687781, 2.3125872006816",Paris,75056,0.4166666666666667,10
42022,Gare RER - Maurice Grandcoing,OUI,36,0,36,34,2,OUI,OUI,2025-03-13 09:59:23+00:00,"48.813881, 2.392429",Ivry-sur-Seine,94041,1.0,10
1116,Ventadour - Opéra,OUI,25,7,18,7,11,OUI,OUI,2025-03-13 10:00:12+00:00,"48.866810653323, 2.3343884482519",Paris,75056,0.72,10
15018,Dutot - Place Alleray,OUI,56,52,4,0,4,OUI,OUI,2025-03-13 09:57:05+00:00,"48.836826091766, 2.3071701095578",Paris,75056,0.07142857142857142,10
32024,Port - Confluence,OUI,22,16,6,5,1,OUI,OUI,2025-03-13 09:51:20+00:00,"48.936093926526, 2.3436167797955",Saint-Denis,93066,0.2727272727272727,10
10166,Strasbourg - Saint-Denis,OUI,16,8,8,6,2,OUI,OUI,2025-03-13 10:00:36+00:00,"48.869601642433, 2.3542908579111",Paris,75056,0.5,10
15040,Saint-Amand - Labrouste,OUI,34,33,1,0,1,OUI,OUI,2025-03-13 09:52:14+00:00,"48.834097274832295, 2.3087677359581",Paris,75056,0.029411764705882353,10
45004,République - Louis Loucheur,OUI,37,4,33,5,28,OUI,OUI,2025-03-13 10:00:46+00:00,"48.823549261189, 2.5101865455508",Champigny-sur-Marne,94017,0.8918918918918919,10
22601,Marx Dormoy - Château Sainte-Barbe,OUI,20,19,1,0,1,OUI,OUI,2025-03-13 09:52:17+00:00,"48.791782341055324, 2.297856844961643",Fontenay-aux-Roses,92032,0.05,10
23202,Henri Barbusse - Gabriel Péri,OUI,17,13,4,0,4,OUI,OUI,2025-03-13 09:59:29+00:00,"48.801773795836, 2.2874166362216",Châtillon,92020,0.23529411764705882,10
1023,Saint-Honoré - Musée du Louvre,OUI,21,1,20,10,10,OUI,OUI,2025-03-13 10:00:46+00:00,"48.863443132848, 2.3348781846405",Paris,75056,0.9523809523809523,10
13049,Vincent Auriol - Louise Weiss,OUI,22,2,20,13,7,OUI,OUI,2025-03-13 10:00:00+00:00,"48.834001935501, 2.3703888058662",Paris,75056,0.9090909090909091,10
48008,Guy Môquet - Parvis Georges Marchais,OUI,30,30,0,0,0,OUI,OUI,2025-03-13 09:50:22+00:00,"48.79518840095975, 2.35943466424942",Villejuif,94076,0.0,10
32605,Mairie,OUI,19,19,0,0,0,OUI,OUI,2025-03-13 09:55:04+00:00,"48.87914304162, 2.4163350908311",Les Lilas,93045,0.0,10
14201,Decrès - Alésia,OUI,30,30,0,0,0,OUI,OUI,2025-03-13 10:00:29+00:00,"48.832200060759, 2.3139070151575",Paris,75056,0.0,10
17202,Mariotte - Batignolles,OUI,18,13,5,2,3,OUI,OUI,2025-03-13 10:00:41+00:00,"48.884571659595, 2.321469503475",Paris,75056,0.2777777777777778,10
5003,Le Goff - Gay-Lussac,OUI,34,20,14,7,7,OUI,OUI,2025-03-13 10:00:46+00:00,"48.846102400979, 2.3412207886577",Paris,75056,0.4117647058823529,10
8202,Londres - Europe,OUI,27,17,10,3,7,OUI,OUI,2025-03-13 09:56:54+00:00,"48.878618556803, 2.3248164693922",Paris,75056,0.37037037037037035,10
27001,Square Victor Basch,OUI,19,2,17,10,7,OUI,OUI,2025-03-13 09:58:40+00:00,"48.914304862261, 2.2289156913757",Colombes,92025,0.8947368421052632,10
17020,Jouffroy d'Abbans - Malesherbes,OUI,26,13,13,6,7,OUI,OUI,2025-03-13 10:00:41+00:00,"48.8850134, 2.3070717",Paris,75056,0.5,10
17021,Jouffroy d'Abbans - Villiers,OUI,31,6,25,18,7,OUI,OUI,2025-03-13 10:01:07+00:00,"48.884215547037, 2.3056533560157",Paris,75056,0.8064516129032258,10
8040,Pierre Charron - Champs-Elysées,OUI,30,0,30,14,16,OUI,OUI,2025-03-13 09:59:37+00:00,"48.870103359864, 2.3043501377106",Paris,75056,1.0,10
3007,Archives - Pastourelle,OUI,26,5,21,14,7,OUI,OUI,2025-03-13 10:00:22+00:00,"48.8623615, 2.3595041",Paris,75056,0.8076923076923077,10
48001,Chastenet de Géry - Marcel Paul,OUI,25,23,2,1,1,OUI,OUI,2025-03-13 09:57:38+00:00,"48.800123, 2.3567359",Villejuif,94076,0.08,10
31020,Résistance - Parmentier,OUI,32,30,2,1,1,OUI,OUI,2025-03-13 09:59:55+00:00,"48.85965138131299, 2.436705082654953",Montreuil,93048,0.0625,10
18135,Ney - Porte de Montmartre,OUI,23,19,4,2,2,OUI,OUI,2025-03-13 10:00:02+00:00,"48.897918, 2.3364872",Paris,75056,0.17391304347826086,10
28005,Jean Jaurès - Paul Lafargue,OUI,25,1,24,7,17,OUI,OUI,2025-03-13 09:59:06+00:00,"48.884933177666, 2.2484488785267",Puteaux,92062,0.96,10
21329,Gare - Aristide Briand,OUI,28,13,15,12,3,OUI,OUI,2025-03-13 10:01:12+00:00,"48.821410564722, 2.2555950104387",Issy-les-Moulineaux,92040,0.5357142857142857,10
35005,Quai de l'Aisne - Général Leclerc,OUI,25,19,6,1,5,OUI,OUI,2025-03-13 09:59:09+00:00,"48.895713, 2.400571",Pantin,93055,0.24,10
21704,Place du Maréchal de Lattre de Tassigny,OUI,26,24,2,1,1,OUI,OUI,2025-03-13 09:56:11+00:00,"48.821707715257055, 2.2853431485432423",Vanves,92075,0.07692307692307693,10
16139,Suresnes - Muette à Neuilly,OUI,26,21,5,3,2,OUI,OUI,2025-03-13 09:54:39+00:00,"48.868570404348, 2.266000919044",Paris,75056,0.19230769230769232,10
13015,Chevaleret - Louise Weiss,OUI,35,17,18,7,11,OUI,OUI,2025-03-13 09:57:49+00:00,"48.832586513351, 2.37121138812",Paris,75056,0.5142857142857142,10
6007,Bréa - Raspail,OUI,24,7,17,4,13,OUI,OUI,2025-03-13 09:59:02+00:00,"48.842738478258, 2.3297942217634",Paris,75056,0.7083333333333334,10
25007,Bons Raisins - Voltaire,OUI,24,23,1,0,1,OUI,OUI,2025-03-13 09:59:12+00:00,"48.87282451461399, 2.1947155570850896",Rueil-Malmaison,92063,0.041666666666666664,10
42028,Verdun - Carnot,OUI,28,27,1,0,1,OUI,OUI,2025-03-13 09:57:00+00:00,"48.808439376064946, 2.373795211315155",Ivry-sur-Seine,94041,0.03571428571428571,10
12123,Château de Vincennes,OUI,49,40,9,4,5,OUI,OUI,2025-03-13 10:01:03+00:00,"48.84423193255657, 2.439209537709179",Paris,75056,0.1836734693877551,10
12166,Parc Floral du Bel Air,OUI,23,12,11,5,6,OUI,OUI,2025-03-13 10:01:04+00:00,"48.839285711865735, 2.438560165464878",Paris,75056,0.4782608695652174,10
21002,Place Denfert-Rochereau,OUI,19,14,5,1,4,OUI,OUI,2025-03-13 10:01:06+00:00,"48.843252536286684, 2.245987951755524",Boulogne-Billancourt,92012,0.2631578947368421,10
21119,Belfort - Victor Hugo,OUI,21,4,17,14,3,OUI,OUI,2025-03-13 10:00:30+00:00,"48.9018492, 2.3172724",Clichy,92024,0.8095238095238095,10
24004,Paix - Verdun,OUI,33,27,6,1,5,OUI,OUI,2025-03-13 10:00:07+00:00,"48.900504, 2.261173",Courbevoie,92026,0.18181818181818182,10
23042,André Theuriet - Blagis,OUI,30,19,11,8,3,OUI,OUI,2025-03-13 09:56:31+00:00,"48.77977325745441, 2.3130525648593903",Bourg-la-Reine,92014,0.36666666666666664,10
24005,Edith Cavell - Volta,OUI,32,29,3,0,3,OUI,OUI,2025-03-13 10:01:25+00:00,"48.901616564286975, 2.269354350864887",Courbevoie,92026,0.09375,10
31104,Mairie de Rosny-sous-Bois,OUI,26,11,15,10,5,OUI,OUI,2025-03-13 09:59:15+00:00,"48.871256519012, 2.4865807592869",Rosny-sous-Bois,93064,0.5769230769230769,10
32020,Jules Guesdes - Carnot,OUI,14,14,0,0,0,OUI,OUI,2025-03-13 09:54:01+00:00,"48.93828169931872, 2.3508992046117783",Saint-Denis,93066,0.0,10
42024,Danielle Casanova - Ledru-Rollin,OUI,28,13,15,14,1,OUI,OUI,2025-03-13 10:01:07+00:00,"48.815783497876815, 2.383259721100331",Ivry-sur-Seine,94041,0.5357142857142857,10
1008,Les Halles - Saint-Eustache,OUI,32,15,17,5,12,OUI,OUI,2025-03-13 10:01:19+00:00,"48.86362695901683, 2.342623919248581",Paris,75056,0.53125,10
5027,Gobelins - Port-Royal,OUI,36,13,23,20,3,OUI,OUI,2025-03-13 10:01:13+00:00,"48.837135900263, 2.3515201359987",Paris,75056,0.6388888888888888,10
9019,Victor Massé - Jean-Baptiste Pigalle,OUI,18,17,1,0,1,OUI,OUI,2025-03-13 10:00:09+00:00,"48.8811043724, 2.3366955667734",Paris,75056,0.05555555555555555,10
15203,Porte de Versailles,OUI,27,15,12,8,4,OUI,OUI,2025-03-13 09:59:55+00:00,"48.832324016657, 2.2875617349045",Paris,75056,0.4444444444444444,10
19046,Porte de Pantin.,OUI,33,27,6,0,6,OUI,OUI,2025-03-13 09:59:20+00:00,"48.889199725577, 2.3950181901455",Paris,75056,0.18181818181818182,10
13116,Place du Docteur Yersin,OUI,50,44,6,4,2,OUI,OUI,2025-03-13 09:59:51+00:00,"48.82010494991975, 2.3725583776831627",Paris,75056,0.12,10
11111,Léon Frot - Charonne,OUI,18,12,6,3,3,OUI,OUI,2025-03-13 10:01:15+00:00,"48.854963800335234, 2.387217085372007",Paris,75056,0.3333333333333333,10
12016,Saint-Mande - Picpus,OUI,34,30,4,1,3,OUI,OUI,2025-03-13 10:00:19+00:00,"48.845127728278, 2.4015686296482",Paris,75056,0.11764705882352941,10
48006,Maxime Gorki - Paul Vaillant-Couturier,OUI,19,18,1,0,1,OUI,OUI,2025-03-13 09:59:59+00:00,"48.79673508795443, 2.3683342337608337",Villejuif,94076,0.05263157894736842,10
42210,Victor Hugo - Paul Eluard,OUI,31,3,28,26,2,OUI,OUI,2025-03-13 10:01:00+00:00,"48.819602554907, 2.4114319673051",Charenton-le-Pont,94018,0.9032258064516129,10
18016,Francoeur - Caulaincourt,OUI,33,25,8,0,8,OUI,OUI,2025-03-13 10:01:01+00:00,"48.8899944409612, 2.342529706656933",Paris,75056,0.24242424242424243,10
44008,Youri Gagarine - Commune de Paris,OUI,32,10,22,11,11,OUI,OUI,2025-03-13 09:56:48+00:00,"48.782427463041, 2.3939734697342",Vitry-sur-Seine,94081,0.6875,10
19117,Euryale Dehaynin - Loire,OUI,29,26,3,1,2,OUI,OUI,2025-03-13 09:59:21+00:00,"48.886248917304805, 2.3774591088294987",Paris,75056,0.10344827586206896,10
23104,Quai de Sèvres - Manufacture Nationale,OUI,26,14,12,6,6,OUI,OUI,2025-03-13 10:00:22+00:00,"48.828688, 2.22499",Sèvres,92072,0.46153846153846156,10
15053,Lecourbe - Convention,OUI,45,41,4,2,2,OUI,OUI,2025-03-13 09:52:45+00:00,"48.83923319241899, 2.2915197908878326",Paris,75056,0.08888888888888889,10
21011,Silly - Louis Blériot,OUI,23,4,19,7,12,OUI,OUI,2025-03-13 10:00:32+00:00,"48.83219045374266, 2.2340199351310734",Boulogne-Billancourt,92012,0.8260869565217391,10
21022,Dôme - République,OUI,24,0,24,15,9,OUI,OUI,2025-03-13 09:57:43+00:00,"48.832681, 2.250257",Boulogne-Billancourt,92012,1.0,10
20010,Sorbier - Gasnier-Guy,OUI,34,34,0,0,0,OUI,OUI,2025-03-13 09:59:34+00:00,"48.865217631011, 2.3936596512794",Paris,75056,0.0,10
20003,Pyrénées - Cours de Vincennes,OUI,19,5,14,8,6,OUI,OUI,2025-03-13 10:00:03+00:00,"48.847796779935, 2.4061721563339",Paris,75056,0.7368421052631579,10
26012,Jardin Modèle - Pierre Boudou,OUI,15,12,3,3,0,OUI,OUI,2025-03-13 10:00:33+00:00,"48.914866710946, 2.3057010525935",Asnières-sur-Seine,92004,0.2,10
11022,Roquette - Auguste Laurent,OUI,16,6,10,10,0,OUI,OUI,2025-03-13 09:59:37+00:00,"48.858001906023354, 2.381797702650783",Paris,75056,0.625,10
20048,Bagnolet - Place Saint-Blaise,OUI,27,26,1,0,1,OUI,OUI,2025-03-13 09:59:27+00:00,"48.85973, 2.40334",Paris,75056,0.037037037037037035,10
41602,Place Charles Digeon,OUI,30,27,3,2,1,OUI,OUI,2025-03-13 09:59:35+00:00,"48.84354203133597, 2.418427169322968",Saint-Mandé,94067,0.1,10
6015,André Mazet - Saint-André des Arts,OUI,55,7,48,43,5,OUI,OUI,2025-03-13 10:01:10+00:00,"48.85375581057431, 2.3390958085656166",Paris,75056,0.8727272727272727,10
15069,Félix Faure - Convention,OUI,43,28,15,13,2,OUI,OUI,2025-03-13 10:01:17+00:00,"48.841249336041, 2.2883866008495",Paris,75056,0.3488372093023256,10
32011,Stade de France - Francis de Pressensé,OUI,43,1,42,3,39,OUI,OUI,2025-03-13 10:01:16+00:00,"48.919141953558, 2.3620655760169",Saint-Denis,93066,0.9767441860465116,10
14004,Port Royal - Hôpital Cochin,OUI,22,15,7,1,6,OUI,OUI,2025-03-13 10:00:59+00:00,"48.838608030238, 2.3406994164846",Paris,75056,0.3181818181818182,10
12202,Charenton - Wattignies,OUI,40,40,0,0,0,OUI,OUI,2025-03-13 09:59:41+00:00,"48.836919119234, 2.3916775206425",Paris,75056,0.0,10
48002,LCL Campus - Place Oscar Niemeyer,OUI,37,37,0,0,0,OUI,OUI,2025-03-13 09:54:37+00:00,"48.805342480621576, 2.363983690738678",Villejuif,94076,0.0,10
23206,Béranger - Félix Faure,OUI,26,26,0,0,0,OUI,OUI,2025-03-13 09:52:18+00:00,"48.80404828621485, 2.2848263373723436",Châtillon,92020,0.0,10
41605,Général De Gaulle - Vivien,OUI,21,21,0,0,0,OUI,OUI,2025-03-13 10:00:56+00:00,"48.83607420090204, 2.4189166724681854",Saint-Mandé,94067,0.0,10
10202,Bichat - Grange aux Belles,OUI,29,25,4,2,2,OUI,OUI,2025-03-13 09:57:58+00:00,"48.873688, 2.365015",Paris,75056,0.13793103448275862,10
12008,Hector Malot - Daumesnil,OUI,52,2,50,47,3,OUI,OUI,2025-03-13 10:00:41+00:00,"48.84693552991762, 2.3770876228809357",Paris,75056,0.9615384615384616,10
42030,Stéphanie Bouvard - Gambetta,OUI,30,23,7,5,2,OUI,OUI,2025-03-13 09:59:00+00:00,"48.814548138856, 2.4024386957288",Ivry-sur-Seine,94041,0.23333333333333334,10
12102,Bercy - Traversiére,OUI,30,2,28,21,7,OUI,OUI,2025-03-13 10:00:00+00:00,"48.846192642574, 2.3703800886869",Paris,75056,0.9333333333333333,10
8018,Saint-Augustin,OUI,28,0,28,11,17,OUI,OUI,2025-03-13 10:01:11+00:00,"48.8762009747008, 2.319786250591278",Paris,75056,1.0,10
13120,Pierre Joseph Desault,OUI,18,5,13,12,1,OUI,OUI,2025-03-13 09:59:41+00:00,"48.82110230800372, 2.378775402903557",Paris,75056,0.7222222222222222,10
12119,Dom-Pérignon - Gravelle,OUI,46,25,21,18,3,OUI,OUI,2025-03-13 09:59:18+00:00,"48.825481574435, 2.409880310297",Paris,75056,0.45652173913043476,10
20142,Mûriers - Père Lachaise,OUI,19,17,2,1,1,OUI,OUI,2025-03-13 09:54:38+00:00,"48.864130509668044, 2.39164982067019",Paris,75056,0.10526315789473684,10
43007,Hôtel de Ville de Vincennes,OUI,26,20,6,4,2,OUI,OUI,2025-03-13 09:54:09+00:00,"48.84827609706963, 2.4398955702781677",Vincennes,94080,0.23076923076923078,10
51008,Martyrs de Châteaubriant - Jean Grandel,OUI,38,27,11,1,10,OUI,OUI,2025-03-13 10:00:57+00:00,"48.951432, 2.211214",Argenteuil,95018,0.2894736842105263,10
15050,Dominique Pado - Croix Nivert,OUI,22,21,1,0,1,OUI,OUI,2025-03-13 10:00:21+00:00,"48.83648798164934, 2.2897250577807426",Paris,75056,0.045454545454545456,10
24101,Place Charles de Gaulle,OUI,24,22,2,0,2,OUI,OUI,2025-03-13 09:59:30+00:00,"48.826073335699, 2.1894485725692",Ville-d'Avray,92077,0.08333333333333333,10
16025,Jean de la Fontaine - Boulainvilliers,OUI,66,3,63,46,17,OUI,OUI,2025-03-13 10:01:03+00:00,"48.85264791461651, 2.2758664190769196",Paris,75056,0.9545454545454546,10
34011,Clef des Champs - Albert Dhalenne,OUI,25,0,25,11,14,OUI,OUI,2025-03-13 10:00:02+00:00,"48.914938, 2.330665",Saint-Ouen-sur-Seine,93070,1.0,10
43004,Montreuil - République,OUI,23,18,5,1,4,OUI,OUI,2025-03-13 09:59:34+00:00,"48.85026349463687, 2.4345204234123234",Vincennes,94080,0.21739130434782608,10
19121,Belleville -  Pré Saint-Gervais,OUI,21,21,0,0,0,OUI,OUI,2025-03-13 09:57:54+00:00,"48.875565910073, 2.3930460959673",Paris,75056,0.0,10
14009,Tombe Issoire - René Coty,OUI,35,32,3,2,1,OUI,OUI,2025-03-13 09:57:21+00:00,"48.830512876709, 2.3343613743782",Paris,75056,0.08571428571428572,10
19114,Manin - Secrétan,OUI,20,19,1,0,1,OUI,OUI,2025-03-13 09:52:27+00:00,"48.8791665, 2.3787959",Paris,75056,0.05,10
16017,Siam - La Pompe,OUI,16,12,4,0,4,OUI,OUI,2025-03-13 10:01:09+00:00,"48.861720329027264, 2.275346568555312",Paris,75056,0.25,10
13024,Bobillot - Tolbiac,OUI,33,27,6,0,6,OUI,OUI,2025-03-13 10:00:07+00:00,"48.8255961335041, 2.350204177200794",Paris,75056,0.18181818181818182,10
15045,Porte de la Plaine,OUI,35,32,3,3,0,OUI,OUI,2025-03-13 09:59:25+00:00,"48.82805169605981, 2.2924277186393742",Paris,75056,0.08571428571428572,10
23041,Général Leclerc - Bièvre,OUI,24,18,6,2,4,OUI,OUI,2025-03-13 10:00:36+00:00,"48.782414428747316, 2.3166695237159733",Bourg-la-Reine,92014,0.25,10
25004,Marcel Pourtout - Édouard Manet,OUI,24,5,19,18,1,OUI,OUI,2025-03-13 09:59:02+00:00,"48.87555620763429, 2.1655967831611638",Rueil-Malmaison,92063,0.7916666666666666,10
15012,Cambronne - Mademoiselle,OUI,66,62,4,3,1,OUI,OUI,2025-03-13 09:56:37+00:00,"48.843277330035214, 2.30230766886348",Paris,75056,0.06060606060606061,10
12022,Sahel - Général Michel Bizot,OUI,30,28,2,2,0,OUI,OUI,2025-03-13 09:59:17+00:00,"48.840872964793355, 2.4044444784522057",Paris,75056,0.06666666666666667,10
15041,Franquet - Labrouste,OUI,37,37,0,0,0,OUI,OUI,2025-03-13 09:57:08+00:00,"48.83287705011431, 2.306762784719467",Paris,75056,0.0,10
21023,Ancienne Mairie - André Morizet,OUI,25,12,13,8,5,OUI,OUI,2025-03-13 10:01:09+00:00,"48.838311, 2.234077",Boulogne-Billancourt,92012,0.52,10
10003,Hauteville - Bonne Nouvelle,OUI,17,4,13,2,11,OUI,OUI,2025-03-13 09:56:34+00:00,"48.87077436024, 2.3496496368327",Paris,75056,0.7647058823529411,10
31105,Lavoisier - Missak Manouchian,OUI,13,9,4,1,3,OUI,OUI,2025-03-13 09:56:05+00:00,"48.86286468896063, 2.495676465332508",Rosny-sous-Bois,93064,0.3076923076923077,10
41103,Place de la vache noire,OUI,23,20,3,0,3,OUI,OUI,2025-03-13 09:59:29+00:00,"48.81040517059777, 2.327060401439667",Arcueil,94003,0.13043478260869565,10
42205,Place Aristide Briand,OUI,35,22,13,10,3,OUI,OUI,2025-03-13 09:55:00+00:00,"48.82189236575831, 2.413003742694855",Charenton-le-Pont,94018,0.37142857142857144,10
13028,Gouthière - Poterne des Peupliers,OUI,32,30,2,1,1,OUI,OUI,2025-03-13 09:58:22+00:00,"48.820507, 2.351342",Paris,75056,0.0625,10
22701,Général Leclerc - République,OUI,28,9,19,18,1,OUI,OUI,2025-03-13 10:01:18+00:00,"48.915885074177, 2.2682306702811",Bois-Colombes,92009,0.6785714285714286,10
20012,Buzenval - Vignoles,OUI,17,15,2,1,1,OUI,OUI,2025-03-13 09:56:31+00:00,"48.853858171688, 2.4000040814281",Paris,75056,0.11764705882352941,10
20032,Square des Amandiers,OUI,26,24,2,1,1,OUI,OUI,2025-03-13 09:51:54+00:00,"48.86615630668046, 2.3891324177384377",Paris,75056,0.07692307692307693,10
14027,Gergovie - Alésia,OUI,54,53,1,0,1,OUI,OUI,2025-03-13 09:57:49+00:00,"48.83088717455243, 2.318882101207347",Paris,75056,0.018518518518518517,10
20014,Charonne - Alexandre Dumas,OUI,34,31,3,2,1,OUI,OUI,2025-03-13 09:53:20+00:00,"48.856077415056, 2.3948693275452",Paris,75056,0.08823529411764706,10
42303,Place Eustache Deschamps,OUI,20,12,8,3,5,OUI,OUI,2025-03-13 09:55:45+00:00,"48.793855, 2.336637",Cachan,94016,0.4,10
14035,Maine - Jean Zay,OUI,45,39,6,2,4,OUI,OUI,2025-03-13 10:01:15+00:00,"48.837925263898, 2.3225428909063",Paris,75056,0.13333333333333333,10
30003,Moscou - Edouard Vaillant,OUI,29,20,9,3,6,OUI,OUI,2025-03-13 09:59:42+00:00,"48.90755810177, 2.4689837335263",Bobigny,93008,0.3103448275862069,10
8046,Marceau - Président Wilson,OUI,29,5,24,15,9,OUI,OUI,2025-03-13 09:59:51+00:00,"48.8652359, 2.3002513",Paris,75056,0.8275862068965517,10
35013,Guillaume Tell - Parc Henri Barbusse,OUI,20,16,4,1,3,OUI,OUI,2025-03-13 09:57:54+00:00,"48.88958925894009, 2.4198862910270695",Pantin,93055,0.2,10
8007,Rome - Provence,OUI,29,1,28,23,5,OUI,OUI,2025-03-13 09:59:51+00:00,"48.874230055580306, 2.325570111724113",Paris,75056,0.9655172413793104,10
20020,Pyrénées - Charles Renouvier,OUI,29,29,0,0,0,OUI,OUI,2025-03-13 09:56:37+00:00,"48.86095933229224, 2.400421852042113",Paris,75056,0.0,10
18101,Championnet.,OUI,20,19,1,0,1,OUI,OUI,2025-03-13 09:59:54+00:00,"48.8953643, 2.3498166",Paris,75056,0.05,10
15024,Suffren - La Motte-Piquet,OUI,23,6,17,11,6,OUI,OUI,2025-03-13 10:00:32+00:00,"48.850881230919, 2.3012199997902",Paris,75056,0.7391304347826086,10
6028,Quatre Vents - Carrefour de l'Odéon,OUI,37,15,22,18,4,OUI,OUI,2025-03-13 10:01:13+00:00,"48.851751374458864, 2.338161695134053",Paris,75056,0.5945945945945946,10
13006,Duméril - Jeanne d'Arc,OUI,40,33,7,6,1,OUI,OUI,2025-03-13 10:01:06+00:00,"48.838151608087, 2.3571084495564",Paris,75056,0.175,10
20005,Reynaldo Hahn - Lagny,OUI,19,17,2,1,1,OUI,OUI,2025-03-13 09:56:21+00:00,"48.849266043601794, 2.412330328844772",Paris,75056,0.10526315789473684,10
13036,Olympiades,OUI,36,32,4,0,4,OUI,OUI,2025-03-13 10:01:20+00:00,"48.826764665199, 2.3650860786438",Paris,75056,0.1111111111111111,10
21207,Verdier - République,OUI,29,27,2,1,1,OUI,OUI,2025-03-13 09:58:29+00:00,"48.815403766277, 2.31739372015",Montrouge,92049,0.06896551724137931,10
17117,Pereire - Saussure,OUI,32,22,10,7,3,OUI,OUI,2025-03-13 09:55:48+00:00,"48.888229075478, 2.3101296275854",Paris,75056,0.3125,10
12122,Bois de Vincennes - Polygone,OUI,51,46,5,1,4,OUI,OUI,2025-03-13 09:58:43+00:00,"48.83544491617421, 2.431421081436563",Paris,75056,0.09803921568627451,10
18021,Marcadet - Ramey,OUI,21,19,2,0,2,OUI,OUI,2025-03-13 10:01:02+00:00,"48.890875, 2.3449019",Paris,75056,0.09523809523809523,10
21205,Arthur Auger - Jean Jaurès,OUI,23,15,8,7,1,OUI,OUI,2025-03-13 10:01:17+00:00,"48.813736445585235, 2.3069277405738835",Montrouge,92049,0.34782608695652173,10
16116,George Sand - Jean de La Fontaine,OUI,29,22,7,6,1,OUI,OUI,2025-03-13 09:57:18+00:00,"48.84986918764119, 2.268257387525699",Paris,75056,0.2413793103448276,10
6004,Regard - Rennes,OUI,46,29,17,8,9,OUI,OUI,2025-03-13 10:00:56+00:00,"48.847385404956, 2.3268555477262",Paris,75056,0.3695652173913043,10
20013,Alexandre Dumas - Place de la Réunion,OUI,45,43,2,1,1,OUI,OUI,2025-03-13 09:55:19+00:00,"48.85533710742046, 2.3997703687646292",Paris,75056,0.044444444444444446,10
11029,Ménilmontant - Oberkampf,OUI,39,30,9,2,7,OUI,OUI,2025-03-13 09:57:26+00:00,"48.866617658681, 2.3830134404158",Paris,75056,0.23076923076923078,10
5033,Saint-Séverin - Saint-Michel,OUI,30,11,19,15,4,OUI,OUI,2025-03-13 10:00:08+00:00,"48.852731305488, 2.3440927639604",Paris,75056,0.6333333333333333,10
11028,Guillaume Bertrand - République,OUI,38,35,3,1,2,OUI,OUI,2025-03-13 09:55:35+00:00,"48.863825174341, 2.380906377155",Paris,75056,0.07894736842105263,10
15027,Duhamel - André Gide,OUI,20,20,0,0,0,OUI,OUI,2025-03-13 09:52:54+00:00,"48.8365662244334, 2.312707121097412",Paris,75056,0.0,10
13055,M.- A. Lagroua Weill-Hallé -  F. Dolto,OUI,59,2,57,27,30,OUI,OUI,2025-03-13 09:59:16+00:00,"48.828595283857425, 2.380220606266108",Paris,75056,0.9661016949152542,10
17110,Legendre - Nollet,OUI,29,26,3,1,2,OUI,OUI,2025-03-13 09:58:57+00:00,"48.887742186754224, 2.320293079881375",Paris,75056,0.10344827586206896,10
22014,Victor Hugo - Bineau,OUI,24,10,14,5,9,OUI,OUI,2025-03-13 09:56:43+00:00,"48.88758225888669, 2.2783890366554265",Neuilly-sur-Seine,92051,0.5833333333333334,10
31701,Mairie de Bagnolet,OUI,28,27,1,0,1,OUI,OUI,2025-03-13 10:00:00+00:00,"48.868421318555, 2.4179587885737",Bagnolet,93006,0.03571428571428571,10
15044,Dantzig - Lefebvre,OUI,33,33,0,0,0,OUI,OUI,2025-03-13 09:56:15+00:00,"48.83013921586756, 2.295934036374092",Paris,75056,0.0,10
22404,Pierre Brossolette - 12 Février 1934,OUI,22,7,15,6,9,OUI,OUI,2025-03-13 09:58:44+00:00,"48.8176962416867, 2.3076123744249344",Malakoff,92046,0.6818181818181818,10
25002,Hôtel de Ville de Rueil-Malmaison,OUI,19,3,16,10,6,OUI,OUI,2025-03-13 10:00:15+00:00,"48.878194, 2.181724",Rueil-Malmaison,92063,0.8421052631578947,10
30004,Jean Jaurès - Place de la Libération,OUI,28,3,25,11,14,OUI,OUI,2025-03-13 10:01:21+00:00,"48.90617751921, 2.4391458057475",Bobigny,93008,0.8928571428571429,10
15113,Arsonval - Falguière,OUI,24,23,1,1,0,OUI,OUI,2025-03-13 09:55:56+00:00,"48.84040040365445, 2.313117867297474",Paris,75056,0.041666666666666664,10
20110,Gambetta - Tourelles,OUI,20,19,1,0,1,OUI,OUI,2025-03-13 09:52:04+00:00,"48.875337902264, 2.4059921130538",Paris,75056,0.05,10
16022,Jean Bologne - Passy,OUI,19,18,1,1,0,OUI,OUI,2025-03-13 10:00:12+00:00,"48.857566889784465, 2.280027395306772",Paris,75056,0.05263157894736842,10
14005,René Coty - Place Denfert-Rochereau,OUI,36,33,3,0,3,OUI,OUI,2025-03-13 10:01:00+00:00,"48.833056477316, 2.3329411447048",Paris,75056,0.08333333333333333,10
20011,Pyrénées - Dagorno,OUI,20,20,0,0,0,OUI,OUI,2025-03-13 10:00:01+00:00,"48.855425770695085, 2.4051643162965775",Paris,75056,0.0,10
21218,Gabriel Péri - Place de la Libération,OUI,17,14,3,0,3,OUI,OUI,2025-03-13 10:01:01+00:00,"48.819828421929, 2.3117361743705",Montrouge,92049,0.17647058823529413,10
19001,Crimée - Ourcq,OUI,56,52,4,1,3,OUI,OUI,2025-03-13 09:54:32+00:00,"48.894104140316, 2.3729460884673",Paris,75056,0.07142857142857142,10
17006,Guy Môquet - Compoint,OUI,35,33,2,2,0,OUI,OUI,2025-03-13 09:56:00+00:00,"48.89213559044868, 2.32321947813034",Paris,75056,0.05714285714285714,10
20106,Mairie du 20ème,OUI,27,25,2,0,2,OUI,OUI,2025-03-13 09:58:24+00:00,"48.865302324275, 2.3990669846535",Paris,75056,0.07407407407407407,10
11016,Philippe-Auguste,OUI,47,42,5,4,1,OUI,OUI,2025-03-13 09:57:55+00:00,"48.851853488265, 2.3932945355773",Paris,75056,0.10638297872340426,10
21007,Rond-Point Rhin et Danube,OUI,53,32,21,5,16,OUI,OUI,2025-03-13 09:56:50+00:00,"48.840452820991764, 2.2280225157737736",Boulogne-Billancourt,92012,0.39622641509433965,10
15120,Colonel Pierre Avia,OUI,29,10,19,15,4,OUI,OUI,2025-03-13 09:58:46+00:00,"48.8296843300915, 2.275342586850291",Paris,75056,0.6551724137931034,10
19007,Flandre - Ourcq,OUI,29,25,4,1,3,OUI,OUI,2025-03-13 09:59:57+00:00,"48.89260159189023, 2.3790915682911873",Paris,75056,0.13793103448275862,10
16033,Marché d'Auteuil,OUI,31,2,29,25,4,OUI,OUI,2025-03-13 10:00:27+00:00,"48.84842761367387, 2.265253821160005",Paris,75056,0.9354838709677419,10
21016,Point du Jour - Jean Jaurès,OUI,39,29,10,8,2,OUI,OUI,2025-03-13 10:00:58+00:00,"48.828753141436465, 2.245911467014621",Boulogne-Billancourt,92012,0.2564102564102564,10
16023,Passy - Place du Costa Rica,OUI,30,25,5,1,4,OUI,OUI,2025-03-13 10:00:23+00:00,"48.8584893, 2.2839655",Paris,75056,0.16666666666666666,10
11018,Saint-Maur - République,OUI,36,29,7,3,4,OUI,OUI,2025-03-13 10:00:46+00:00,"48.864185861455, 2.3783174157143",Paris,75056,0.19444444444444445,10
24007,Jean-Baptiste Charcot - Sainte-Geneviève,OUI,21,19,2,2,0,OUI,OUI,2025-03-13 10:00:17+00:00,"48.90310883721567, 2.278892956674099",Courbevoie,92026,0.09523809523809523,10
22007,Commandant Charcot - Bretteville,OUI,31,21,10,8,2,OUI,OUI,2025-03-13 09:57:15+00:00,"48.87530570765423, 2.2558460757136345",Neuilly-sur-Seine,92051,0.3225806451612903,10
15114,Pasteur - Cotentin,OUI,9,6,3,0,3,OUI,OUI,2025-03-13 09:59:55+00:00,"48.8389284, 2.316356",Paris,75056,0.3333333333333333,10
12039,Général Michel Bizot - Claude Decaen,OUI,36,33,3,1,2,OUI,OUI,2025-03-13 09:49:25+00:00,"48.83481262982544, 2.400927788127704",Paris,75056,0.08333333333333333,10
19014,Lorraine - Jean Jaurès,OUI,18,17,1,1,0,OUI,OUI,2025-03-13 09:58:08+00:00,"48.8863865, 2.3825772",Paris,75056,0.05555555555555555,10
13037,Ivry - Baudricourt,OUI,20,14,6,4,2,OUI,OUI,2025-03-13 09:59:37+00:00,"48.824695995415006, 2.363106073577468",Paris,75056,0.3,10
15014,Volontaires - Vaugirard,OUI,33,30,3,3,0,OUI,OUI,2025-03-13 09:58:11+00:00,"48.84132050184004, 2.30808901725357",Paris,75056,0.09090909090909091,10
5031,Lacépède - Linné,OUI,52,24,28,19,9,OUI,OUI,2025-03-13 09:58:07+00:00,"48.8437035476636, 2.354651279747486",Paris,75056,0.5384615384615384,10
21027,Fief - République,OUI,25,0,25,20,5,OUI,OUI,2025-03-13 10:01:24+00:00,"48.83170888166024, 2.255771979689598",Boulogne-Billancourt,92012,1.0,10
12017,Saint-Mandé - Docteur Arnold Netter,OUI,36,20,16,11,5,OUI,OUI,2025-03-13 10:00:16+00:00,"48.84462585769668, 2.404946386814118",Paris,75056,0.4444444444444444,10
6005,Montparnasse -  Square Ozanam,OUI,49,17,32,18,14,OUI,OUI,2025-03-13 10:01:13+00:00,"48.843310567822, 2.3265242949128",Paris,75056,0.6530612244897959,10
14025,Jacquier - Didot,OUI,30,30,0,0,0,OUI,OUI,2025-03-13 10:00:52+00:00,"48.82953336292279, 2.318179272115231",Paris,75056,0.0,10
6009,Guynemer - Jardin du Luxembourg,OUI,34,10,24,11,13,OUI,OUI,2025-03-13 10:01:09+00:00,"48.8466127, 2.3325478",Paris,75056,0.7058823529411765,10
13023,Bobillot - Moulin des Prés,OUI,28,27,1,0,1,OUI,OUI,2025-03-13 09:54:56+00:00,"48.828657346203, 2.353020646317",Paris,75056,0.03571428571428571,10
20033,Etienne Dolet - Place Maurice Chevalier,OUI,47,46,1,0,1,OUI,OUI,2025-03-13 09:51:11+00:00,"48.86798303359366, 2.3851405311143026",Paris,75056,0.02127659574468085,10
12040,Porte de Charenton,OUI,66,51,15,7,8,OUI,OUI,2025-03-13 09:57:53+00:00,"48.831240105856, 2.3989107459784",Paris,75056,0.22727272727272727,10
30005,Convention - Campus de Bobigny,OUI,29,10,19,5,14,OUI,OUI,2025-03-13 09:54:17+00:00,"48.914920058264, 2.4172238067445",Bobigny,93008,0.6551724137931034,10
6020,Place Saint-André des Arts,OUI,33,2,31,18,13,OUI,OUI,2025-03-13 09:59:56+00:00,"48.852886173881, 2.3426544293761",Paris,75056,0.9393939393939394,10
5105,Geoffroy-Saint-Hilaire - Saint-Marcel,OUI,17,8,9,8,1,OUI,OUI,2025-03-13 10:01:07+00:00,"48.83907826424974, 2.356877340669728",Paris,75056,0.5294117647058824,10
17050,Batignolles - Abel Truchet,OUI,26,23,3,2,1,OUI,OUI,2025-03-13 09:55:56+00:00,"48.883103904582, 2.3238347490884",Paris,75056,0.11538461538461539,10
19123,Metz - Marne,OUI,30,26,4,0,4,OUI,OUI,2025-03-13 09:55:25+00:00,"48.891163, 2.3865705",Paris,75056,0.13333333333333333,10
8044,Alfred de Vigny - Place du Général Brocard,OUI,32,10,22,8,14,OUI,OUI,2025-03-13 10:00:43+00:00,"48.87836138361425, 2.305254448220567",Paris,75056,0.6875,10
21107,Bertrand Sincholle - Henri Barbusse,OUI,18,3,15,12,3,OUI,OUI,2025-03-13 10:01:26+00:00,"48.89925982394349, 2.3042294383049016",Clichy,92024,0.8333333333333334,10
21510,Fontaine du Tertre - Calvaire,OUI,23,21,2,0,2,OUI,OUI,2025-03-13 09:52:41+00:00,"48.8702539, 2.2187778",Suresnes,92073,0.08695652173913043,10
42027,Verdun - Pierre et Marie Curie,OUI,26,25,1,0,1,OUI,OUI,2025-03-13 09:59:06+00:00,"48.812822398263286, 2.3707106709480286",Ivry-sur-Seine,94041,0.038461538461538464,10
17036,Place Tristan Bernard,OUI,28,23,5,1,4,OUI,OUI,2025-03-13 10:00:50+00:00,"48.8794936, 2.2915423",Paris,75056,0.17857142857142858,10
16104,Paul Valery - Victor Hugo,OUI,33,25,8,1,7,OUI,OUI,2025-03-13 09:58:27+00:00,"48.87137406080164, 2.2887128591537476",Paris,75056,0.24242424242424243,10
13008,Place d'Italie - Soeur Rosalie,OUI,52,39,13,3,10,OUI,OUI,2025-03-13 09:58:33+00:00,"48.831908520394, 2.3546943448098",Paris,75056,0.25,10
13013,Saint-Marcel - Hôpital,OUI,20,13,7,4,3,OUI,OUI,2025-03-13 10:01:03+00:00,"48.839504424583, 2.3609894170229",Paris,75056,0.35,10
22703,Place Jean Mermoz,OUI,27,23,4,1,3,OUI,OUI,2025-03-13 09:59:28+00:00,"48.9220937, 2.2718348",Bois-Colombes,92009,0.14814814814814814,10
1201,Perrault - Place du Louvre,OUI,27,3,24,14,10,OUI,OUI,2025-03-13 10:01:04+00:00,"48.860273568996, 2.3412468419093",Paris,75056,0.8888888888888888,10
20030,Ménilmontant - Père Lachaise,OUI,40,35,5,5,0,OUI,OUI,2025-03-13 10:00:06+00:00,"48.863287291502, 2.3869940266013",Paris,75056,0.125,10
51007,Résistance - Romain Rolland,OUI,28,25,3,0,3,OUI,OUI,2025-03-13 09:56:50+00:00,"48.950873482371, 2.2310190077797",Argenteuil,95018,0.10714285714285714,10
3201,Payenne - Square George Caïn,OUI,22,1,21,16,5,OUI,OUI,2025-03-13 10:00:48+00:00,"48.8578329, 2.3622643",Paris,75056,0.9545454545454546,10
11040,Temple - Jean-Pierre Timbaud,OUI,32,16,16,13,3,OUI,OUI,2025-03-13 10:01:11+00:00,"48.86446597201, 2.3660597205162",Paris,75056,0.5,10
21508,Georges Pompidou - Verdun,OUI,24,3,21,11,10,OUI,OUI,2025-03-13 10:01:17+00:00,"48.875481, 2.232443",Suresnes,92073,0.875,10
11038,Temple - Charlot,OUI,41,4,37,32,5,OUI,OUI,2025-03-13 09:59:57+00:00,"48.865709343796, 2.3652737250724",Paris,75056,0.9024390243902439,10
20037,Gambetta - Saint Fargeau,OUI,24,23,1,0,1,OUI,OUI,2025-03-13 09:55:39+00:00,"48.871244610447015, 2.4039056897163396",Paris,75056,0.041666666666666664,10
21511,Marcel Monge - Marcel Dassault,OUI,46,6,40,34,6,OUI,OUI,2025-03-13 10:00:57+00:00,"48.86096384533371, 2.2246733296048142",Suresnes,92073,0.8695652173913043,10
48011,Epi d'Or - Chevilly,OUI,20,13,7,0,7,OUI,OUI,2025-03-13 09:52:26+00:00,"48.781109786782, 2.3549050362061",Villejuif,94076,0.35,10
21033,Sèvres - Maréchal Juin,OUI,17,2,15,11,4,OUI,OUI,2025-03-13 10:00:20+00:00,"48.8324305, 2.2292812",Boulogne-Billancourt,92012,0.8823529411764706,10
21112,Claude Debussy - Marc Bloch,OUI,52,35,17,13,4,OUI,OUI,2025-03-13 10:00:36+00:00,"48.910388180512, 2.3117771744728",Clichy,92024,0.3269230769230769,10
41212,Nungesser - Santé,OUI,22,22,0,0,0,OUI,OUI,2025-03-13 09:52:45+00:00,"48.852335, 2.448967",Fontenay-sous-Bois,94033,0.0,10
8003,Galilée - Vernet,OUI,47,31,16,3,13,OUI,OUI,2025-03-13 10:00:36+00:00,"48.871715878697, 2.2985444962978",Paris,75056,0.3404255319148936,10
34009,Dora Maar - Nadia Guendouz,OUI,28,3,25,21,4,OUI,OUI,2025-03-13 10:00:38+00:00,"48.905452421305, 2.3220406472683",Saint-Ouen-sur-Seine,93070,0.8928571428571429,10
24010,Charles de Gaulle - Rue de l'Alma,OUI,27,4,23,6,17,OUI,OUI,2025-03-13 10:01:28+00:00,"48.896620592993, 2.252313240191",Courbevoie,92026,0.8518518518518519,10
7007,Musée d'Orsay,OUI,63,2,61,41,20,OUI,OUI,2025-03-13 09:59:59+00:00,"48.859726157909, 2.3258604481816",Paris,75056,0.9682539682539683,10
25009,Place des Arts - Jean Mermoz,OUI,20,7,13,12,1,OUI,OUI,2025-03-13 09:58:07+00:00,"48.880391139734, 2.1832160452221",Rueil-Malmaison,92063,0.65,10
22208,Stalingrad - Barbara,OUI,19,18,1,0,1,OUI,OUI,2025-03-13 10:00:56+00:00,"48.809223658808, 2.3175904558822",Bagneux,92007,0.05263157894736842,10
41101,Paul Doumer - Stalingrad,OUI,24,21,3,2,1,OUI,OUI,2025-03-13 09:54:56+00:00,"48.806518992199, 2.3368880152702",Arcueil,94003,0.125,10
22209,Verdun - Henri Barbusse,OUI,23,21,2,1,1,OUI,OUI,2025-03-13 09:57:28+00:00,"48.802056061754, 2.3159965061736",Bagneux,92007,0.08695652173913043,10
26010,Louis Armand - Bernard Palissy,OUI,16,8,8,6,2,OUI,OUI,2025-03-13 09:55:40+00:00,"48.916974, 2.313384",Asnières-sur-Seine,92004,0.5,10
45005,Stalingrad - Général de Gaulle,OUI,26,10,16,4,12,OUI,OUI,2025-03-13 10:00:46+00:00,"48.823450589614, 2.4965062363218",Champigny-sur-Marne,94017,0.6153846153846154,10
16140,Hippodrome de Longchamp,OUI,24,1,23,19,4,OUI,OUI,2025-03-13 10:01:28+00:00,"48.86413226532, 2.239905372262",Paris,75056,0.9583333333333334,10
18018,Carpeaux - Place Jacques Froment,OUI,17,16,1,0,1,OUI,OUI,2025-03-13 09:52:08+00:00,"48.8906542, 2.3309428",Paris,75056,0.058823529411764705,10
20035,Pyrénées - Ménilmontant,OUI,25,23,2,0,2,OUI,OUI,2025-03-13 10:00:10+00:00,"48.8693268535238, 2.395084574818611",Paris,75056,0.08,10
10025,Jemmapes - Ecluses Saint-Martin,OUI,12,7,5,4,1,OUI,OUI,2025-03-13 10:00:47+00:00,"48.87748519186726, 2.3660067468881607",Paris,75056,0.4166666666666667,10
23106,Pavé des Gardes - Charles Vaillant,OUI,20,13,7,7,0,OUI,OUI,2025-03-13 09:57:44+00:00,"48.81168551728, 2.2111820107205",Sèvres,92072,0.35,10
32305,Saint-Germain - Verdun,OUI,29,29,0,0,0,OUI,OUI,2025-03-13 09:58:22+00:00,"48.882877330093, 2.4331868384644",Romainville,93063,0.0,10
15032,Félix Faure - Lourmel,OUI,55,29,26,24,2,OUI,OUI,2025-03-13 10:00:58+00:00,"48.83868901709515, 2.2818081825971603",Paris,75056,0.4727272727272727,10
22305,Jean Jaurès - Place du Dr Roux,OUI,34,22,12,9,3,OUI,OUI,2025-03-13 09:58:46+00:00,"48.927567032796, 2.2947337017374",Gennevilliers,92036,0.35294117647058826,10
19045,Macdonald - Césaria Evora,OUI,66,40,26,8,18,OUI,OUI,2025-03-13 10:00:45+00:00,"48.89883, 2.37933",Paris,75056,0.3939393939393939,10
22507,Châteaudun - Place de la Liberté,OUI,25,23,2,2,0,OUI,OUI,2025-03-13 09:59:54+00:00,"48.90970830301211, 2.2454486480600626",La Garenne-Colombes,92035,0.08,10
22302,Gare RER - Général de Gaulle,OUI,38,19,19,13,6,OUI,OUI,2025-03-13 09:58:00+00:00,"48.933548439566, 2.3064726536317",Gennevilliers,92036,0.5,10
22602,Place Henri Dunant - Gare RER,OUI,30,28,2,1,1,OUI,OUI,2025-03-13 09:57:28+00:00,"48.788093281931, 2.2909234046643",Fontenay-aux-Roses,92032,0.06666666666666667,10
13053,Chevaleret - Tolbiac,OUI,21,1,20,13,7,OUI,OUI,2025-03-13 10:01:26+00:00,"48.82941, 2.375934",Paris,75056,0.9523809523809523,10
23205,Parc des Pierrettes,OUI,22,21,1,1,0,OUI,OUI,2025-03-13 09:56:58+00:00,"48.7973062, 2.2909969",Châtillon,92020,0.045454545454545456,10
9029,Saint-Lazare - Place d'Estienne d'Orves,OUI,39,7,32,17,15,OUI,OUI,2025-03-13 09:59:07+00:00,"48.8768345, 2.3329067",Paris,75056,0.8205128205128205,10
23201,Avenir,OUI,41,37,4,3,1,OUI,OUI,2025-03-13 10:00:34+00:00,"48.8103438, 2.3003776",Châtillon,92020,0.0975609756097561,10
41304,Port - Maurice Chevalier,OUI,30,4,26,23,3,OUI,OUI,2025-03-13 09:58:43+00:00,"48.832474421632, 2.490257616467",Nogent-sur-Marne,94052,0.8666666666666667,10
22018,Charles de Gaulle - Les Sablons,OUI,35,10,25,11,14,OUI,OUI,2025-03-13 09:58:53+00:00,"48.880987514929, 2.2715748726513",Neuilly-sur-Seine,92051,0.7142857142857143,10
10151,Gare du Nord - Faubourg Saint-Denis,OUI,28,27,1,0,1,OUI,OUI,2025-03-13 10:01:10+00:00,"48.879612765504, 2.3568402975798",Paris,75056,0.03571428571428571,10
21320,Président Roosevelt - Rouget de Lisle,OUI,40,0,40,23,17,OUI,OUI,2025-03-13 10:00:56+00:00,"48.83047518749, 2.2616135525345",Issy-les-Moulineaux,92040,1.0,10
8031,Jean Mermoz - Champs-Elysées,OUI,44,2,42,16,26,OUI,OUI,2025-03-13 10:00:12+00:00,"48.869689856852, 2.3107324540615",Paris,75056,0.9545454545454546,10
21327,Jean Bouin - Gouverneur Général Eboué,OUI,30,3,27,25,2,OUI,OUI,2025-03-13 09:59:05+00:00,"48.824792734266, 2.2651904328524",Issy-les-Moulineaux,92040,0.9,10
26011,Ménil - Argenteuil,OUI,18,14,4,2,2,OUI,OUI,2025-03-13 10:01:28+00:00,"48.925901818305, 2.2741496502338",Asnières-sur-Seine,92004,0.2222222222222222,10
23203,Division Leclerc - Kléber,OUI,25,17,8,3,5,OUI,OUI,2025-03-13 09:59:03+00:00,"48.798666226364, 2.2833752789972",Châtillon,92020,0.32,10
35021,Cartier Bresson - Denis Papin,OUI,31,21,10,3,7,OUI,OUI,2025-03-13 09:58:48+00:00,"48.902616, 2.397814",Pantin,93055,0.3225806451612903,10
17126,Hélène et François Missoffe - Emile Borel,OUI,28,7,21,18,3,OUI,OUI,2025-03-13 10:01:29+00:00,"48.89990653843488, 2.321543991674844",Paris,75056,0.75,10
18045,Pierre Ginier - Clichy,OUI,16,14,2,0,2,OUI,OUI,2025-03-13 10:00:09+00:00,"48.8867667, 2.326228",Paris,75056,0.125,10
17127,Porte de Clichy - Place des Nations Unies,OUI,37,3,34,33,1,OUI,OUI,2025-03-13 10:00:20+00:00,"48.896737263309504, 2.310542999196392",Paris,75056,0.918918918918919,10
14110,Abbé Carton - Plantes,OUI,25,23,2,1,1,OUI,OUI,2025-03-13 09:59:04+00:00,"48.827673823166, 2.3209181427956",Paris,75056,0.08,10
26008,Henri Barbusse - Bourguignons,OUI,32,24,8,3,5,OUI,OUI,2025-03-13 10:00:30+00:00,"48.91301722799713, 2.2734212270774417",Asnières-sur-Seine,92004,0.25,10
21954,Val-Fleury,OUI,23,18,5,4,1,OUI,OUI,2025-03-13 09:56:55+00:00,"48.807671407991, 2.2407217696309",Meudon,92048,0.21739130434782608,10
23204,Roland Garros - Jean Bouin,OUI,27,24,3,2,1,OUI,OUI,2025-03-13 10:00:44+00:00,"48.809460857173, 2.2853198638301",Châtillon,92020,0.1111111111111111,10
11201,Faubourg St-Antoine - Place de la Nation,OUI,16,10,6,1,5,OUI,OUI,2025-03-13 09:59:36+00:00,"48.8487726, 2.393606",Paris,75056,0.375,10
21514,Place de la Paix - Abbé Saint-Pierre,OUI,24,21,3,3,0,OUI,OUI,2025-03-13 09:56:27+00:00,"48.86462724459225, 2.2047570338469806",Suresnes,92073,0.125,10
12106,Gare de Lyon - Roland Barthes,OUI,68,2,66,62,4,OUI,OUI,2025-03-13 10:00:13+00:00,"48.84395729494058, 2.3790882155299187",Paris,75056,0.9705882352941176,10
31303,Simone Signoret - Paris,OUI,26,18,8,4,4,OUI,OUI,2025-03-13 09:56:38+00:00,"48.903600624712865, 2.465406596265139",Noisy-le-Sec,93053,0.3076923076923077,10
32023,Guy Môquet - Jean Moulin,OUI,27,4,23,12,11,OUI,OUI,2025-03-13 09:55:09+00:00,"48.940931521020836, 2.363948999931771",Saint-Denis,93066,0.8518518518518519,10
16006,Lauriston - Copernic,OUI,19,11,8,0,8,OUI,OUI,2025-03-13 10:00:53+00:00,"48.86926, 2.289918",Paris,75056,0.42105263157894735,10
25010,Maréchal Leclerc de Hauteclocque - Marché Buzenval,OUI,30,23,7,4,3,OUI,OUI,2025-03-13 09:57:09+00:00,"48.858446, 2.192077",Rueil-Malmaison,92063,0.23333333333333334,10
8008,Joseph Sansboeuf - Saint Lazare,OUI,31,22,9,4,5,OUI,OUI,2025-03-13 10:00:32+00:00,"48.875315630653, 2.3229019716382",Paris,75056,0.2903225806451613,10
12165,Champs de Manoeuvre - Cartoucherie,OUI,32,12,20,12,8,OUI,OUI,2025-03-13 09:58:56+00:00,"48.835261, 2.447974",Paris,75056,0.625,10
31201,Suzanne Masson,OUI,33,2,31,13,18,OUI,OUI,2025-03-13 09:58:41+00:00,"48.923306888013, 2.3847292397611",La Courneuve,93027,0.9393939393939394,10
12001,Bastille - Biscornet,OUI,59,4,55,42,13,OUI,OUI,2025-03-13 10:00:46+00:00,"48.851355779579, 2.369220033288",Paris,75056,0.9322033898305084,10
15013,Volontaires - Lecourbe,OUI,29,23,6,3,3,OUI,OUI,2025-03-13 09:57:06+00:00,"48.84351378799, 2.3065522313118",Paris,75056,0.20689655172413793,10
11001,Richard Lenoir - Place de la Bastille,OUI,46,10,36,25,11,OUI,OUI,2025-03-13 10:00:02+00:00,"48.8538327, 2.3697222",Paris,75056,0.782608695652174,10
13035,Choisy - Tolbiac,OUI,20,19,1,0,1,OUI,OUI,2025-03-13 10:01:01+00:00,"48.82591155587, 2.3602393269539",Paris,75056,0.05,10
9035,Gare Saint-Lazare - Place de Budapest,OUI,43,24,19,5,14,OUI,OUI,2025-03-13 10:00:44+00:00,"48.877753, 2.327339",Paris,75056,0.4418604651162791,10
19018,Cité de la Musique,OUI,51,30,21,13,8,OUI,OUI,2025-03-13 09:59:31+00:00,"48.888796556487, 2.3925811931922",Paris,75056,0.4117647058823529,10
10114,Granges aux Belles - Hôpital Saint-Louis,OUI,59,53,6,4,2,OUI,OUI,2025-03-13 09:59:29+00:00,"48.874794994841, 2.366669436985",Paris,75056,0.1016949152542373,10
34005,Adrien Lesesne - Docteur Bauer,OUI,29,28,1,1,0,OUI,OUI,2025-03-13 09:57:28+00:00,"48.90263867304635, 2.348248063431511",Saint-Ouen-sur-Seine,93070,0.034482758620689655,10
18134,Ney - Porte de Clignancourt,OUI,24,22,2,1,1,OUI,OUI,2025-03-13 09:54:08+00:00,"48.8978867, 2.3458001",Paris,75056,0.08333333333333333,10
26009,Marceau Delorme - Pierre Brossolette,OUI,26,21,5,1,4,OUI,OUI,2025-03-13 09:54:58+00:00,"48.91206062860357, 2.295897423568745",Asnières-sur-Seine,92004,0.19230769230769232,10
13203,Square de Choisy - Eastman,OUI,23,20,3,1,2,OUI,OUI,2025-03-13 10:01:27+00:00,"48.828543456283, 2.3583075090494",Paris,75056,0.13043478260869565,10
34008,Garibaldi - Gabriel Péri,OUI,29,22,7,3,4,OUI,OUI,2025-03-13 09:58:57+00:00,"48.905741911394, 2.3316044208059",Saint-Ouen-sur-Seine,93070,0.2413793103448276,10
47007,Liberté - Vert-de-Maisons,OUI,20,2,18,14,4,OUI,OUI,2025-03-13 09:58:42+00:00,"48.790147809608, 2.4328628182411",Maisons-Alfort,94046,0.9,10
34012,Bateliers - Quai de Seine,OUI,21,10,11,7,4,OUI,OUI,2025-03-13 09:55:53+00:00,"48.915817585516, 2.3239533298594",Saint-Ouen-sur-Seine,93070,0.5238095238095238,10
13051,Halle Freyssinet - Parvis Alan Turing,OUI,23,4,19,9,10,OUI,OUI,2025-03-13 09:58:07+00:00,"48.832846814471, 2.3711421713233",Paris,75056,0.8260869565217391,10
31301,Gare RER,OUI,25,17,8,2,6,OUI,OUI,2025-03-13 09:58:28+00:00,"48.896280181078, 2.4581568985227",Noisy-le-Sec,93053,0.32,10
8038,François 1er - Montaigne,OUI,51,13,38,20,18,OUI,OUI,2025-03-13 09:59:44+00:00,"48.866887649978, 2.3066755757207",Paris,75056,0.7450980392156863,10
5107,Pontoise - La Tournelle,OUI,22,5,17,13,4,OUI,OUI,2025-03-13 09:59:23+00:00,"48.850458009188, 2.3524542754922",Paris,75056,0.7727272727272727,10
21501,Pont de Suresnes,OUI,16,11,5,2,3,OUI,OUI,2025-03-13 09:55:12+00:00,"48.867415092322, 2.2258946679617",Suresnes,92073,0.3125,10
10026,Gare de l'Est - Chateau Landon,OUI,54,51,3,1,2,OUI,OUI,2025-03-13 09:54:46+00:00,"48.879305, 2.362424",Paris,75056,0.05555555555555555,10
19204,Rampal - Belleville,OUI,19,19,0,0,0,OUI,OUI,2025-03-13 09:59:23+00:00,"48.873114661405, 2.3798409114805",Paris,75056,0.0,10
17010,Jonquière - Docteur Paul Brousse,OUI,38,34,4,3,1,OUI,OUI,2025-03-13 10:00:13+00:00,"48.894799816683985, 2.318705212173216",Paris,75056,0.10526315789473684,10
18042,Place Pigalle,OUI,20,19,1,1,0,OUI,OUI,2025-03-13 10:00:14+00:00,"48.8827555, 2.3361566",Paris,75056,0.05,10
18023,Ordener - Poissonniers,OUI,34,33,1,0,1,OUI,OUI,2025-03-13 09:56:00+00:00,"48.891213890844654, 2.351288666219873",Paris,75056,0.029411764705882353,10
18041,Rochechouart - Martyrs,OUI,17,13,4,2,2,OUI,OUI,2025-03-13 09:59:04+00:00,"48.882193779572, 2.3405495658517",Paris,75056,0.23529411764705882,10
18026,Ruisseau - Ordener,OUI,33,32,1,0,1,OUI,OUI,2025-03-13 10:01:00+00:00,"48.89299462568024, 2.340144887566567",Paris,75056,0.030303030303030304,10
11014,Place de la Nation - Taillebourg,OUI,46,30,16,11,5,OUI,OUI,2025-03-13 10:01:23+00:00,"48.8488408, 2.3973043",Paris,75056,0.34782608695652173,10
18024,Clignancourt - Ordener,OUI,35,33,2,0,2,OUI,OUI,2025-03-13 09:58:54+00:00,"48.891457726153774, 2.348636478060487",Paris,75056,0.05714285714285714,10
11102,Alexandre Dumas - Voltaire,OUI,58,57,1,1,0,OUI,OUI,2025-03-13 10:00:51+00:00,"48.852888670365, 2.3891476408096",Paris,75056,0.017241379310344827,10
13205,Choisy - Pointe d'Ivry,OUI,24,20,4,2,2,OUI,OUI,2025-03-13 09:58:54+00:00,"48.822154170359, 2.3633708034878",Paris,75056,0.16666666666666666,10
16103,Traktir - Foch,OUI,20,9,11,2,9,OUI,OUI,2025-03-13 10:00:37+00:00,"48.872755334614, 2.2915497802487",Paris,75056,0.55,10
31202,Gabriel Péri - Jules Ferry,OUI,27,7,20,14,6,OUI,OUI,2025-03-13 10:00:53+00:00,"48.926182814311, 2.3912295762525",La Courneuve,93027,0.7407407407407407,10
35001,Jean Jaurès - Ouvrières Pivéreuses,OUI,21,20,1,0,1,OUI,OUI,2025-03-13 09:57:46+00:00,"48.910423437526, 2.3995766043663",Pantin,93055,0.047619047619047616,10
7201,Place De Fontenoy - Saxe,OUI,18,0,18,13,5,OUI,OUI,2025-03-13 09:57:36+00:00,"48.850270554523, 2.3069813815839",Paris,75056,1.0,10
15105,Fédération - Suffren,OUI,24,14,10,10,0,OUI,OUI,2025-03-13 10:00:16+00:00,"48.852828153442, 2.2978776320815",Paris,75056,0.4166666666666667,10
8057,Hoche - Tilsitt,OUI,31,22,9,3,6,OUI,OUI,2025-03-13 09:59:42+00:00,"48.874836457837, 2.2971323132515",Paris,75056,0.2903225806451613,10
13204,Tolbiac - Boussingault,OUI,41,38,3,1,2,OUI,OUI,2025-03-13 09:58:43+00:00,"48.826177754027, 2.3420378552202",Paris,75056,0.07317073170731707,10
9025,Taitbout - Châteaudun,OUI,53,1,52,40,12,OUI,OUI,2025-03-13 10:01:10+00:00,"48.876383969379, 2.3353566779335",Paris,75056,0.9811320754716981,10
15062,Convention - Lourmel,OUI,35,16,19,19,0,OUI,OUI,2025-03-13 09:57:53+00:00,"48.842055041656, 2.2859910875559",Paris,75056,0.5428571428571428,10
40007,Préfecture de Créteil,OUI,27,4,23,14,9,OUI,OUI,2025-03-13 10:00:47+00:00,"48.783680285918, 2.4544713672215",Créteil,94028,0.8518518518518519,10
13202,Place Farhat Hached,OUI,28,2,26,10,16,OUI,OUI,2025-03-13 10:00:27+00:00,"48.825487045602, 2.3816306985827",Paris,75056,0.9285714285714286,10
12107,Diderot - Pierre Bourdan,OUI,21,1,20,9,11,OUI,OUI,2025-03-13 09:59:48+00:00,"48.847648620797, 2.3902582749724",Paris,75056,0.9523809523809523,10
5201,Saint-Jacques - Soufflot,OUI,16,0,16,3,13,OUI,OUI,2025-03-13 10:00:48+00:00,"48.846280383395, 2.3430785379567",Paris,75056,1.0,10
12105,Bercy - Villot,OUI,38,1,37,24,13,OUI,OUI,2025-03-13 10:00:22+00:00,"48.841795009027, 2.3767850184816",Paris,75056,0.9736842105263158,10
11037,Faubourg Du Temple - Republique,OUI,38,4,34,32,2,OUI,OUI,2025-03-13 10:01:16+00:00,"48.867872484749, 2.3648982158072",Paris,75056,0.8947368421052632,10
26005,Hôtel de Ville d'Asnières sur Seine,OUI,26,20,6,3,3,OUI,OUI,2025-03-13 10:00:40+00:00,"48.90999330025577, 2.288238108158112",Asnières-sur-Seine,92004,0.23076923076923078,10
35002,Jean Jaurès - Presles,OUI,31,27,4,3,1,OUI,OUI,2025-03-13 09:59:48+00:00,"48.907134414988, 2.3960057280531",Pantin,93055,0.12903225806451613,10
40003,Centre Hospitalier Intercommunal de Créteil,OUI,17,17,0,0,0,OUI,OUI,2025-03-13 09:58:41+00:00,"48.797078298909, 2.463801423807",Créteil,94028,0.0,10
11020,Belfort - Voltaire,OUI,39,27,12,9,3,OUI,OUI,2025-03-13 10:01:16+00:00,"48.8563358, 2.3829901",Paris,75056,0.3076923076923077,10
51005,Yves Farges - Route d'Enghien,OUI,33,16,17,6,11,OUI,OUI,2025-03-13 10:00:24+00:00,"48.95756799268, 2.2834496977978",Argenteuil,95018,0.5151515151515151,10
8039,Colisée - Champs-Elysées,OUI,15,1,14,3,11,OUI,OUI,2025-03-13 09:57:58+00:00,"48.870475399387, 2.3076190799475",Paris,75056,0.9333333333333333,10
18044,Clichy - Douai,OUI,32,26,6,0,6,OUI,OUI,2025-03-13 10:01:13+00:00,"48.883687771522, 2.328063700029",Paris,75056,0.1875,10
35014,Charles de Gaulle - Jean Lolive,OUI,26,21,5,1,4,OUI,OUI,2025-03-13 09:59:56+00:00,"48.8932644350857, 2.4126765131950383",Pantin,93055,0.19230769230769232,10
12157,Fabre d'Eglantine - Place de la Nation,OUI,66,57,9,0,9,OUI,OUI,2025-03-13 10:00:00+00:00,"48.8471116, 2.3956204",Paris,75056,0.13636363636363635,10
15103,Cauchy - Cévennes,OUI,50,7,43,43,0,OUI,OUI,2025-03-13 09:59:28+00:00,"48.843372571022, 2.2751328349113",Paris,75056,0.86,10
21213,Vanne - Général de Gaulle,OUI,25,23,2,0,2,OUI,OUI,2025-03-13 10:00:18+00:00,"48.815007, 2.328318",Montrouge,92049,0.08,10
15026,Bir Hakeim,OUI,32,5,27,23,4,OUI,OUI,2025-03-13 10:01:24+00:00,"48.853844054334, 2.289705348222",Paris,75056,0.84375,10
3004,Place de la République - Temple,OUI,16,2,14,11,3,OUI,OUI,2025-03-13 10:01:08+00:00,"48.867211201859, 2.3635464370545",Paris,75056,0.875,10
41301,Bois de Vincennes - Gare,OUI,50,45,5,5,0,OUI,OUI,2025-03-13 09:57:50+00:00,"48.836022242887, 2.470833995083",Nogent-sur-Marne,94052,0.1,10
11046,Place de la République - Voltaire,OUI,16,2,14,14,0,OUI,OUI,2025-03-13 10:01:18+00:00,"48.866830968942, 2.3654810339212",Paris,75056,0.875,10
19203,Pailleron - Bouret,OUI,27,24,3,1,2,OUI,OUI,2025-03-13 09:58:51+00:00,"48.880516995482, 2.3763902374411",Paris,75056,0.1111111111111111,10
11009,Boulets - Voltaire,OUI,24,16,8,6,2,OUI,OUI,2025-03-13 10:00:32+00:00,"48.85218705621, 2.3890301585197",Paris,75056,0.3333333333333333,10
1003,Saint-Denis - Rivoli,OUI,42,12,30,21,9,OUI,OUI,2025-03-13 10:01:25+00:00,"48.859059340842, 2.3476943001151",Paris,75056,0.7142857142857143,10
15060,Place de la Montagne du Goulet,OUI,20,2,18,12,6,OUI,OUI,2025-03-13 09:58:59+00:00,"48.8443415, 2.2773844",Paris,75056,0.9,10
32012,Carrefour Pleyel,OUI,65,22,43,14,29,OUI,OUI,2025-03-13 09:59:09+00:00,"48.92034156960326, 2.3438543826341625",Saint-Denis,93066,0.6615384615384615,10
11011,Richard Lenoir - Voltaire,OUI,25,13,12,9,3,OUI,OUI,2025-03-13 09:58:47+00:00,"48.86164273878, 2.3727491497993",Paris,75056,0.48,10
34014,Michelet - Dr Bauer,OUI,29,26,3,0,3,OUI,OUI,2025-03-13 09:51:38+00:00,"48.906125424194, 2.3440374449846",Saint-Ouen-sur-Seine,93070,0.10344827586206896,10
7111,Ecole Militaire - Place Joffre,OUI,25,15,10,7,3,OUI,OUI,2025-03-13 10:00:32+00:00,"48.852060203583, 2.3017993569374",Paris,75056,0.4,10
27004,Gare de la Garenne-Colombes,OUI,27,18,9,6,3,OUI,OUI,2025-03-13 09:58:59+00:00,"48.909752, 2.239145",Colombes,92025,0.3333333333333333,10
11012,Montreuil - Voltaire,OUI,33,30,3,1,2,OUI,OUI,2025-03-13 09:51:55+00:00,"48.850507011842, 2.3930755582745",Paris,75056,0.09090909090909091,10
4104,Sebastopol - Rambuteau,OUI,15,1,14,10,4,OUI,OUI,2025-03-13 10:01:16+00:00,"48.86181809267, 2.3501381278038",Paris,75056,0.9333333333333333,10
18205,Mauroy - Cheminots,OUI,30,26,4,1,3,OUI,OUI,2025-03-13 10:00:46+00:00,"48.897715198403, 2.357895075822",Paris,75056,0.13333333333333333,10
13123,BNF - Bibliothèque Nationale de France,OUI,44,5,39,26,13,OUI,OUI,2025-03-13 10:01:16+00:00,"48.8350268238, 2.3760157451034",Paris,75056,0.8863636363636364,10
7023,Bourdonnais - Tour Eiffel,OUI,58,16,42,30,12,OUI,OUI,2025-03-13 10:01:20+00:00,"48.860897797941, 2.295599598447",Paris,75056,0.7241379310344828,10
32001,Proudhon - Président Wilson,OUI,30,11,19,9,10,OUI,OUI,2025-03-13 10:01:14+00:00,"48.906442763495, 2.3584905266762",Saint-Denis,93066,0.6333333333333333,10
7109,Place Joffre - Frédéric le Play,OUI,37,26,11,8,3,OUI,OUI,2025-03-13 09:57:36+00:00,"48.853754486938, 2.3044242337346",Paris,75056,0.2972972972972973,10
40002,Bleuets - Bordières,OUI,21,17,4,2,2,OUI,OUI,2025-03-13 10:00:34+00:00,"48.802117531472, 2.4543687905029",Créteil,94028,0.19047619047619047,10
7025,Octave Gréard - Tour Eiffel,OUI,32,3,29,21,8,OUI,OUI,2025-03-13 10:01:27+00:00,"48.856502977696, 2.2931787543289",Paris,75056,0.90625,10
33019,Madeleine Vionnet,OUI,49,0,49,15,34,OUI,OUI,2025-03-13 10:00:50+00:00,"48.902519074064, 2.3740895837545",Aubervilliers,93001,1.0,10
4108,Quai de Béthune - Pont de la Tournelle,OUI,25,9,16,15,1,OUI,OUI,2025-03-13 09:59:39+00:00,"48.85097433194, 2.3563072085381",Paris,75056,0.64,10
8002,Gare Saint-Lazare - Cour du Havre,OUI,42,32,10,4,6,OUI,OUI,2025-03-13 10:00:57+00:00,"48.875674400851, 2.3265598341823",Paris,75056,0.23809523809523808,10
40010,Haut du Mont-Mesly,OUI,21,14,7,3,4,OUI,OUI,2025-03-13 09:54:21+00:00,"48.780191921646, 2.4685737495183",Créteil,94028,0.3333333333333333,10
21302,Aristide Briand - Place de la Résistance,OUI,40,2,38,33,5,OUI,OUI,2025-03-13 09:59:54+00:00,"48.82124248401006, 2.2511002421379094",Issy-les-Moulineaux,92040,0.95,10
40012,Stade de la Habette,OUI,16,16,0,0,0,OUI,OUI,2025-03-13 10:00:46+00:00,"48.774397033806, 2.4668785263921",Créteil,94028,0.0,10
12127,Tremblay - Lac des Minimes,OUI,52,8,44,15,29,OUI,OUI,2025-03-13 10:00:48+00:00,"48.834131261494, 2.4547516554594",Paris,75056,0.8461538461538461,10
40013,Hôtel de Ville de Créteil,OUI,36,17,19,13,6,OUI,OUI,2025-03-13 09:59:54+00:00,"48.77699496201, 2.4552552404284",Créteil,94028,0.5277777777777778,10
8004,Malesherbes - Place de la Madeleine,OUI,78,10,68,24,44,OUI,OUI,2025-03-13 10:00:17+00:00,"48.870406028483, 2.323243509808",Paris,75056,0.8717948717948718,10
40014,Créteil Pointe du Lac,OUI,28,2,26,9,17,OUI,OUI,2025-03-13 09:59:42+00:00,"48.769807356177, 2.4623027310281",Créteil,94028,0.9285714285714286,10
23011,Bineau - Louise Michel,OUI,26,21,5,3,2,OUI,OUI,2025-03-13 09:57:04+00:00,"48.88666162207, 2.2843274474144",Levallois-Perret,92044,0.19230769230769232,10
16005,Raymond Poincaré - Place Victor Hugo,OUI,22,19,3,0,3,OUI,OUI,2025-03-13 09:59:10+00:00,"48.87030612437, 2.2850745414202",Paris,75056,0.13636363636363635,10
12201,Dugommier,OUI,53,50,3,0,3,OUI,OUI,2025-03-13 09:57:53+00:00,"48.838811048815, 2.3896577954292",Paris,75056,0.05660377358490566,10
23801,Place de la Gare,OUI,20,17,3,1,2,OUI,OUI,2025-03-13 09:53:24+00:00,"48.838513582184, 2.1866139007512",Garches,92033,0.15,10
40004,Créteil Village,OUI,25,4,21,7,14,OUI,OUI,2025-03-13 10:01:01+00:00,"48.79122395576, 2.4642198533952",Créteil,94028,0.84,10
23703,Gare de Chaville Rive Gauche,OUI,18,17,1,1,0,OUI,OUI,2025-03-13 09:57:20+00:00,"48.805160304345, 2.188277207315",Chaville,92022,0.05555555555555555,10
40008,Créteil Pompadour,OUI,44,15,29,12,17,OUI,OUI,2025-03-13 10:00:47+00:00,"48.773011623355, 2.435166164893",Créteil,94028,0.6590909090909091,10
14021,Place de la Porte de Châtillon,OUI,59,57,2,0,2,OUI,OUI,2025-03-13 09:57:55+00:00,"48.8242469, 2.3186306",Paris,75056,0.03389830508474576,10
13106,Bobillot - Paulin Mery,OUI,21,17,4,1,3,OUI,OUI,2025-03-13 10:00:50+00:00,"48.829899841747, 2.3543356766749",Paris,75056,0.19047619047619047,10
40015,Iles de Loisirs de Créteil,OUI,24,4,20,10,10,OUI,OUI,2025-03-13 10:01:25+00:00,"48.780258200618, 2.4455094301232",Créteil,94028,0.8333333333333334,10
10031,Louis Blanc - Aqueduc,OUI,36,34,2,1,1,OUI,OUI,2025-03-13 09:58:30+00:00,"48.882030182599, 2.363561578095",Paris,75056,0.05555555555555555,10
32004,Wilson - Landy,OUI,38,18,20,14,6,OUI,OUI,2025-03-13 10:01:21+00:00,"48.91516726221354, 2.357633225619793",Saint-Denis,93066,0.5263157894736842,10
20137,Borrégo - Gambetta,OUI,25,25,0,0,0,OUI,OUI,2025-03-13 09:54:01+00:00,"48.87330497045532, 2.4014145880937576",Paris,75056,0.0,10
31708,Noisy le Sec - Jean-Baptiste Clément,OUI,19,18,1,0,1,OUI,OUI,2025-03-13 10:00:45+00:00,"48.874515389637, 2.4152836203575",Bagnolet,93006,0.05263157894736842,10
10013,Alibert - Jemmapes,OUI,57,48,9,4,5,OUI,OUI,2025-03-13 09:58:54+00:00,"48.871044051984, 2.3661044619878",Paris,75056,0.15789473684210525,10
1022,Danielle Casanova - Place Vendôme,OUI,37,0,37,19,18,OUI,OUI,2025-03-13 09:58:52+00:00,"48.868266498223, 2.3304839059711",Paris,75056,1.0,10
18043,Clichy - Place Blanche,OUI,18,15,3,2,1,OUI,OUI,2025-03-13 10:00:30+00:00,"48.883601088297, 2.3332237824798",Paris,75056,0.16666666666666666,10
21404,Jean Jaurès - Gare de Clamart,OUI,20,18,2,1,1,OUI,OUI,2025-03-13 09:52:48+00:00,"48.81321981219, 2.2716768079163",Clamart,92023,0.1,10
17123,Mstislav Rostropovitch - Berthier,OUI,18,15,3,2,1,OUI,OUI,2025-03-13 09:55:58+00:00,"48.892120821173975, 2.309234105050564",Paris,75056,0.16666666666666666,10
6001,Institut de France,OUI,17,1,16,12,4,OUI,OUI,2025-03-13 09:59:48+00:00,"48.857615678565, 2.3358313530377",Paris,75056,0.9411764705882353,10
1002,Victoria - Place du Chatelet,OUI,19,2,17,7,10,OUI,OUI,2025-03-13 09:59:12+00:00,"48.857992591527, 2.3469167947769",Paris,75056,0.8947368421052632,10
17038,Grande Armée - Brunel,OUI,60,32,28,14,14,OUI,OUI,2025-03-13 09:59:20+00:00,"48.876116, 2.288124",Paris,75056,0.4666666666666667,10
8052,Balzac - Champs Elysées,OUI,30,20,10,4,6,OUI,OUI,2025-03-13 10:00:37+00:00,"48.872699639621, 2.3001953959465",Paris,75056,0.3333333333333333,10
12010,Daumesnil - Picpus,OUI,19,13,6,3,3,OUI,OUI,2025-03-13 09:56:51+00:00,"48.8374688, 2.401765",Paris,75056,0.3157894736842105,10
21021,Enfants du Paradis - Peupliers,OUI,59,1,58,24,34,OUI,OUI,2025-03-13 10:01:17+00:00,"48.833122686454, 2.2571459412575",Boulogne-Billancourt,92012,0.9830508474576272,10
15056,Place Balard,OUI,28,3,25,23,2,OUI,OUI,2025-03-13 09:59:59+00:00,"48.836395736424, 2.2784192115068",Paris,75056,0.8928571428571429,10
9104,Caumartin - Provence,OUI,22,2,20,15,5,OUI,OUI,2025-03-13 09:59:58+00:00,"48.874422773426545, 2.3284685611724854",Paris,75056,0.9090909090909091,10
16107,Benjamin Godard - Victor Hugo,OUI,32,31,1,0,1,OUI,OUI,2025-03-13 11:00:24+00:00,"48.865983, 2.275725",Paris,75056,0.03125,11
44015,Rouget de L'isle - Watteau,OUI,20,10,10,0,10,OUI,OUI,2025-03-13 11:01:43+00:00,"48.778192750803, 2.3963020229163",Vitry-sur-Seine,94081,0.5,11
40001,Hôpital Mondor,OUI,28,10,18,9,9,OUI,OUI,2025-03-13 10:58:27+00:00,"48.798922410229, 2.4537451531298",Créteil,94028,0.6428571428571429,11
14111,Cassini - Denfert-Rochereau,OUI,23,19,4,0,4,OUI,OUI,2025-03-13 11:00:31+00:00,"48.837525839067, 2.3360354080796",Paris,75056,0.17391304347826086,11
9020,Toudouze - Clauzel,OUI,21,17,4,2,2,OUI,OUI,2025-03-13 10:59:04+00:00,"48.87929591733507, 2.3373600840568547",Paris,75056,0.19047619047619047,11
14014,Jourdan - Stade Charléty,OUI,58,50,8,2,6,OUI,OUI,2025-03-13 10:59:59+00:00,"48.819428333369, 2.3433353751898",Paris,75056,0.13793103448275862,11
13007,Le Brun - Gobelins,OUI,47,35,12,10,2,OUI,OUI,2025-03-13 10:58:41+00:00,"48.835092787824, 2.3534681351338",Paris,75056,0.2553191489361702,11
32017,Basilique,OUI,20,13,7,1,6,OUI,OUI,2025-03-13 11:00:08+00:00,"48.93626891059109, 2.3588666820200914",Saint-Denis,93066,0.35,11
6003,Saint-Sulpice,OUI,21,11,10,5,5,OUI,OUI,2025-03-13 11:01:11+00:00,"48.85165383178419, 2.3308077827095985",Paris,75056,0.47619047619047616,11
11104,Charonne - Robert et Sonia Delaunay,OUI,20,19,1,1,0,OUI,OUI,2025-03-13 10:57:40+00:00,"48.855907555969, 2.3925706744194",Paris,75056,0.05,11
7002,Vaneau - Sèvres,OUI,35,12,23,18,5,OUI,OUI,2025-03-13 11:00:55+00:00,"48.848563233059, 2.3204218259346",Paris,75056,0.6571428571428571,11
8026,Messine - Place Du Pérou,OUI,12,0,12,6,6,OUI,OUI,2025-03-13 10:56:30+00:00,"48.875448033960744, 2.315508019010038",Paris,75056,1.0,11
42016,Pierre et Marie Curie - Maurice Thorez,OUI,26,22,4,2,2,OUI,OUI,2025-03-13 10:57:13+00:00,"48.81580226360801, 2.376804985105991",Ivry-sur-Seine,94041,0.15384615384615385,11
5110,Lacépède - Monge,OUI,23,17,6,2,4,OUI,OUI,2025-03-13 10:59:33+00:00,"48.84389286531899, 2.3519663885235786",Paris,75056,0.2608695652173913,11
25006,Place Nelson Mandela,OUI,22,20,2,2,0,OUI,OUI,2025-03-13 10:59:52+00:00,"48.862453313908, 2.1961666225454",Rueil-Malmaison,92063,0.09090909090909091,11
6108,Saint-Romain - Cherche-Midi,OUI,16,11,5,2,3,OUI,OUI,2025-03-13 11:01:33+00:00,"48.84708159081946, 2.321374788880348",Paris,75056,0.3125,11
30002,Jean Rostand - Paul Vaillant Couturier,OUI,39,25,14,7,7,OUI,OUI,2025-03-13 11:01:41+00:00,"48.908168131015, 2.4530601033354",Bobigny,93008,0.358974358974359,11
33006,André Karman - République,OUI,30,21,9,4,5,OUI,OUI,2025-03-13 10:56:06+00:00,"48.91039875761846, 2.3851355910301213",Aubervilliers,93001,0.3,11
32304,Charcot - Benfleet,OUI,28,27,1,0,1,NON,NON,2025-03-13 10:52:18+00:00,"48.878370277021, 2.440523876268",Romainville,93063,0.03571428571428571,11
40011,Bas du Mont-Mesly,OUI,26,18,8,5,3,OUI,OUI,2025-03-13 11:01:31+00:00,"48.779035118572, 2.4609763908985",Créteil,94028,0.3076923076923077,11
5016,Thouin - Cardinal Lemoine,OUI,16,1,15,1,14,OUI,OUI,2025-03-13 11:01:12+00:00,"48.84504716661511, 2.3494647851273465",Paris,75056,0.9375,11
21010,Silly - Galliéni,OUI,25,16,9,5,4,OUI,OUI,2025-03-13 10:55:14+00:00,"48.835583838706, 2.2325500845909",Boulogne-Billancourt,92012,0.36,11
15202,Bracion - Périphérique,OUI,30,27,3,1,2,OUI,OUI,2025-03-13 10:52:30+00:00,"48.826103771275, 2.3004549373748",Paris,75056,0.1,11
7003,Square Boucicaut,OUI,58,18,40,22,18,OUI,OUI,2025-03-13 10:59:41+00:00,"48.851296433665276, 2.325061820447445",Paris,75056,0.6896551724137931,11
12109,Mairie du 12ème,OUI,29,28,1,1,0,OUI,OUI,2025-03-13 10:51:48+00:00,"48.840855311763, 2.3875549435616",Paris,75056,0.034482758620689655,11
17041,Guersant - Gouvion-Saint-Cyr,OUI,33,22,11,5,6,OUI,OUI,2025-03-13 10:59:52+00:00,"48.88287775178599, 2.287667370814871",Paris,75056,0.3333333333333333,11
13101,Croulebarde - Corvisart,OUI,33,25,8,7,1,OUI,OUI,2025-03-13 11:01:40+00:00,"48.830981659316855, 2.3481646925210953",Paris,75056,0.24242424242424243,11
11025,Froment - Bréguet,OUI,43,24,19,16,3,OUI,OUI,2025-03-13 11:00:52+00:00,"48.8570414504784, 2.37289470306807",Paris,75056,0.4418604651162791,11
31024,Romainville - Vaillant-Couturier,OUI,36,35,1,0,1,OUI,OUI,2025-03-13 11:00:12+00:00,"48.86785, 2.446748",Montreuil,93048,0.027777777777777776,11
15047,Morillons - Dantzig,OUI,51,51,0,0,0,OUI,OUI,2025-03-13 10:53:32+00:00,"48.83310149953933, 2.299380004405976",Paris,75056,0.0,11
17044,Porte de Saint-Ouen - Bessières,OUI,42,36,6,3,3,OUI,OUI,2025-03-13 10:59:34+00:00,"48.89792240854517, 2.32851451022192",Paris,75056,0.14285714285714285,11
17026,Jouffroy d'Abbans - Wagram,OUI,39,14,25,11,14,OUI,OUI,2025-03-13 10:58:02+00:00,"48.881973298352, 2.301132157445",Paris,75056,0.6410256410256411,11
17025,Chazelles - Courcelles,OUI,33,23,10,1,9,OUI,OUI,2025-03-13 11:01:26+00:00,"48.879406604954, 2.3034455627202988",Paris,75056,0.30303030303030304,11
6021,Beaux-Arts - Bonaparte,OUI,20,1,19,12,7,OUI,OUI,2025-03-13 11:00:29+00:00,"48.856451985396, 2.3348518833518",Paris,75056,0.95,11
20143,Ramponeau - Belleville,OUI,44,38,6,2,4,OUI,OUI,2025-03-13 10:58:55+00:00,"48.871031137596, 2.379056852114",Paris,75056,0.13636363636363635,11
8050,Boétie - Ponthieu,OUI,43,1,42,11,31,OUI,OUI,2025-03-13 11:01:09+00:00,"48.871417284355, 2.3076787590981",Paris,75056,0.9767441860465116,11
16138,Saint-Cloud - Hippodrome,OUI,30,22,8,3,5,OUI,OUI,2025-03-13 10:56:03+00:00,"48.85772148887421, 2.2549109905958176",Paris,75056,0.26666666666666666,11
14108,Le Brix et Mesmin - Jourdan,OUI,19,19,0,0,0,OUI,OUI,2025-03-13 10:56:01+00:00,"48.82234096593411, 2.327861653302471",Paris,75056,0.0,11
22207,Rond-point du Dr Albert Schweitzer,OUI,21,17,4,1,3,OUI,OUI,2025-03-13 10:57:26+00:00,"48.78980918988166, 2.3143940046429634",Bagneux,92007,0.19047619047619047,11
2022,Saint-Fiacre - Poissonière,OUI,33,16,17,10,7,OUI,OUI,2025-03-13 11:01:05+00:00,"48.870828911558, 2.3459213599563",Paris,75056,0.5151515151515151,11
19027,Serrurier,OUI,18,18,0,0,0,OUI,OUI,2025-03-13 10:58:04+00:00,"48.880493403246, 2.398064173758",Paris,75056,0.0,11
19033,Cambrai - Benjamin Constant,OUI,40,34,6,1,5,OUI,OUI,2025-03-13 10:59:40+00:00,"48.89594736851349, 2.381133802246315",Paris,75056,0.15,11
17048,De Toqueville - Terrasse,OUI,30,26,4,3,1,OUI,OUI,2025-03-13 11:00:00+00:00,"48.882428, 2.314002",Paris,75056,0.13333333333333333,11
21326,Moulin de Pierre - Abbé Grégoire,OUI,20,17,3,0,3,OUI,OUI,2025-03-13 10:56:18+00:00,"48.822036188382, 2.2754641655975",Issy-les-Moulineaux,92040,0.15,11
43002,Lagny - Victor Basch,OUI,24,22,2,1,1,OUI,OUI,2025-03-13 10:58:55+00:00,"48.84884147189881, 2.426325418925233",Vincennes,94080,0.08333333333333333,11
2017,Caire - Dussoubs,OUI,39,9,30,24,6,OUI,OUI,2025-03-13 11:01:17+00:00,"48.86785342111862, 2.349364310503006",Paris,75056,0.7692307692307693,11
21216,Louis Lejeune - Barbès,OUI,24,23,1,0,1,OUI,OUI,2025-03-13 11:01:24+00:00,"48.81807418981508, 2.3267009854316716",Montrouge,92049,0.041666666666666664,11
9008,Tour d'Auvergne - Rodier,OUI,15,11,4,0,4,OUI,OUI,2025-03-13 11:01:24+00:00,"48.879161, 2.343698",Paris,75056,0.26666666666666666,11
15068,Général Martial Valin - Pont du Garigliano,OUI,14,7,7,2,5,OUI,OUI,2025-03-13 10:57:05+00:00,"48.83823094269141, 2.270506024360657",Paris,75056,0.5,11
8048,Marceau - Chaillot,OUI,19,4,15,3,12,OUI,OUI,2025-03-13 10:58:18+00:00,"48.868834023334, 2.2986030816809",Paris,75056,0.7894736842105263,11
92002,Théâtre des Amandiers - Palais des sports,OUI,23,6,17,8,9,OUI,OUI,2025-03-13 11:00:47+00:00,"48.892648526839, 2.2136941552162",Nanterre,92050,0.7391304347826086,11
18111,Félix Ziem - Armand Gauthier,OUI,23,22,1,0,1,OUI,OUI,2025-03-13 10:57:21+00:00,"48.88949630486821, 2.333393658804396",Paris,75056,0.043478260869565216,11
31028,Raspail Barbès,OUI,28,26,2,1,1,OUI,OUI,2025-03-13 11:01:32+00:00,"48.8529945, 2.4247387",Montreuil,93048,0.07142857142857142,11
9002,Abbeville - Faubourg Poissonnière,OUI,14,13,1,1,0,OUI,OUI,2025-03-13 10:56:19+00:00,"48.879223, 2.349147",Paris,75056,0.07142857142857142,11
44017,Jules Guesde - Pont du Port à l'Anglais,OUI,26,2,24,23,1,OUI,OUI,2025-03-13 10:59:42+00:00,"48.79628807093802, 2.417212128639221",Vitry-sur-Seine,94081,0.9230769230769231,11
48003,Youri Gagarine - Karl Marx,OUI,22,19,3,1,2,OUI,OUI,2025-03-13 10:55:55+00:00,"48.78448485079149, 2.35908430069685",Villejuif,94076,0.13636363636363635,11
16118,Michel-Ange - Parent de Rosan,OUI,23,19,4,0,4,OUI,OUI,2025-03-13 11:01:09+00:00,"48.840579923690115, 2.2584119439125065",Paris,75056,0.17391304347826086,11
43009,Place Jean-Spire-Lemaître,OUI,48,48,0,0,0,OUI,OUI,2025-03-13 10:53:09+00:00,"48.8468428626593, 2.452062070369721",Vincennes,94080,0.0,11
8103,Artois - Berri,OUI,22,1,21,10,11,OUI,OUI,2025-03-13 11:00:56+00:00,"48.87393521240818, 2.3064258322119713",Paris,75056,0.9545454545454546,11
17032,Jean Oestreicher - Porte de Champerret,OUI,21,10,11,9,2,OUI,OUI,2025-03-13 11:01:21+00:00,"48.88655580065981, 2.288640439510346",Paris,75056,0.5238095238095238,11
14013,Liard - Amiral Mouchez,OUI,26,26,0,0,0,OUI,OUI,2025-03-13 11:00:33+00:00,"48.8214169, 2.342167",Paris,75056,0.0,11
8016,Square Louis XVI,OUI,29,3,26,15,11,OUI,OUI,2025-03-13 10:59:09+00:00,"48.87320440102894, 2.323658830743138",Paris,75056,0.896551724137931,11
13118,Regnault - Patay,OUI,63,11,52,41,11,OUI,OUI,2025-03-13 10:59:40+00:00,"48.82435782216384, 2.377065159380436",Paris,75056,0.8253968253968254,11
10029,Dunkerque - Rocroy,OUI,24,24,0,0,0,OUI,OUI,2025-03-13 10:58:08+00:00,"48.880726, 2.351464",Paris,75056,0.0,11
15112,Vigée-Lebrun - Anselme Payen,OUI,23,18,5,0,5,OUI,OUI,2025-03-13 11:00:53+00:00,"48.838683941628375, 2.3110422492027287",Paris,75056,0.21739130434782608,11
10161,Gare de l'Est - Faubourg-Saint-Martin,OUI,31,25,6,4,2,OUI,OUI,2025-03-13 10:58:57+00:00,"48.875642647477, 2.3594588041306",Paris,75056,0.1935483870967742,11
13030,Italie - Tolbiac,OUI,21,19,2,1,1,OUI,OUI,2025-03-13 11:00:24+00:00,"48.82557229464416, 2.3576171323657036",Paris,75056,0.09523809523809523,11
9038,Douai - Bruxelles,OUI,26,23,3,0,3,OUI,OUI,2025-03-13 11:01:43+00:00,"48.88320784122797, 2.3308449949028507",Paris,75056,0.11538461538461539,11
16110,Octave Feuillet - Albéric Magnard,OUI,21,4,17,1,16,OUI,OUI,2025-03-13 10:59:43+00:00,"48.86106902949534, 2.2730283066630363",Paris,75056,0.8095238095238095,11
8009,Gare Saint-Lazare - Isly,OUI,25,12,13,7,6,OUI,OUI,2025-03-13 11:01:23+00:00,"48.874777677621296, 2.326515804784655",Paris,75056,0.52,11
9001,Bellefond - Poissonnière,OUI,15,14,1,0,1,OUI,OUI,2025-03-13 11:00:02+00:00,"48.87759897050706, 2.348463758826256",Paris,75056,0.06666666666666667,11
31103,Gare Rosny-Bois-Perrier,OUI,32,10,22,0,22,OUI,OUI,2025-03-13 10:59:35+00:00,"48.88115023337061, 2.480436824262142",Rosny-sous-Bois,93064,0.6875,11
10115,Granges aux Belles,OUI,27,24,3,1,2,OUI,OUI,2025-03-13 11:01:13+00:00,"48.8761373390584, 2.3680844979417",Paris,75056,0.1111111111111111,11
5005,Gay Lussac - Saint-Jacques,OUI,24,4,20,4,16,OUI,OUI,2025-03-13 10:55:40+00:00,"48.844730256132, 2.3419239448664",Paris,75056,0.8333333333333334,11
41303,Gare de Nogent-le-Perreux,OUI,31,19,12,10,2,OUI,OUI,2025-03-13 10:59:05+00:00,"48.83842553348809, 2.493693307042122",Nogent-sur-Marne,94052,0.3870967741935484,11
8053,Place Georges Guillaumin,OUI,27,13,14,6,8,OUI,OUI,2025-03-13 11:01:38+00:00,"48.874750203957, 2.301771435326",Paris,75056,0.5185185185185185,11
12031,Gabriel Lamé,OUI,34,29,5,3,2,OUI,OUI,2025-03-13 11:00:45+00:00,"48.8351212784276, 2.385534569621086",Paris,75056,0.14705882352941177,11
9014,Faubourg Montmartre - La Fayette,OUI,32,5,27,14,13,OUI,OUI,2025-03-13 11:00:40+00:00,"48.875254549053, 2.3408536612988",Paris,75056,0.84375,11
1001,Quai de l'Horloge - Pont Neuf,OUI,16,2,14,9,5,OUI,OUI,2025-03-13 11:01:42+00:00,"48.857058739111, 2.3417982839439",Paris,75056,0.875,11
9106,Boudreau - Auber,OUI,27,13,14,3,11,OUI,OUI,2025-03-13 11:01:41+00:00,"48.87219, 2.329423",Paris,75056,0.5185185185185185,11
5022,Boulangers - Cardinal Lemoine,OUI,18,1,17,9,8,OUI,OUI,2025-03-13 10:59:29+00:00,"48.8462904, 2.3521495",Paris,75056,0.9444444444444444,11
31706,Château - République,OUI,25,24,1,0,1,OUI,OUI,2025-03-13 11:01:43+00:00,"48.862923800596, 2.4155035614967",Bagnolet,93006,0.04,11
21328,Verger - Colonel Guichard,OUI,29,28,1,0,1,OUI,OUI,2025-03-13 11:01:34+00:00,"48.816376985087, 2.2670380088932",Issy-les-Moulineaux,92040,0.034482758620689655,11
17004,Legendre - Clichy,OUI,38,35,3,1,2,OUI,OUI,2025-03-13 10:59:45+00:00,"48.88896161855884, 2.322528975094376",Paris,75056,0.07894736842105263,11
13104,Gare d'Austerlitz - Quai Saint-Bernard,OUI,26,2,24,15,9,OUI,OUI,2025-03-13 11:00:46+00:00,"48.84369030864, 2.3657163977623",Paris,75056,0.9230769230769231,11
19003,Quai de la Seine,OUI,24,24,0,0,0,OUI,OUI,2025-03-13 10:59:17+00:00,"48.884492238407525, 2.3703941702842717",Paris,75056,0.0,11
17040,Pereire - Ternes,OUI,48,47,1,1,0,OUI,OUI,2025-03-13 10:57:05+00:00,"48.87973954830735, 2.288012132048607",Paris,75056,0.020833333333333332,11
5020,Institut du Monde Arabe - Saint-Germain,OUI,38,1,37,35,2,OUI,OUI,2025-03-13 11:01:18+00:00,"48.849063299501, 2.3558086529374",Paris,75056,0.9736842105263158,11
17008,Porte Pouchet-Bessières,OUI,23,15,8,7,1,OUI,OUI,2025-03-13 10:58:16+00:00,"48.8978765, 2.3230632",Paris,75056,0.34782608695652173,11
92007,Pesaro - Préfecture,OUI,21,14,7,1,6,OUI,OUI,2025-03-13 10:57:23+00:00,"48.89577046284005, 2.223908342421055",Nanterre,92050,0.3333333333333333,11
7018,Ségur - d'Estrées,OUI,19,4,15,5,10,OUI,OUI,2025-03-13 11:01:36+00:00,"48.851419978983, 2.3097044974566",Paris,75056,0.7894736842105263,11
16026,Ranelagh - Mozart,OUI,7,5,2,2,0,OUI,OUI,2025-03-13 10:50:00+00:00,"48.8554439, 2.2704418",Paris,75056,0.2857142857142857,11
18203,Lamarck - Saint-Ouen,OUI,40,40,0,0,0,NON,NON,2025-03-13 10:57:42+00:00,"48.891334555236, 2.3272445342326",Paris,75056,0.0,11
9028,Moncey - Blanche,OUI,17,15,2,1,1,OUI,OUI,2025-03-13 10:59:01+00:00,"48.88006587474148, 2.3310810327529907",Paris,75056,0.11764705882352941,11
21323,Charlot - Stade Gabriel Voisin,OUI,31,0,31,27,4,OUI,OUI,2025-03-13 11:01:33+00:00,"48.827228120536, 2.268122527474",Issy-les-Moulineaux,92040,1.0,11
10107,Gare du Nord - Hôpital Lariboisière,OUI,49,48,1,0,1,OUI,OUI,2025-03-13 10:58:56+00:00,"48.881949, 2.352339",Paris,75056,0.02040816326530612,11
19105,Ambroise Rendu - Porte Brunet,OUI,17,15,2,1,1,OUI,OUI,2025-03-13 10:55:46+00:00,"48.883667, 2.395733",Paris,75056,0.11764705882352941,11
19026,Place de Rhin et Danube,OUI,14,13,1,0,1,OUI,OUI,2025-03-13 10:58:12+00:00,"48.88192765861766, 2.392586767673493",Paris,75056,0.07142857142857142,11
22409,Henri Barbusse - Stalingrad,OUI,15,15,0,0,0,OUI,OUI,2025-03-13 10:54:13+00:00,"48.814183748660554, 2.2872862592339516",Malakoff,92046,0.0,11
11023,Saint-Maur - Roquette,OUI,46,45,1,0,1,OUI,OUI,2025-03-13 11:00:49+00:00,"48.858688774062955, 2.383553994571467",Paris,75056,0.021739130434782608,11
19015,Thionville - Ourcq,OUI,22,20,2,1,1,OUI,OUI,2025-03-13 10:56:59+00:00,"48.88917613743794, 2.3833653330802917",Paris,75056,0.09090909090909091,11
11002,Roquette - Thiéré,OUI,22,0,22,16,6,OUI,OUI,2025-03-13 11:01:39+00:00,"48.85507930579506, 2.3733686318721463",Paris,75056,1.0,11
9022,Rossini - Laffitte,OUI,33,3,30,17,13,OUI,OUI,2025-03-13 11:01:15+00:00,"48.87334627510507, 2.337980867701675",Paris,75056,0.9090909090909091,11
8034,Berri - Haussmann,OUI,34,1,33,12,21,OUI,OUI,2025-03-13 10:59:33+00:00,"48.874746047357135, 2.3082953318953514",Paris,75056,0.9705882352941176,11
26003,Argenteuil - Voltaire,OUI,16,13,3,1,2,OUI,OUI,2025-03-13 10:56:59+00:00,"48.91864865955558, 2.2814112156629562",Asnières-sur-Seine,92004,0.1875,11
11047,Amelot - Saint-Sébastien,OUI,29,15,14,12,2,OUI,OUI,2025-03-13 11:00:06+00:00,"48.861142162761, 2.3677996181077",Paris,75056,0.4827586206896552,11
12151,Gare de Lyon - Place Louis Armand,OUI,58,6,52,46,6,OUI,OUI,2025-03-13 10:58:51+00:00,"48.845515089794, 2.3726498446286",Paris,75056,0.896551724137931,11
19043,Delphine Seyrig - Général Leclerc,OUI,51,47,4,2,2,OUI,OUI,2025-03-13 10:58:22+00:00,"48.893923963057865, 2.39790290594101",Pantin,93055,0.0784313725490196,11
26002,Redoute - Les Courtilles,OUI,37,17,20,16,4,OUI,OUI,2025-03-13 11:01:20+00:00,"48.929867194519, 2.2836696356535",Asnières-sur-Seine,92004,0.5405405405405406,11
5032,Panthéon - Valette,OUI,39,1,38,6,32,OUI,OUI,2025-03-13 10:59:07+00:00,"48.847020571652, 2.3464982619671",Paris,75056,0.9743589743589743,11
17043,Belidor - Gouvion-Saint-Cyr,OUI,38,26,12,12,0,OUI,OUI,2025-03-13 10:57:51+00:00,"48.88022154052015, 2.2854680567979813",Paris,75056,0.3157894736842105,11
6006,Notre-Dame-des-Champs - Stanislas,OUI,19,6,13,11,2,OUI,OUI,2025-03-13 10:57:47+00:00,"48.84479928858768, 2.329337755887181",Paris,75056,0.6842105263157895,11
16039,Exelmans - Versailles,OUI,47,19,28,25,3,OUI,OUI,2025-03-13 11:00:01+00:00,"48.84097491091973, 2.264390252530575",Paris,75056,0.5957446808510638,11
11027,Saint-Ambroise - Parmentier,OUI,35,31,4,3,1,OUI,OUI,2025-03-13 10:59:35+00:00,"48.862147844548, 2.3772348091006",Paris,75056,0.11428571428571428,11
45003,11 Novembre 1918 - 8 Mai 1945,OUI,36,13,23,14,9,OUI,OUI,2025-03-13 10:55:41+00:00,"48.80889533774377, 2.5382421165704727",Champigny-sur-Marne,94017,0.6388888888888888,11
31022,Mairie de Montreuil,OUI,51,49,2,2,0,OUI,OUI,2025-03-13 10:59:04+00:00,"48.86131452758348, 2.440614402294159",Montreuil,93048,0.0392156862745098,11
12111,Claude Decaen - Cannebière,OUI,27,24,3,1,2,OUI,OUI,2025-03-13 11:00:10+00:00,"48.83761417037952, 2.397253782195704",Paris,75056,0.1111111111111111,11
46002,Rouget de Lisle,OUI,35,5,30,16,14,OUI,OUI,2025-03-13 10:56:06+00:00,"48.764615483395254, 2.4071189761161804",Choisy-le-Roi,94022,0.8571428571428571,11
18107,Chartres - La Charbonnière,OUI,34,33,1,0,1,OUI,OUI,2025-03-13 10:58:04+00:00,"48.8847601, 2.3534657",Paris,75056,0.029411764705882353,11
14020,Cimetière de Montrouge,OUI,57,55,2,0,2,OUI,OUI,2025-03-13 10:53:40+00:00,"48.821466904768, 2.3215785772007",Paris,75056,0.03508771929824561,11
20042,Pyrénées - Emmery,OUI,38,35,3,0,3,OUI,OUI,2025-03-13 11:01:04+00:00,"48.872010281270974, 2.392039597034455",Paris,75056,0.07894736842105263,11
33017,Anatole France - President Roosevelt,OUI,25,23,2,0,2,OUI,OUI,2025-03-13 11:01:19+00:00,"48.9155156, 2.3814103",Aubervilliers,93001,0.08,11
15067,Desaix - Edgar Faure,OUI,11,4,7,3,4,OUI,OUI,2025-03-13 10:58:40+00:00,"48.852804604940296, 2.293077029857222",Paris,75056,0.6363636363636364,11
15042,Henry Farman,OUI,16,5,11,10,1,OUI,OUI,2025-03-13 10:57:06+00:00,"48.83372430280548, 2.2713854536414146",Paris,75056,0.6875,11
17030,Pereire - Rennequin,OUI,22,17,5,2,3,OUI,OUI,2025-03-13 10:58:10+00:00,"48.88364782887555, 2.2952447086572647",Paris,75056,0.22727272727272727,11
21212,Marne - Germain Dardan,OUI,21,18,3,2,1,OUI,OUI,2025-03-13 10:53:38+00:00,"48.81217465201, 2.3035024699104",Montrouge,92049,0.14285714285714285,11
12128,Pyramide - Ecole du Breuil,OUI,33,27,6,2,4,OUI,OUI,2025-03-13 10:54:22+00:00,"48.82237977153955, 2.4586871266365056",Paris,75056,0.18181818181818182,11
19120,Carducci - Place Hannah Arendt,OUI,27,26,1,0,1,OUI,OUI,2025-03-13 11:01:21+00:00,"48.877436681515796, 2.3860743641853337",Paris,75056,0.037037037037037035,11
8010,Liège - Moscou,OUI,15,13,2,2,0,OUI,OUI,2025-03-13 11:01:36+00:00,"48.8795431, 2.3264628",Paris,75056,0.13333333333333333,11
18003,Cimetière de Montmartre,OUI,43,43,0,0,0,OUI,OUI,2025-03-13 10:56:49+00:00,"48.886472466142, 2.3328901827335",Paris,75056,0.0,11
10016,Récollets - Square Villemin,OUI,17,15,2,0,2,OUI,OUI,2025-03-13 10:55:01+00:00,"48.875034655883944, 2.359801238597928",Paris,75056,0.11764705882352941,11
11113,Richard Lenoir - Republique,OUI,57,22,35,33,2,OUI,OUI,2025-03-13 11:01:07+00:00,"48.8667175, 2.3692541",Paris,75056,0.6140350877192983,11
31009,Place Du Général De Gaulle,OUI,25,24,1,0,1,OUI,OUI,2025-03-13 10:58:37+00:00,"48.8687591, 2.4329931",Montreuil,93048,0.04,11
15104,Hôpital Européen Georges Pompidou,OUI,63,10,53,47,6,OUI,OUI,2025-03-13 11:00:12+00:00,"48.837695319163, 2.2753742337227",Paris,75056,0.8412698412698413,11
41302,Charles de Gaulle - Beauté,OUI,48,48,0,0,0,OUI,OUI,2025-03-13 11:00:01+00:00,"48.83649602312711, 2.479562651149885",Nogent-sur-Marne,94052,0.0,11
14138,Porte de Vanves,OUI,30,29,1,1,0,OUI,OUI,2025-03-13 11:01:28+00:00,"48.828012849445, 2.3056878894567",Paris,75056,0.03333333333333333,11
18011,Pajol - Place Herbert,OUI,39,37,2,1,1,OUI,OUI,2025-03-13 10:59:32+00:00,"48.8927825, 2.3635598",Paris,75056,0.05128205128205128,11
12114,Victor Hugo - Jeanne Jugan,OUI,28,24,4,2,2,OUI,OUI,2025-03-13 10:55:05+00:00,"48.843949064031825, 2.415081394834419",Paris,75056,0.14285714285714285,11
33102,Gabriel Péri - Francisco Ferrer,OUI,17,16,1,0,1,OUI,OUI,2025-03-13 10:53:30+00:00,"48.88633710236977, 2.407338917255402",Le Pré-Saint-Gervais,93061,0.058823529411764705,11
14008,Mouton Duvernet - Général Leclerc,OUI,26,23,3,1,2,OUI,OUI,2025-03-13 11:01:31+00:00,"48.831632518293, 2.3293121159077",Paris,75056,0.11538461538461539,11
42706,Roger Salengro - Fontainebleau,OUI,25,25,0,0,0,OUI,OUI,2025-03-13 11:01:28+00:00,"48.814548697325, 2.3611663654447",Le Kremlin-Bicêtre,94043,0.0,11
15054,Lecourbe - Jean Maridor,OUI,18,15,3,3,0,OUI,OUI,2025-03-13 11:01:43+00:00,"48.83796366147599, 2.2877392172813416",Paris,75056,0.16666666666666666,11
44006,Concorde - Stalingrad,OUI,35,35,0,0,0,OUI,OUI,2025-03-13 11:00:51+00:00,"48.7985844, 2.3821302",Vitry-sur-Seine,94081,0.0,11
5124,Erasme - Ulm,OUI,22,6,16,0,16,OUI,OUI,2025-03-13 10:57:50+00:00,"48.84264375274712, 2.3445946723222733",Paris,75056,0.7272727272727273,11
14003,Schoelcher - Raspail,OUI,48,43,5,1,4,OUI,OUI,2025-03-13 10:56:38+00:00,"48.83681733526843, 2.3312794080411474",Paris,75056,0.10416666666666667,11
14106,Marc Sangnier - Porte de Vanves,OUI,20,20,0,0,0,OUI,OUI,2025-03-13 10:47:07+00:00,"48.825218683556734, 2.3107116669416428",Paris,75056,0.0,11
43008,Fontenay - Libération,OUI,25,22,3,0,3,OUI,OUI,2025-03-13 11:00:08+00:00,"48.847803063647, 2.4451419711113",Vincennes,94080,0.12,11
22406,Guy Môquet - Etienne Dolet,OUI,22,19,3,1,2,OUI,OUI,2025-03-13 10:58:45+00:00,"48.81527009991819, 2.298078276995073",Malakoff,92046,0.13636363636363635,11
5018,Mutualité,OUI,37,1,36,27,9,OUI,OUI,2025-03-13 11:00:47+00:00,"48.848225572724, 2.3502873256803",Paris,75056,0.972972972972973,11
18022,Marcadet - Barbès,OUI,34,32,2,0,2,OUI,OUI,2025-03-13 11:00:56+00:00,"48.890451120965, 2.3490573929687",Paris,75056,0.058823529411764705,11
19101,Square Simon Bolivar,OUI,23,21,2,1,1,OUI,OUI,2025-03-13 11:01:37+00:00,"48.875089888322, 2.3826304078102",Paris,75056,0.08695652173913043,11
8054,Bertie Albrecht - Hoche,OUI,32,14,18,7,11,OUI,OUI,2025-03-13 10:56:47+00:00,"48.87614039826388, 2.301303138307601",Paris,75056,0.5625,11
19103,Manin - Carrières d'Amérique,OUI,17,15,2,0,2,OUI,OUI,2025-03-13 10:59:20+00:00,"48.88467214209463, 2.3919698596000676",Paris,75056,0.11764705882352941,11
15109,Cevennes - Bergers,OUI,28,22,6,3,3,OUI,OUI,2025-03-13 10:57:19+00:00,"48.84240765130395, 2.281037718057633",Paris,75056,0.21428571428571427,11
46003,Conservatoire de Musique,OUI,24,2,22,19,3,OUI,OUI,2025-03-13 11:01:42+00:00,"48.77093586667601, 2.4034014344215398",Choisy-le-Roi,94022,0.9166666666666666,11
21209,Molière - République,OUI,30,30,0,0,0,OUI,OUI,2025-03-13 10:54:46+00:00,"48.81111581390707, 2.3145738624448158",Montrouge,92049,0.0,11
41209,Cimetière de Fontenay-sous-Bois,OUI,15,15,0,0,0,OUI,OUI,2025-03-13 10:59:31+00:00,"48.84706173362218, 2.4787822365760808",Fontenay-sous-Bois,94033,0.0,11
21005,Hôtel de Ville de Boulogne Billancourt,OUI,26,3,23,9,14,OUI,OUI,2025-03-13 10:54:34+00:00,"48.83495885166784, 2.2416803240776066",Boulogne-Billancourt,92012,0.8846153846153846,11
21312,Lucie Aubrac - Fort,OUI,30,26,4,0,4,OUI,OUI,2025-03-13 10:54:20+00:00,"48.818144834008976, 2.271184623241425",Issy-les-Moulineaux,92040,0.13333333333333333,11
35010,Hoche - Jean Lolive,OUI,20,15,5,4,1,OUI,OUI,2025-03-13 11:00:42+00:00,"48.89110239200789, 2.402843534946442",Pantin,93055,0.25,11
13001,Port-Royal - Hôpital du Val-de-Grâce,OUI,17,14,3,1,2,OUI,OUI,2025-03-13 11:00:37+00:00,"48.837668272811, 2.3448138346607",Paris,75056,0.17647058823529413,11
10042,Enghien - Faubourg Poissonnière,OUI,32,4,28,21,7,OUI,OUI,2025-03-13 10:55:37+00:00,"48.872420063053, 2.3483952362828",Paris,75056,0.875,11
18028,Championnet - Vauvenargues,OUI,31,28,3,1,2,OUI,OUI,2025-03-13 11:00:16+00:00,"48.89401874744574, 2.3319872841238976",Paris,75056,0.0967741935483871,11
4016,Lobau - Hôtel de Ville,OUI,59,0,59,49,10,OUI,OUI,2025-03-13 11:01:28+00:00,"48.8562118, 2.3532536",Paris,75056,1.0,11
8017,Rocher - Laborde,OUI,64,53,11,8,3,OUI,OUI,2025-03-13 11:00:30+00:00,"48.87590240712654, 2.322616316378116",Paris,75056,0.171875,11
15133,Saint Lambert - Blomet,OUI,26,24,2,2,0,OUI,OUI,2025-03-13 10:59:04+00:00,"48.83659148147257, 2.2930556908249855",Paris,75056,0.07692307692307693,11
15106,Grenelle - Violet,OUI,34,17,17,15,2,OUI,OUI,2025-03-13 10:59:29+00:00,"48.84993035512154, 2.294612042605877",Paris,75056,0.5,11
15110,Place Robert Guillemard,OUI,22,3,19,17,2,OUI,OUI,2025-03-13 10:59:14+00:00,"48.836191728066666, 2.2811267160086417",Paris,75056,0.8636363636363636,11
18046,Etienne Jodelle - Saint Ouen,OUI,32,29,3,0,3,OUI,OUI,2025-03-13 10:59:07+00:00,"48.88794016394694, 2.326124420314341",Paris,75056,0.09375,11
21006,Marcelin Berthelot,OUI,27,23,4,3,1,OUI,OUI,2025-03-13 10:55:14+00:00,"48.8415473058801, 2.233161628246308",Boulogne-Billancourt,92012,0.14814814814814814,11
31102,Boissière - Etienne Dolet,OUI,20,19,1,1,0,OUI,OUI,2025-03-13 10:57:12+00:00,"48.876111, 2.4677312",Montreuil,93048,0.05,11
44013,Edouard Tremblay - Julian Grimaux,OUI,30,29,1,1,0,OUI,OUI,2025-03-13 10:54:15+00:00,"48.781383825117, 2.3723508417606",Vitry-sur-Seine,94081,0.03333333333333333,11
2111,Chabanais - Petits Champs,OUI,29,1,28,21,7,OUI,OUI,2025-03-13 10:58:20+00:00,"48.86703740186721, 2.336716018617153",Paris,75056,0.9655172413793104,11
20131,Repos - Cimetière du Père Lachaise,OUI,33,32,1,1,0,OUI,OUI,2025-03-13 10:54:24+00:00,"48.859358523593, 2.3896131366845",Paris,75056,0.030303030303030304,11
14012,Sibelle - Alésia,OUI,37,34,3,1,2,OUI,OUI,2025-03-13 10:56:23+00:00,"48.826701758539215, 2.3384983465075493",Paris,75056,0.08108108108108109,11
6025,Assas - Rennes,OUI,32,10,22,13,9,OUI,OUI,2025-03-13 11:01:27+00:00,"48.8492084999386, 2.32851454623001",Paris,75056,0.6875,11
17203,Place de la Porte de Champeret,OUI,28,11,17,16,1,OUI,OUI,2025-03-13 11:00:10+00:00,"48.886062068226, 2.2917001576821",Paris,75056,0.6071428571428571,11
21015,Nationale - Place Jules Guesde,OUI,23,12,11,7,4,OUI,OUI,2025-03-13 11:01:42+00:00,"48.82753962462998, 2.2416052222251897",Boulogne-Billancourt,92012,0.4782608695652174,11
42014,Place Marcel Cachin,OUI,32,8,24,23,1,OUI,OUI,2025-03-13 11:01:23+00:00,"48.81411442356866, 2.39090770483017",Ivry-sur-Seine,94041,0.75,11
48010,Karl Marx,OUI,16,4,12,2,10,OUI,OUI,2025-03-13 10:54:13+00:00,"48.784527937293184, 2.3646667979455587",Villejuif,94076,0.75,11
8045,Place de la Reine Astrid,OUI,57,17,40,23,17,OUI,OUI,2025-03-13 11:00:10+00:00,"48.864920982538, 2.3025491823859",Paris,75056,0.7017543859649122,11
41202,Gare Rer de Fontenay sous Bois,OUI,59,45,14,4,10,OUI,OUI,2025-03-13 10:57:43+00:00,"48.8436279, 2.4630465",Fontenay-sous-Bois,94033,0.23728813559322035,11
14124,David Weill - Parc Montsouris,OUI,22,11,11,1,10,OUI,OUI,2025-03-13 10:59:01+00:00,"48.821092374256104, 2.333725690841675",Paris,75056,0.5,11
35020,Marcelle - Thalie,OUI,20,20,0,0,0,OUI,OUI,2025-03-13 10:58:47+00:00,"48.8835462, 2.4137883",Pantin,93055,0.0,11
31003,Paris - Emile Zola,OUI,29,26,3,1,2,OUI,OUI,2025-03-13 11:01:41+00:00,"48.854898095789295, 2.4186685681343083",Montreuil,93048,0.10344827586206896,11
44003,Gabriel Péri - Danielle Casanova,OUI,20,6,14,9,5,OUI,OUI,2025-03-13 10:59:22+00:00,"48.790114, 2.4025777",Vitry-sur-Seine,94081,0.7,11
9116,Victoire - Chaussée d'Antin,OUI,24,2,22,8,14,OUI,OUI,2025-03-13 11:01:25+00:00,"48.875065791004396, 2.3316738009452824",Paris,75056,0.9166666666666666,11
15034,Lakanal - Commerce,OUI,49,14,35,35,0,OUI,OUI,2025-03-13 10:58:03+00:00,"48.84442462786544, 2.294059172272682",Paris,75056,0.7142857142857143,11
17013,Legendre - Dulong,OUI,23,20,3,0,3,OUI,OUI,2025-03-13 11:01:26+00:00,"48.885325169402904, 2.316423766314984",Paris,75056,0.13043478260869565,11
5028,Censier - Jardin des Plantes,OUI,28,9,19,17,2,OUI,OUI,2025-03-13 10:57:58+00:00,"48.84107178161383, 2.355475388467312",Paris,75056,0.6785714285714286,11
11026,Chemin Vert - Saint-Maur,OUI,44,41,3,0,3,OUI,OUI,2025-03-13 11:01:35+00:00,"48.86112461407359, 2.381299026310444",Paris,75056,0.06818181818181818,11
22203,Tertres - Fontaine,OUI,27,26,1,0,1,OUI,OUI,2025-03-13 11:00:23+00:00,"48.787553654715644, 2.306235730648041",Bagneux,92007,0.037037037037037035,11
23006,Jules Guesde - Alsace,OUI,24,2,22,11,11,OUI,OUI,2025-03-13 11:00:32+00:00,"48.890566275506, 2.2950777411461",Levallois-Perret,92044,0.9166666666666666,11
42021,Raspail - Manufacture des Oeillets,OUI,30,8,22,22,0,OUI,OUI,2025-03-13 10:59:33+00:00,"48.8094458, 2.3903009",Ivry-sur-Seine,94041,0.7333333333333333,11
15021,Joseph Liouville - Croix Nivert,OUI,62,42,20,18,2,OUI,OUI,2025-03-13 11:01:24+00:00,"48.844835471244416, 2.297508493065834",Paris,75056,0.3225806451612903,11
1119,Cossonnerie - Sébastopol,OUI,23,8,15,8,7,OUI,OUI,2025-03-13 11:01:00+00:00,"48.86132665908402, 2.349419631063938",Paris,75056,0.6521739130434783,11
17105,Place Madeleine Daniélou,OUI,42,14,28,20,8,OUI,OUI,2025-03-13 11:01:21+00:00,"48.883498, 2.282015",Paris,75056,0.6666666666666666,11
1020,Cambon - Rivoli,OUI,34,1,33,20,13,OUI,OUI,2025-03-13 11:01:15+00:00,"48.866143390992, 2.3251800647137",Paris,75056,0.9705882352941176,11
9010,Rochechouart lamartine,OUI,24,21,3,0,3,OUI,OUI,2025-03-13 10:58:35+00:00,"48.876719895109, 2.344393021854",Paris,75056,0.125,11
25003,Henri Ste-Claire Déville - Paul Héroult,OUI,21,7,14,6,8,OUI,OUI,2025-03-13 11:01:25+00:00,"48.892663, 2.172411",Rueil-Malmaison,92063,0.6666666666666666,11
43005,Gare RER de Vincennes,OUI,48,24,24,14,10,OUI,OUI,2025-03-13 11:01:42+00:00,"48.847563015126106, 2.433383166790009",Vincennes,94080,0.5,11
20115,Louis Lumière - Porte de Bagnolet,OUI,20,20,0,0,0,OUI,OUI,2025-03-13 10:53:56+00:00,"48.86431136000005, 2.4105210229754443",Paris,75056,0.0,11
19022,Marché Secrétan,OUI,25,19,6,1,5,OUI,OUI,2025-03-13 11:00:28+00:00,"48.88125496379482, 2.373463287949562",Paris,75056,0.24,11
22402,Jean Jaurès - Salvador Allende,OUI,42,40,2,2,0,OUI,OUI,2025-03-13 11:00:22+00:00,"48.821475594736775, 2.3026576638221745",Malakoff,92046,0.047619047619047616,11
21701,Larmeroux - Baudelaire,OUI,28,24,4,0,4,OUI,OUI,2025-03-13 10:57:12+00:00,"48.816939911292, 2.2809894804846",Vanves,92075,0.14285714285714285,11
11030,Oberkampf - République,OUI,20,15,5,1,4,OUI,OUI,2025-03-13 10:59:54+00:00,"48.86531608707, 2.37611478491",Paris,75056,0.25,11
22003,Beffroy,OUI,26,4,22,7,15,OUI,OUI,2025-03-13 10:59:53+00:00,"48.886591074488, 2.2613945603371",Neuilly-sur-Seine,92051,0.8461538461538461,11
11039,Richard Lenoir - Jean-Pierre Timbaud,OUI,35,12,23,20,3,OUI,OUI,2025-03-13 11:01:07+00:00,"48.865804276686, 2.3693370749669",Paris,75056,0.6571428571428571,11
13050,Quai Panhard et Levassor,OUI,57,4,53,30,23,OUI,OUI,2025-03-13 11:01:38+00:00,"48.828374828097, 2.3842737458056",Paris,75056,0.9298245614035088,11
32604,Square du Théâtre du Garde-Chasse,OUI,50,49,1,0,1,OUI,OUI,2025-03-13 10:52:49+00:00,"48.881287375060616, 2.420119643211365",Les Lilas,93045,0.02,11
21008,Victor Hugo - Galliéni,OUI,33,15,18,17,1,OUI,OUI,2025-03-13 10:57:43+00:00,"48.838020154411, 2.2460845112801",Boulogne-Billancourt,92012,0.5454545454545454,11
19024,Botzaris - Parc des Buttes Chaumont,OUI,20,19,1,0,1,OUI,OUI,2025-03-13 10:58:29+00:00,"48.877951, 2.381464",Paris,75056,0.05,11
20134,Lieutenant Chauré - Etienne Marey,OUI,19,18,1,0,1,OUI,OUI,2025-03-13 11:01:04+00:00,"48.86746195408435, 2.405970990657807",Paris,75056,0.05263157894736842,11
41601,Général De Gaulle - Alouette,OUI,25,17,8,6,2,OUI,OUI,2025-03-13 11:01:32+00:00,"48.839109, 2.4175664",Saint-Mandé,94067,0.32,11
22016,Charles de Gaulle - Sablonville,OUI,26,13,13,6,7,OUI,OUI,2025-03-13 11:01:13+00:00,"48.87991924860035, 2.2763770446181297",Neuilly-sur-Seine,92051,0.5,11
18009,Jean-François Lépine - Stephenson,OUI,22,20,2,0,2,OUI,OUI,2025-03-13 10:54:14+00:00,"48.88611466796807, 2.356855627529275",Paris,75056,0.09090909090909091,11
42010,Mairie d'Ivry-sur-Seine,OUI,50,23,27,26,1,OUI,OUI,2025-03-13 11:00:33+00:00,"48.81057120969284, 2.3842826485633855",Ivry-sur-Seine,94041,0.54,11
11105,Parmentier - République,OUI,21,15,6,2,4,OUI,OUI,2025-03-13 11:00:13+00:00,"48.8644954, 2.3750124",Paris,75056,0.2857142857142857,11
19029,Seine - Flandre,OUI,18,18,0,0,0,OUI,OUI,2025-03-13 10:58:06+00:00,"48.886785741479684, 2.3746193200349808",Paris,75056,0.0,11
16108,Sablons - Georges Mandel,OUI,38,35,3,2,1,OUI,OUI,2025-03-13 11:00:22+00:00,"48.863875, 2.28189",Paris,75056,0.07894736842105263,11
19016,Hautpoul - Jean Jaurès,OUI,30,28,2,0,2,OUI,OUI,2025-03-13 10:59:57+00:00,"48.886393679436, 2.3865414544355",Paris,75056,0.06666666666666667,11
17125,Marie-Georges Picquart - Pereire,OUI,31,26,5,4,1,OUI,OUI,2025-03-13 10:59:14+00:00,"48.88863669349711, 2.3111706599593163",Paris,75056,0.16129032258064516,11
32003,Wilson - Métallurgie,OUI,28,11,17,12,5,OUI,OUI,2025-03-13 11:01:00+00:00,"48.909423010092326, 2.3584435880184174",Saint-Denis,93066,0.6071428571428571,11
16136,Théophile Gautier - François Millet,OUI,27,16,11,9,2,OUI,OUI,2025-03-13 11:01:16+00:00,"48.85034821320644, 2.273029983043671",Paris,75056,0.4074074074074074,11
21104,Madame de Sanzillon - Mozart,OUI,22,1,21,13,8,OUI,OUI,2025-03-13 11:01:04+00:00,"48.90379820774301, 2.3187401890754704",Clichy,92024,0.9545454545454546,11
19032,Villette - Belleville,OUI,40,32,8,4,4,OUI,OUI,2025-03-13 11:01:43+00:00,"48.8726877314, 2.376461327076",Paris,75056,0.2,11
1013,Place du Palais Royal,OUI,65,2,63,43,20,OUI,OUI,2025-03-13 11:01:12+00:00,"48.862382970647, 2.3384822532535",Paris,75056,0.9692307692307692,11
16008,Galilée - Kléber,OUI,30,13,17,1,16,OUI,OUI,2025-03-13 10:59:06+00:00,"48.867411865714, 2.2907813801148",Paris,75056,0.5666666666666667,11
8025,Miromesnil - La Boétie,OUI,32,7,25,12,13,OUI,OUI,2025-03-13 11:01:18+00:00,"48.873722412917, 2.3158480972052",Paris,75056,0.78125,11
11024,Mairie du 11ème,OUI,51,29,22,16,6,OUI,OUI,2025-03-13 11:00:55+00:00,"48.858925, 2.3789759",Paris,75056,0.43137254901960786,11
7102,Mairie du 7ème,OUI,48,8,40,24,16,OUI,OUI,2025-03-13 11:01:41+00:00,"48.8577967, 2.3192664",Paris,75056,0.8333333333333334,11
24001,Arche - Léonard de Vinci,OUI,28,18,10,7,3,OUI,OUI,2025-03-13 10:53:56+00:00,"48.89790972494496, 2.2383723043644914",Courbevoie,92026,0.35714285714285715,11
20121,Boyer - Ménilmontant,OUI,19,19,0,0,0,OUI,OUI,2025-03-13 10:52:18+00:00,"48.868895162679, 2.3919824145635",Paris,75056,0.0,11
14136,Auguste Cain - Jean Moulin,OUI,40,38,2,0,2,OUI,OUI,2025-03-13 10:58:17+00:00,"48.82577028927573, 2.3210415244102482",Paris,75056,0.05,11
19013,Laumière - Petit,OUI,32,32,0,0,0,OUI,OUI,2025-03-13 10:54:20+00:00,"48.88467368538326, 2.380039058625698",Paris,75056,0.0,11
32302,Chemin Vert - Fraternité,OUI,20,18,2,1,1,OUI,OUI,2025-03-13 10:58:52+00:00,"48.877141208359035, 2.4461565166711807",Romainville,93063,0.1,11
42504,Gare RER de Gentilly,OUI,30,25,5,2,3,OUI,OUI,2025-03-13 10:52:22+00:00,"48.814280450380224, 2.3410347104072575",Gentilly,94037,0.16666666666666666,11
10014,Marseille - Beaurepaire,OUI,46,12,34,26,8,OUI,OUI,2025-03-13 10:58:17+00:00,"48.871624306962985, 2.3639265082738348",Paris,75056,0.7391304347826086,11
26013,Quai du docteur Dervaux,OUI,26,18,8,8,0,OUI,OUI,2025-03-13 10:57:50+00:00,"48.910482, 2.297998",Asnières-sur-Seine,92004,0.3076923076923077,11
11035,Parmentier - Abel Rabaud,OUI,49,48,1,0,1,OUI,OUI,2025-03-13 11:01:22+00:00,"48.86921273836114, 2.371688821240712",Paris,75056,0.02040816326530612,11
20111,Villiers de l'Isle Adam - Pyrénées,OUI,20,20,0,0,0,OUI,OUI,2025-03-13 10:52:37+00:00,"48.867362, 2.396222",Paris,75056,0.0,11
15046,Parc Georges Brassens - Brancion,OUI,28,26,2,0,2,OUI,OUI,2025-03-13 11:01:16+00:00,"48.83227829269761, 2.3022570088505745",Paris,75056,0.07142857142857142,11
42015,Place Jean Ferrat,OUI,23,22,1,0,1,OUI,OUI,2025-03-13 10:59:34+00:00,"48.8184945213025, 2.3744174838066106",Ivry-sur-Seine,94041,0.043478260869565216,11
46001,Place Paul Eluard,OUI,19,4,15,9,6,OUI,OUI,2025-03-13 10:57:57+00:00,"48.7672039733195, 2.4144977331161503",Choisy-le-Roi,94022,0.7894736842105263,11
32016,Place de la Porte de Paris,OUI,36,26,10,6,4,OUI,OUI,2025-03-13 11:01:00+00:00,"48.93009363207303, 2.3564037680625916",Saint-Denis,93066,0.2777777777777778,11
16040,Exelmans - Michel-Ange,OUI,31,17,14,11,3,OUI,OUI,2025-03-13 11:01:35+00:00,"48.84309486651855, 2.2597770800669053",Paris,75056,0.45161290322580644,11
92008,Hôtel de Ville de Nanterre,OUI,35,13,22,11,11,OUI,OUI,2025-03-13 11:01:14+00:00,"48.892371898250424, 2.205548956990242",Nanterre,92050,0.6285714285714286,11
22006,Pierret - Madrid,OUI,27,5,22,16,6,OUI,OUI,2025-03-13 10:59:40+00:00,"48.882976576876565, 2.260125767248034",Neuilly-sur-Seine,92051,0.8148148148148148,11
41402,Victor Hugo - Ecoles,OUI,22,13,9,6,3,OUI,OUI,2025-03-13 10:54:53+00:00,"48.80476007936134, 2.4180373930262093",Alfortville,94002,0.4090909090909091,11
17028,Reims - Raymond Pitet,OUI,36,13,23,17,6,OUI,OUI,2025-03-13 11:00:42+00:00,"48.8888, 2.296319",Paris,75056,0.6388888888888888,11
18012,Stephenson - Doudeauville,OUI,35,32,3,1,2,OUI,OUI,2025-03-13 10:59:14+00:00,"48.888537048944826, 2.3561610281467438",Paris,75056,0.08571428571428572,11
21301,Saint-Vincent - Verdun,OUI,33,10,23,21,2,OUI,OUI,2025-03-13 10:57:53+00:00,"48.819211549234495, 2.254007756710053",Issy-les-Moulineaux,92040,0.696969696969697,11
12009,Charenton - Diderot,OUI,18,10,8,6,2,OUI,OUI,2025-03-13 10:58:56+00:00,"48.846171461187, 2.3793068155646",Paris,75056,0.4444444444444444,11
42302,Aristide Briand - Gare de Bagneux,OUI,20,20,0,0,0,OUI,OUI,2025-03-13 10:57:56+00:00,"48.79387269664978, 2.321148812770844",Cachan,94016,0.0,11
19125,Place de l'Édit de Nantes,OUI,27,24,3,2,1,OUI,OUI,2025-03-13 11:01:38+00:00,"48.88879, 2.3785",Paris,75056,0.1111111111111111,11
9032,Mathurins - Auber,OUI,35,7,28,21,7,OUI,OUI,2025-03-13 11:00:43+00:00,"48.872988840744, 2.3294984212276",Paris,75056,0.8,11
11042,Grand Prieuré - Crussol,OUI,46,19,27,25,2,OUI,OUI,2025-03-13 10:59:52+00:00,"48.864660627935, 2.3692265531829",Paris,75056,0.5869565217391305,11
19205,Simon Bolivar - Henri Turot,OUI,23,23,0,0,0,OUI,OUI,2025-03-13 10:56:25+00:00,"48.877475489801, 2.3739709492211",Paris,75056,0.0,11
32026,Leroy des Barres - Médiathèque,OUI,27,2,25,11,14,OUI,OUI,2025-03-13 11:01:03+00:00,"48.928253687082, 2.3681719727966",Saint-Denis,93066,0.9259259259259259,11
5123,Saint-Germain - Thenard,OUI,29,0,29,18,11,OUI,OUI,2025-03-13 11:01:16+00:00,"48.850571, 2.3471015",Paris,75056,1.0,11
9005,Square d'Anvers,OUI,31,30,1,1,0,OUI,OUI,2025-03-13 10:57:45+00:00,"48.882633484311, 2.3448844062122",Paris,75056,0.03225806451612903,11
11036,Jules Ferry - Faubourg du Temple Paris,OUI,56,34,22,15,7,OUI,OUI,2025-03-13 10:58:14+00:00,"48.868397, 2.3678933",Paris,75056,0.39285714285714285,11
13002,Arago - Glacière,OUI,26,21,5,4,1,OUI,OUI,2025-03-13 11:01:36+00:00,"48.83486054775774, 2.3445770524322067",Paris,75056,0.19230769230769232,11
9021,Saint Georges - d'Aumale,OUI,23,18,5,2,3,OUI,OUI,2025-03-13 10:52:44+00:00,"48.87778639599673, 2.337429821491241",Paris,75056,0.21739130434782608,11
42301,Gare Arcueil - Cachan,OUI,25,14,11,1,10,OUI,OUI,2025-03-13 11:01:15+00:00,"48.799824, 2.328171",Arcueil,94003,0.44,11
23009,Anatole France - Louise Michel,OUI,47,38,9,3,6,OUI,OUI,2025-03-13 10:59:56+00:00,"48.88873214926474, 2.2881576418876652",Levallois-Perret,92044,0.19148936170212766,11
20043,Charonne - Avron,OUI,26,25,1,1,0,OUI,OUI,2025-03-13 10:54:15+00:00,"48.851602665222, 2.3984030470379",Paris,75056,0.038461538461538464,11
8035,Bienfaisance - Place de Narvik,OUI,34,0,34,19,15,OUI,OUI,2025-03-13 11:00:13+00:00,"48.87660163459077, 2.3129771277308464",Paris,75056,1.0,11
15201,Place Amédée Gordini - Lefebvre,OUI,37,32,5,1,4,OUI,OUI,2025-03-13 10:55:35+00:00,"48.83061737745, 2.2920634208276",Paris,75056,0.13513513513513514,11
21313,Guynemer - Séverine,OUI,24,8,16,14,2,OUI,OUI,2025-03-13 10:57:13+00:00,"48.83091743371036, 2.2790706530213356",Issy-les-Moulineaux,92040,0.6666666666666666,11
31010,Stalingrad - Désiré Chevalier,OUI,41,41,0,0,0,OUI,OUI,2025-03-13 10:56:11+00:00,"48.85670169739857, 2.445072233676911",Montreuil,93048,0.0,11
35018,Ancien Canal - Hélène Brion,OUI,23,21,2,1,1,OUI,OUI,2025-03-13 10:56:22+00:00,"48.89484799296163, 2.4188338592648506",Pantin,93055,0.08695652173913043,11
19008,Flandre - Alphonse Karr,OUI,26,24,2,0,2,OUI,OUI,2025-03-13 10:57:29+00:00,"48.89465, 2.381868",Paris,75056,0.07692307692307693,11
10113,Parmentier - Hôpital Saint-Louis,OUI,39,31,8,3,5,OUI,OUI,2025-03-13 10:55:02+00:00,"48.871379874257, 2.3698963836667",Paris,75056,0.20512820512820512,11
11004,Charonne - Faubourg Saint-Antoine,OUI,31,5,26,22,4,OUI,OUI,2025-03-13 11:01:05+00:00,"48.852191909696, 2.3740932717919",Paris,75056,0.8387096774193549,11
41606,Pasteur - Gambetta,OUI,19,18,1,1,0,OUI,OUI,2025-03-13 10:55:31+00:00,"48.84572797384512, 2.4236011505126953",Saint-Mandé,94067,0.05263157894736842,11
18201,Tristan Tzara -  Tchaïkovski,OUI,31,31,0,0,0,OUI,OUI,2025-03-13 10:56:42+00:00,"48.89490221746837, 2.3648490384221077",Paris,75056,0.0,11
17011,Fragonard - Porte de Clichy,OUI,55,29,26,22,4,OUI,OUI,2025-03-13 11:00:14+00:00,"48.894155633419, 2.3143893107772",Paris,75056,0.4727272727272727,11
51004,Général Delambre - Prebuard,OUI,28,17,11,2,9,OUI,OUI,2025-03-13 10:55:05+00:00,"48.93870344444, 2.2234171606307",Argenteuil,95018,0.39285714285714285,11
5021,Jussieu - Fossés Saint-Bernard,OUI,38,1,37,35,2,OUI,OUI,2025-03-13 11:00:31+00:00,"48.847185510023, 2.3534858599305",Paris,75056,0.9736842105263158,11
14036,Boulard - Daguerre,OUI,43,43,0,0,0,OUI,OUI,2025-03-13 10:58:03+00:00,"48.83446472680611, 2.3293386027216907",Paris,75056,0.0,11
23001,Paul Vaillant Couturier - Chaptal,OUI,36,14,22,17,5,OUI,OUI,2025-03-13 11:01:43+00:00,"48.893479576183, 2.2775253653526",Levallois-Perret,92044,0.6111111111111112,11
43003,Hôpital Bégin,OUI,26,26,0,0,0,NON,NON,2025-03-13 10:58:30+00:00,"48.84571672113, 2.4272462725639",Vincennes,94080,0.0,11
15010,Square Cambronne,OUI,59,5,54,50,4,OUI,OUI,2025-03-13 11:00:31+00:00,"48.84756654526, 2.3025691509247",Paris,75056,0.9152542372881356,11
12027,Montgallet - Charenton,OUI,15,10,5,2,3,OUI,OUI,2025-03-13 10:59:07+00:00,"48.842647778701, 2.3861649278137",Paris,75056,0.3333333333333333,11
17037,Bayen - Pereire,OUI,21,18,3,2,1,OUI,OUI,2025-03-13 11:01:24+00:00,"48.881804409079656, 2.2921088710427284",Paris,75056,0.14285714285714285,11
42029,Stalingrad - Germaine Tailleferre,OUI,28,28,0,0,0,OUI,OUI,2025-03-13 11:01:03+00:00,"48.80257200481316, 2.3786691203713417",Ivry-sur-Seine,94041,0.0,11
18141,Clignancourt - Sofia,OUI,19,19,0,0,0,OUI,OUI,2025-03-13 11:00:38+00:00,"48.88511992309783, 2.34719488842051",Paris,75056,0.0,11
17102,Alfred Roll - Berthier,OUI,28,23,5,5,0,OUI,OUI,2025-03-13 11:00:21+00:00,"48.887808570529, 2.3000952981763",Paris,75056,0.17857142857142858,11
33003,Bordier - Félix Faure,OUI,43,40,3,2,1,OUI,OUI,2025-03-13 10:57:21+00:00,"48.90390751882016, 2.3830059170722966",Aubervilliers,93001,0.06976744186046512,11
28001,Richard Wallace - Place du 8 Mai 1945,OUI,29,14,15,10,5,OUI,OUI,2025-03-13 11:01:25+00:00,"48.87866794788021, 2.2420343756675725",Puteaux,92062,0.5172413793103449,11
33009,Félix Faure - Sadi Carnot,OUI,33,26,7,6,1,OUI,OUI,2025-03-13 10:58:31+00:00,"48.90812110228388, 2.378623187541962",Aubervilliers,93001,0.21212121212121213,11
26007,Square Gilbert Thomain,OUI,19,12,7,5,2,OUI,OUI,2025-03-13 10:53:15+00:00,"48.90717373809284, 2.2695400938391685",Asnières-sur-Seine,92004,0.3684210526315789,11
14034,Ouest - Château,OUI,23,20,3,3,0,OUI,OUI,2025-03-13 10:58:16+00:00,"48.83617286014242, 2.319392143923804",Paris,75056,0.13043478260869565,11
16111,Faustin Hélie - Desbordes-Valmore,OUI,27,23,4,1,3,OUI,OUI,2025-03-13 10:58:28+00:00,"48.859403, 2.276522",Paris,75056,0.14814814814814814,11
16018,Flandrin - Henri Martin,OUI,18,14,4,0,4,OUI,OUI,2025-03-13 11:00:41+00:00,"48.8643275, 2.2724174",Paris,75056,0.2222222222222222,11
11007,Jean Macé - Faidherbe,OUI,57,51,6,2,4,OUI,OUI,2025-03-13 11:00:27+00:00,"48.85337548426, 2.3828620836139",Paris,75056,0.10526315789473684,11
12034,Pirogues de Bercy - Libourne,OUI,48,29,19,5,14,OUI,OUI,2025-03-13 10:59:30+00:00,"48.832308, 2.38637",Paris,75056,0.3958333333333333,11
15025,Dupleix - du Guesclin,OUI,46,17,29,22,7,OUI,OUI,2025-03-13 11:01:29+00:00,"48.85147910413369, 2.296709530055523",Paris,75056,0.6304347826086957,11
25008,Place du 8 Mai 1945,OUI,18,13,5,5,0,OUI,OUI,2025-03-13 10:59:54+00:00,"48.871552174017, 2.2025031970585",Rueil-Malmaison,92063,0.2777777777777778,11
18110,Departement - Pajol,OUI,16,15,1,0,1,OUI,OUI,2025-03-13 11:00:34+00:00,"48.886674849730184, 2.3613611608743668",Paris,75056,0.0625,11
16034,Porte d'Auteuil,OUI,32,26,6,3,3,OUI,OUI,2025-03-13 10:55:54+00:00,"48.8479394142243, 2.2608396783471107",Paris,75056,0.1875,11
19005,Flandre - Riquet,OUI,19,19,0,0,0,OUI,OUI,2025-03-13 10:59:01+00:00,"48.888013281448, 2.3737595955229",Paris,75056,0.0,11
20132,Réunion - Avron,OUI,26,24,2,1,1,OUI,OUI,2025-03-13 10:52:36+00:00,"48.852566752033766, 2.403928068708116",Paris,75056,0.07692307692307693,11
17045,Place des Ternes.,OUI,44,39,5,4,1,OUI,OUI,2025-03-13 10:59:26+00:00,"48.878438631226516, 2.297727763652802",Paris,75056,0.11363636363636363,11
15122,Place Charles Vallin,OUI,26,24,2,2,0,OUI,OUI,2025-03-13 10:58:59+00:00,"48.835523812041, 2.3025986552238",Paris,75056,0.07692307692307693,11
43402,Place de Verdun,OUI,40,20,20,18,2,OUI,OUI,2025-03-13 10:59:51+00:00,"48.8202823, 2.473775",Joinville-le-Pont,94042,0.5,11
92003,Chanzy - Sud-Est,OUI,25,23,2,1,1,OUI,OUI,2025-03-13 10:59:10+00:00,"48.888912037698766, 2.195632159709931",Nanterre,92050,0.08,11
33018,Edouard Poisson - Victor Hugo,OUI,26,23,3,2,1,OUI,OUI,2025-03-13 11:01:08+00:00,"48.91118557052621, 2.379864752692811",Aubervilliers,93001,0.11538461538461539,11
5119,Jussieu - Guy de la Brosse,OUI,40,7,33,25,8,OUI,OUI,2025-03-13 11:01:11+00:00,"48.845665, 2.355653",Paris,75056,0.825,11
12013,Montgallet - Reuilly,OUI,14,10,4,1,3,OUI,OUI,2025-03-13 10:56:49+00:00,"48.844291, 2.3896481",Paris,75056,0.2857142857142857,11
35009,Jean Lolive - Parc Stalingrad,OUI,22,22,0,0,0,OUI,OUI,2025-03-13 10:57:01+00:00,"48.89206174403158, 2.4091735482215886",Pantin,93055,0.0,11
21305,Place Jacques Madaule,OUI,23,3,20,18,2,OUI,OUI,2025-03-13 11:01:20+00:00,"48.823933787309, 2.2606918215752",Issy-les-Moulineaux,92040,0.8695652173913043,11
27002,Parc Pierre Lagravère,OUI,30,14,16,9,7,OUI,OUI,2025-03-13 11:00:06+00:00,"48.92650488131725, 2.239069678491417",Colombes,92025,0.5333333333333333,11
11115,Montreuil - Gonnet,OUI,24,20,4,2,2,OUI,OUI,2025-03-13 11:01:06+00:00,"48.850500564921, 2.3890856287864",Paris,75056,0.16666666666666666,11
21109,Guichet - Jean Jaurès,OUI,23,17,6,3,3,OUI,OUI,2025-03-13 10:56:50+00:00,"48.905169868129036, 2.3023840785026555",Clichy,92024,0.2608695652173913,11
7015,Varenne,OUI,44,19,25,16,9,OUI,OUI,2025-03-13 11:01:36+00:00,"48.857202661803, 2.3152771219611",Paris,75056,0.5681818181818182,11
21502,Verdun - Place Henri IV,OUI,25,6,19,14,5,OUI,OUI,2025-03-13 11:01:21+00:00,"48.870797375639214, 2.2277003154158592",Suresnes,92073,0.76,11
31012,Place Carnot,OUI,23,21,2,0,2,OUI,OUI,2025-03-13 10:56:25+00:00,"48.85593932186797, 2.441531717777252",Montreuil,93048,0.08695652173913043,11
6013,Jacques Callot - Mazarine,OUI,27,0,27,24,3,OUI,OUI,2025-03-13 11:01:21+00:00,"48.855280175332, 2.3375743255019",Paris,75056,1.0,11
12024,Gare de Bercy,OUI,35,13,22,20,2,OUI,OUI,2025-03-13 10:59:48+00:00,"48.839794573906, 2.3826066032052",Paris,75056,0.6285714285714286,11
12115,Porte de Vincennes,OUI,32,29,3,0,3,OUI,OUI,2025-03-13 10:58:02+00:00,"48.846454, 2.415514",Paris,75056,0.09375,11
16129,Ceinture du Lac Inferieure - Saint-Cloud,OUI,41,38,3,0,3,OUI,OUI,2025-03-13 10:56:03+00:00,"48.86218070933143, 2.2617871686816216",Paris,75056,0.07317073170731707,11
8033,Commandant Rivière,OUI,38,2,36,23,13,OUI,OUI,2025-03-13 11:01:35+00:00,"48.872933, 2.309796",Paris,75056,0.9473684210526315,11
35019,Anatole France - Jean Lolive,OUI,27,22,5,4,1,OUI,OUI,2025-03-13 10:59:04+00:00,"48.8949922, 2.4253764",Pantin,93055,0.18518518518518517,11
16121,Jardin d'Acclimatation,OUI,30,21,9,7,2,OUI,OUI,2025-03-13 11:01:40+00:00,"48.878772242510465, 2.270772233605385",Paris,75056,0.3,11
20113,Piat - Parc de Belleville,OUI,21,19,2,0,2,OUI,OUI,2025-03-13 11:01:24+00:00,"48.87195626635528, 2.384981390278095",Paris,75056,0.09523809523809523,11
41102,Gare de Laplace,OUI,43,42,1,1,0,OUI,OUI,2025-03-13 10:55:19+00:00,"48.80893199114179, 2.3349460959434514",Arcueil,94003,0.023255813953488372,11
20119,Square des Saint-Simoniens,OUI,25,25,0,0,0,OUI,OUI,2025-03-13 10:57:18+00:00,"48.8701796, 2.3967273",Paris,75056,0.0,11
16124,Route de Sèvres - Porte de Bagatelle,OUI,65,6,59,52,7,OUI,OUI,2025-03-13 10:59:45+00:00,"48.87525984132485, 2.249415814876557",Paris,75056,0.9076923076923077,11
6030,Assas - Vaugirard,OUI,34,17,17,9,8,OUI,OUI,2025-03-13 11:01:27+00:00,"48.848274111398, 2.3292413726449",Paris,75056,0.5,11
5106,Cujas - Saint-Michel,OUI,19,0,19,4,15,OUI,OUI,2025-03-13 11:01:42+00:00,"48.848191348584, 2.341831654854",Paris,75056,1.0,11
23802,Raymond Poincaré - Allée de la Marche,OUI,22,13,9,7,2,OUI,OUI,2025-03-13 10:57:27+00:00,"48.838634069623, 2.1724102640451",Garches,92033,0.4090909090909091,11
25005,18 juin 1940 - Buzenval,OUI,25,18,7,4,3,OUI,OUI,2025-03-13 11:00:13+00:00,"48.868807, 2.185428",Rueil-Malmaison,92063,0.28,11
12126,Gravelle - Route du Bac,OUI,49,45,4,4,0,OUI,OUI,2025-03-13 11:00:23+00:00,"48.824407, 2.418455",Paris,75056,0.08163265306122448,11
22505,Mairie de La Garenne Colombes,OUI,22,18,4,4,0,OUI,OUI,2025-03-13 10:52:56+00:00,"48.90663823468682, 2.24679596722126",La Garenne-Colombes,92035,0.18181818181818182,11
15017,Place Falguière,OUI,23,23,0,0,0,OUI,OUI,2025-03-13 11:01:14+00:00,"48.83629973941847, 2.3104464635252953",Paris,75056,0.0,11
13045,Jean Colly - Tolbiac,OUI,36,28,8,4,4,OUI,OUI,2025-03-13 11:00:30+00:00,"48.827817291597846, 2.3705490678548813",Paris,75056,0.2222222222222222,11
17018,Parc Monceau,OUI,18,4,14,7,7,OUI,OUI,2025-03-13 10:56:01+00:00,"48.881077914129, 2.3095492646098",Paris,75056,0.7777777777777778,11
19115,Porte de la Villette,OUI,26,21,5,4,1,OUI,OUI,2025-03-13 11:01:29+00:00,"48.89835196548483, 2.386150136590004",Paris,75056,0.19230769230769232,11
18020,Francoeur - Marcadet,OUI,20,20,0,0,0,OUI,OUI,2025-03-13 11:00:53+00:00,"48.89104123261663, 2.340014585442034",Paris,75056,0.0,11
32010,Place aux Étoiles,OUI,37,13,24,4,20,OUI,OUI,2025-03-13 11:00:16+00:00,"48.91835629408464, 2.3523425683379173",Saint-Denis,93066,0.6486486486486487,11
43006,Vignerons - Minimes,OUI,29,23,6,5,1,OUI,OUI,2025-03-13 11:01:05+00:00,"48.841486, 2.430793",Vincennes,94080,0.20689655172413793,11
15033,Place Violet,OUI,29,25,4,4,0,OUI,OUI,2025-03-13 11:00:24+00:00,"48.84487893836502, 2.2905756533145905",Paris,75056,0.13793103448275862,11
5002,Sommerard - Saint-Jacques,OUI,34,0,34,26,8,OUI,OUI,2025-03-13 11:00:25+00:00,"48.850310432924466, 2.345015835298588",Paris,75056,1.0,11
19044,Grands Moulins de Pantin,OUI,50,39,11,2,9,OUI,OUI,2025-03-13 11:00:24+00:00,"48.89738369720229, 2.3959985375404362",Paris,75056,0.22,11
15028,Grenelle - Dr Finlay,OUI,71,12,59,57,2,OUI,OUI,2025-03-13 11:01:24+00:00,"48.851315406715976, 2.2919502854347233",Paris,75056,0.8309859154929577,11
24002,Gare de Courbevoie,OUI,32,27,5,4,1,OUI,OUI,2025-03-13 10:57:50+00:00,"48.8993867, 2.2506506",Courbevoie,92026,0.15625,11
8102,Lamennais - Washington,OUI,25,2,23,10,13,OUI,OUI,2025-03-13 11:01:41+00:00,"48.87352990026496, 2.303444892168045",Paris,75056,0.92,11
33001,Victor Hugo - Magasins Généraux,OUI,34,25,9,4,5,OUI,OUI,2025-03-13 10:57:15+00:00,"48.903281401126755, 2.368072383105755",Aubervilliers,93001,0.2647058823529412,11
7004,Raspail - Varenne,OUI,17,9,8,7,1,OUI,OUI,2025-03-13 11:01:06+00:00,"48.853147816545, 2.3263905197382",Paris,75056,0.47058823529411764,11
41404,Carnot - Pâquerettes,OUI,23,2,21,21,0,OUI,OUI,2025-03-13 11:01:05+00:00,"48.79592939432515, 2.4261841177940373",Alfortville,94002,0.9130434782608695,11
42503,Vladimir Ilitch Lénine - Andrée Chedid,OUI,31,27,4,0,4,OUI,OUI,2025-03-13 10:58:19+00:00,"48.813240124373, 2.3319716067039",Gentilly,94037,0.12903225806451613,11
7009,Assemblée Nationale,OUI,75,6,69,31,38,OUI,OUI,2025-03-13 10:55:58+00:00,"48.861411014652, 2.3201214185208",Paris,75056,0.92,11
2010,Uzès - Montmartre,OUI,26,1,25,14,11,OUI,OUI,2025-03-13 11:00:40+00:00,"48.870790980240706, 2.3431010171771054",Paris,75056,0.9615384615384616,11
42707,Place Jean-Baptiste Clément,OUI,23,23,0,0,0,OUI,OUI,2025-03-13 10:53:07+00:00,"48.81240466867336, 2.3617091774940495",Le Kremlin-Bicêtre,94043,0.0,11
11114,Ledru-Rollin - Charonne,OUI,31,13,18,8,10,OUI,OUI,2025-03-13 10:59:10+00:00,"48.85345855607243, 2.3772463581947094",Paris,75056,0.5806451612903226,11
19019,Petit - Manin,OUI,22,22,0,0,0,NON,NON,2025-03-13 10:55:26+00:00,"48.886506875343, 2.3938155401308",Paris,75056,0.0,11
5116,Place Valhubert,OUI,51,0,51,44,7,OUI,OUI,2025-03-13 10:59:29+00:00,"48.844182577315, 2.3640366643667",Paris,75056,1.0,11
8055,Courcelles - Place des Ternes,OUI,28,26,2,0,2,OUI,OUI,2025-03-13 10:59:31+00:00,"48.878199928923124, 2.2992860188665043",Paris,75056,0.07142857142857142,11
34002,Capitaine Glarner - Gabriel Péri,OUI,24,20,4,3,1,OUI,OUI,2025-03-13 11:01:39+00:00,"48.902449900418745, 2.3304807533425724",Saint-Ouen-sur-Seine,93070,0.16666666666666666,11
23701,Parvis Robert Schuman - Roger Salengro,OUI,24,15,9,2,7,OUI,OUI,2025-03-13 10:54:18+00:00,"48.812657470558754, 2.1921751275658607",Chaville,92022,0.375,11
13026,Place Jean Delay,OUI,33,28,5,1,4,OUI,OUI,2025-03-13 10:59:58+00:00,"48.823316, 2.354336",Paris,75056,0.15151515151515152,11
17007,Navier - Epinettes,OUI,36,34,2,1,1,OUI,OUI,2025-03-13 10:54:27+00:00,"48.89587780769155, 2.3226776719093327",Paris,75056,0.05555555555555555,11
23002,Pont de Levallois-bécon,OUI,49,19,30,16,14,OUI,OUI,2025-03-13 11:01:32+00:00,"48.8984179, 2.2791311",Levallois-Perret,92044,0.6122448979591837,11
14104,Boyer-Barret - Raymond Losserand,OUI,22,20,2,1,1,OUI,OUI,2025-03-13 11:01:18+00:00,"48.83329880233322, 2.3173383995890617",Paris,75056,0.09090909090909091,11
13102,Pitié-Salpêtrière,OUI,49,11,38,17,21,OUI,OUI,2025-03-13 11:01:12+00:00,"48.83748810318667, 2.365213818848133",Paris,75056,0.7755102040816326,11
31705,Champeaux - Gallieni,OUI,47,46,1,0,1,OUI,OUI,2025-03-13 10:53:46+00:00,"48.864459134684644, 2.4161778017878532",Bagnolet,93006,0.02127659574468085,11
11101,Charles Delescluze,OUI,48,21,27,23,4,OUI,OUI,2025-03-13 11:00:51+00:00,"48.85242200848887, 2.380632497370243",Paris,75056,0.5625,11
20036,Ménilmontant - Pelleport,OUI,31,31,0,0,0,OUI,OUI,2025-03-13 10:52:15+00:00,"48.870682633845, 2.3989596023316",Paris,75056,0.0,11
14130,Jonquoy - Didot,OUI,30,27,3,0,3,OUI,OUI,2025-03-13 11:01:29+00:00,"48.82890454823947, 2.31648076325655",Paris,75056,0.1,11
41604,Lagny - Joffre,OUI,30,14,16,16,0,OUI,OUI,2025-03-13 11:01:42+00:00,"48.84930687084088, 2.417949736118317",Saint-Mandé,94067,0.5333333333333333,11
10015,Lucien Sampaix - Récollets,OUI,41,36,5,3,2,OUI,OUI,2025-03-13 10:58:30+00:00,"48.874330377560476, 2.3621229082345963",Paris,75056,0.12195121951219512,11
15029,Emeriau - Place de Brazzaville,OUI,51,2,49,39,10,OUI,OUI,2025-03-13 11:01:31+00:00,"48.850785261674964, 2.2871585190296173",Paris,75056,0.9607843137254902,11
21308,Bara - Henri Farman,OUI,58,9,49,31,18,OUI,OUI,2025-03-13 11:01:29+00:00,"48.833218027457846, 2.2677567601203923",Issy-les-Moulineaux,92040,0.8448275862068966,11
18005,Tardieu - Chappe,OUI,16,14,2,1,1,OUI,OUI,2025-03-13 10:55:46+00:00,"48.884146759782, 2.341845408082",Paris,75056,0.125,11
12032,Porte Dorée,OUI,35,7,28,19,9,OUI,OUI,2025-03-13 11:00:15+00:00,"48.8354337, 2.4077132",Paris,75056,0.8,11
10005,Petites Ecuries - Faubourg Poissonnière,OUI,17,3,14,11,3,OUI,OUI,2025-03-13 11:00:57+00:00,"48.87397217237368, 2.348388757504776",Paris,75056,0.8235294117647058,11
19037,Belleville - Porte des Lilas,OUI,29,27,2,0,2,OUI,OUI,2025-03-13 10:53:56+00:00,"48.87660391892763, 2.404769691129476",Paris,75056,0.06896551724137931,11
26001,Gare d'Asnières sur Seine,OUI,21,11,10,8,2,OUI,OUI,2025-03-13 11:00:14+00:00,"48.90636459217474, 2.2835066914558415",Asnières-sur-Seine,92004,0.47619047619047616,11
6103,Mézières - Rennes,OUI,53,43,10,4,6,OUI,OUI,2025-03-13 10:56:11+00:00,"48.85023459321703, 2.3303819820284843",Paris,75056,0.18867924528301888,11
92004,Nanterre - Université,OUI,19,6,13,8,5,OUI,OUI,2025-03-13 10:54:50+00:00,"48.901365, 2.212693",Nanterre,92050,0.6842105263157895,11
15038,Place Adolphe Cherioux - Vaugirard,OUI,62,58,4,1,3,OUI,OUI,2025-03-13 10:58:53+00:00,"48.83959442800459, 2.3010657727718353",Paris,75056,0.06451612903225806,11
20136,Henri Chevreau - Couronnes,OUI,26,26,0,0,0,OUI,OUI,2025-03-13 10:58:48+00:00,"48.87033205312931, 2.388777695596218",Paris,75056,0.0,11
7005,Raspail - Bac,OUI,51,10,41,22,19,OUI,OUI,2025-03-13 10:58:38+00:00,"48.855628721101, 2.3256602883339",Paris,75056,0.803921568627451,11
5026,Pascal - Claude Bernard,OUI,46,12,34,30,4,OUI,OUI,2025-03-13 11:01:40+00:00,"48.839061952159746, 2.3499782010912895",Paris,75056,0.7391304347826086,11
21105,Morice - Général Leclerc,OUI,25,19,6,5,1,OUI,OUI,2025-03-13 11:01:38+00:00,"48.90245471981591, 2.3128929734230046",Clichy,92024,0.24,11
14018,Porte d'Orléans,OUI,45,42,3,0,3,OUI,OUI,2025-03-13 10:59:27+00:00,"48.8227639, 2.3249313",Paris,75056,0.06666666666666667,11
19109,Tanger - Place du Maroc,OUI,19,18,1,1,0,OUI,OUI,2025-03-13 10:55:04+00:00,"48.8862524447104, 2.3689296841621403",Paris,75056,0.05263157894736842,11
31702,Pierre et Marie Curie - Julien Grimau,OUI,18,17,1,0,1,OUI,OUI,2025-03-13 10:55:18+00:00,"48.870714014863225, 2.424097023904324",Bagnolet,93006,0.05555555555555555,11
17124,Porte de Saint-Ouen - Henri Huchard,OUI,26,8,18,15,3,OUI,OUI,2025-03-13 10:54:31+00:00,"48.898708366365064, 2.3295360803604126",Paris,75056,0.6923076923076923,11
21013,Pierre Grenier - Pont de Billancourt,OUI,21,17,4,3,1,OUI,OUI,2025-03-13 10:56:46+00:00,"48.8258020742942, 2.2487989068031315",Boulogne-Billancourt,92012,0.19047619047619047,11
31016,Lucie Aubrac - Franklin,OUI,35,33,2,1,1,OUI,OUI,2025-03-13 10:58:06+00:00,"48.86223916006812, 2.4435862898826604",Montreuil,93048,0.05714285714285714,11
21111,Professeur René Leriche - Général Leclerc,OUI,50,24,26,20,6,OUI,OUI,2025-03-13 11:01:02+00:00,"48.90782845483013, 2.307887971401215",Clichy,92024,0.52,11
51003,Hôtel de Ville d'Argenteuil,OUI,29,12,17,11,6,OUI,OUI,2025-03-13 11:01:03+00:00,"48.946504, 2.2496396",Argenteuil,95018,0.5862068965517241,11
7006,Quai Voltaire,OUI,32,2,30,26,4,OUI,OUI,2025-03-13 11:00:55+00:00,"48.858942986179, 2.3314182047146",Paris,75056,0.9375,11
22101,Gare Routière de Saint Cloud,OUI,29,6,23,18,5,OUI,OUI,2025-03-13 11:01:02+00:00,"48.84288183896324, 2.222245037555695",Saint-Cloud,92064,0.7931034482758621,11
7014,Saint-François-Xavier,OUI,42,7,35,20,15,OUI,OUI,2025-03-13 11:01:31+00:00,"48.85154484769, 2.3146149516106",Paris,75056,0.8333333333333334,11
44102,Verdun - Adrien Damalix,OUI,25,14,11,8,3,OUI,OUI,2025-03-13 10:58:14+00:00,"48.8222334178559, 2.4215328320860863",Saint-Maurice,94069,0.44,11
8012,Batignolles - Place de Clichy,OUI,46,38,8,2,6,OUI,OUI,2025-03-13 10:57:49+00:00,"48.883474535757, 2.326493114233",Paris,75056,0.17391304347826086,11
16032,Eglise d'Auteuil,OUI,20,15,5,1,4,OUI,OUI,2025-03-13 10:57:03+00:00,"48.84749841771691, 2.26848387135299",Paris,75056,0.25,11
20040,Parc de Belleville - Julien Lacroix,OUI,26,23,3,2,1,OUI,OUI,2025-03-13 10:56:00+00:00,"48.8703459, 2.3842214",Paris,75056,0.11538461538461539,11
22001,Château - Bineau,OUI,21,0,21,9,12,OUI,OUI,2025-03-13 11:01:27+00:00,"48.890404028589806, 2.270106375217438",Neuilly-sur-Seine,92051,1.0,11
17017,Gare de Pont-Cardinet,OUI,31,24,7,3,4,OUI,OUI,2025-03-13 10:59:32+00:00,"48.88713901475306, 2.314494143994255",Paris,75056,0.22580645161290322,11
18025,Mairie du 18ème,OUI,40,39,1,1,0,OUI,OUI,2025-03-13 10:55:48+00:00,"48.892939296937605, 2.3445510864257812",Paris,75056,0.025,11
10023,Gare de l'Est - Verdun,OUI,13,11,2,2,0,OUI,OUI,2025-03-13 10:57:48+00:00,"48.876156054271, 2.3609149083206",Paris,75056,0.15384615384615385,11
31007,Paris - Désiré Préaux,OUI,44,39,5,1,4,OUI,OUI,2025-03-13 10:55:38+00:00,"48.85742876694898, 2.4323049187660217",Montreuil,93048,0.11363636363636363,11
14139,Pierre Larousse - Raymond Losserand,OUI,30,29,1,0,1,OUI,OUI,2025-03-13 10:58:20+00:00,"48.83059564231877, 2.3119183257222176",Paris,75056,0.03333333333333333,11
15108,Lourmel - Marie Skobtsov,OUI,22,18,4,1,3,OUI,OUI,2025-03-13 11:00:57+00:00,"48.844974, 2.287283",Paris,75056,0.18181818181818182,11
15055,Vasco de Gama,OUI,54,27,27,21,6,OUI,OUI,2025-03-13 11:01:14+00:00,"48.83671783466264, 2.283664085650799",Paris,75056,0.5,11
17047,Courcelles - Pierre Demours,OUI,26,4,22,11,11,OUI,OUI,2025-03-13 11:01:04+00:00,"48.883769733273496, 2.29858466343129",Paris,75056,0.8461538461538461,11
41207,Place du Général de Gaulle,OUI,28,15,13,1,12,OUI,OUI,2025-03-13 11:00:35+00:00,"48.8525288, 2.4877332",Fontenay-sous-Bois,94033,0.4642857142857143,11
18109,Pajol - Riquet,OUI,46,43,3,1,2,OUI,OUI,2025-03-13 11:01:29+00:00,"48.88960028134536, 2.3628534749150276",Paris,75056,0.06521739130434782,11
12011,Charenton - Place du Col Bourgoin,OUI,34,19,15,12,3,OUI,OUI,2025-03-13 11:00:37+00:00,"48.844867319554, 2.3825789350545",Paris,75056,0.4411764705882353,11
35017,Toffier Decaux - Cartier Bresson,OUI,17,12,5,1,4,OUI,OUI,2025-03-13 11:00:53+00:00,"48.90165072551549, 2.4017545580863957",Pantin,93055,0.29411764705882354,11
21032,Sèvres-Gallieni,OUI,25,5,20,17,3,OUI,OUI,2025-03-13 10:58:57+00:00,"48.837809408957, 2.2281519323587",Boulogne-Billancourt,92012,0.8,11
20118,Orteaux - Mouraud,OUI,24,22,2,0,2,OUI,OUI,2025-03-13 10:52:17+00:00,"48.85558642847872, 2.408762907764669",Paris,75056,0.08333333333333333,11
20021,Indre - Prairies,OUI,38,37,1,0,1,OUI,OUI,2025-03-13 11:01:26+00:00,"48.86254398506782, 2.403290458023548",Paris,75056,0.02631578947368421,11
9117,Bellefond - Maubeuge,OUI,28,27,1,1,0,OUI,OUI,2025-03-13 11:00:34+00:00,"48.878255397645, 2.3452642187476",Paris,75056,0.03571428571428571,11
6018,Michelet - Assas,OUI,16,6,10,1,9,OUI,OUI,2025-03-13 11:01:25+00:00,"48.842741502832, 2.3350211977959",Paris,75056,0.625,11
20023,Pelleport - Belgrand,OUI,14,13,1,0,1,OUI,OUI,2025-03-13 10:57:29+00:00,"48.86500081847653, 2.403980836377493",Paris,75056,0.07142857142857142,11
21019,Edouard Vaillant - Paul-Adolphe Souriau,OUI,26,0,26,18,8,OUI,OUI,2025-03-13 11:01:24+00:00,"48.834845858829, 2.2479459643364",Boulogne-Billancourt,92012,1.0,11
10020,Chabrol - d'Hauteville,OUI,11,8,3,0,3,OUI,OUI,2025-03-13 11:00:24+00:00,"48.877018388033, 2.3513179644942",Paris,75056,0.2727272727272727,11
31019,Vincennes - Douy-Delcupe,OUI,37,36,1,0,1,OUI,OUI,2025-03-13 10:57:06+00:00,"48.85493692155721, 2.436049282550812",Montreuil,93048,0.02702702702702703,11
18113,Lepic - Armée d'Orient,OUI,24,24,0,0,0,OUI,OUI,2025-03-13 10:53:25+00:00,"48.887536403814, 2.3343077301979",Paris,75056,0.0,11
32014,Place du Cornillon - Stade de France,OUI,33,4,29,20,9,OUI,OUI,2025-03-13 11:01:37+00:00,"48.92540695835961, 2.3644426837563515",Saint-Denis,93066,0.8787878787878788,11
18032,Porte de Clignancourt.,OUI,55,53,2,0,2,OUI,OUI,2025-03-13 10:54:11+00:00,"48.897488, 2.343996",Paris,75056,0.03636363636363636,11
11041,Square Saint-Ambroise,OUI,39,4,35,32,3,OUI,OUI,2025-03-13 11:01:00+00:00,"48.860934, 2.375841",Paris,75056,0.8974358974358975,11
44012,Génie - Mozart,OUI,18,18,0,0,0,OUI,OUI,2025-03-13 10:52:27+00:00,"48.794902381218904, 2.3734183609485626",Vitry-sur-Seine,94081,0.0,11
31703,Sadi Carnot - François Mitterrand,OUI,26,25,1,0,1,OUI,OUI,2025-03-13 10:56:33+00:00,"48.87532687671517, 2.4241617321968083",Bagnolet,93006,0.038461538461538464,11
17027,Place du Maréchal Juin - Péreire,OUI,44,26,18,18,0,OUI,OUI,2025-03-13 10:58:57+00:00,"48.885263, 2.298286",Paris,75056,0.4090909090909091,11
35003,Gabrielle Josserand - Edouard Vaillant,OUI,24,22,2,1,1,OUI,OUI,2025-03-13 11:01:08+00:00,"48.90271566255436, 2.3933270573616032",Pantin,93055,0.08333333333333333,11
13016,Primo Levi - Frigos,OUI,33,0,33,23,10,OUI,OUI,2025-03-13 11:01:40+00:00,"48.83094844846017, 2.37965351592796",Paris,75056,1.0,11
15031,Théâtre - Lourmel,OUI,52,10,42,39,3,OUI,OUI,2025-03-13 10:59:26+00:00,"48.8482070397636, 2.2898658737540245",Paris,75056,0.8076923076923077,11
13043,Dunois - Clisson,OUI,50,45,5,3,2,OUI,OUI,2025-03-13 10:57:16+00:00,"48.832294, 2.3674523",Paris,75056,0.1,11
5121,Square René Viviani - Montebello,OUI,33,4,29,28,1,OUI,OUI,2025-03-13 11:01:12+00:00,"48.851904891406, 2.3478421568871",Paris,75056,0.8787878787878788,11
8051,Batignolles - Rome,OUI,11,9,2,0,2,OUI,OUI,2025-03-13 10:59:28+00:00,"48.881823370566806, 2.3202589899301524",Paris,75056,0.18181818181818182,11
11006,Ledru-Rollin - Place du Père Chaillet,OUI,37,21,16,14,2,OUI,OUI,2025-03-13 10:58:53+00:00,"48.856433706943704, 2.379020587761426",Paris,75056,0.43243243243243246,11
2009,Filles Saint-Thomas - Place de la Bourse,OUI,58,7,51,22,29,OUI,OUI,2025-03-13 10:59:49+00:00,"48.868899890853, 2.3397543845203",Paris,75056,0.8793103448275862,11
19127,Aubervilliers - Curial,OUI,23,20,3,1,2,OUI,OUI,2025-03-13 10:59:47+00:00,"48.89088305227546, 2.3688579350709915",Paris,75056,0.13043478260869565,11
9115,Milton - Manuel,OUI,21,17,4,2,2,OUI,OUI,2025-03-13 10:58:19+00:00,"48.878249, 2.341181",Paris,75056,0.19047619047619047,11
1120,Lavandieres Sainte Opportune - Rivoli,OUI,23,4,19,17,2,OUI,OUI,2025-03-13 11:00:09+00:00,"48.859279702476, 2.3466217517853",Paris,75056,0.8260869565217391,11
19039,Edouard Pailleron - Simon Bolivar,OUI,23,21,2,0,2,OUI,OUI,2025-03-13 10:58:30+00:00,"48.87979886049996, 2.374839261174202",Paris,75056,0.08695652173913043,11
14112,Méchain - Faubourg Saint-Jacques,OUI,15,11,4,1,3,OUI,OUI,2025-03-13 11:01:35+00:00,"48.83586772099485, 2.33798034198275",Paris,75056,0.26666666666666666,11
21003,Jean Jaurès - Jean Baptiste Clément,OUI,38,21,17,7,10,OUI,OUI,2025-03-13 11:01:19+00:00,"48.84576261454011, 2.2369650006294255",Boulogne-Billancourt,92012,0.4473684210526316,11
9026,Jean-Baptiste Pigalle - La Bruyere,OUI,16,11,5,3,2,OUI,OUI,2025-03-13 10:58:13+00:00,"48.87939826447722, 2.333709173337285",Paris,75056,0.3125,11
17122,Bridaine - Lamandé,OUI,28,27,1,0,1,OUI,OUI,2025-03-13 11:00:11+00:00,"48.8862074, 2.3206239",Paris,75056,0.03571428571428571,11
21001,Transvaal - Charles de Gaulle,OUI,27,12,15,5,10,OUI,OUI,2025-03-13 11:01:35+00:00,"48.848280403628806, 2.2373420120857195",Boulogne-Billancourt,92012,0.5555555555555556,11
20027,Porte de Ménilmontant,OUI,15,15,0,0,0,OUI,OUI,2025-03-13 10:57:48+00:00,"48.8691543609174, 2.40932246879487",Paris,75056,0.0,11
18033,Belliard - Damrémont,OUI,34,33,1,1,0,OUI,OUI,2025-03-13 10:53:22+00:00,"48.89669238777841, 2.338023450388167",Paris,75056,0.029411764705882353,11
9023,Laffitte - Italiens,OUI,31,2,29,16,13,OUI,OUI,2025-03-13 10:58:29+00:00,"48.871815737396, 2.3372015478451",Paris,75056,0.9354838709677419,11
16122,Route de la Muette - Porte de Neuilly,OUI,49,45,4,2,2,OUI,OUI,2025-03-13 11:00:27+00:00,"48.8798926, 2.2587671",Paris,75056,0.08163265306122448,11
14122,Colonel Monteil - Brune,OUI,19,18,1,1,0,OUI,OUI,2025-03-13 10:56:22+00:00,"48.82650293311, 2.3092747998272",Paris,75056,0.05263157894736842,11
21310,Kléber - Gouverneur Général Eboué,OUI,22,1,21,14,7,OUI,OUI,2025-03-13 10:57:06+00:00,"48.826885843069796, 2.2723413258790965",Issy-les-Moulineaux,92040,0.9545454545454546,11
16123,Mahatma Gandhi,OUI,24,3,21,16,5,OUI,OUI,2025-03-13 10:58:13+00:00,"48.876356, 2.264205",Paris,75056,0.875,11
10010,Place Jacques Bonsergent,OUI,33,4,29,20,9,OUI,OUI,2025-03-13 11:01:10+00:00,"48.870948218595, 2.3612049221992",Paris,75056,0.8787878787878788,11
19040,Belleville - Télégraphe,OUI,40,40,0,0,0,OUI,OUI,2025-03-13 10:59:18+00:00,"48.8756045, 2.3995549",Paris,75056,0.0,11
42004,Westermeyer - Paul Vaillant-Couturier,OUI,28,6,22,21,1,OUI,OUI,2025-03-13 11:01:15+00:00,"48.819116181578764, 2.3966637253761296",Ivry-sur-Seine,94041,0.7857142857142857,11
6016,Danton - Serpente,OUI,21,3,18,15,3,OUI,OUI,2025-03-13 11:01:38+00:00,"48.852297362582, 2.3414132371545",Paris,75056,0.8571428571428571,11
6107,Place Alphonse Deville,OUI,22,2,20,11,9,OUI,OUI,2025-03-13 11:01:26+00:00,"48.850188262662, 2.3275961726904",Paris,75056,0.9090909090909091,11
41204,République - Danton,OUI,19,18,1,0,1,OUI,OUI,2025-03-13 11:01:18+00:00,"48.85249172181667, 2.462034523487091",Fontenay-sous-Bois,94033,0.05263157894736842,11
16029,Maison de Radio - France,OUI,41,3,38,36,2,OUI,OUI,2025-03-13 11:01:29+00:00,"48.85132886434057, 2.277785539627075",Paris,75056,0.926829268292683,11
17046,Mac-Mahon - Brey,OUI,24,18,6,4,2,OUI,OUI,2025-03-13 10:54:37+00:00,"48.877532084130166, 2.294512536052928",Paris,75056,0.25,11
8019,Naples - Rome,OUI,25,25,0,0,0,OUI,OUI,2025-03-13 10:59:57+00:00,"48.879960700846226, 2.321358695626259",Paris,75056,0.0,11
17121,Square des Epinettes,OUI,20,19,1,0,1,OUI,OUI,2025-03-13 10:59:28+00:00,"48.89383909781389, 2.325953990221024",Paris,75056,0.05,11
9017,Lallier - Trudaine,OUI,28,23,5,4,1,OUI,OUI,2025-03-13 10:58:15+00:00,"48.88109246617963, 2.3408224806189537",Paris,75056,0.17857142857142858,11
19009,Cité des Sciences et de l'Industrie,OUI,28,21,7,2,5,OUI,OUI,2025-03-13 10:59:49+00:00,"48.89659571178903, 2.384599149227142",Paris,75056,0.25,11
7008,Villersexel - Saint-Germain,OUI,16,1,15,10,5,OUI,OUI,2025-03-13 10:58:19+00:00,"48.858297001218, 2.3237934708595",Paris,75056,0.9375,11
19038,Lassus - Delouvain,OUI,19,19,0,0,0,OUI,OUI,2025-03-13 10:58:12+00:00,"48.8755044846, 2.3890327325519",Paris,75056,0.0,11
14030,Pernety - Raymond Losserand,OUI,32,31,1,0,1,OUI,OUI,2025-03-13 10:54:49+00:00,"48.834254627953, 2.317609339387",Paris,75056,0.03125,11
18029,Emile Blemont - Poteau,OUI,39,36,3,1,2,OUI,OUI,2025-03-13 11:01:15+00:00,"48.8943782, 2.3415122",Paris,75056,0.07692307692307693,11
20201,Eugène Reisz - Davout,OUI,20,19,1,0,1,OUI,OUI,2025-03-13 10:53:38+00:00,"48.85631874632638, 2.410396970808506",Paris,75056,0.05,11
21703,Square du Carrefour de l'Insurrection,OUI,20,18,2,0,2,OUI,OUI,2025-03-13 10:59:25+00:00,"48.820864559770676, 2.291113436222077",Vanves,92075,0.1,11
13046,Eugène Oudiné - Dessous Des Berges,OUI,44,18,26,18,8,OUI,OUI,2025-03-13 11:00:17+00:00,"48.8256423, 2.3750226",Paris,75056,0.5909090909090909,11
16021,François Ponsard - La Muette,OUI,23,21,2,2,0,OUI,OUI,2025-03-13 10:59:13+00:00,"48.8583666, 2.2744515",Paris,75056,0.08695652173913043,11
15003,Gare Montparnasse - Vaugirard,OUI,66,59,7,0,7,OUI,OUI,2025-03-13 10:59:30+00:00,"48.8418071798797, 2.31951002690117",Paris,75056,0.10606060606060606,11
9031,Provence - Chaussée d'Antin,OUI,25,2,23,16,7,OUI,OUI,2025-03-13 11:01:42+00:00,"48.87428447542072, 2.332976511564311",Paris,75056,0.92,11
4110,Neuve Saint-Pierre - Beautreillis,OUI,19,9,10,6,4,OUI,OUI,2025-03-13 11:00:48+00:00,"48.85355351439652, 2.3639122769236565",Paris,75056,0.5263157894736842,11
14002,Edgar Quinet - Raspail,OUI,44,38,6,1,5,OUI,OUI,2025-03-13 10:58:54+00:00,"48.83940266673835, 2.32971478253603",Paris,75056,0.13636363636363635,11
6032,Sabot - Rennes,OUI,26,1,25,22,3,OUI,OUI,2025-03-13 10:59:43+00:00,"48.852575112948415, 2.331552766263485",Paris,75056,0.9615384615384616,11
15035,Place Etienne Pernet,OUI,42,15,27,25,2,OUI,OUI,2025-03-13 11:01:42+00:00,"48.84243457133779, 2.2921819612383847",Paris,75056,0.6428571428571429,11
17022,Pereire - Place de Wagram,OUI,45,42,3,2,1,OUI,OUI,2025-03-13 10:59:44+00:00,"48.887070607581215, 2.304111124531457",Paris,75056,0.06666666666666667,11
18049,Porte d'Aubervilliers,OUI,53,39,14,8,6,OUI,OUI,2025-03-13 11:01:32+00:00,"48.89859661942376, 2.3689722642302513",Paris,75056,0.2641509433962264,11
7020,Champ de Mars - Cler,OUI,39,12,27,25,2,OUI,OUI,2025-03-13 11:01:33+00:00,"48.856691550115315, 2.306646779179573",Paris,75056,0.6923076923076923,11
21014,Hameau Fleuri - Marché,OUI,21,2,19,8,11,OUI,OUI,2025-03-13 11:00:34+00:00,"48.831448892608314, 2.2412404417991643",Boulogne-Billancourt,92012,0.9047619047619048,11
10036,Aqueduc - Villette,OUI,24,23,1,0,1,OUI,OUI,2025-03-13 10:55:59+00:00,"48.883886063895, 2.367198803315",Paris,75056,0.041666666666666664,11
47005,Ecole Vétérinaire,OUI,35,15,20,16,4,OUI,OUI,2025-03-13 11:01:13+00:00,"48.81488859822486, 2.4224362157778994",Maisons-Alfort,94046,0.5714285714285714,11
13103,Hôpital Pitié Salpêtrière,OUI,48,37,11,9,2,OUI,OUI,2025-03-13 10:59:12+00:00,"48.8377016, 2.3604946",Paris,75056,0.22916666666666666,11
16015,Bassano -  Iéna,OUI,15,1,14,4,10,OUI,OUI,2025-03-13 11:01:29+00:00,"48.868144510482075, 2.296149600985935",Paris,75056,0.9333333333333333,11
9101,Cadet - La Fayette,OUI,18,7,11,8,3,OUI,OUI,2025-03-13 10:53:20+00:00,"48.875601632672, 2.3435704037547",Paris,75056,0.6111111111111112,11
15070,Balard - Montagne de la Fage,OUI,35,2,33,28,5,OUI,OUI,2025-03-13 11:01:40+00:00,"48.83850740333351, 2.2782871127128606",Paris,75056,0.9428571428571428,11
18017,Caulaincourt - Place Constantin Pecqueur,OUI,42,41,1,0,1,OUI,OUI,2025-03-13 10:58:53+00:00,"48.889677905028, 2.3381787144261",Paris,75056,0.023809523809523808,11
47004,Stade Auguste Delaune,OUI,21,5,16,16,0,OUI,OUI,2025-03-13 11:00:45+00:00,"48.80896378683884, 2.4345204234123234",Maisons-Alfort,94046,0.7619047619047619,11
19041,Belleville - Pyrénées,OUI,38,38,0,0,0,OUI,OUI,2025-03-13 10:59:30+00:00,"48.8741908, 2.3860039",Paris,75056,0.0,11
11010,Boulets - Faubourg Saint-Antoine,OUI,42,41,1,1,0,OUI,OUI,2025-03-13 11:00:29+00:00,"48.849259262115, 2.3917546141943",Paris,75056,0.023809523809523808,11
32603,Calmette,OUI,31,30,1,1,0,OUI,OUI,2025-03-13 11:01:24+00:00,"48.88104925098552, 2.424993216991425",Les Lilas,93045,0.03225806451612903,11
15002,Maine - Antoine Bourdelle,OUI,17,12,5,4,1,OUI,OUI,2025-03-13 10:59:40+00:00,"48.84308531746595, 2.320263946784738",Paris,75056,0.29411764705882354,11
21311,Parvis Corentin Celton,OUI,52,8,44,41,3,OUI,OUI,2025-03-13 11:01:42+00:00,"48.82747252522725, 2.2784319519996648",Issy-les-Moulineaux,92040,0.8461538461538461,11
23007,Président Wilson - Jean Jaures,OUI,25,16,9,5,4,OUI,OUI,2025-03-13 10:59:20+00:00,"48.89034054052266, 2.2920683026313786",Levallois-Perret,92044,0.36,11
23403,Chateau,OUI,21,17,4,2,2,OUI,OUI,2025-03-13 10:59:12+00:00,"48.774661399959, 2.3135878035462",Bourg-la-Reine,92014,0.19047619047619047,11
20016,Pyrénées - Maraîchers,OUI,32,32,0,0,0,OUI,OUI,2025-03-13 10:54:51+00:00,"48.85714001395299, 2.4043509364128113",Paris,75056,0.0,11
4013,Vieille du Temple - Francs Bourgeois,OUI,28,1,27,21,6,OUI,OUI,2025-03-13 11:00:23+00:00,"48.858256413365815, 2.35821794718504",Paris,75056,0.9642857142857143,11
32015,Gare RER de Saint-Denis,OUI,36,25,11,9,2,OUI,OUI,2025-03-13 11:01:31+00:00,"48.93554324248177, 2.3471488058567047",Saint-Denis,93066,0.3055555555555556,11
45001,Hôtel de Ville de Champigny sur Marne,OUI,21,1,20,9,11,OUI,OUI,2025-03-13 11:01:21+00:00,"48.813810628405, 2.5096759200096",Champigny-sur-Marne,94017,0.9523809523809523,11
16043,Place de Passy,OUI,12,12,0,0,0,OUI,OUI,2025-03-13 11:00:06+00:00,"48.85780291711202, 2.277500546942199",Paris,75056,0.0,11
31023,Place François Mitterand,OUI,34,34,0,0,0,OUI,OUI,2025-03-13 10:52:31+00:00,"48.86492782016328, 2.442958317697048",Montreuil,93048,0.0,11
16027,Mozart - Jasmin,OUI,62,59,3,1,2,OUI,OUI,2025-03-13 10:52:38+00:00,"48.85286124871689, 2.268483570651513",Paris,75056,0.04838709677419355,11
9118,Faubourg Poissonniere - Delta,OUI,36,35,1,0,1,OUI,OUI,2025-03-13 10:57:44+00:00,"48.882555807626765, 2.3497482016682625",Paris,75056,0.027777777777777776,11
20116,Haies - Réunion,OUI,20,20,0,0,0,OUI,OUI,2025-03-13 11:01:44+00:00,"48.85386896766491, 2.402426162238911",Paris,75056,0.0,11
10163,Gare du Nord - Demarquay,OUI,28,25,3,0,3,OUI,OUI,2025-03-13 10:57:49+00:00,"48.881154, 2.358411",Paris,75056,0.10714285714285714,11
18008,Square Léon,OUI,33,31,2,0,2,OUI,OUI,2025-03-13 10:57:25+00:00,"48.88667396788626, 2.353205569088459",Paris,75056,0.06060606060606061,11
20019,Place du Maquis du Vercors,OUI,30,29,1,0,1,OUI,OUI,2025-03-13 10:52:14+00:00,"48.877321579493575, 2.4083782732486725",Paris,75056,0.03333333333333333,11
16112,Chernoviz - Raynouard,OUI,36,32,4,0,4,OUI,OUI,2025-03-13 11:00:48+00:00,"48.8569864146289, 2.282173218142987",Paris,75056,0.1111111111111111,11
18137,Poissonniers - Nord,OUI,28,25,3,2,1,OUI,OUI,2025-03-13 11:00:29+00:00,"48.892511213520656, 2.3522228747606277",Paris,75056,0.10714285714285714,11
42703,Fontainebleau - Edmond Michelet,OUI,45,43,2,1,1,OUI,OUI,2025-03-13 10:56:07+00:00,"48.80956436844049, 2.3626908659935",Le Kremlin-Bicêtre,94043,0.044444444444444446,11
8056,Beaujon - Wagram,OUI,28,26,2,1,1,OUI,OUI,2025-03-13 11:00:24+00:00,"48.875352455985, 2.2964416444302",Paris,75056,0.07142857142857142,11
22102,Mont Valérien - Michel Salles,OUI,24,9,15,11,4,OUI,OUI,2025-03-13 10:58:38+00:00,"48.8561915, 2.2152966",Saint-Cloud,92064,0.625,11
18138,Station Paris Basketball - Ney - Charles Hermite,OUI,20,11,9,6,3,OUI,OUI,2025-03-13 11:00:27+00:00,"48.898748039775, 2.3645754531026",Paris,75056,0.45,11
23304,Mairie de Sceaux,OUI,33,29,4,1,3,OUI,OUI,2025-03-13 10:59:45+00:00,"48.778916905132, 2.2887361764861",Sceaux,92071,0.12121212121212122,11
13041,Porte d'Ivry,OUI,50,42,8,6,2,OUI,OUI,2025-03-13 10:59:56+00:00,"48.821768747596, 2.3688706755638",Paris,75056,0.16,11
6017,Sénat - Condé,OUI,32,2,30,20,10,OUI,OUI,2025-03-13 11:01:42+00:00,"48.84954227788459, 2.337939441204071",Paris,75056,0.9375,11
7016,Surcouf - Université,OUI,55,12,43,36,7,OUI,OUI,2025-03-13 11:01:30+00:00,"48.861273016278, 2.3094535509142",Paris,75056,0.7818181818181819,11
12161,Diderot - Reuilly,OUI,44,5,39,37,2,OUI,OUI,2025-03-13 11:00:47+00:00,"48.847208456061, 2.3861273378134",Paris,75056,0.8863636363636364,11
18019,Square Raymond Souplex,OUI,51,48,3,1,2,OUI,OUI,2025-03-13 10:53:30+00:00,"48.89183721478911, 2.335426103165901",Paris,75056,0.058823529411764705,11
15107,Palais des Sports,OUI,21,1,20,18,2,OUI,OUI,2025-03-13 11:01:28+00:00,"48.833468517426, 2.2858720645308",Paris,75056,0.9523809523809523,11
11043,Place Pasdeloup,OUI,20,0,20,16,4,OUI,OUI,2025-03-13 11:00:05+00:00,"48.862654215631, 2.3670325062844",Paris,75056,1.0,11
11003,Keller - La Roquette,OUI,34,21,13,12,1,OUI,OUI,2025-03-13 10:58:53+00:00,"48.8555508, 2.3752778",Paris,75056,0.38235294117647056,11
1117,Pont Neuf - Rivoli,OUI,24,4,20,14,6,OUI,OUI,2025-03-13 10:58:47+00:00,"48.860089892617, 2.344057559967",Paris,75056,0.8333333333333334,11
11034,Parmentier - Fontaine au Roi,OUI,45,39,6,0,6,OUI,OUI,2025-03-13 10:57:25+00:00,"48.86787670551736, 2.372705978671471",Paris,75056,0.13333333333333333,11
23903,Stade Gaston Bouillant,OUI,29,23,6,3,3,OUI,OUI,2025-03-13 10:59:12+00:00,"48.939958667023, 2.3279571813836",Villeneuve-la-Garenne,92078,0.20689655172413793,11
9012,Rougemont - Poissonnière,OUI,30,7,23,17,6,OUI,OUI,2025-03-13 11:00:42+00:00,"48.871611569354755, 2.345873080193996",Paris,75056,0.7666666666666667,11
13010,Place d'Italie - Vincent Auriol,OUI,39,26,13,1,12,OUI,OUI,2025-03-13 11:01:04+00:00,"48.831481874467, 2.3567550292319",Paris,75056,0.3333333333333333,11
13113,Vistule - Choisy,OUI,33,32,1,1,0,OUI,OUI,2025-03-13 10:52:43+00:00,"48.82365543660611, 2.3615723848342896",Paris,75056,0.030303030303030304,11
31704,Jeanne Hornet - Girardot,OUI,28,27,1,0,1,OUI,OUI,2025-03-13 11:01:32+00:00,"48.873802681432146, 2.427820265293122",Bagnolet,93006,0.03571428571428571,11
13114,Nationale - Marcel Duchamp,OUI,23,14,9,9,0,OUI,OUI,2025-03-13 10:53:01+00:00,"48.82463749337136, 2.3678014799952507",Paris,75056,0.391304347826087,11
17201,Porte Maillot - Perreire,OUI,50,30,20,8,12,OUI,OUI,2025-03-13 11:01:42+00:00,"48.878021154637, 2.2842371277102",Paris,75056,0.4,11
21108,Mairie de Clichy,OUI,44,42,2,2,0,OUI,OUI,2025-03-13 11:01:43+00:00,"48.903653634661, 2.3059353232384",Clichy,92024,0.045454545454545456,11
15059,Parc André Citroën,OUI,64,9,55,52,3,OUI,OUI,2025-03-13 11:01:33+00:00,"48.840639944296655, 2.2780618071556096",Paris,75056,0.859375,11
31018,Gambetta - Michelet,OUI,30,26,4,1,3,OUI,OUI,2025-03-13 11:00:29+00:00,"48.85273792380526, 2.429966032505036",Montreuil,93048,0.13333333333333333,11
21024,Billancourt - Général Leclerc,OUI,22,16,6,4,2,OUI,OUI,2025-03-13 11:01:00+00:00,"48.8322649, 2.2380413",Boulogne-Billancourt,92012,0.2727272727272727,11
47002,Les Juilliottes,OUI,21,8,13,12,1,OUI,OUI,2025-03-13 11:01:37+00:00,"48.8043072, 2.4437362",Maisons-Alfort,94046,0.6190476190476191,11
2001,Greneta - Sebastopol,OUI,32,4,28,21,7,OUI,OUI,2025-03-13 10:58:03+00:00,"48.865242333228, 2.3516669869423",Paris,75056,0.875,11
33005,République - Henri Barbusse,OUI,31,18,13,10,3,OUI,OUI,2025-03-13 11:00:36+00:00,"48.90661553626751, 2.389432489871979",Aubervilliers,93001,0.41935483870967744,11
19023,Manin - Simon Bolivar,OUI,24,23,1,0,1,OUI,OUI,2025-03-13 10:53:55+00:00,"48.876499654127, 2.3794073625991",Paris,75056,0.041666666666666664,11
2110,Jeûneurs - Mulhouse,OUI,27,15,12,7,5,OUI,OUI,2025-03-13 11:00:04+00:00,"48.868997, 2.346925",Paris,75056,0.4444444444444444,11
7101,Raspail - Chomel,OUI,49,8,41,25,16,OUI,OUI,2025-03-13 11:01:13+00:00,"48.852233164303, 2.3266580700874",Paris,75056,0.8367346938775511,11
7026,Place de Finlande,OUI,24,3,21,19,2,OUI,OUI,2025-03-13 11:00:48+00:00,"48.862408335967, 2.3113624379039",Paris,75056,0.875,11
17116,Reims - Porte d'Asnières,OUI,26,14,12,5,7,OUI,OUI,2025-03-13 11:01:06+00:00,"48.891834448210986, 2.300144659954865",Paris,75056,0.46153846153846156,11
5019,Poissy - Saint-Germain,OUI,24,2,22,18,4,OUI,OUI,2025-03-13 10:58:05+00:00,"48.84969649427, 2.3529685288668",Paris,75056,0.9166666666666666,11
4011,Hôtel de Ville - Pont-Marie,OUI,33,4,29,27,2,OUI,OUI,2025-03-13 11:01:09+00:00,"48.853899645527, 2.3569472506642",Paris,75056,0.8787878787878788,11
1016,Thérèse - Opéra,OUI,24,1,23,15,8,OUI,OUI,2025-03-13 10:57:25+00:00,"48.866483514509, 2.3344334212238",Paris,75056,0.9583333333333334,11
12041,Bois de Vincennes.,OUI,58,37,21,7,14,OUI,OUI,2025-03-13 11:00:29+00:00,"48.8338064, 2.4132221",Saint-Mandé,94067,0.3620689655172414,11
17033,Carnot - Général Lanrezac,OUI,29,25,4,2,2,OUI,OUI,2025-03-13 10:52:16+00:00,"48.875443870736, 2.2938242935036",Paris,75056,0.13793103448275862,11
12108,Bercy.,OUI,64,3,61,46,15,OUI,OUI,2025-03-13 10:59:11+00:00,"48.839966914994, 2.3788625746965",Paris,75056,0.953125,11
10164,Claude Vellefaux - Sambre et Meuse,OUI,32,31,1,1,0,OUI,OUI,2025-03-13 10:57:11+00:00,"48.875022, 2.370478",Paris,75056,0.03125,11
14006,Saint-Jacques - Tombe Issoire,OUI,20,17,3,0,3,OUI,OUI,2025-03-13 10:58:18+00:00,"48.833206330538864, 2.3369108140468597",Paris,75056,0.15,11
11107,Faidherbe - Dahomey,OUI,40,18,22,19,3,OUI,OUI,2025-03-13 10:59:53+00:00,"48.851358329771806, 2.383823134795429",Paris,75056,0.55,11
7013,Duroc - Place de Breteuil,OUI,46,20,26,21,5,OUI,OUI,2025-03-13 10:59:40+00:00,"48.847460641142, 2.3126140236855",Paris,75056,0.5652173913043478,11
20103,Le Vau - Maurice Bertaux,OUI,23,23,0,0,0,OUI,OUI,2025-03-13 10:53:04+00:00,"48.86803439043193, 2.411030612453627",Paris,75056,0.0,11
21114,Gustave Eiffel - Parc des Impressionnistes,OUI,30,27,3,1,2,OUI,OUI,2025-03-13 10:54:55+00:00,"48.90390619651018, 2.2946908324956894",Clichy,92024,0.1,11
4109,Mornay - Sully,OUI,13,10,3,1,2,OUI,OUI,2025-03-13 10:58:47+00:00,"48.84970399548416, 2.364460788667202",Paris,75056,0.23076923076923078,11
31013,Centenaire - Sorins,OUI,42,39,3,0,3,OUI,OUI,2025-03-13 10:55:43+00:00,"48.85853523359734, 2.4273508787155156",Montreuil,93048,0.07142857142857142,11
8105,François 1er - Lincoln,OUI,29,3,26,3,23,OUI,OUI,2025-03-13 11:01:22+00:00,"48.869517979344, 2.3024262188416",Paris,75056,0.896551724137931,11
32018,Franciade - Gabriel Péri,OUI,25,16,9,8,1,OUI,OUI,2025-03-13 11:00:40+00:00,"48.93261499331498, 2.355954498052597",Saint-Denis,93066,0.36,11
15058,Place du Moulin de Javel,OUI,58,6,52,39,13,OUI,OUI,2025-03-13 11:01:09+00:00,"48.84021670922, 2.2716060653329",Paris,75056,0.896551724137931,11
17016,Brochant - Square des Batignolles,OUI,31,28,3,1,2,OUI,OUI,2025-03-13 10:59:53+00:00,"48.88818698581028, 2.316861143151153",Paris,75056,0.0967741935483871,11
8049,Georges V - François 1er,OUI,20,8,12,3,9,OUI,OUI,2025-03-13 11:01:39+00:00,"48.87034, 2.30082",Paris,75056,0.6,11
20202,Dupont de l'Eure - Gambetta,OUI,29,29,0,0,0,OUI,OUI,2025-03-13 11:00:45+00:00,"48.8679385, 2.4003649",Paris,75056,0.0,11
12154,Square Georges Melies,OUI,37,25,12,7,5,OUI,OUI,2025-03-13 11:00:54+00:00,"48.84070239213081, 2.409667745232582",Paris,75056,0.32432432432432434,11
15020,Mairie du 15ème,OUI,30,19,11,6,5,OUI,OUI,2025-03-13 10:58:19+00:00,"48.8417762, 2.2986539",Paris,75056,0.36666666666666664,11
19021,Mairie du 19ème,OUI,24,24,0,0,0,OUI,OUI,2025-03-13 10:59:02+00:00,"48.88256264247959, 2.3812624812126164",Paris,75056,0.0,11
41206,Place des Larris,OUI,34,29,5,1,4,OUI,OUI,2025-03-13 10:57:23+00:00,"48.8568363, 2.4780236",Fontenay-sous-Bois,94033,0.14705882352941177,11
22002,Argenson - Château,OUI,24,7,17,12,5,OUI,OUI,2025-03-13 10:59:27+00:00,"48.888559314669514, 2.2642001509666447",Neuilly-sur-Seine,92051,0.7083333333333334,11
19031,Manin - Crimée,OUI,21,20,1,0,1,OUI,OUI,2025-03-13 11:01:18+00:00,"48.8831217743719, 2.3863670602440834",Paris,75056,0.047619047619047616,11
35008,Place de l'Eglise - Pantin,OUI,28,27,1,0,1,OUI,OUI,2025-03-13 11:00:20+00:00,"48.892809461520265, 2.4124351143836975",Pantin,93055,0.03571428571428571,11
15061,Square Desnouettes,OUI,21,5,16,12,4,OUI,OUI,2025-03-13 11:01:06+00:00,"48.83476837934194, 2.284142297394666",Paris,75056,0.7619047619047619,11
13022,Butte aux Cailles - Esperance,OUI,30,28,2,2,0,OUI,OUI,2025-03-13 11:01:11+00:00,"48.82758774190948, 2.3492151126265526",Paris,75056,0.06666666666666667,11
20017,Saint-Blaise - Mouraud,OUI,27,25,2,0,2,OUI,OUI,2025-03-13 10:59:54+00:00,"48.85696177597818, 2.40869477391243",Paris,75056,0.07407407407407407,11
20045,Louis Ganne - Davout,OUI,30,30,0,0,0,OUI,OUI,2025-03-13 10:57:11+00:00,"48.86338720692607, 2.409725748002529",Paris,75056,0.0,11
11019,Charonne - Philippe-Auguste,OUI,31,30,1,0,1,OUI,OUI,2025-03-13 10:53:46+00:00,"48.855603162026, 2.39054639062",Paris,75056,0.03225806451612903,11
13019,Fernand Braudel - Vincent Auriol,OUI,36,14,22,15,7,OUI,OUI,2025-03-13 11:00:44+00:00,"48.83637852318147, 2.3723404482007027",Paris,75056,0.6111111111111112,11
23008,Hôtel de Ville de Levallois Perret,OUI,26,12,14,9,5,OUI,OUI,2025-03-13 11:01:30+00:00,"48.89314451997415, 2.2888818383216862",Levallois-Perret,92044,0.5384615384615384,11
5030,Sorbonne - Ecoles,OUI,47,3,44,13,31,OUI,OUI,2025-03-13 11:01:32+00:00,"48.849686566191, 2.3434996604919",Paris,75056,0.9361702127659575,11
8015,Roquépine - Malesherbes,OUI,50,5,45,22,23,OUI,OUI,2025-03-13 11:01:41+00:00,"48.87345073390807, 2.320404499769211",Paris,75056,0.9,11
21952,Place Tony de Graaff,OUI,42,21,21,19,2,OUI,OUI,2025-03-13 11:00:37+00:00,"48.8181645, 2.2458109",Meudon,92048,0.5,11
6014,Pont de Lodi - Dauphine,OUI,21,4,17,9,8,OUI,OUI,2025-03-13 11:00:40+00:00,"48.855296898603285, 2.339947307565249",Paris,75056,0.8095238095238095,11
9015,Lamartine - Faubourg Montmartre,OUI,30,5,25,15,10,OUI,OUI,2025-03-13 11:00:21+00:00,"48.876613982891, 2.3397656902671",Paris,75056,0.8333333333333334,11
14116,Romain Rolland,OUI,25,24,1,0,1,OUI,OUI,2025-03-13 10:57:52+00:00,"48.820215229662765, 2.3234144234418346",Montrouge,92049,0.04,11
16031,Vignes - Boulainvilliers,OUI,19,17,2,0,2,OUI,OUI,2025-03-13 10:55:46+00:00,"48.856399483950504, 2.275240458548069",Paris,75056,0.10526315789473684,11
14007,Ferrus - Saint-Jacques,OUI,33,29,4,2,2,OUI,OUI,2025-03-13 10:58:56+00:00,"48.8313878, 2.3408563",Paris,75056,0.12121212121212122,11
21017,Place Marcel Sembat,OUI,55,0,55,46,9,OUI,OUI,2025-03-13 11:00:42+00:00,"48.83328865030686, 2.2441747784614567",Boulogne-Billancourt,92012,1.0,11
9113,Bleue - Trévise,OUI,27,12,15,7,8,OUI,OUI,2025-03-13 11:01:13+00:00,"48.87578906564573, 2.347289621829987",Paris,75056,0.5555555555555556,11
12033,François Truffaut - Saint Emilion,OUI,66,20,46,43,3,OUI,OUI,2025-03-13 11:01:42+00:00,"48.83372354344807, 2.386601903271428",Paris,75056,0.696969696969697,11
2014,Daunou - Louis le Grand,OUI,30,1,29,11,18,OUI,OUI,2025-03-13 11:00:15+00:00,"48.869113, 2.332515",Paris,75056,0.9666666666666667,11
18142,Jessaint - Marx Dormoy,OUI,30,29,1,0,1,OUI,OUI,2025-03-13 10:55:25+00:00,"48.88484543106364, 2.358930408954621",Paris,75056,0.03333333333333333,11
3101,Porte Saint-Martin,OUI,31,1,30,19,11,OUI,OUI,2025-03-13 11:01:37+00:00,"48.86860172112996, 2.35570102930069",Paris,75056,0.967741935483871,11
23105,Sèvres Rive Gauche,OUI,33,20,13,13,0,OUI,OUI,2025-03-13 10:53:28+00:00,"48.821443218278, 2.2150785306885",Sèvres,92072,0.3939393939393939,11
11048,Place Mireille Havet,OUI,42,12,30,23,7,OUI,OUI,2025-03-13 11:01:40+00:00,"48.850533, 2.383756",Paris,75056,0.7142857142857143,11
21120,Docteur Calmette - Martre,OUI,30,14,16,15,1,OUI,OUI,2025-03-13 10:59:19+00:00,"48.898969358483, 2.3086513252383",Clichy,92024,0.5333333333333333,11
2101,Bachaumont - Montmartre,OUI,33,6,27,25,2,OUI,OUI,2025-03-13 10:58:11+00:00,"48.86617395079137, 2.3449775576591496",Paris,75056,0.8181818181818182,11
20117,Saint-Fargeau - Mortier,OUI,31,30,1,0,1,OUI,OUI,2025-03-13 10:59:13+00:00,"48.87266656122256, 2.407912909984589",Paris,75056,0.03225806451612903,11
22017,Charles de Gaulle - Louis Philippe,OUI,27,14,13,8,5,OUI,OUI,2025-03-13 11:01:24+00:00,"48.881742142181, 2.2710045335353",Neuilly-sur-Seine,92051,0.48148148148148145,11
31017,Jean Moulin - Paul Doumer,OUI,17,15,2,0,2,OUI,OUI,2025-03-13 11:01:36+00:00,"48.8622179854695, 2.45533436536789",Montreuil,93048,0.11764705882352941,11
17104,Jardin Marguerite Long,OUI,21,15,6,2,4,OUI,OUI,2025-03-13 10:54:42+00:00,"48.8816985773914, 2.2836575657129288",Paris,75056,0.2857142857142857,11
22403,Pierre Brossolette - Adolphe Pinard,OUI,23,22,1,1,0,OUI,OUI,2025-03-13 10:59:15+00:00,"48.821772279548, 2.3131558299065",Malakoff,92046,0.043478260869565216,11
19030,Melun - Jean Jaurès,OUI,27,24,3,2,1,OUI,OUI,2025-03-13 10:56:53+00:00,"48.8837796723475, 2.376477420330048",Paris,75056,0.1111111111111111,11
42011,Quai Marcel Boyer - Victor Hugo,OUI,29,5,24,21,3,OUI,OUI,2025-03-13 10:58:30+00:00,"48.822556366667, 2.3920395970345",Ivry-sur-Seine,94041,0.8275862068965517,11
21004,Jean Jaurès - Reine,OUI,31,3,28,23,5,OUI,OUI,2025-03-13 11:01:17+00:00,"48.84009622558849, 2.239872515201569",Boulogne-Billancourt,92012,0.9032258064516129,11
20047,Cours de Vincennes - Davout,OUI,48,42,6,4,2,OUI,OUI,2025-03-13 11:01:20+00:00,"48.847238029966, 2.4107042336225",Paris,75056,0.125,11
11044,Square du Bataclan,OUI,16,3,13,12,1,OUI,OUI,2025-03-13 11:00:11+00:00,"48.8633762, 2.3711327",Paris,75056,0.8125,11
9013,Mairie du 9ème,OUI,24,8,16,13,3,OUI,OUI,2025-03-13 10:56:09+00:00,"48.873267137583, 2.3407534480528",Paris,75056,0.6666666666666666,11
16041,Versailles - Claude Terrasse,OUI,45,17,28,25,3,OUI,OUI,2025-03-13 11:00:25+00:00,"48.840219338074, 2.263834191153",Paris,75056,0.6222222222222222,11
92005,Gare de Nanterre Ville,OUI,42,17,25,20,5,OUI,OUI,2025-03-13 11:00:41+00:00,"48.8950295, 2.1957932",Nanterre,92050,0.5952380952380952,11
8029,Place du Canada,OUI,56,4,52,24,28,OUI,OUI,2025-03-13 11:01:19+00:00,"48.865346269363, 2.3101937879648",Paris,75056,0.9285714285714286,11
10039,Sambre et Meuse - Villette,OUI,24,21,3,2,1,OUI,OUI,2025-03-13 10:54:18+00:00,"48.874405666217, 2.3738072379951",Paris,75056,0.125,11
11110,Roquette - Folie Regnault,OUI,50,48,2,0,2,OUI,OUI,2025-03-13 10:58:31+00:00,"48.859246959155485, 2.386553623578705",Paris,75056,0.04,11
31101,Jules Guesde - Laennec,OUI,19,14,5,0,5,OUI,OUI,2025-03-13 10:55:12+00:00,"48.87628983900398, 2.5006942078471184",Rosny-sous-Bois,93064,0.2631578947368421,11
12153,Terroirs de France - Lheureux,OUI,55,15,40,19,21,OUI,OUI,2025-03-13 11:01:42+00:00,"48.83212027074841, 2.388618104159832",Paris,75056,0.7272727272727273,11
31026,Demi-Lune - Aristide Briand,OUI,20,20,0,0,0,OUI,OUI,2025-03-13 10:59:05+00:00,"48.87626381919953, 2.4562818557024",Montreuil,93048,0.0,11
17005,Brochant - Clichy,OUI,52,52,0,0,0,OUI,OUI,2025-03-13 10:54:41+00:00,"48.89032998912038, 2.319730559929781",Paris,75056,0.0,11
17001,Guy Môquet - Saint-Ouen,OUI,44,42,2,1,1,OUI,OUI,2025-03-13 11:00:42+00:00,"48.892777719023975, 2.3270335793495183",Paris,75056,0.045454545454545456,11
14127,Odessa - Départ,OUI,39,25,14,6,8,OUI,OUI,2025-03-13 10:57:22+00:00,"48.842885590081, 2.3244281485677",Paris,75056,0.358974358974359,11
35004,Place du Président Salvador Allende,OUI,58,46,12,2,10,OUI,OUI,2025-03-13 11:01:40+00:00,"48.897307310356055, 2.40079153681279",Pantin,93055,0.20689655172413793,11
14016,René Coty - Parc Montsouris,OUI,54,53,1,0,1,OUI,OUI,2025-03-13 11:01:34+00:00,"48.82479134498032, 2.336124926805496",Paris,75056,0.018518518518518517,11
13020,Paul Klee - Place Augusta Holmes,OUI,43,16,27,6,21,OUI,OUI,2025-03-13 10:59:00+00:00,"48.838946417408025, 2.3704235663952966",Paris,75056,0.627906976744186,11
12120,Lac Daumesnil - Saint-Maurice,OUI,49,36,13,10,3,OUI,OUI,2025-03-13 10:53:57+00:00,"48.82774555743318, 2.4183654785156246",Paris,75056,0.2653061224489796,11
35015,Averroès - Aimé Césaire,OUI,18,14,4,4,0,OUI,OUI,2025-03-13 11:00:12+00:00,"48.91405323432864, 2.412636950612068",Pantin,93055,0.2222222222222222,11
22012,Madeleine Michelis - Roule,OUI,23,19,4,3,1,OUI,OUI,2025-03-13 11:01:32+00:00,"48.88260431301364, 2.2773634269833565",Neuilly-sur-Seine,92051,0.17391304347826086,11
15019,Paul Barruel - Vaugirard,OUI,36,34,2,1,1,OUI,OUI,2025-03-13 11:00:30+00:00,"48.84014918546239, 2.3044332861900334",Paris,75056,0.05555555555555555,11
4010,Saint-Antoine Sévigné,OUI,27,10,17,11,6,OUI,OUI,2025-03-13 11:01:36+00:00,"48.8550222, 2.3612322",Paris,75056,0.6296296296296297,11
20203,Evariste Galois,OUI,20,19,1,0,1,OUI,OUI,2025-03-13 11:01:36+00:00,"48.873341356228, 2.4133544409574",Paris,75056,0.05,11
18035,René Binet - Porte de Montmartre,OUI,36,28,8,2,6,OUI,OUI,2025-03-13 11:01:43+00:00,"48.89905109950848, 2.3365534096956253",Paris,75056,0.2222222222222222,11
20004,Commandant l'Herminier - Gallieni,OUI,17,16,1,1,0,OUI,OUI,2025-03-13 10:56:01+00:00,"48.847040552603, 2.4160453677177",Paris,75056,0.058823529411764705,11
13110,Moulin de la Pointe,OUI,20,18,2,1,1,OUI,OUI,2025-03-13 10:57:29+00:00,"48.82092946051445, 2.3563179373741145",Paris,75056,0.1,11
12150,Bastille - Quai de la Rapée,OUI,27,2,25,18,7,OUI,OUI,2025-03-13 11:00:48+00:00,"48.84682410855, 2.3669364675879",Paris,75056,0.9259259259259259,11
15009,Suffren - Pérignon,OUI,44,9,35,31,4,OUI,OUI,2025-03-13 11:01:43+00:00,"48.84717561492764, 2.307052147596786",Paris,75056,0.7954545454545454,11
12125,Pyramide - Parc Floral,OUI,49,47,2,1,1,OUI,OUI,2025-03-13 10:59:34+00:00,"48.837442, 2.440452",Paris,75056,0.04081632653061224,11
23005,Gare de Clichy-Levallois,OUI,25,10,15,14,1,OUI,OUI,2025-03-13 11:01:32+00:00,"48.89679827481989, 2.2984680533409123",Levallois-Perret,92044,0.6,11
13515,Auguste Blanqui - Glacière,OUI,59,54,5,5,0,OUI,OUI,2025-03-13 10:58:32+00:00,"48.831151602964, 2.343822196126",Paris,75056,0.0847457627118644,11
48009,République - Auguste Perret,OUI,30,30,0,0,0,OUI,OUI,2025-03-13 10:55:33+00:00,"48.78695280952244, 2.3518594354391094",Villejuif,94076,0.0,11
9016,Choron - Martyrs,OUI,17,12,5,2,3,OUI,OUI,2025-03-13 10:59:07+00:00,"48.877851443503, 2.3396701365709",Paris,75056,0.29411764705882354,11
14125,Dareau - Broussais,OUI,21,19,2,0,2,OUI,OUI,2025-03-13 11:00:33+00:00,"48.8307758, 2.3361804",Paris,75056,0.09523809523809523,11
10037,Quai de Valmy,OUI,26,23,3,2,1,OUI,OUI,2025-03-13 10:57:48+00:00,"48.88126951579429, 2.368186041712761",Paris,75056,0.11538461538461539,11
21009,Le Corbusier - Jean Jaurès,OUI,45,17,28,16,12,OUI,OUI,2025-03-13 11:00:51+00:00,"48.83780830557548, 2.2408381104469304",Boulogne-Billancourt,92012,0.6222222222222222,11
15125,Parc Suzanne Lenglen,OUI,51,2,49,46,3,OUI,OUI,2025-03-13 11:01:10+00:00,"48.833250690537874, 2.2765403240919113",Paris,75056,0.9607843137254902,11
13047,Boutroux - Porte de Vitry,OUI,49,29,20,19,1,OUI,OUI,2025-03-13 10:58:49+00:00,"48.822632, 2.377738",Paris,75056,0.40816326530612246,11
13117,Stade Georges Carpentier,OUI,39,32,7,3,4,OUI,OUI,2025-03-13 10:59:54+00:00,"48.820482438381, 2.3668321967125",Paris,75056,0.1794871794871795,11
18114,Véron - Lepic,OUI,23,22,1,0,1,OUI,OUI,2025-03-13 11:00:41+00:00,"48.88526123395252, 2.334559857845307",Paris,75056,0.043478260869565216,11
13027,Mazagran - Pierre de Coubertin,OUI,15,11,4,1,3,OUI,OUI,2025-03-13 10:55:38+00:00,"48.816218640260445, 2.344226874411106",Paris,75056,0.26666666666666666,11
44103,Pont De Charenton,OUI,18,6,12,12,0,OUI,OUI,2025-03-13 11:01:33+00:00,"48.8179685, 2.4199531",Saint-Maurice,94069,0.6666666666666666,11
11103,Pelée - Alphonse Baudin,OUI,35,18,17,12,5,OUI,OUI,2025-03-13 11:01:11+00:00,"48.8600265, 2.3710541",Paris,75056,0.4857142857142857,11
4107,Beaumarchais - Pas de la Mule,OUI,17,2,15,8,7,OUI,OUI,2025-03-13 11:01:32+00:00,"48.855580507049, 2.3684333673431",Paris,75056,0.8823529411764706,11
21203,Place Jules Ferry,OUI,28,28,0,0,0,OUI,OUI,2025-03-13 11:00:11+00:00,"48.812107928414775, 2.325837314128876",Montrouge,92049,0.0,11
21951,Place Centrale,OUI,22,21,1,1,0,OUI,OUI,2025-03-13 10:52:12+00:00,"48.78740167690531, 2.2278830409049992",Meudon,92048,0.045454545454545456,11
21029,Cours de l'Ile Seguin - Parc Billancourt,OUI,28,11,17,9,8,OUI,OUI,2025-03-13 11:01:40+00:00,"48.82714055843935, 2.234234511852265",Boulogne-Billancourt,92012,0.6071428571428571,11
22103,Senard - Charles Blum,OUI,24,8,16,5,11,OUI,OUI,2025-03-13 10:59:02+00:00,"48.857315824799, 2.221091687679291",Saint-Cloud,92064,0.6666666666666666,11
10153,Gare du Nord - Denain,OUI,20,17,3,0,3,OUI,OUI,2025-03-13 10:59:58+00:00,"48.879595787608, 2.3544725775719",Paris,75056,0.15,11
19113,Pré Saint-Gervais - Lilas,OUI,27,27,0,0,0,OUI,OUI,2025-03-13 10:56:43+00:00,"48.877870626988, 2.3959073424339",Paris,75056,0.0,11
15072,Place Fernand Forest,OUI,28,0,28,21,7,OUI,OUI,2025-03-13 11:00:36+00:00,"48.849269143836, 2.281863167882",Paris,75056,1.0,11
14128,Gergovie - Vercingétorix,OUI,29,28,1,0,1,OUI,OUI,2025-03-13 11:00:59+00:00,"48.83453413883994, 2.313154547426182",Paris,75056,0.034482758620689655,11
12006,Gare de Lyon - Van Gogh,OUI,41,3,38,27,11,OUI,OUI,2025-03-13 11:00:06+00:00,"48.843839785643, 2.3704450240357",Paris,75056,0.926829268292683,11
19036,Hôpital Robert Debré,OUI,33,31,2,0,2,OUI,OUI,2025-03-13 10:56:48+00:00,"48.88005222200894, 2.4008650346327003",Paris,75056,0.06060606060606061,11
16014,Eylau - Trocadéro,OUI,22,10,12,0,12,OUI,OUI,2025-03-13 11:00:27+00:00,"48.863354122371, 2.2864209115505",Paris,75056,0.5454545454545454,11
12129,Bois de Vincennes - Porte Jaune,OUI,35,32,3,2,1,OUI,OUI,2025-03-13 10:58:30+00:00,"48.838751246689455, 2.4605489149689674",Paris,75056,0.08571428571428572,11
10110,Louis Blanc - Jemmapes,OUI,31,23,8,1,7,OUI,OUI,2025-03-13 11:00:57+00:00,"48.879330755297, 2.3684485629201",Paris,75056,0.25806451612903225,11
31707,Edouard Vaillant - Galliéni,OUI,48,46,2,0,2,OUI,OUI,2025-03-13 10:55:02+00:00,"48.858462881661, 2.4147954583168",Bagnolet,93006,0.041666666666666664,11
42304,Marc Sangnier - Division Leclerc,OUI,20,7,13,12,1,OUI,OUI,2025-03-13 11:01:15+00:00,"48.78599652305309, 2.329955510795116",Cachan,94016,0.65,11
8011,Clapeyron - Moscou,OUI,15,14,1,0,1,OUI,OUI,2025-03-13 11:00:08+00:00,"48.88078819514121, 2.324815057218075",Paris,75056,0.06666666666666667,11
16115,Raffet - Montmorency,OUI,40,40,0,0,0,OUI,OUI,2025-03-13 11:01:29+00:00,"48.85258670812, 2.2629252456151954",Paris,75056,0.0,11
19124,Alexander Fleming - Belvédère,OUI,31,29,2,1,1,OUI,OUI,2025-03-13 10:53:00+00:00,"48.88179064200294, 2.4030599377642674",Paris,75056,0.06451612903225806,11
21031,Cimetière de Boulogne-Billancourt,OUI,40,9,31,24,7,OUI,OUI,2025-03-13 10:59:16+00:00,"48.830764, 2.252024",Boulogne-Billancourt,92012,0.775,11
7010,Constantine - Université,OUI,59,9,50,40,10,OUI,OUI,2025-03-13 11:00:55+00:00,"48.860680473738, 2.3148481955842",Paris,75056,0.847457627118644,11
17039,Place Saint-Ferdinand,OUI,38,30,8,1,7,OUI,OUI,2025-03-13 11:00:40+00:00,"48.87815529789739, 2.288518047864942",Paris,75056,0.21052631578947367,11
14113,Santé - Arago,OUI,36,30,6,5,1,OUI,OUI,2025-03-13 11:01:14+00:00,"48.83507657562064, 2.3415737262044938",Paris,75056,0.16666666666666666,11
22604,Hôtel de Ville de Fontenay-aux-Roses,OUI,32,32,0,0,0,OUI,OUI,2025-03-13 11:01:20+00:00,"48.790844603480856, 2.2871455930319455",Fontenay-aux-Roses,92032,0.0,11
32021,Place du Front Populaire - George Sand,OUI,64,43,21,19,2,OUI,OUI,2025-03-13 11:01:39+00:00,"48.90680713698062, 2.364541214992642",Saint-Denis,93066,0.328125,11
42305,Vanne - Saussaies,OUI,20,19,1,0,1,OUI,OUI,2025-03-13 11:01:04+00:00,"48.786404, 2.338848",Cachan,94016,0.05,11
7024,Rapp - Place du Général Gouraud,OUI,29,17,12,8,4,OUI,OUI,2025-03-13 11:01:43+00:00,"48.858102885107, 2.3004072904587",Paris,75056,0.41379310344827586,11
11032,Jean-Pierre Timbaud - Vaucouleurs,OUI,45,41,4,1,3,OUI,OUI,2025-03-13 10:59:10+00:00,"48.867937, 2.377885",Paris,75056,0.08888888888888889,11
11031,Jacquard - Ternaux,OUI,39,22,17,14,3,OUI,OUI,2025-03-13 10:56:05+00:00,"48.8646605, 2.373162",Paris,75056,0.4358974358974359,11
16101,Malakoff - Place de la Porte Maillot,OUI,26,14,12,3,9,OUI,OUI,2025-03-13 10:54:09+00:00,"48.876733496638, 2.2834577411413",Paris,75056,0.46153846153846156,11
10152,Gare du Nord - Place de Valenciennes,OUI,23,21,2,0,2,OUI,OUI,2025-03-13 10:59:37+00:00,"48.879089, 2.354235",Paris,75056,0.08695652173913043,11
21307,Victor Cresson - Telles de la Poterie,OUI,29,18,11,8,3,OUI,OUI,2025-03-13 11:00:43+00:00,"48.822698842979, 2.2686498274964",Issy-les-Moulineaux,92040,0.3793103448275862,11
15131,Charles Lecocq - Lecourbe,OUI,28,21,7,6,1,OUI,OUI,2025-03-13 10:56:39+00:00,"48.84044, 2.294867",Paris,75056,0.25,11
10012,Vinaigriers - Magenta,OUI,24,13,11,7,4,OUI,OUI,2025-03-13 11:00:14+00:00,"48.8731167, 2.3593052",Paris,75056,0.4583333333333333,11
9036,Athènes - Clichy,OUI,18,9,9,4,5,OUI,OUI,2025-03-13 11:01:30+00:00,"48.878113787876, 2.32956021945824",Paris,75056,0.5,11
21028,Pierre Lefaucheux - Traversière,OUI,34,12,22,15,7,OUI,OUI,2025-03-13 11:01:05+00:00,"48.82435208303827, 2.2417913004755974",Boulogne-Billancourt,92012,0.6470588235294118,11
17029,Pierre Demours - Laugier,OUI,36,31,5,2,3,OUI,OUI,2025-03-13 10:56:54+00:00,"48.8813072, 2.294846",Paris,75056,0.1388888888888889,11
4003,Quai aux Fleurs - Pont Saint-Louis,OUI,21,5,16,16,0,OUI,OUI,2025-03-13 11:01:29+00:00,"48.852915956209, 2.3521957173944",Paris,75056,0.7619047619047619,11
10004,Metz - Faubourg Saint-Denis,OUI,44,14,30,20,10,OUI,OUI,2025-03-13 10:59:14+00:00,"48.870893, 2.353521",Paris,75056,0.6818181818181818,11
32301,Mairie de Romainville,OUI,17,16,1,0,1,OUI,OUI,2025-03-13 10:53:55+00:00,"48.885109, 2.435679",Romainville,93063,0.058823529411764705,11
21118,Neuilly - Petit,OUI,14,10,4,3,1,OUI,OUI,2025-03-13 10:56:44+00:00,"48.898965361341254, 2.29627937078476",Clichy,92024,0.2857142857142857,11
23902,Gallieni - Lycée Charles Petitet,OUI,44,21,23,17,6,OUI,OUI,2025-03-13 11:00:07+00:00,"48.927640283627, 2.3308986340524",Villeneuve-la-Garenne,92078,0.5227272727272727,11
20039,Belleville - Couronnes,OUI,48,45,3,2,1,OUI,OUI,2025-03-13 11:01:08+00:00,"48.868831082877, 2.3809862136841",Paris,75056,0.0625,11
20007,Buzenval - Avron,OUI,49,45,4,3,1,OUI,OUI,2025-03-13 10:55:35+00:00,"48.851617204999, 2.4015135973077",Paris,75056,0.08163265306122448,11
5034,Censier - Santeuil,OUI,66,11,55,41,14,OUI,OUI,2025-03-13 10:59:50+00:00,"48.840658921385234, 2.3537524044513702",Paris,75056,0.8333333333333334,11
20122,Vitruve - Davout,OUI,23,22,1,0,1,OUI,OUI,2025-03-13 10:58:06+00:00,"48.86053161154489, 2.4091592812626543",Paris,75056,0.043478260869565216,11
10017,Gare de l'Est - Fidélité,OUI,12,5,7,5,2,OUI,OUI,2025-03-13 11:01:42+00:00,"48.874575, 2.356796",Paris,75056,0.5833333333333334,11
16020,Place de la Porte de Passy,OUI,34,28,6,3,3,OUI,OUI,2025-03-13 10:59:02+00:00,"48.857341095470794, 2.2644165538827115",Paris,75056,0.17647058823529413,11
22013,Mairie de Neuilly sur Seine,OUI,31,23,8,5,3,OUI,OUI,2025-03-13 10:58:45+00:00,"48.88494728765838, 2.2677031159400944",Neuilly-sur-Seine,92051,0.25806451612903225,11
14101,Gare Montparnasse - Edgar Quinet,OUI,33,24,9,4,5,OUI,OUI,2025-03-13 10:57:45+00:00,"48.841487851079, 2.3233232282801",Paris,75056,0.2727272727272727,11
21316,Cimetière d'Issy-les-Moulineaux,OUI,23,21,2,1,1,OUI,OUI,2025-03-13 11:01:17+00:00,"48.817699773925, 2.2609312087297",Issy-les-Moulineaux,92040,0.08695652173913043,11
17015,Place de Lévis,OUI,48,46,2,1,1,OUI,OUI,2025-03-13 10:58:09+00:00,"48.883546851533254, 2.3131933808326726",Paris,75056,0.041666666666666664,11
19025,Botzaris - Crimée,OUI,20,19,1,0,1,OUI,OUI,2025-03-13 10:59:25+00:00,"48.87959698690176, 2.3887913337477067",Paris,75056,0.05,11
15023,La Motte-Picquet - Grenelle,OUI,34,10,24,22,2,OUI,OUI,2025-03-13 11:01:24+00:00,"48.84858321339195, 2.299347817897797",Paris,75056,0.7058823529411765,11
16009,Saint-Didier - Raymond Poincaré,OUI,17,9,8,1,7,OUI,OUI,2025-03-13 11:00:52+00:00,"48.86642312020962, 2.285863497192411",Paris,75056,0.47058823529411764,11
4001,Arcole - Notre-Dame,OUI,27,12,15,4,11,OUI,OUI,2025-03-13 11:01:03+00:00,"48.853883541328, 2.3493797332048",Paris,75056,0.5555555555555556,11
16003,André Maurois - Joseph et Marie Hackin,OUI,27,9,18,13,5,OUI,OUI,2025-03-13 11:01:39+00:00,"48.8778983, 2.2789591",Paris,75056,0.6666666666666666,11
40009,Lycée Saint Exupéry - Juliette Savar,OUI,29,19,10,8,2,OUI,OUI,2025-03-13 10:58:56+00:00,"48.783021513972, 2.4637357216879",Créteil,94028,0.3448275862068966,11
16007,Longchamp - Place d'Iéna,OUI,25,5,20,6,14,OUI,OUI,2025-03-13 11:01:42+00:00,"48.864917233434, 2.2926748171449",Paris,75056,0.8,11
12043,Daumesnil - Hébrard,OUI,39,20,19,15,4,OUI,OUI,2025-03-13 11:01:23+00:00,"48.8429, 2.38474",Paris,75056,0.48717948717948717,11
21115,Chancé Milly - Cimetière Communal Sud,OUI,32,15,17,13,4,OUI,OUI,2025-03-13 10:58:40+00:00,"48.89687189382465, 2.303922325372696",Clichy,92024,0.53125,11
23003,Président Wilson - Baudin,OUI,28,9,19,15,4,OUI,OUI,2025-03-13 10:59:32+00:00,"48.89826887103676, 2.2849336266517644",Levallois-Perret,92044,0.6785714285714286,11
21708,Marcel Yol - Jullien,OUI,29,26,3,1,2,OUI,OUI,2025-03-13 11:00:52+00:00,"48.82537611802588, 2.287235018058929",Vanves,92075,0.10344827586206896,11
14131,Jourdan - Monticelli,OUI,30,28,2,0,2,OUI,OUI,2025-03-13 10:59:44+00:00,"48.822032, 2.329095",Paris,75056,0.06666666666666667,11
13048,Wurtz - Tolbiac,OUI,28,28,0,0,0,NON,NON,2025-03-13 10:56:00+00:00,"48.82631195621, 2.344585955143",Paris,75056,0.0,11
19108,Gaston Tessier - Rosa Parks RER,OUI,37,28,9,7,2,OUI,OUI,2025-03-13 10:57:30+00:00,"48.8963765, 2.3743692",Paris,75056,0.24324324324324326,11
41210,Hôtel de ville de Fontenay-sous-Bois,OUI,19,17,2,0,2,OUI,OUI,2025-03-13 10:52:32+00:00,"48.84949749106274, 2.4750164151191716",Fontenay-sous-Bois,94033,0.10526315789473684,11
44007,Camille Groult - Guy Môquet,OUI,21,7,14,11,3,OUI,OUI,2025-03-13 10:58:42+00:00,"48.787482746521306, 2.3976725712418556",Vitry-sur-Seine,94081,0.6666666666666666,11
21702,Gare SNCF Vanves-Malakoff,OUI,49,47,2,2,0,OUI,OUI,2025-03-13 11:00:47+00:00,"48.819002163836444, 2.292150005103606",Vanves,92075,0.04081632653061224,11
10105,Mazagran - Bonne Nouvelle,OUI,25,10,15,8,7,OUI,OUI,2025-03-13 10:59:55+00:00,"48.870047123655, 2.3511248454452",Paris,75056,0.6,11
11109,Pierre Levée - Fontaine Timbaud,OUI,21,16,5,0,5,OUI,OUI,2025-03-13 10:55:13+00:00,"48.86632723374305, 2.3711163550615306",Paris,75056,0.23809523809523808,11
42501,Raspail - Albert Schweitzer,OUI,27,8,19,18,1,OUI,OUI,2025-03-13 11:00:54+00:00,"48.81031545, 2.34395871",Gentilly,94037,0.7037037037037037,11
15052,Convention - Vaugirard,OUI,44,40,4,2,2,OUI,OUI,2025-03-13 11:01:06+00:00,"48.83767682233156, 2.295586926020252",Paris,75056,0.09090909090909091,11
13109,Brillat-Savarin - Küss,OUI,21,17,4,3,1,OUI,OUI,2025-03-13 11:01:30+00:00,"48.822203, 2.350422",Paris,75056,0.19047619047619047,11
31021,Résistance - Hoche,OUI,28,28,0,0,0,OUI,OUI,2025-03-13 10:53:44+00:00,"48.864273423741956, 2.435784414410591",Montreuil,93048,0.0,11
21204,Estienne d'Orves - Henri Ginoux,OUI,31,27,4,3,1,OUI,OUI,2025-03-13 10:56:23+00:00,"48.815388220397274, 2.320886790760933",Montrouge,92049,0.12903225806451613,11
44002,Paul Vaillant-Couturier - Gare RER,OUI,25,0,25,20,5,OUI,OUI,2025-03-13 11:00:49+00:00,"48.80108159069614, 2.402097210288048",Vitry-sur-Seine,94081,1.0,11
43001,Paris - Laitières,OUI,22,7,15,2,13,OUI,OUI,2025-03-13 11:00:37+00:00,"48.84630274151258, 2.4207553267478947",Vincennes,94080,0.6818181818181818,11
15123,Commerce - Letellier,OUI,44,28,16,9,7,OUI,OUI,2025-03-13 10:58:59+00:00,"48.84797660373612, 2.2966245196598805",Paris,75056,0.36363636363636365,11
22206,Louis Pasteur - Albert Petit,OUI,30,27,3,0,3,OUI,OUI,2025-03-13 11:00:34+00:00,"48.796261, 2.317289",Bagneux,92007,0.1,11
13039,Ivry - Simone Weil,OUI,18,12,6,5,1,OUI,OUI,2025-03-13 10:58:35+00:00,"48.823283932030755, 2.3659095168113713",Paris,75056,0.3333333333333333,11
21217,Louis Rolland - République,OUI,26,25,1,0,1,OUI,OUI,2025-03-13 11:00:28+00:00,"48.81710889740748, 2.3193106434955717",Montrouge,92049,0.038461538461538464,11
21030,Fessart - Château,OUI,20,3,17,16,1,OUI,OUI,2025-03-13 11:01:02+00:00,"48.84245, 2.23989",Boulogne-Billancourt,92012,0.85,11
15030,Emeriau - Beaugrenelle,OUI,73,7,66,58,8,OUI,OUI,2025-03-13 11:01:36+00:00,"48.84791249714942, 2.2843059897422795",Paris,75056,0.9041095890410958,11
16024,Ranelagh - Maison de la Radio,OUI,20,10,10,10,0,OUI,OUI,2025-03-13 10:56:41+00:00,"48.85293603169479, 2.280449643731117",Paris,75056,0.5,11
47001,Place de la Gare,OUI,45,4,41,37,4,OUI,OUI,2025-03-13 11:00:42+00:00,"48.80253358011283, 2.4275037646293645",Maisons-Alfort,94046,0.9111111111111111,11
15043,Brancion - Lefebvre,OUI,9,7,2,0,2,OUI,OUI,2025-03-13 10:56:33+00:00,"48.82900222785569, 2.301431038163409",Paris,75056,0.2222222222222222,11
44101,Place Mongolfier,OUI,37,14,23,13,10,OUI,OUI,2025-03-13 11:00:06+00:00,"48.815160030060376, 2.4592879414558415",Saint-Maurice,94069,0.6216216216216216,11
20009,Docteurs Déjérine - Pte de Montreuil,OUI,19,14,5,4,1,OUI,OUI,2025-03-13 10:59:56+00:00,"48.85398448133697, 2.41208288897222",Paris,75056,0.2631578947368421,11
13032,Italie - Jardin Joan Miro,OUI,24,21,3,2,1,OUI,OUI,2025-03-13 10:56:28+00:00,"48.81990914045756, 2.3592948541045193",Paris,75056,0.125,11
21955,Vaugirard - Verrerie,OUI,24,1,23,17,6,OUI,OUI,2025-03-13 10:58:27+00:00,"48.820881336842, 2.2367222622987",Meudon,92048,0.9583333333333334,11
10165,Gare de l'Est - Place du 11 Novembre 1918,OUI,39,37,2,1,1,OUI,OUI,2025-03-13 10:59:34+00:00,"48.876327, 2.3585464",Paris,75056,0.05128205128205128,11
8001,Petit Palais,OUI,42,7,35,19,16,OUI,OUI,2025-03-13 11:01:37+00:00,"48.8667692, 2.3157655",Paris,75056,0.8333333333333334,11
14010,Jean Moulin - Place Victor et Hélène Basch,OUI,38,37,1,0,1,OUI,OUI,2025-03-13 10:59:35+00:00,"48.82764910241, 2.3261967301369",Paris,75056,0.02631578947368421,11
13121,Bruneseau - Quai d'Ivry,OUI,46,1,45,42,3,OUI,OUI,2025-03-13 11:01:19+00:00,"48.824945637583, 2.3885661363602",Ivry-sur-Seine,94041,0.9782608695652174,11
22303,Lucien Lanternier - Le Luth,OUI,25,10,15,12,3,OUI,OUI,2025-03-13 11:01:18+00:00,"48.93159430558871, 2.2889783978462224",Gennevilliers,92036,0.6,11
10018,Square Alban Satragne,OUI,29,17,12,2,10,OUI,OUI,2025-03-13 11:00:37+00:00,"48.875388227727, 2.3559567333359",Paris,75056,0.41379310344827586,11
92001,Mairie de quartier du Plateau - Mont-Valérien,OUI,20,14,6,4,2,OUI,OUI,2025-03-13 10:53:02+00:00,"48.8799933, 2.2072437",Nanterre,92050,0.3,11
20108,Jardin de l'Hospice Debrousse,OUI,23,23,0,0,0,OUI,OUI,2025-03-13 10:51:44+00:00,"48.861451061938, 2.40568600595",Paris,75056,0.0,11
15057,Lucien Bossoutrot - Général Martial Vallin,OUI,37,8,29,17,12,OUI,OUI,2025-03-13 11:01:00+00:00,"48.836956046311, 2.2741072252393",Paris,75056,0.7837837837837838,11
21219,Amaury Duval - Gabriel Péri,OUI,36,36,0,0,0,OUI,OUI,2025-03-13 11:00:50+00:00,"48.81718759671675, 2.323841750621796",Montrouge,92049,0.0,11
16002,Pergolèse - Malakoff,OUI,37,30,7,2,5,OUI,OUI,2025-03-13 10:58:59+00:00,"48.87521088779225, 2.2842781618237495",Paris,75056,0.1891891891891892,11
13011,Hôpital - Campo-Formio,OUI,11,7,4,0,4,OUI,OUI,2025-03-13 11:01:27+00:00,"48.835405, 2.358218",Paris,75056,0.36363636363636365,11
15004,Vaugirard - Pasteur,OUI,21,20,1,0,1,OUI,OUI,2025-03-13 11:01:21+00:00,"48.84040868803496, 2.3154367133975033",Paris,75056,0.047619047619047616,11
31025,Paul Signac - Aristide Briand,OUI,33,31,2,0,2,OUI,OUI,2025-03-13 10:52:53+00:00,"48.86950262156371, 2.4502260982990265",Montreuil,93048,0.06060606060606061,11
23010,Voltaire - Anatole France,OUI,26,5,21,14,7,OUI,OUI,2025-03-13 10:59:18+00:00,"48.891999360256904, 2.284262739121914",Levallois-Perret,92044,0.8076923076923077,11
5014,Jean Calvin - Tournefort,OUI,28,16,12,12,0,OUI,OUI,2025-03-13 11:01:34+00:00,"48.84158856925782, 2.348489575088024",Paris,75056,0.42857142857142855,11
19128,Quai de l'Oise - Aisne,OUI,28,25,3,1,2,OUI,OUI,2025-03-13 11:00:04+00:00,"48.8906231, 2.3833701",Paris,75056,0.10714285714285714,11
8549,George V - Christophe Colomb,OUI,22,2,20,6,14,OUI,OUI,2025-03-13 11:01:39+00:00,"48.87046, 2.30104",Paris,75056,0.9090909090909091,11
15005,Place Jacques et Thérèse Tréfouël,OUI,42,23,19,15,4,OUI,OUI,2025-03-13 10:58:05+00:00,"48.842726498317, 2.3125657439232",Paris,75056,0.4523809523809524,11
13033,Porte d'Italie,OUI,13,8,5,2,3,OUI,OUI,2025-03-13 10:56:41+00:00,"48.817161987718954, 2.360236309468746",Paris,75056,0.38461538461538464,11
21401,Mairie de Clamart,OUI,31,27,4,0,4,OUI,OUI,2025-03-13 11:00:10+00:00,"48.800612, 2.262151",Clamart,92023,0.12903225806451613,11
42701,Charles Gide - Fort de Bicêtre,OUI,29,12,17,3,14,OUI,OUI,2025-03-13 11:00:47+00:00,"48.8071937956922, 2.353984415531159",Le Kremlin-Bicêtre,94043,0.5862068965517241,11
13044,Place Jeanne d'Arc,OUI,35,33,2,1,1,OUI,OUI,2025-03-13 10:53:14+00:00,"48.829575, 2.369126",Paris,75056,0.05714285714285714,11
13126,Place Nationale - Château-des-Rentiers,OUI,18,8,10,6,4,OUI,OUI,2025-03-13 11:00:36+00:00,"48.829268, 2.365212",Paris,75056,0.5555555555555556,11
9027,Douai - Pierre Fontaine,OUI,23,21,2,0,2,OUI,OUI,2025-03-13 10:59:00+00:00,"48.88229101148092, 2.33324121683836",Paris,75056,0.08695652173913043,11
8020,Batignolles - Beudant,OUI,43,40,3,2,1,OUI,OUI,2025-03-13 10:59:32+00:00,"48.88216401466375, 2.319852970540523",Paris,75056,0.06976744186046512,11
22501,Théâtre de La Garenne,OUI,20,16,4,1,3,OUI,OUI,2025-03-13 10:57:08+00:00,"48.905658361454, 2.2345951981176",La Garenne-Colombes,92035,0.2,11
23004,Paul Vaillant-Couturier - Victor Hugo,OUI,34,1,33,25,8,OUI,OUI,2025-03-13 11:01:17+00:00,"48.89819702263572, 2.293848017974069",Levallois-Perret,92044,0.9705882352941176,11
42003,Place de l'Insurrection d'Août 1944,OUI,30,0,30,28,2,OUI,OUI,2025-03-13 10:59:01+00:00,"48.81477852751594, 2.398074567317963",Ivry-sur-Seine,94041,1.0,11
22408,Place du 14 Juillet,OUI,22,20,2,1,1,OUI,OUI,2025-03-13 11:01:12+00:00,"48.819266959525, 2.3011998832226",Malakoff,92046,0.09090909090909091,11
5012,Estrapade - Ulm,OUI,16,1,15,1,14,OUI,OUI,2025-03-13 11:01:21+00:00,"48.84512772828, 2.3454568170362",Paris,75056,0.9375,11
17023,Porte d'Asnières,OUI,33,29,4,4,0,OUI,OUI,2025-03-13 10:59:11+00:00,"48.89035817610495, 2.3036286234855656",Paris,75056,0.12121212121212122,11
8037,Monceau - Malesherbes,OUI,37,26,11,3,8,OUI,OUI,2025-03-13 11:00:57+00:00,"48.8795079, 2.3145456",Paris,75056,0.2972972972972973,11
4002,Marché aux fleurs,OUI,20,4,16,8,8,OUI,OUI,2025-03-13 11:01:29+00:00,"48.855258115391, 2.3473754525185",Paris,75056,0.8,11
33015,Charles Tillon - Cimetière Communal,OUI,26,2,24,6,18,OUI,OUI,2025-03-13 11:00:14+00:00,"48.91844023641836, 2.3935630917549138",Aubervilliers,93001,0.9230769230769231,11
17003,Jacques Kellner - Saint-Ouen,OUI,43,43,0,0,0,OUI,OUI,2025-03-13 10:57:50+00:00,"48.895809485802886, 2.327897409164145",Paris,75056,0.0,11
15311,Quai du Président Roosevelt - Pont Aval,OUI,30,0,30,20,10,OUI,OUI,2025-03-13 10:58:20+00:00,"48.8343883676388, 2.2656820714473724",Paris,75056,1.0,11
6008,Assas - Luxembourg,OUI,32,19,13,6,7,OUI,OUI,2025-03-13 11:01:43+00:00,"48.843734468779, 2.3334283818759",Paris,75056,0.40625,11
41205,Maréchal Joffre - Verdun,OUI,20,20,0,0,0,OUI,OUI,2025-03-13 11:00:32+00:00,"48.85385, 2.470307",Fontenay-sous-Bois,94033,0.0,11
42209,Place de l'Europe - Quai de Bercy,OUI,15,4,11,10,1,OUI,OUI,2025-03-13 11:00:31+00:00,"48.82529858840266, 2.3945679143071175",Charenton-le-Pont,94018,0.7333333333333333,11
17119,Toqueville - Cardinet,OUI,31,29,2,1,1,OUI,OUI,2025-03-13 10:57:45+00:00,"48.88490187110713, 2.3109393194317818",Paris,75056,0.06451612903225806,11
11021,Charonne - Pierre Bayle,OUI,23,23,0,0,0,OUI,OUI,2025-03-13 11:01:17+00:00,"48.858445054262, 2.3903981223891",Paris,75056,0.0,11
33016,Fort d'Aubervilliers,OUI,20,12,8,7,1,OUI,OUI,2025-03-13 10:54:06+00:00,"48.91502382370325, 2.4035281687974925",Aubervilliers,93001,0.4,11
9114,Faubourg Poissonnière - Dunkerque,OUI,30,27,3,2,1,OUI,OUI,2025-03-13 10:57:31+00:00,"48.880883445404436, 2.349934279918671",Paris,75056,0.1,11
10162,Alexandre Parodi - Quai de Valmy,OUI,24,21,3,0,3,OUI,OUI,2025-03-13 10:57:46+00:00,"48.879359419425, 2.3665961623192",Paris,75056,0.125,11
16011,Victor Hugo - La Pompe,OUI,40,29,11,0,11,OUI,OUI,2025-03-13 11:01:34+00:00,"48.86795222470859, 2.28146318346262",Paris,75056,0.275,11
6012,Saint-Germain - Ciseaux,OUI,18,3,15,9,6,OUI,OUI,2025-03-13 10:59:44+00:00,"48.853305277595, 2.3344654618827",Paris,75056,0.8333333333333334,11
12007,Gare de Lyon - Chalon,OUI,45,21,24,13,11,OUI,OUI,2025-03-13 11:00:07+00:00,"48.845666194202, 2.3741452395916",Paris,75056,0.5333333333333333,11
13009,Auguste Blanqui - Corvisart,OUI,25,20,5,2,3,OUI,OUI,2025-03-13 11:00:27+00:00,"48.8300989, 2.3502726",Paris,75056,0.2,11
25001,Colmar - Victor Hugo,OUI,31,7,24,12,12,OUI,OUI,2025-03-13 10:53:37+00:00,"48.88652251096166, 2.173960916697979",Rueil-Malmaison,92063,0.7741935483870968,11
15071,Suffren - Champ de Mars,OUI,23,8,15,15,0,OUI,OUI,2025-03-13 10:59:17+00:00,"48.8547194, 2.2952168",Paris,75056,0.6521739130434783,11
35007,Benjamin Delessert - Jean Lolive,OUI,20,20,0,0,0,OUI,OUI,2025-03-13 11:00:45+00:00,"48.89392043619345, 2.417981922626496",Pantin,93055,0.0,11
9024,Taitbout - La Fayette,OUI,51,6,45,20,25,OUI,OUI,2025-03-13 11:01:43+00:00,"48.8733298892, 2.3352625966072",Paris,75056,0.8823529411764706,11
15064,Javel - André Citroën,OUI,44,0,44,39,5,OUI,OUI,2025-03-13 11:00:55+00:00,"48.846276485475, 2.2786368057132",Paris,75056,1.0,11
21319,Esplanade du Foncet - Camille Desmoulins,OUI,27,3,24,20,4,OUI,OUI,2025-03-13 11:01:11+00:00,"48.827090233494964, 2.2606857866048813",Issy-les-Moulineaux,92040,0.8888888888888888,11
13128,Quai de la Gare - Pont de Bercy,OUI,30,0,30,26,4,OUI,OUI,2025-03-13 11:01:05+00:00,"48.83730787972, 2.3740861260598",Paris,75056,1.0,11
9006,Dunkerque - Trudaine,OUI,16,13,3,0,3,OUI,OUI,2025-03-13 10:55:50+00:00,"48.88215166773376, 2.3463253676891327",Paris,75056,0.1875,11
43010,La Jarry - Place Diderot,OUI,25,22,3,0,3,OUI,OUI,2025-03-13 10:54:14+00:00,"48.849726940367326, 2.452013790607453",Vincennes,94080,0.12,11
92006,Place Nelson Mandela,OUI,30,19,11,2,9,OUI,OUI,2025-03-13 10:58:18+00:00,"48.897874318180556, 2.2182820737361912",Nanterre,92050,0.36666666666666664,11
17107,Berthier - Place Stuart Merril,OUI,36,21,15,12,3,OUI,OUI,2025-03-13 11:00:00+00:00,"48.885927922355044, 2.2933450341224675",Paris,75056,0.4166666666666667,11
5024,Place Monge,OUI,21,17,4,1,3,OUI,OUI,2025-03-13 10:59:31+00:00,"48.842761803051, 2.3524079471827",Paris,75056,0.19047619047619047,11
6027,Blaise-Desgoffe - Vaugirard,OUI,32,19,13,6,7,OUI,OUI,2025-03-13 10:59:20+00:00,"48.846128877747, 2.3242672160268",Paris,75056,0.40625,11
21314,Chemin de Bretagne,OUI,28,2,26,19,7,OUI,OUI,2025-03-13 11:01:31+00:00,"48.824753068884, 2.2588385956052",Issy-les-Moulineaux,92040,0.9285714285714286,11
18007,Goutte d'or - Barbès,OUI,20,18,2,0,2,OUI,OUI,2025-03-13 10:57:23+00:00,"48.885124323627, 2.3496962338686",Paris,75056,0.1,11
12038,Picpus - Louis Braille,OUI,43,41,2,1,1,OUI,OUI,2025-03-13 11:01:04+00:00,"48.839988788912, 2.4005256685521",Paris,75056,0.046511627906976744,11
18006,Square Louise Michel,OUI,35,30,5,0,5,OUI,OUI,2025-03-13 11:01:29+00:00,"48.884687354509, 2.3441386967897",Paris,75056,0.14285714285714285,11
12005,Crozatier - Faubourg Saint-Antoine,OUI,40,16,24,17,7,OUI,OUI,2025-03-13 11:01:15+00:00,"48.850440013405, 2.378901366211",Paris,75056,0.6,11
17108,Bessières - Porte de Clichy,OUI,30,8,22,15,7,OUI,OUI,2025-03-13 10:58:44+00:00,"48.89611762451474, 2.31790903955698",Paris,75056,0.7333333333333333,11
13516,Glacière - Soeur Catherine Marie,OUI,40,33,7,2,5,OUI,OUI,2025-03-13 10:57:31+00:00,"48.829522989420596, 2.343570403754711",Paris,75056,0.175,11
4020,Place Edmond Michelet,OUI,23,11,12,10,2,OUI,OUI,2025-03-13 11:00:36+00:00,"48.860134890542, 2.3500636965036",Paris,75056,0.5217391304347826,11
12155,Rottembourg - Général Michel Bizot,OUI,42,36,6,5,1,OUI,OUI,2025-03-13 11:00:21+00:00,"48.83787825992554, 2.4044052511453633",Paris,75056,0.14285714285714285,11
15022,Emile Zola - Fondary,OUI,41,7,34,31,3,OUI,OUI,2025-03-13 11:00:55+00:00,"48.847051143113745, 2.2953405976295476",Paris,75056,0.8292682926829268,11
9011,Geoffroy - Marie,OUI,18,6,12,8,4,OUI,OUI,2025-03-13 10:58:00+00:00,"48.873781940593325, 2.344513876337893",Paris,75056,0.6666666666666666,11
11017,Charonne - Bureau,OUI,44,42,2,0,2,OUI,OUI,2025-03-13 10:56:54+00:00,"48.854176, 2.396093",Paris,75056,0.045454545454545456,11
10021,Marché Saint-Quentin,OUI,14,14,0,0,0,OUI,OUI,2025-03-13 11:01:04+00:00,"48.877356057652, 2.3545114456374",Paris,75056,0.0,11
21306,Place Lafayette,OUI,61,6,55,49,6,OUI,OUI,2025-03-13 11:00:39+00:00,"48.829654975522, 2.2638675570488",Issy-les-Moulineaux,92040,0.9016393442622951,11
2108,Vivienne - Montmartre,OUI,37,5,32,13,19,OUI,OUI,2025-03-13 11:01:22+00:00,"48.871347597383, 2.3414588347077",Paris,75056,0.8648648648648649,11
1021,Halles - Bourdonnais,OUI,18,2,16,15,1,OUI,OUI,2025-03-13 10:59:34+00:00,"48.860448992575, 2.3460162431002",Paris,75056,0.8888888888888888,11
12101,Charenton - Prague,OUI,28,6,22,14,8,OUI,OUI,2025-03-13 11:00:32+00:00,"48.848175129981, 2.3763584494312",Paris,75056,0.7857142857142857,11
7017,La Motte-Picquet - La Tour Maubourg,OUI,40,20,20,15,5,OUI,OUI,2025-03-13 11:01:23+00:00,"48.856926701847, 2.3096215831203",Paris,75056,0.5,11
51001,Gare d'Argenteuil,OUI,37,19,18,4,14,OUI,OUI,2025-03-13 10:57:11+00:00,"48.947022436806705, 2.256898172199726",Argenteuil,95018,0.4864864864864865,11
35006,Delizy - Louis Nadot,OUI,21,16,5,4,1,OUI,OUI,2025-03-13 10:56:20+00:00,"48.896212845581346, 2.4094578623771667",Pantin,93055,0.23809523809523808,11
15039,Abbé Groult - Convention,OUI,12,11,1,0,1,OUI,OUI,2025-03-13 11:01:33+00:00,"48.83596927866069, 2.302064039509349",Paris,75056,0.08333333333333333,11
22015,Île de la Jatte,OUI,23,14,9,5,4,OUI,OUI,2025-03-13 11:01:16+00:00,"48.894036161302104, 2.2666339203715324",Neuilly-sur-Seine,92051,0.391304347826087,11
21315,Jules Guesdes - Général de Gaulle,OUI,24,23,1,1,0,OUI,OUI,2025-03-13 10:58:04+00:00,"48.81930581291959, 2.278934195637703",Issy-les-Moulineaux,92040,0.041666666666666664,11
12018,Saint-Mandé - Fabre d'Eglantine,OUI,33,28,5,2,3,OUI,OUI,2025-03-13 11:00:00+00:00,"48.8453579, 2.3965022",Paris,75056,0.15151515151515152,11
23102,Hôtel de Ville de Sèvres,OUI,31,17,14,13,1,OUI,OUI,2025-03-13 11:00:47+00:00,"48.824363561289, 2.2131047397852",Sèvres,92072,0.45161290322580644,11
44016,Balzac - Olympes de Gouges,OUI,28,12,16,8,8,OUI,OUI,2025-03-13 10:58:04+00:00,"48.77850332486751, 2.4006786569952965",Vitry-sur-Seine,94081,0.5714285714285714,11
15036,Croix Nivert - Square Saint-Lambert,OUI,47,47,0,0,0,NON,NON,2025-03-03 09:03:43+00:00,"48.843051521591, 2.2952004522085",Paris,75056,0.0,9
44005,Place Saint-Just,OUI,21,13,8,5,3,OUI,OUI,2025-03-13 11:00:30+00:00,"48.790379518724265, 2.3895226791501045",Vitry-sur-Seine,94081,0.38095238095238093,11
6022,Marché Saint-Germain,OUI,18,0,18,9,9,OUI,OUI,2025-03-13 11:01:35+00:00,"48.85165625855281, 2.335500307381153",Paris,75056,1.0,11
15011,Cambronne - Villa Croix Nivert,OUI,61,48,13,11,2,OUI,OUI,2025-03-13 11:00:22+00:00,"48.845847561366, 2.3017574474216",Paris,75056,0.21311475409836064,11
15006,Cherche-Midi - Hôpital Necker,OUI,36,29,7,4,3,OUI,OUI,2025-03-13 11:00:19+00:00,"48.84461063309956, 2.317914068698883",Paris,75056,0.19444444444444445,11
9004,Gérando - Rochechouart,OUI,21,20,1,0,1,OUI,OUI,2025-03-13 10:52:40+00:00,"48.88294340845, 2.3464846238494",Paris,75056,0.047619047619047616,11
21402,Place Aimé Césaire,OUI,27,23,4,0,4,OUI,OUI,2025-03-13 10:52:17+00:00,"48.783194713067815, 2.2429127991199493",Clamart,92023,0.14814814814814814,11
51002,Placette Grégoire Collas,OUI,25,15,10,4,6,OUI,OUI,2025-03-13 11:01:35+00:00,"48.94342014002797, 2.2487476095557213",Argenteuil,95018,0.4,11
9007,Condorcet - Turgot,OUI,19,19,0,0,0,OUI,OUI,2025-03-13 11:01:01+00:00,"48.87985155789093, 2.345232367515564",Paris,75056,0.0,11
32601,Porte des Lilas - Faidherbe,OUI,39,38,1,1,0,OUI,OUI,2025-03-13 10:57:26+00:00,"48.87861855668978, 2.4120327830314636",Les Lilas,93045,0.02564102564102564,11
13052,Leredde - Tolbiac,OUI,43,14,29,10,19,OUI,OUI,2025-03-13 11:01:28+00:00,"48.82887629664, 2.3744382709265",Paris,75056,0.6744186046511628,11
12026,Place Ginette Hamelin,OUI,50,21,29,24,5,OUI,OUI,2025-03-13 11:01:34+00:00,"48.837853, 2.382064",Paris,75056,0.58,11
17024,Villiers - Batignolles,OUI,23,20,3,1,2,OUI,OUI,2025-03-13 11:01:27+00:00,"48.88125253846116, 2.31653843075037",Paris,75056,0.13043478260869565,11
27005,Gare du Stade,OUI,18,14,4,1,3,OUI,OUI,2025-03-13 10:54:35+00:00,"48.9312676, 2.2603778",Colombes,92025,0.2222222222222222,11
15127,Place Charles Michels,OUI,35,10,25,17,8,OUI,OUI,2025-03-13 11:01:36+00:00,"48.846401, 2.28502",Paris,75056,0.7142857142857143,11
8201,Arsène Houssaye - Friedland,OUI,29,20,9,3,6,OUI,OUI,2025-03-13 10:58:45+00:00,"48.874510616163, 2.2994716674148",Paris,75056,0.3103448275862069,11
33103,Jean Jaurès - Jules Jacquemin,OUI,22,22,0,0,0,OUI,OUI,2025-03-13 11:00:54+00:00,"48.88433053604843, 2.4082902455152104",Le Pré-Saint-Gervais,93061,0.0,11
17111,Lemercier - Cardinet,OUI,24,21,3,0,3,OUI,OUI,2025-03-13 10:59:16+00:00,"48.890097168851746, 2.317377626895905",Paris,75056,0.125,11
14032,Mairie du 14ème,OUI,32,28,4,0,4,OUI,OUI,2025-03-13 11:00:56+00:00,"48.83254578123, 2.3254923149943",Paris,75056,0.125,11
9102,Londres - Place d'Estienne d'Orves,OUI,24,1,23,12,11,OUI,OUI,2025-03-13 11:00:55+00:00,"48.876693805756986, 2.3305362090468407",Paris,75056,0.9583333333333334,11
14031,Didot - Place de Moro-Giafferi,OUI,20,18,2,0,2,OUI,OUI,2025-03-13 10:58:27+00:00,"48.8337, 2.3215",Paris,75056,0.1,11
8116,Champs-Elysees - Bassano,OUI,25,25,0,0,0,NON,NON,2021-02-21 19:09:18+00:00,"48.871811807816, 2.300238981843",Paris,75056,0.0,19
16019,Porte de la Muette,OUI,34,12,22,3,19,OUI,OUI,2025-03-13 10:59:15+00:00,"48.86302317841182, 2.2687188170157406",Paris,75056,0.6470588235294118,11
18030,Joseph Dijon - Ornano,OUI,36,35,1,1,0,OUI,OUI,2025-03-13 10:58:53+00:00,"48.89374453351521, 2.3476678133010864",Paris,75056,0.027777777777777776,11
3102,Bourg l'Abbé - Saint-Martin,OUI,36,23,13,9,4,OUI,OUI,2025-03-13 11:00:30+00:00,"48.86393331949257, 2.352406270802021",Paris,75056,0.3611111111111111,11
31005,Square Denise Buisson,OUI,45,44,1,0,1,OUI,OUI,2025-03-13 10:59:08+00:00,"48.8562322730982, 2.426436245441437",Montreuil,93048,0.022222222222222223,11
11033,Bréguet - Sabin,OUI,29,5,24,20,4,OUI,OUI,2025-03-13 11:01:10+00:00,"48.856931678257, 2.3706749462105",Paris,75056,0.8275862068965517,11
12028,Vivaldi - Antoine-Julien Hénard,OUI,27,23,4,4,0,OUI,OUI,2025-03-13 10:59:32+00:00,"48.841923663276546, 2.389728979467376",Paris,75056,0.14814814814814814,11
41203,Stalingrad - Rigollots,OUI,50,46,4,2,2,OUI,OUI,2025-03-13 10:58:09+00:00,"48.84997403844251, 2.45557576417923",Fontenay-sous-Bois,94033,0.08,11
9034,Godot de Mauroy - Madeleine,OUI,21,0,21,8,13,OUI,OUI,2025-03-13 11:00:51+00:00,"48.869789, 2.326347",Paris,75056,1.0,11
12035,Madagascar - Meuniers,OUI,31,23,8,2,6,OUI,OUI,2025-03-13 10:56:49+00:00,"48.83460464474706, 2.3970650508999825",Paris,75056,0.25806451612903225,11
20022,Porte de Bagnolet,OUI,33,33,0,0,0,OUI,OUI,2025-03-13 10:59:27+00:00,"48.864707139122984, 2.408344637349607",Paris,75056,0.0,11
5115,Buffon - Jardin des Plantes,OUI,29,11,18,16,2,OUI,OUI,2025-03-13 11:01:24+00:00,"48.842668466104875, 2.3618587106466293",Paris,75056,0.6206896551724138,11
10008,Cité Riverin - Château d'Eau,OUI,18,2,16,6,10,OUI,OUI,2025-03-13 11:00:38+00:00,"48.870702423554306, 2.358739863900845",Paris,75056,0.8888888888888888,11
41211,Louis Xavier de Ricard - Ancienne Mairie,OUI,34,33,1,1,0,OUI,OUI,2025-03-13 10:57:45+00:00,"48.84629899065091, 2.472420372068882",Fontenay-sous-Bois,94033,0.029411764705882353,11
8117,Place de la Madeleine - Royale,OUI,41,0,41,24,17,OUI,OUI,2025-03-13 11:00:53+00:00,"48.869228052648, 2.324421107769",Paris,75056,1.0,11
44011,Lebrun - Colonel Fabien,OUI,27,25,2,1,1,OUI,OUI,2025-03-13 11:01:07+00:00,"48.78266870733145, 2.381317801773548",Vitry-sur-Seine,94081,0.07407407407407407,11
10032,Claude Vellefaux - Hôpital Saint-Louis,OUI,31,28,3,2,1,OUI,OUI,2025-03-13 11:01:24+00:00,"48.872859139003, 2.3700717069851",Paris,75056,0.0967741935483871,11
21707,Square Etienne Jarousse,OUI,22,21,1,0,1,OUI,OUI,2025-03-13 10:59:56+00:00,"48.82485182597129, 2.2925933450460434",Vanves,92075,0.045454545454545456,11
48004,Maxime Gorki - Louis Aragon,OUI,20,18,2,0,2,OUI,OUI,2025-03-13 11:00:57+00:00,"48.78909814728443, 2.368387877941132",Villejuif,94076,0.1,11
4019,Cloître Saint-Merri - Renard,OUI,29,3,26,22,4,OUI,OUI,2025-03-13 11:01:07+00:00,"48.858835448898, 2.3518279194832",Paris,75056,0.896551724137931,11
18139,Poissonniers - Championnet,OUI,28,26,2,0,2,OUI,OUI,2025-03-13 11:01:04+00:00,"48.89543299733937, 2.3530178144574165",Paris,75056,0.07142857142857142,11
5001,Harpe - Saint-Germain,OUI,43,30,13,12,1,OUI,OUI,2025-03-13 11:01:10+00:00,"48.851518815017, 2.3436703160405",Paris,75056,0.3023255813953488,11
1006,Grande Truanderie - Saint-Denis,OUI,27,9,18,13,5,OUI,OUI,2025-03-13 11:01:22+00:00,"48.8626302, 2.3498075",Paris,75056,0.6666666666666666,11
15129,Hôpital Necker,OUI,38,20,18,14,4,OUI,OUI,2025-03-13 10:58:48+00:00,"48.846043490118454, 2.313245013356209",Paris,75056,0.47368421052631576,11
15001,Gare Montparnasse - Arrivée,OUI,42,27,15,5,10,OUI,OUI,2025-03-13 11:00:55+00:00,"48.843827994315, 2.3225811123848",Paris,75056,0.35714285714285715,11
8027,Mairie du 8ème,OUI,14,8,6,5,1,OUI,OUI,2025-03-13 11:00:50+00:00,"48.877932, 2.318264",Paris,75056,0.42857142857142855,11
19110,Square Claude Bernard,OUI,29,16,13,7,6,OUI,OUI,2025-03-13 11:00:50+00:00,"48.89876016219984, 2.375325746834278",Paris,75056,0.4482758620689655,11
41403,Gare RER - Malleret-Joinville,OUI,20,7,13,9,4,OUI,OUI,2025-03-13 10:59:57+00:00,"48.802936, 2.42531",Alfortville,94002,0.65,11
11112,Jules Vallès - Charonne,OUI,23,17,6,1,5,OUI,OUI,2025-03-13 11:01:39+00:00,"48.854284379935, 2.3847674578428",Paris,75056,0.2608695652173913,11
13018,Bruant - Vincent Auriol,OUI,25,6,19,15,4,OUI,OUI,2025-03-13 11:01:00+00:00,"48.834848452929, 2.3668264996271",Paris,75056,0.76,11
5007,Ecoles - Carmes,OUI,34,3,31,16,15,OUI,OUI,2025-03-13 11:00:27+00:00,"48.848904447989405, 2.3473486304283147",Paris,75056,0.9117647058823529,11
21303,Jean Monnet - Iles,OUI,32,2,30,27,3,OUI,OUI,2025-03-13 11:01:29+00:00,"48.823393984057304, 2.2497073194874866",Issy-les-Moulineaux,92040,0.9375,11
16105,Crevaux - Bugeaud,OUI,31,29,2,0,2,OUI,OUI,2025-03-13 10:58:02+00:00,"48.87080942867, 2.2811490076919",Paris,75056,0.06451612903225806,11
33014,Parc Eli Lotar,OUI,19,13,6,3,3,OUI,OUI,2025-03-13 11:01:39+00:00,"48.91844993053703, 2.3727085813879967",Aubervilliers,93001,0.3157894736842105,11
18202,Diane Arbus,OUI,37,33,4,2,2,OUI,OUI,2025-03-13 10:53:15+00:00,"48.898800717199, 2.3524022474885",Paris,75056,0.10810810810810811,11
20105,Benoît Frachon - République,OUI,28,27,1,1,0,OUI,OUI,2025-03-13 10:59:35+00:00,"48.85230729014318, 2.415605485439301",Paris,75056,0.03571428571428571,11
45002,Roger Salengro - Général de Gaulle,OUI,27,13,14,5,9,OUI,OUI,2025-03-13 10:58:27+00:00,"48.820029010376956, 2.4846760556101803",Champigny-sur-Marne,94017,0.5185185185185185,11
14011,Place des Droits de l'Enfant,OUI,39,37,2,1,1,OUI,OUI,2025-03-13 11:01:30+00:00,"48.8274804, 2.3319217",Paris,75056,0.05128205128205128,11
12037,Reuilly - Daumesnil,OUI,36,32,4,1,3,OUI,OUI,2025-03-13 11:00:18+00:00,"48.8395385, 2.3972516",Paris,75056,0.1111111111111111,11
41401,Marne - Charles de Gaulle,OUI,25,15,10,10,0,OUI,OUI,2025-03-13 11:00:09+00:00,"48.815071719544434, 2.4121668934822087",Alfortville,94002,0.4,11
18004,Place des Abbesses,OUI,12,10,2,1,1,OUI,OUI,2025-03-13 10:55:32+00:00,"48.884542726149725, 2.3386867716908455",Paris,75056,0.16666666666666666,11
6002,Saint-Benoît - Jacob,OUI,22,0,22,12,10,OUI,OUI,2025-03-13 11:01:06+00:00,"48.85545136013941, 2.3334722220897675",Paris,75056,1.0,11
16013,Mairie du 16ème,OUI,35,32,3,0,3,OUI,OUI,2025-03-13 11:01:39+00:00,"48.863936848471994, 2.2765953093767166",Paris,75056,0.08571428571428572,11
20044,Davout - Volga,OUI,27,26,1,0,1,OUI,OUI,2025-03-13 10:58:38+00:00,"48.852919679957296, 2.410522909779111",Paris,75056,0.037037037037037035,11
7012,Cité Vaneau,OUI,23,7,16,9,7,OUI,OUI,2025-03-13 10:57:48+00:00,"48.8542210666207, 2.319614924490452",Paris,75056,0.6956521739130435,11
33012,Landy - Heurtault,OUI,29,28,1,1,0,OUI,OUI,2025-03-13 10:57:59+00:00,"48.915096534520316, 2.375951372087002",Aubervilliers,93001,0.034482758620689655,11
20008,Pyrénées - Avron,OUI,31,31,0,0,0,OUI,OUI,2025-03-13 10:57:16+00:00,"48.853246898211985, 2.405871044529538",Paris,75056,0.0,11
2013,Favart - Italiens,OUI,17,1,16,4,12,OUI,OUI,2025-03-13 11:00:48+00:00,"48.871446353921, 2.3382901058508",Paris,75056,0.9411764705882353,11
18034,Leibniz - Jean Dollfus,OUI,32,31,1,0,1,OUI,OUI,2025-03-13 10:56:17+00:00,"48.896328348515986, 2.333390423834684",Paris,75056,0.03125,11
10019,Paradis - Hauteville,OUI,31,8,23,17,6,OUI,OUI,2025-03-13 11:01:21+00:00,"48.874999954666755, 2.3522757401923404",Paris,75056,0.7419354838709677,11
20104,Louis Lumière.,OUI,22,22,0,0,0,OUI,OUI,2025-03-13 10:56:25+00:00,"48.86216198070008, 2.41112578185621",Paris,75056,0.0,11
10033,Gare du Nord - Saint-Vincent de Paul,OUI,24,23,1,1,0,OUI,OUI,2025-03-13 11:01:29+00:00,"48.880955741648, 2.3524305148385",Paris,75056,0.041666666666666664,11
3010,Beaubourg - Michel-le-Comte,OUI,14,1,13,10,3,OUI,OUI,2025-03-13 11:00:02+00:00,"48.862534941806, 2.3543103039265",Paris,75056,0.9285714285714286,11
18039,Jardins d'Eole,OUI,19,18,1,0,1,OUI,OUI,2025-03-13 10:52:42+00:00,"48.8869703, 2.3668488",Paris,75056,0.05263157894736842,11
12156,Niger - Soult,OUI,23,19,4,2,2,OUI,OUI,2025-03-13 11:00:03+00:00,"48.84369906369085, 2.410361237220498",Paris,75056,0.17391304347826086,11
18140,Porte de Clignancourt - Ney,OUI,38,33,5,2,3,OUI,OUI,2025-03-13 11:01:28+00:00,"48.899641123987095, 2.344321422278881",Paris,75056,0.13157894736842105,11
12036,Reuilly - Place Felix Eboue,OUI,41,40,1,1,0,OUI,OUI,2025-03-13 10:56:25+00:00,"48.84030274499962, 2.394630398715453",Paris,75056,0.024390243902439025,11
9009,Square Montholon,OUI,19,11,8,1,7,OUI,OUI,2025-03-13 11:00:06+00:00,"48.876620377545024, 2.3457641154527664",Paris,75056,0.42105263157894735,11
14026,Plantes - Moulin Vert,OUI,45,44,1,0,1,OUI,OUI,2025-03-13 10:59:48+00:00,"48.83005755305626, 2.3232302069664006",Paris,75056,0.022222222222222223,11
10034,Louis Blanc - La Chapelle,OUI,21,21,0,0,0,OUI,OUI,2025-03-13 10:58:55+00:00,"48.884008964514, 2.3599335551262",Paris,75056,0.0,11
16012,Flandrin - Longchamp,OUI,40,4,36,17,19,OUI,OUI,2025-03-13 11:01:31+00:00,"48.86877849178477, 2.274354539176829",Paris,75056,0.9,11
6104,Herschel - Observatoire,OUI,36,19,17,4,13,OUI,OUI,2025-03-13 10:59:40+00:00,"48.84342376221923, 2.3376645147800446",Paris,75056,0.4722222222222222,11
16036,Porte Molitor,OUI,59,4,55,41,14,OUI,OUI,2025-03-13 11:00:34+00:00,"48.84524763511433, 2.2569015249609947",Paris,75056,0.9322033898305084,11
21309,Mairie d'Issy,OUI,39,32,7,6,1,OUI,OUI,2025-03-13 11:01:23+00:00,"48.823767792468, 2.2723111510277",Issy-les-Moulineaux,92040,0.1794871794871795,11
42505,Charles Frérot - Albert Guilpin,OUI,29,23,6,3,3,OUI,OUI,2025-03-13 11:00:12+00:00,"48.8155839183714, 2.3505029082298283",Gentilly,94037,0.20689655172413793,11
16102,Pergolèse - Marbeau,OUI,26,20,6,0,6,OUI,OUI,2025-03-13 10:53:30+00:00,"48.873568706869, 2.2815125225299",Paris,75056,0.23076923076923078,11
12015,Place de la Nation - Picpus,OUI,36,31,5,3,2,OUI,OUI,2025-03-13 10:59:26+00:00,"48.846821681548, 2.4001130461693",Paris,75056,0.1388888888888889,11
4021,Centre Georges Pompidou,OUI,24,7,17,15,2,OUI,OUI,2025-03-13 11:00:55+00:00,"48.861419, 2.352581",Paris,75056,0.7083333333333334,11
14001,Edgar Quinet - Gaité,OUI,27,17,10,3,7,OUI,OUI,2025-03-13 11:01:25+00:00,"48.841160928966, 2.324595451355",Paris,75056,0.37037037037037035,11
20034,Sorbier - Ménilmontant,OUI,24,24,0,0,0,OUI,OUI,2025-03-13 10:59:52+00:00,"48.868542395661, 2.3897721245885",Paris,75056,0.0,11
26004,Gare RER les Grésillons,OUI,22,15,7,7,0,OUI,OUI,2025-03-13 10:57:49+00:00,"48.919898633572764, 2.31458459136273",Asnières-sur-Seine,92004,0.3181818181818182,11
13005,Cordelières - Arago,OUI,45,21,24,22,2,OUI,OUI,2025-03-13 11:01:03+00:00,"48.83548071896613, 2.348572461702221",Paris,75056,0.5333333333333333,11
16042,Murat - Porte de Saint-Cloud,OUI,38,1,37,32,5,OUI,OUI,2025-03-13 10:59:55+00:00,"48.83750862621299, 2.2577651962637906",Paris,75056,0.9736842105263158,11
19201,Petit - Georges Thill,OUI,23,23,0,0,0,OUI,OUI,2025-03-13 11:01:43+00:00,"48.88603131999171, 2.3895753175020222",Paris,75056,0.0,11
15008,Sèvres - Lecourbe,OUI,60,43,17,15,2,OUI,OUI,2025-03-13 11:01:16+00:00,"48.8447677, 2.3110086",Paris,75056,0.2833333333333333,11
19010,Emile Reynaud - Porte de la Villette,OUI,22,22,0,0,0,OUI,OUI,2025-03-13 10:57:08+00:00,"48.90098953630053, 2.3887022584676743",Paris,75056,0.0,11
22201,Henri Ravera - Gabriel Péri,OUI,28,27,1,0,1,OUI,OUI,2025-03-13 10:56:39+00:00,"48.79722273833844, 2.302115857601166",Bagneux,92007,0.03571428571428571,11
15132,Bargue -  Dutot,OUI,21,17,4,2,2,OUI,OUI,2025-03-13 10:57:25+00:00,"48.837884, 2.308876",Paris,75056,0.19047619047619047,11
4006,Bourdon - Pont Morland,OUI,49,26,23,19,4,OUI,OUI,2025-03-13 11:00:47+00:00,"48.8478103, 2.3659356",Paris,75056,0.46938775510204084,11
8028,Arsène Houssaye - Champs-Elysées,OUI,28,3,25,2,23,OUI,OUI,2025-03-13 11:00:49+00:00,"48.873409276267, 2.2977904602885",Paris,75056,0.8928571428571429,11
3008,Perle - Vieille du Temple,OUI,35,5,30,20,10,OUI,OUI,2025-03-13 11:00:32+00:00,"48.8601346, 2.3611206",Paris,75056,0.8571428571428571,11
10011,Bourse du Travail,OUI,15,1,14,12,2,OUI,OUI,2025-03-13 10:59:47+00:00,"48.868976638826, 2.3623438552022",Paris,75056,0.9333333333333333,11
6010,Chevreuse - Montparnasse,OUI,15,12,3,1,2,OUI,OUI,2025-03-13 11:01:20+00:00,"48.841739161231, 2.3315522167367",Paris,75056,0.2,11
14137,Maurice d'Ocagne - General Maudhuy,OUI,28,26,2,1,1,OUI,OUI,2025-03-13 10:55:41+00:00,"48.82414282524159, 2.3158789426088333",Paris,75056,0.07142857142857142,11
5015,Epée de Bois - Mouffetard,OUI,62,50,12,5,7,OUI,OUI,2025-03-13 10:57:17+00:00,"48.841508690388835, 2.350066713988781",Paris,75056,0.1935483870967742,11
3011,Turbigo - Réaumur,OUI,31,4,27,24,3,OUI,OUI,2025-03-13 11:01:34+00:00,"48.865574047531, 2.3564198613167",Paris,75056,0.8709677419354839,11
15128,Cadix - Hameau,OUI,36,31,5,2,3,OUI,OUI,2025-03-13 10:55:20+00:00,"48.8340107632249, 2.289516180753708",Paris,75056,0.1388888888888889,11
31709,Place de la Fraternité,OUI,22,20,2,1,1,OUI,OUI,2025-03-13 10:56:27+00:00,"48.85716405838368, 2.422847449779511",Montreuil,93048,0.09090909090909091,11
44014,Camille Risch - Paul Armangot,OUI,25,16,9,5,4,OUI,OUI,2025-03-13 10:52:56+00:00,"48.774703, 2.373685",Vitry-sur-Seine,94081,0.36,11
10006,Petites Ecuries - Faubourg Saint-Denis,OUI,26,12,14,10,4,OUI,OUI,2025-03-13 10:56:20+00:00,"48.87287120589831, 2.3542150855064397",Paris,75056,0.5384615384615384,11
1007,Turbigo - Française,OUI,16,3,13,11,2,OUI,OUI,2025-03-13 11:01:33+00:00,"48.86358858111446, 2.3477794602513313",Paris,75056,0.8125,11
21506,Maurice Payret-Dortail,OUI,22,19,3,0,3,OUI,OUI,2025-03-13 11:01:31+00:00,"48.87811957063342, 2.2233625128865246",Suresnes,92073,0.13636363636363635,11
47003,Charentonneau - Maisons Alfort,OUI,20,16,4,4,0,OUI,OUI,2025-03-13 11:00:05+00:00,"48.809932980484355, 2.443288456496946",Maisons-Alfort,94046,0.2,11
3001,Beaumarchais - Saint-Gilles,OUI,44,32,12,4,8,OUI,OUI,2025-03-13 11:01:36+00:00,"48.8580378, 2.3679352",Paris,75056,0.2727272727272727,11
20001,Place de la Nation - Charonne,OUI,35,26,9,5,4,OUI,OUI,2025-03-13 10:54:43+00:00,"48.848364667777, 2.3997623859813",Paris,75056,0.2571428571428571,11
21026,Sèvres - Général Leclerc,OUI,29,5,24,17,7,OUI,OUI,2025-03-13 11:00:50+00:00,"48.830121559055, 2.2314262390137",Boulogne-Billancourt,92012,0.8275862068965517,11
12019,Gare de Reuilly - Picpus,OUI,26,26,0,0,0,OUI,OUI,2025-03-13 11:00:13+00:00,"48.84267354116789, 2.3972943797707558",Paris,75056,0.0,11
19129,Solitaires - Place des Fêtes,OUI,29,29,0,0,0,NON,NON,2025-02-23 09:26:05+00:00,"48.876601, 2.391769",Paris,75056,0.0,9
14135,Jourdan - Cité Universitaire,OUI,39,29,10,9,1,OUI,OUI,2025-03-13 11:00:37+00:00,"48.819897343156676, 2.3397007964124366",Paris,75056,0.2564102564102564,11
2003,Saint-Denis - Réaumur,OUI,31,9,22,10,12,OUI,OUI,2025-03-13 11:00:18+00:00,"48.8661116315789, 2.3507790675507594",Paris,75056,0.7096774193548387,11
8110,Gare Saint-Lazare - Stockholm,OUI,30,26,4,1,3,OUI,OUI,2025-03-13 10:57:19+00:00,"48.877127316667654, 2.322417162358761",Paris,75056,0.13333333333333333,11
1102,Française - Etienne Marcel,OUI,35,17,18,15,3,OUI,OUI,2025-03-13 11:01:34+00:00,"48.864053304653766, 2.347587011754513",Paris,75056,0.5142857142857142,11
20024,Gambetta - Père Lachaise,OUI,27,26,1,0,1,OUI,OUI,2025-03-13 10:54:33+00:00,"48.864295696165875, 2.398228667282044",Paris,75056,0.037037037037037035,11
13017,Nationale - Vincent Auriol,OUI,33,27,6,1,5,OUI,OUI,2025-03-13 11:01:40+00:00,"48.83252708397293, 2.362354410392119",Paris,75056,0.18181818181818182,11
15111,Olivier de Serres - Leriche,OUI,24,23,1,0,1,OUI,OUI,2025-03-13 11:01:00+00:00,"48.83460221715206, 2.2957482933998112",Paris,75056,0.041666666666666664,11
19002,Centquatre,OUI,38,32,6,1,5,NON,NON,2025-03-13 11:00:32+00:00,"48.889333538455, 2.3707854375243",Paris,75056,0.15789473684210525,11
12020,Cours de Vincennes - Soult,OUI,44,41,3,3,0,OUI,OUI,2025-03-13 11:01:21+00:00,"48.846918761569, 2.4105220288038",Paris,75056,0.06818181818181818,11
17019,Phalsbourg - Villiers,OUI,19,7,12,8,4,OUI,OUI,2025-03-13 10:54:01+00:00,"48.88242307900951, 2.3090453445911407",Paris,75056,0.631578947368421,11
2021,Cléry - Montmartre,OUI,58,29,29,17,12,OUI,OUI,2025-03-13 11:01:40+00:00,"48.867458, 2.3445211",Paris,75056,0.5,11
10009,Mairie du 10ème,OUI,18,3,15,11,4,OUI,OUI,2025-03-13 10:59:39+00:00,"48.872089449907, 2.3575825989246",Paris,75056,0.8333333333333334,11
24006,Adolphe Lalyre - Armand Silvestre,OUI,39,36,3,0,3,OUI,OUI,2025-03-13 10:59:42+00:00,"48.90406266961591, 2.273416221141815",Courbevoie,92026,0.07692307692307693,11
22301,Chausson - Gabriel Péri,OUI,20,12,8,8,0,OUI,OUI,2025-03-13 11:01:23+00:00,"48.921891003481115, 2.2952306270599365",Gennevilliers,92036,0.4,11
3009,Temple - Haudriettes,OUI,19,1,18,14,4,OUI,OUI,2025-03-13 10:59:44+00:00,"48.861636880212, 2.3566960206458",Paris,75056,0.9473684210526315,11
41405,Place de l'Europe - Alfortville,OUI,24,6,18,18,0,OUI,OUI,2025-03-13 11:00:47+00:00,"48.78913702405837, 2.4284800887107854",Alfortville,94002,0.75,11
4014,Blancs-Manteaux - Archives,OUI,28,3,25,22,3,OUI,OUI,2025-03-13 10:58:35+00:00,"48.85941800703, 2.3559471219778",Paris,75056,0.8928571428571429,11
20006,Pyrénées - Plaine,OUI,12,11,1,1,0,OUI,OUI,2025-03-13 11:01:26+00:00,"48.85026702458, 2.4062821269035",Paris,75056,0.08333333333333333,11
23702,Hôtel de Ville de Chaville,OUI,20,19,1,0,1,OUI,OUI,2025-03-13 10:56:59+00:00,"48.80887149094033, 2.188134044408798",Chaville,92022,0.05,11
21953,Gare de Bellevue,OUI,20,17,3,0,3,OUI,OUI,2025-03-13 10:56:33+00:00,"48.8192404685572, 2.2295309230685234",Meudon,92048,0.15,11
14022,Didot - Mariniers,OUI,35,34,1,0,1,OUI,OUI,2025-03-13 10:59:24+00:00,"48.82650543613106, 2.313136198271666",Paris,75056,0.02857142857142857,11
14019,Sarrette - Général Leclerc,OUI,22,18,4,2,2,OUI,OUI,2025-03-13 11:01:26+00:00,"48.825030852925, 2.3264128693982",Paris,75056,0.18181818181818182,11
2002,Etienne Marcel - Montorgueil,OUI,25,3,22,18,4,OUI,OUI,2025-03-13 11:01:27+00:00,"48.86450567259199, 2.3461959511041637",Paris,75056,0.88,11
10027,Dunkerque - Alsace,OUI,20,19,1,1,0,OUI,OUI,2025-03-13 10:59:47+00:00,"48.879355, 2.358379",Paris,75056,0.05,11
19012,Lally-Tollendal - Armand Carrel,OUI,27,26,1,0,1,OUI,OUI,2025-03-13 11:00:14+00:00,"48.88270066221072, 2.374717555940151",Paris,75056,0.037037037037037035,11
22401,Charles de Gaulle - Plateau de Vanves,OUI,32,26,6,5,1,OUI,OUI,2025-03-13 11:01:36+00:00,"48.82233088973263, 2.298571803412886",Malakoff,92046,0.1875,11
31001,Lagny - Auguste Blanqui,OUI,26,12,14,10,4,OUI,OUI,2025-03-13 11:00:37+00:00,"48.84922568052601, 2.4218603968620305",Montreuil,93048,0.5384615384615384,11
12002,Lacuée - Lyon,OUI,16,0,16,10,6,OUI,OUI,2025-03-13 11:00:38+00:00,"48.849268481958, 2.3704585433006",Paris,75056,1.0,11
21507,Gardenat-Lapostol - Velettes,OUI,20,12,8,1,7,OUI,OUI,2025-03-13 10:57:58+00:00,"48.87387, 2.224185",Suresnes,92073,0.4,11
4103,Archives - Rivoli,OUI,19,3,16,7,9,OUI,OUI,2025-03-13 10:59:18+00:00,"48.857346707443, 2.3539767041802",Paris,75056,0.8421052631578947,11
22306,Place du 17 Octobre,OUI,16,14,2,2,0,OUI,OUI,2025-03-13 10:56:32+00:00,"48.91962690034779, 2.2978286134199792",Gennevilliers,92036,0.125,11
14103,Maine - Liancourt,OUI,25,24,1,0,1,OUI,OUI,2025-03-13 11:01:31+00:00,"48.835064363954, 2.323731449974",Paris,75056,0.04,11
14023,Adolphe Pinard - Victor Hugo,OUI,51,48,3,0,3,OUI,OUI,2025-03-13 10:56:33+00:00,"48.8236825874564, 2.3077843710780144",Malakoff,92046,0.058823529411764705,11
9037,Parme - Clichy,OUI,24,21,3,1,2,OUI,OUI,2025-03-13 11:01:02+00:00,"48.881266424227, 2.3281970934506",Paris,75056,0.125,11
22502,Kléber - National,OUI,20,12,8,6,2,OUI,OUI,2025-03-13 10:57:40+00:00,"48.906333898712234, 2.2393910586833954",La Garenne-Colombes,92035,0.4,11
7021,Bosquet - Saint-Dominique,OUI,28,24,4,2,2,OUI,OUI,2025-03-13 10:59:23+00:00,"48.858651709526, 2.3037165802346",Paris,75056,0.14285714285714285,11
3006,Mairie du 3ème,OUI,23,1,22,16,6,OUI,OUI,2025-03-13 11:00:12+00:00,"48.86446178139141, 2.361762821674347",Paris,75056,0.9565217391304348,11
2015,Louis le Grand - Italiens,OUI,33,1,32,17,15,OUI,OUI,2025-03-13 11:01:32+00:00,"48.870508937204, 2.3340544619393",Paris,75056,0.9696969696969697,11
32013,Saint-Denis - Université,OUI,19,2,17,7,10,OUI,OUI,2025-03-13 11:01:43+00:00,"48.94563430946964, 2.3638297989964485",Saint-Denis,93066,0.8947368421052632,11
4015,Mairie du 4ème,OUI,41,0,41,28,13,OUI,OUI,2025-03-13 11:00:43+00:00,"48.855949910497, 2.3563823103905",Paris,75056,1.0,11
20029,Frères Flavien - Porte des Lilas,OUI,23,22,1,1,0,OUI,OUI,2025-03-13 10:54:59+00:00,"48.8780992764359, 2.41104629853209",Paris,75056,0.043478260869565216,11
3003,Fille du Calvaire - Turenne,OUI,26,4,22,20,2,OUI,OUI,2025-03-13 10:59:28+00:00,"48.86210505412563, 2.3649600148200993",Paris,75056,0.8461538461538461,11
22503,Joffre - Aigle,OUI,19,12,7,3,4,OUI,OUI,2025-03-13 10:58:38+00:00,"48.904033, 2.245096",La Garenne-Colombes,92035,0.3684210526315789,11
13125,Gare d'Austerlitz - Pont Charles de Gaulle,OUI,55,14,41,22,19,OUI,OUI,2025-03-13 11:01:15+00:00,"48.842319830109, 2.3670300096273",Paris,75056,0.7454545454545455,11
14132,Bézout - Général Leclerc,OUI,28,24,4,0,4,OUI,OUI,2025-03-13 10:57:37+00:00,"48.82884804502439, 2.3285973072052",Paris,75056,0.14285714285714285,11
8036,Lisbonne - Monceau,OUI,46,10,36,14,22,OUI,OUI,2025-03-13 11:01:05+00:00,"48.877455676814, 2.3096942214195",Paris,75056,0.782608695652174,11
2005,Montmartre - Etienne Marcel,OUI,16,9,7,6,1,OUI,OUI,2025-03-13 10:58:26+00:00,"48.86502194581, 2.3450684401448",Paris,75056,0.4375,11
6031,Pierre Sarrazin - Saint-Michel,OUI,31,2,29,22,7,OUI,OUI,2025-03-13 11:01:37+00:00,"48.850908146398, 2.342130728066",Paris,75056,0.9354838709677419,11
3012,Square Emile - Chautemps,OUI,25,2,23,18,5,OUI,OUI,2025-03-13 11:01:13+00:00,"48.867433724231, 2.3536357283592",Paris,75056,0.92,11
14133,Froidevaux - Boulard,OUI,35,35,0,0,0,OUI,OUI,2025-03-13 10:55:10+00:00,"48.835147319625, 2.3294411972165",Paris,75056,0.0,11
19111,Cesaria Evora - Rosa Parks,OUI,35,26,9,7,2,OUI,OUI,2025-03-13 10:58:29+00:00,"48.89717672825043, 2.3745173960924144",Paris,75056,0.2571428571428571,11
4012,Tiron - Rivoli,OUI,27,6,21,16,5,OUI,OUI,2025-03-13 10:59:27+00:00,"48.855692253233, 2.3579058051109",Paris,75056,0.7777777777777778,11
9111,Victoire - Laffitte,OUI,19,3,16,14,2,OUI,OUI,2025-03-13 10:59:41+00:00,"48.87514373494672, 2.338118505144376",Paris,75056,0.8421052631578947,11
21215,Verdier - Jean Jaurès,OUI,32,31,1,1,0,OUI,OUI,2025-03-13 10:56:09+00:00,"48.81614048711214, 2.3123561963438988",Montrouge,92049,0.03125,11
5122,Saint-Michel - Luxembourg,OUI,28,9,19,2,17,OUI,OUI,2025-03-13 11:01:27+00:00,"48.84501507626, 2.3394941166043",Paris,75056,0.6785714285714286,11
41208,Alouettes - Maréchal de Lattre de Tassigny,OUI,21,11,10,2,8,OUI,OUI,2025-03-13 11:00:43+00:00,"48.85511009293948, 2.4930700287222862",Fontenay-sous-Bois,94033,0.47619047619047616,11
21110,Parc Roger Salengro,OUI,31,4,27,22,5,OUI,OUI,2025-03-13 11:01:31+00:00,"48.905303858642, 2.31055945158",Clichy,92024,0.8709677419354839,11
42704,Mairie du Kremlin-Bicêtre,OUI,25,25,0,0,0,OUI,OUI,2025-03-13 10:56:18+00:00,"48.81191981537702, 2.3570189997553825",Le Kremlin-Bicêtre,94043,0.0,11
48005,Eugène Varlin - Place de la Paix,OUI,23,21,2,1,1,OUI,OUI,2025-03-13 10:52:54+00:00,"48.792862, 2.363093",Villejuif,94076,0.08695652173913043,11
4017,Place de l'Hôtel de Ville,OUI,13,0,13,12,1,OUI,OUI,2025-03-13 10:59:47+00:00,"48.8573314, 2.351458",Paris,75056,1.0,11
21706,Jean Bleuzen - Square du 11 Novembre,OUI,45,36,9,7,2,OUI,OUI,2025-03-13 10:59:47+00:00,"48.8232579, 2.2965213",Vanves,92075,0.2,11
26006,Bas - Gabriel Péri,OUI,30,14,16,15,1,OUI,OUI,2025-03-13 11:01:11+00:00,"48.91585580539625, 2.2948095202445984",Asnières-sur-Seine,92004,0.5333333333333333,11
1014,Rivoli - Musée du Louvre,OUI,20,2,18,9,9,OUI,OUI,2025-03-13 11:01:13+00:00,"48.86364636851945, 2.33409583568573",Paris,75056,0.9,11
2012,Choiseul - Quatre Septembre,OUI,44,0,44,17,27,OUI,OUI,2025-03-13 11:01:07+00:00,"48.8699355331869, 2.3359975218772893",Paris,75056,1.0,11
42211,Séminaire de Conflans - Liberté,OUI,24,6,18,9,9,OUI,OUI,2025-03-13 11:01:38+00:00,"48.823194, 2.404179",Charenton-le-Pont,94018,0.75,11
21509,Gardenat Lapostol - Franklin Roosevelt,OUI,24,23,1,0,1,OUI,OUI,2025-03-13 10:56:02+00:00,"48.871839, 2.222505",Suresnes,92073,0.041666666666666664,11
42026,Barbès - Monique Maunoury,OUI,40,40,0,0,0,OUI,OUI,2025-03-13 11:00:46+00:00,"48.81552718820216, 2.3687169334905405",Ivry-sur-Seine,94041,0.0,11
13054,Pau Casals - Neuve Tolbiac,OUI,53,2,51,18,33,OUI,OUI,2025-03-13 11:01:33+00:00,"48.8311602, 2.3774395",Paris,75056,0.9622641509433962,11
12163,Hippodrome Paris-Vincennes,OUI,42,40,2,1,1,OUI,OUI,2025-03-13 10:53:51+00:00,"48.82048387758518, 2.446271181106568",Paris,75056,0.047619047619047616,11
2004,Square Pierre Lazareff,OUI,17,4,13,5,8,OUI,OUI,2025-03-13 10:58:42+00:00,"48.867141720746, 2.3483933508396",Paris,75056,0.7647058823529411,11
3002,Saint-Gilles - Turenne,OUI,15,4,11,8,3,OUI,OUI,2025-03-13 11:00:42+00:00,"48.858158956779, 2.3647149920992",Paris,75056,0.7333333333333333,11
19130,Place Paul Delouvrier,OUI,26,25,1,0,1,OUI,OUI,2025-03-13 10:55:50+00:00,"48.89197621431365, 2.3851288855075836",Paris,75056,0.038461538461538464,11
1012,Jean-Jacques Rousseau - Deux Ecus,OUI,21,1,20,12,8,OUI,OUI,2025-03-13 10:59:13+00:00,"48.86297805972131, 2.3414635285735126",Paris,75056,0.9523809523809523,11
21505,Édouard Vaillant - Place Jean Jaurès,OUI,20,19,1,1,0,OUI,OUI,2025-03-13 10:55:31+00:00,"48.86265537999924, 2.2089037319128613",Suresnes,92073,0.05,11
35012,Candale - Mehul,OUI,25,22,3,1,2,OUI,OUI,2025-03-13 10:55:55+00:00,"48.8893935006175, 2.414379715919495",Pantin,93055,0.12,11
16044,Porte de Saint Cloud - Parc des Princes,OUI,31,20,11,6,5,OUI,OUI,2025-03-13 10:59:10+00:00,"48.838662757066, 2.2525164484978",Paris,75056,0.3548387096774194,11
2016,Aboukir - Alexandrie,OUI,21,6,15,15,0,OUI,OUI,2025-03-13 11:01:39+00:00,"48.86868344444473, 2.3502043269474897",Paris,75056,0.7142857142857143,11
4007,Place de la Bastille - Bourdon,OUI,33,5,28,12,16,OUI,OUI,2025-03-13 11:00:38+00:00,"48.852364355271, 2.3681089282036",Paris,75056,0.8484848484848485,11
4018,Saint-Bon - Rivoli,OUI,15,2,13,10,3,OUI,OUI,2025-03-13 10:59:12+00:00,"48.857999643315, 2.3502172809763",Paris,75056,0.8666666666666667,11
5004,Saint-Jacques - Val de Grâce,OUI,19,2,17,5,12,OUI,OUI,2025-03-13 10:59:08+00:00,"48.8417514, 2.3413893",Paris,75056,0.8947368421052632,11
44001,Quai Jules Guesde - Saint-Simon,OUI,30,0,30,27,3,OUI,OUI,2025-03-13 11:00:43+00:00,"48.80391487219, 2.4089661620274",Vitry-sur-Seine,94081,1.0,11
10041,Gare du Nord - La Chapelle,OUI,18,17,1,1,0,OUI,OUI,2025-03-13 10:52:03+00:00,"48.884178287286, 2.3561057075858",Paris,75056,0.05555555555555555,11
4009,Village Saint-Paul,OUI,27,5,22,21,1,OUI,OUI,2025-03-13 11:01:21+00:00,"48.852639866625, 2.3607301712036",Paris,75056,0.8148148148148148,11
22506,Gare des Vallées,OUI,18,10,8,6,2,OUI,OUI,2025-03-13 10:56:31+00:00,"48.913179, 2.257726",La Garenne-Colombes,92035,0.4444444444444444,11
4101,Bastille - Beaumarchais,OUI,20,0,20,16,4,OUI,OUI,2025-03-13 11:00:07+00:00,"48.853833463852, 2.3685702681541",Paris,75056,1.0,11
1025,Oratoire - Rivoli,OUI,17,3,14,8,6,OUI,OUI,2025-03-13 11:01:18+00:00,"48.861342760889, 2.3400047421455",Paris,75056,0.8235294117647058,11
33020,Waldeck Rochet - Germaine Tillon,OUI,30,2,28,16,12,OUI,OUI,2025-03-13 10:59:57+00:00,"48.91105960199651, 2.3676301538944244",Aubervilliers,93001,0.9333333333333333,11
1018,Alger - Rivoli,OUI,14,1,13,8,5,OUI,OUI,2025-03-13 10:58:50+00:00,"48.864773553495, 2.3294493936128",Paris,75056,0.9285714285714286,11
32019,Place du 8 mai 1945.,OUI,28,24,4,3,1,OUI,OUI,2025-03-13 10:56:57+00:00,"48.938882272105, 2.3566243797541",Saint-Denis,93066,0.14285714285714285,11
2008,Mairie du 2ème,OUI,28,2,26,13,13,OUI,OUI,2025-03-13 11:01:14+00:00,"48.8672190355135, 2.3404625437747044",Paris,75056,0.9285714285714286,11
9039,Chaussée d'Antin - Haussmann,OUI,23,3,20,14,6,OUI,OUI,2025-03-13 11:00:05+00:00,"48.87243, 2.33359",Paris,75056,0.8695652173913043,11
1026,Place du Lieutenant Henri Karcher,OUI,29,0,29,23,6,OUI,OUI,2025-03-13 11:01:41+00:00,"48.863490871724466, 2.3400671035051346",Paris,75056,1.0,11
23101,Grande Rue - Europe,OUI,25,18,7,5,2,OUI,OUI,2025-03-13 11:01:01+00:00,"48.8218104687602, 2.205879874527455",Sèvres,92072,0.28,11
18015,Custine - Ramey,OUI,40,40,0,0,0,OUI,OUI,2025-03-13 11:01:11+00:00,"48.888735896947, 2.3469526693225",Paris,75056,0.0,11
1116,Ventadour - Opéra,OUI,25,1,24,10,14,OUI,OUI,2025-03-13 10:59:09+00:00,"48.866810653323, 2.3343884482519",Paris,75056,0.96,11
17106,Berthier - Porte de Clichy,OUI,24,19,5,4,1,OUI,OUI,2025-03-13 10:59:11+00:00,"48.894222687781, 2.3125872006816",Paris,75056,0.20833333333333334,11
32024,Port - Confluence,OUI,23,19,4,3,1,OUI,OUI,2025-03-13 10:50:59+00:00,"48.936093926526, 2.3436167797955",Saint-Denis,93066,0.17391304347826086,11
1017,Saint-Honoré - 29 juillet,OUI,18,1,17,10,7,OUI,OUI,2025-03-13 11:00:40+00:00,"48.86557114282421, 2.330567417577153",Paris,75056,0.9444444444444444,11
6026,Saint-Placide - Cherche Midi,OUI,66,49,17,14,3,OUI,OUI,2025-03-13 10:58:55+00:00,"48.8490535919234, 2.325317971408367",Paris,75056,0.25757575757575757,11
15040,Saint-Amand - Labrouste,OUI,34,33,1,1,0,OUI,OUI,2025-03-13 11:01:29+00:00,"48.834097274832295, 2.3087677359581",Paris,75056,0.029411764705882353,11
12164,Stade Pershing,OUI,26,26,0,0,0,NON,NON,2025-02-26 05:58:32+00:00,"48.829107826857, 2.4583535268903",Paris,75056,0.0,6
23107,Gare de Sèvres - Ville d'Avray,OUI,22,16,6,3,3,OUI,OUI,2025-03-13 10:54:31+00:00,"48.826262366227, 2.2001516849313",Sèvres,92072,0.2727272727272727,11
19202,Marseillaise - Grenade,OUI,43,41,2,1,1,OUI,OUI,2025-03-13 11:01:12+00:00,"48.889371092747, 2.3979396821544",Paris,75056,0.046511627906976744,11
6201,Saint Pères - Saint Germain,OUI,22,13,9,8,1,OUI,OUI,2025-03-13 10:59:12+00:00,"48.853729675265, 2.3300181032703",Paris,75056,0.4090909090909091,11
14201,Decrès - Alésia,OUI,30,30,0,0,0,OUI,OUI,2025-03-13 10:59:51+00:00,"48.832200060759, 2.3139070151575",Paris,75056,0.0,11
22601,Marx Dormoy - Château Sainte-Barbe,OUI,20,19,1,0,1,OUI,OUI,2025-03-13 10:52:47+00:00,"48.791782341055324, 2.297856844961643",Fontenay-aux-Roses,92032,0.05,11
27001,Square Victor Basch,OUI,19,5,14,10,4,OUI,OUI,2025-03-13 11:00:53+00:00,"48.914304862261, 2.2289156913757",Colombes,92025,0.7368421052631579,11
42018,Amédée Huon - Fort d'Ivry,OUI,31,31,0,0,0,OUI,OUI,2025-03-13 10:59:30+00:00,"48.805131376899986, 2.388489693403244",Ivry-sur-Seine,94041,0.0,11
31020,Résistance - Parmentier,OUI,32,27,5,2,3,OUI,OUI,2025-03-13 10:56:57+00:00,"48.85965138131299, 2.436705082654953",Montreuil,93048,0.15625,11
1023,Saint-Honoré - Musée du Louvre,OUI,21,1,20,9,11,OUI,OUI,2025-03-13 11:01:00+00:00,"48.863443132848, 2.3348781846405",Paris,75056,0.9523809523809523,11
28005,Jean Jaurès - Paul Lafargue,OUI,25,4,21,6,15,OUI,OUI,2025-03-13 10:59:16+00:00,"48.884933177666, 2.2484488785267",Puteaux,92062,0.84,11
48008,Guy Môquet - Parvis Georges Marchais,OUI,30,30,0,0,0,OUI,OUI,2025-03-13 11:00:56+00:00,"48.79518840095975, 2.35943466424942",Villejuif,94076,0.0,11
42028,Verdun - Carnot,OUI,28,25,3,1,2,OUI,OUI,2025-03-13 10:47:25+00:00,"48.808439376064946, 2.373795211315155",Ivry-sur-Seine,94041,0.10714285714285714,11
5003,Le Goff - Gay-Lussac,OUI,34,12,22,9,13,OUI,OUI,2025-03-13 11:00:22+00:00,"48.846102400979, 2.3412207886577",Paris,75056,0.6470588235294118,11
12166,Parc Floral du Bel Air,OUI,23,13,10,6,4,OUI,OUI,2025-03-13 11:01:25+00:00,"48.839285711865735, 2.438560165464878",Paris,75056,0.43478260869565216,11
17021,Jouffroy d'Abbans - Villiers,OUI,30,23,7,6,1,OUI,OUI,2025-03-13 10:57:52+00:00,"48.884215547037, 2.3056533560157",Paris,75056,0.23333333333333334,11
9019,Victor Massé - Jean-Baptiste Pigalle,OUI,18,16,2,0,2,OUI,OUI,2025-03-13 10:57:56+00:00,"48.8811043724, 2.3366955667734",Paris,75056,0.1111111111111111,11
1024,Coquillière - Louvre,OUI,17,0,17,4,13,OUI,OUI,2025-03-13 11:01:43+00:00,"48.863795909662, 2.3425736278296",Paris,75056,1.0,11
3007,Archives - Pastourelle,OUI,26,2,24,13,11,OUI,OUI,2025-03-13 10:56:31+00:00,"48.8623615, 2.3595041",Paris,75056,0.9230769230769231,11
2102,Saint-Marc - Feydeau,OUI,36,10,26,14,12,OUI,OUI,2025-03-13 11:00:52+00:00,"48.870326843044, 2.3418715826353",Paris,75056,0.7222222222222222,11
35005,Quai de l'Aisne - Général Leclerc,OUI,26,25,1,0,1,OUI,OUI,2025-03-13 10:59:40+00:00,"48.895713, 2.400571",Pantin,93055,0.038461538461538464,11
10201,Magenta - Chabrol,OUI,23,21,2,0,2,OUI,OUI,2025-03-13 11:01:02+00:00,"48.876495350882, 2.3560990020633",Paris,75056,0.08695652173913043,11
18112,Arthur Ranc - Hôpital Bichat,OUI,23,13,10,4,6,OUI,OUI,2025-03-13 10:54:27+00:00,"48.8978712500682, 2.333521842956543",Paris,75056,0.43478260869565216,11
6029,Vaugirard - Monsieur le Prince,OUI,24,0,24,12,12,OUI,OUI,2025-03-13 11:01:25+00:00,"48.848951441614, 2.3411329463124",Paris,75056,1.0,11
16139,Suresnes - Muette à Neuilly,OUI,26,22,4,2,2,OUI,OUI,2025-03-13 10:55:11+00:00,"48.868570404348, 2.266000919044",Paris,75056,0.15384615384615385,11
44008,Youri Gagarine - Commune de Paris,OUI,32,11,21,12,9,OUI,OUI,2025-03-13 10:57:15+00:00,"48.782427463041, 2.3939734697342",Vitry-sur-Seine,94081,0.65625,11
6007,Bréa - Raspail,OUI,23,8,15,3,12,OUI,OUI,2025-03-13 11:01:37+00:00,"48.842738478258, 2.3297942217634",Paris,75056,0.6521739130434783,11
23104,Quai de Sèvres - Manufacture Nationale,OUI,26,14,12,5,7,OUI,OUI,2025-03-13 11:00:32+00:00,"48.828688, 2.22499",Sèvres,92072,0.46153846153846156,11
22603,Place de la Division Leclerc,OUI,33,33,0,0,0,OUI,OUI,2025-03-13 10:59:14+00:00,"48.793824988636516, 2.2731140430551027",Fontenay-aux-Roses,92032,0.0,11
21011,Silly - Louis Blériot,OUI,23,1,22,8,14,OUI,OUI,2025-03-13 11:00:40+00:00,"48.83219045374266, 2.2340199351310734",Boulogne-Billancourt,92012,0.9565217391304348,11
12113,Cardinal Lavigerie,OUI,46,8,38,28,10,OUI,OUI,2025-03-13 11:01:18+00:00,"48.832934193699835, 2.402636749399156",Paris,75056,0.8260869565217391,11
48012,Stalingrad - Henri Luisette,OUI,26,23,3,2,1,OUI,OUI,2025-03-13 11:00:48+00:00,"48.78363092456589, 2.366935946761926",Villejuif,94076,0.11538461538461539,11
21119,Belfort - Victor Hugo,OUI,21,2,19,15,4,OUI,OUI,2025-03-13 11:01:37+00:00,"48.9018492, 2.3172724",Clichy,92024,0.9047619047619048,11
23303,Gare de Robinson,OUI,29,29,0,0,0,OUI,OUI,2025-03-13 10:53:26+00:00,"48.7799259211605, 2.281828634440899",Sceaux,92071,0.0,11
16010,Belles Feuilles - Place de Mexico,OUI,22,18,4,1,3,OUI,OUI,2025-03-13 11:01:36+00:00,"48.865804746474, 2.2829206287861",Paris,75056,0.18181818181818182,11
10166,Strasbourg - Saint-Denis,OUI,16,2,14,7,7,OUI,OUI,2025-03-13 11:01:06+00:00,"48.869601642433, 2.3542908579111",Paris,75056,0.875,11
16201,Porte Dauphine,OUI,60,35,25,8,17,OUI,OUI,2025-03-13 11:01:23+00:00,"48.871139344351, 2.2749781616017",Paris,75056,0.4166666666666667,11
45004,République - Louis Loucheur,OUI,37,5,32,4,28,OUI,OUI,2025-03-13 11:00:55+00:00,"48.823549261189, 2.5101865455508",Champigny-sur-Marne,94017,0.8648648648648649,11
23042,André Theuriet - Blagis,OUI,30,18,12,8,4,OUI,OUI,2025-03-13 10:59:43+00:00,"48.77977325745441, 2.3130525648593903",Bourg-la-Reine,92014,0.4,11
32605,Mairie,OUI,19,19,0,0,0,OUI,OUI,2025-03-13 10:55:43+00:00,"48.87914304162, 2.4163350908311",Les Lilas,93045,0.0,11
42019,Lampes,OUI,43,4,39,36,3,OUI,OUI,2025-03-13 11:01:37+00:00,"48.81152481985875, 2.4017931148409843",Ivry-sur-Seine,94041,0.9069767441860465,11
32011,Stade de France - Francis de Pressensé,OUI,43,0,43,6,37,OUI,OUI,2025-03-13 11:01:27+00:00,"48.919141953558, 2.3620655760169",Saint-Denis,93066,1.0,11
17020,Jouffroy d'Abbans - Malesherbes,OUI,26,24,2,2,0,OUI,OUI,2025-03-13 10:58:33+00:00,"48.8850134, 2.3070717",Paris,75056,0.07692307692307693,11
32020,Jules Guesdes - Carnot,OUI,14,14,0,0,0,OUI,OUI,2025-03-13 10:54:27+00:00,"48.93828169931872, 2.3508992046117783",Saint-Denis,93066,0.0,11
12202,Charenton - Wattignies,OUI,40,38,2,2,0,OUI,OUI,2025-03-13 11:00:08+00:00,"48.836919119234, 2.3916775206425",Paris,75056,0.05,11
27006,Victor Hugo - Gare,OUI,19,14,5,3,2,OUI,OUI,2025-03-13 10:57:08+00:00,"48.923133952658, 2.2600970417261",Colombes,92025,0.2631578947368421,11
42030,Stéphanie Bouvard - Gambetta,OUI,30,18,12,8,4,OUI,OUI,2025-03-13 10:59:26+00:00,"48.814548138856, 2.4024386957288",Ivry-sur-Seine,94041,0.4,11
1015,Place André Malraux,OUI,16,2,14,8,6,OUI,OUI,2025-03-13 11:00:41+00:00,"48.863925158727, 2.3356226831675",Paris,75056,0.875,11
8018,Saint-Augustin,OUI,29,0,29,12,17,OUI,OUI,2025-03-13 11:01:20+00:00,"48.8762009747008, 2.319786250591278",Paris,75056,1.0,11
1008,Les Halles - Saint-Eustache,OUI,32,4,28,15,13,OUI,OUI,2025-03-13 11:01:42+00:00,"48.86362695901683, 2.342623919248581",Paris,75056,0.875,11
20142,Mûriers - Père Lachaise,OUI,19,19,0,0,0,OUI,OUI,2025-03-13 10:59:26+00:00,"48.864130509668044, 2.39164982067019",Paris,75056,0.0,11
2006,Place des Victoires,OUI,23,2,21,15,6,OUI,OUI,2025-03-13 11:00:15+00:00,"48.8660354, 2.3420333",Paris,75056,0.9130434782608695,11
44004,Place de l'Eglise - Vitry-sur-Seine,OUI,28,6,22,21,1,OUI,OUI,2025-03-13 11:00:24+00:00,"48.791922819921815, 2.395057752728462",Vitry-sur-Seine,94081,0.7857142857142857,11
48001,Chastenet de Géry - Marcel Paul,OUI,25,24,1,0,1,OUI,OUI,2025-03-13 10:48:04+00:00,"48.800123, 2.3567359",Villejuif,94076,0.04,11
19046,Porte de Pantin.,OUI,33,32,1,0,1,OUI,OUI,2025-03-13 10:57:38+00:00,"48.889199725577, 2.3950181901455",Paris,75056,0.030303030303030304,11
24101,Place Charles de Gaulle,OUI,24,22,2,0,2,OUI,OUI,2025-03-13 10:59:40+00:00,"48.826073335699, 2.1894485725692",Ville-d'Avray,92077,0.08333333333333333,11
2020,Danielle Casanova - Opéra,OUI,20,1,19,8,11,OUI,OUI,2025-03-13 11:01:07+00:00,"48.867643242297, 2.3333894088864",Paris,75056,0.95,11
25007,Bons Raisins - Voltaire,OUI,24,23,1,0,1,OUI,OUI,2025-03-13 10:59:44+00:00,"48.87282451461399, 2.1947155570850896",Rueil-Malmaison,92063,0.041666666666666664,11
19114,Manin - Secrétan,OUI,20,20,0,0,0,OUI,OUI,2025-03-13 10:56:55+00:00,"48.8791665, 2.3787959",Paris,75056,0.0,11
12016,Saint-Mande - Picpus,OUI,34,25,9,2,7,OUI,OUI,2025-03-13 11:00:46+00:00,"48.845127728278, 2.4015686296482",Paris,75056,0.2647058823529412,11
24004,Paix - Verdun,OUI,33,29,4,0,4,OUI,OUI,2025-03-13 10:57:40+00:00,"48.900504, 2.261173",Courbevoie,92026,0.12121212121212122,11
23301,Les Blagis,OUI,24,11,13,12,1,OUI,OUI,2025-03-13 11:01:00+00:00,"48.785205, 2.302526",Sceaux,92071,0.5416666666666666,11
23041,Général Leclerc - Bièvre,OUI,24,17,7,3,4,OUI,OUI,2025-03-13 11:00:45+00:00,"48.782414428747316, 2.3166695237159733",Bourg-la-Reine,92014,0.2916666666666667,11
42210,Victor Hugo - Paul Eluard,OUI,31,7,24,23,1,OUI,OUI,2025-03-13 11:01:29+00:00,"48.819602554907, 2.4114319673051",Charenton-le-Pont,94018,0.7741935483870968,11
31104,Mairie de Rosny-sous-Bois,OUI,26,13,13,10,3,OUI,OUI,2025-03-13 10:59:24+00:00,"48.871256519012, 2.4865807592869",Rosny-sous-Bois,93064,0.5,11
34013,Blanqui - Docteur Bauer,OUI,20,8,12,6,6,OUI,OUI,2025-03-13 11:01:18+00:00,"48.907735489085, 2.3407192814591",Saint-Ouen-sur-Seine,93070,0.6,11
5027,Gobelins - Port-Royal,OUI,36,12,24,21,3,OUI,OUI,2025-03-13 11:01:19+00:00,"48.837135900263, 2.3515201359987",Paris,75056,0.6666666666666666,11
20140,Paganini - Davout,OUI,21,18,3,2,1,OUI,OUI,2025-03-13 10:54:55+00:00,"48.85135, 2.412021",Paris,75056,0.14285714285714285,11
11111,Léon Frot - Charonne,OUI,18,16,2,0,2,OUI,OUI,2025-03-13 11:00:36+00:00,"48.854963800335234, 2.387217085372007",Paris,75056,0.1111111111111111,11
20010,Sorbier - Gasnier-Guy,OUI,34,34,0,0,0,OUI,OUI,2025-03-13 10:59:51+00:00,"48.865217631011, 2.3936596512794",Paris,75056,0.0,11
15053,Lecourbe - Convention,OUI,44,39,5,4,1,OUI,OUI,2025-03-13 11:01:05+00:00,"48.83923319241899, 2.2915197908878326",Paris,75056,0.11363636363636363,11
42022,Gare RER - Maurice Grandcoing,OUI,36,7,29,28,1,OUI,OUI,2025-03-13 10:59:31+00:00,"48.813881, 2.392429",Ivry-sur-Seine,94041,0.8055555555555556,11
20003,Pyrénées - Cours de Vincennes,OUI,19,11,8,3,5,OUI,OUI,2025-03-13 11:00:09+00:00,"48.847796779935, 2.4061721563339",Paris,75056,0.42105263157894735,11
15018,Dutot - Place Alleray,OUI,56,52,4,0,4,OUI,OUI,2025-03-13 11:00:49+00:00,"48.836826091766, 2.3071701095578",Paris,75056,0.07142857142857142,11
15041,Franquet - Labrouste,OUI,37,37,0,0,0,OUI,OUI,2025-03-13 10:57:40+00:00,"48.83287705011431, 2.306762784719467",Paris,75056,0.0,11
26012,Jardin Modèle - Pierre Boudou,OUI,15,13,2,0,2,OUI,OUI,2025-03-13 11:00:30+00:00,"48.914866710946, 2.3057010525935",Asnières-sur-Seine,92004,0.13333333333333333,11
10003,Hauteville - Bonne Nouvelle,OUI,17,3,14,6,8,OUI,OUI,2025-03-13 11:01:42+00:00,"48.87077436024, 2.3496496368327",Paris,75056,0.8235294117647058,11
20048,Bagnolet - Place Saint-Blaise,OUI,27,26,1,1,0,OUI,OUI,2025-03-13 11:00:54+00:00,"48.85973, 2.40334",Paris,75056,0.037037037037037035,11
13028,Gouthière - Poterne des Peupliers,OUI,32,29,3,1,2,OUI,OUI,2025-03-13 10:58:32+00:00,"48.820507, 2.351342",Paris,75056,0.09375,11
23202,Henri Barbusse - Gabriel Péri,OUI,17,14,3,0,3,OUI,OUI,2025-03-13 10:59:35+00:00,"48.801773795836, 2.2874166362216",Châtillon,92020,0.17647058823529413,11
15069,Félix Faure - Convention,OUI,44,22,22,17,5,OUI,OUI,2025-03-13 11:01:44+00:00,"48.841249336041, 2.2883866008495",Paris,75056,0.5,11
13049,Vincent Auriol - Louise Weiss,OUI,22,7,15,10,5,OUI,OUI,2025-03-13 11:00:07+00:00,"48.834001935501, 2.3703888058662",Paris,75056,0.6818181818181818,11
48002,LCL Campus - Place Oscar Niemeyer,OUI,37,37,0,0,0,OUI,OUI,2025-03-13 10:55:12+00:00,"48.805342480621576, 2.363983690738678",Villejuif,94076,0.0,11
6015,André Mazet - Saint-André des Arts,OUI,55,0,55,49,6,OUI,OUI,2025-03-13 11:01:38+00:00,"48.85375581057431, 2.3390958085656166",Paris,75056,1.0,11
41605,Général De Gaulle - Vivien,OUI,20,18,2,1,1,OUI,OUI,2025-03-13 11:01:24+00:00,"48.83607420090204, 2.4189166724681854",Saint-Mandé,94067,0.1,11
17202,Mariotte - Batignolles,OUI,18,14,4,2,2,OUI,OUI,2025-03-13 10:57:12+00:00,"48.884571659595, 2.321469503475",Paris,75056,0.2222222222222222,11
35013,Guillaume Tell - Parc Henri Barbusse,OUI,20,18,2,0,2,OUI,OUI,2025-03-13 10:58:03+00:00,"48.88958925894009, 2.4198862910270695",Pantin,93055,0.1,11
8202,Londres - Europe,OUI,27,22,5,2,3,OUI,OUI,2025-03-13 10:57:05+00:00,"48.878618556803, 2.3248164693922",Paris,75056,0.18518518518518517,11
12119,Dom-Pérignon - Gravelle,OUI,45,24,21,19,2,OUI,OUI,2025-03-13 11:01:12+00:00,"48.825481574435, 2.409880310297",Paris,75056,0.4666666666666667,11
23206,Béranger - Félix Faure,OUI,26,26,0,0,0,OUI,OUI,2025-03-13 10:53:19+00:00,"48.80404828621485, 2.2848263373723436",Châtillon,92020,0.0,11
15050,Dominique Pado - Croix Nivert,OUI,22,18,4,1,3,OUI,OUI,2025-03-13 10:55:52+00:00,"48.83648798164934, 2.2897250577807426",Paris,75056,0.18181818181818182,11
8040,Pierre Charron - Champs-Elysées,OUI,30,5,25,11,14,OUI,OUI,2025-03-13 11:00:15+00:00,"48.870103359864, 2.3043501377106",Paris,75056,0.8333333333333334,11
16025,Jean de la Fontaine - Boulainvilliers,OUI,66,5,61,46,15,OUI,OUI,2025-03-13 11:01:11+00:00,"48.85264791461651, 2.2758664190769196",Paris,75056,0.9242424242424242,11
10202,Bichat - Grange aux Belles,OUI,28,25,3,1,2,OUI,OUI,2025-03-13 10:59:01+00:00,"48.873688, 2.365015",Paris,75056,0.10714285714285714,11
14009,Tombe Issoire - René Coty,OUI,35,32,3,2,1,OUI,OUI,2025-03-13 10:56:11+00:00,"48.830512876709, 2.3343613743782",Paris,75056,0.08571428571428572,11
17117,Pereire - Saussure,OUI,32,27,5,3,2,OUI,OUI,2025-03-13 10:57:47+00:00,"48.888229075478, 2.3101296275854",Paris,75056,0.15625,11
51008,Martyrs de Châteaubriant - Jean Grandel,OUI,38,27,11,1,10,OUI,OUI,2025-03-13 10:56:37+00:00,"48.951432, 2.211214",Argenteuil,95018,0.2894736842105263,11
18021,Marcadet - Ramey,OUI,21,20,1,0,1,OUI,OUI,2025-03-13 10:58:47+00:00,"48.890875, 2.3449019",Paris,75056,0.047619047619047616,11
18135,Ney - Porte de Montmartre,OUI,23,19,4,2,2,OUI,OUI,2025-03-13 11:00:10+00:00,"48.897918, 2.3364872",Paris,75056,0.17391304347826086,11
20013,Alexandre Dumas - Place de la Réunion,OUI,45,41,4,1,3,OUI,OUI,2025-03-13 10:55:46+00:00,"48.85533710742046, 2.3997703687646292",Paris,75056,0.08888888888888889,11
34011,Clef des Champs - Albert Dhalenne,OUI,25,1,24,12,12,OUI,OUI,2025-03-13 10:57:29+00:00,"48.914938, 2.330665",Saint-Ouen-sur-Seine,93070,0.96,11
15045,Porte de la Plaine,OUI,35,33,2,2,0,OUI,OUI,2025-03-13 11:00:36+00:00,"48.82805169605981, 2.2924277186393742",Paris,75056,0.05714285714285714,11
21329,Gare - Aristide Briand,OUI,28,7,21,15,6,OUI,OUI,2025-03-13 11:01:16+00:00,"48.821410564722, 2.2555950104387",Issy-les-Moulineaux,92040,0.75,11
25004,Marcel Pourtout - Édouard Manet,OUI,24,6,18,17,1,OUI,OUI,2025-03-13 10:59:11+00:00,"48.87555620763429, 2.1655967831611638",Rueil-Malmaison,92063,0.75,11
21704,Place du Maréchal de Lattre de Tassigny,OUI,27,24,3,1,2,OUI,OUI,2025-03-13 10:56:41+00:00,"48.821707715257055, 2.2853431485432423",Vanves,92075,0.1111111111111111,11
12022,Sahel - Général Michel Bizot,OUI,30,25,5,1,4,OUI,OUI,2025-03-13 10:59:46+00:00,"48.840872964793355, 2.4044444784522057",Paris,75056,0.16666666666666666,11
19121,Belleville -  Pré Saint-Gervais,OUI,21,21,0,0,0,OUI,OUI,2025-03-13 10:57:10+00:00,"48.875565910073, 2.3930460959673",Paris,75056,0.0,11
15027,Duhamel - André Gide,OUI,20,19,1,1,0,OUI,OUI,2025-03-13 10:53:22+00:00,"48.8365662244334, 2.312707121097412",Paris,75056,0.05,11
13015,Chevaleret - Louise Weiss,OUI,35,12,23,10,13,OUI,OUI,2025-03-13 10:59:03+00:00,"48.832586513351, 2.37121138812",Paris,75056,0.6571428571428571,11
21023,Ancienne Mairie - André Morizet,OUI,25,14,11,7,4,OUI,OUI,2025-03-13 11:01:15+00:00,"48.838311, 2.234077",Boulogne-Billancourt,92012,0.44,11
12123,Château de Vincennes,OUI,49,38,11,6,5,OUI,OUI,2025-03-13 10:52:31+00:00,"48.84423193255657, 2.439209537709179",Paris,75056,0.22448979591836735,11
31105,Lavoisier - Missak Manouchian,OUI,13,8,5,1,4,OUI,OUI,2025-03-13 11:01:00+00:00,"48.86286468896063, 2.495676465332508",Rosny-sous-Bois,93064,0.38461538461538464,11
21002,Place Denfert-Rochereau,OUI,19,10,9,3,6,OUI,OUI,2025-03-13 11:01:34+00:00,"48.843252536286684, 2.245987951755524",Boulogne-Billancourt,92012,0.47368421052631576,11
42205,Place Aristide Briand,OUI,35,21,14,11,3,OUI,OUI,2025-03-13 10:59:54+00:00,"48.82189236575831, 2.413003742694855",Charenton-le-Pont,94018,0.4,11
13024,Bobillot - Tolbiac,OUI,33,30,3,0,3,OUI,OUI,2025-03-13 10:57:51+00:00,"48.8255961335041, 2.350204177200794",Paris,75056,0.09090909090909091,11
22701,Général Leclerc - République,OUI,28,10,18,16,2,OUI,OUI,2025-03-13 10:59:29+00:00,"48.915885074177, 2.2682306702811",Bois-Colombes,92009,0.6428571428571429,11
24005,Edith Cavell - Volta,OUI,32,30,2,0,2,OUI,OUI,2025-03-13 11:01:42+00:00,"48.901616564286975, 2.269354350864887",Courbevoie,92026,0.0625,11
17110,Legendre - Nollet,OUI,29,24,5,1,4,OUI,OUI,2025-03-13 10:59:05+00:00,"48.887742186754224, 2.320293079881375",Paris,75056,0.1724137931034483,11
42024,Danielle Casanova - Ledru-Rollin,OUI,28,10,18,18,0,OUI,OUI,2025-03-13 10:53:34+00:00,"48.815783497876815, 2.383259721100331",Ivry-sur-Seine,94041,0.6428571428571429,11
22404,Pierre Brossolette - 12 Février 1934,OUI,23,16,7,3,4,OUI,OUI,2025-03-13 10:57:43+00:00,"48.8176962416867, 2.3076123744249344",Malakoff,92046,0.30434782608695654,11
15203,Porte de Versailles,OUI,27,17,10,3,7,OUI,OUI,2025-03-13 11:00:46+00:00,"48.832324016657, 2.2875617349045",Paris,75056,0.37037037037037035,11
20032,Square des Amandiers,OUI,26,26,0,0,0,OUI,OUI,2025-03-13 10:52:21+00:00,"48.86615630668046, 2.3891324177384377",Paris,75056,0.0,11
13116,Place du Docteur Yersin,OUI,50,48,2,0,2,OUI,OUI,2025-03-13 11:00:19+00:00,"48.82010494991975, 2.3725583776831627",Paris,75056,0.04,11
20014,Charonne - Alexandre Dumas,OUI,34,32,2,1,1,OUI,OUI,2025-03-13 10:59:53+00:00,"48.856077415056, 2.3948693275452",Paris,75056,0.058823529411764705,11
48006,Maxime Gorki - Paul Vaillant-Couturier,OUI,19,19,0,0,0,OUI,OUI,2025-03-13 11:00:24+00:00,"48.79673508795443, 2.3683342337608337",Villejuif,94076,0.0,11
14035,Maine - Jean Zay,OUI,45,37,8,3,5,OUI,OUI,2025-03-13 10:57:30+00:00,"48.837925263898, 2.3225428909063",Paris,75056,0.17777777777777778,11
15012,Cambronne - Mademoiselle,OUI,66,58,8,4,4,OUI,OUI,2025-03-13 10:57:07+00:00,"48.843277330035214, 2.30230766886348",Paris,75056,0.12121212121212122,11
8046,Marceau - Président Wilson,OUI,29,2,27,19,8,OUI,OUI,2025-03-13 11:00:44+00:00,"48.8652359, 2.3002513",Paris,75056,0.9310344827586207,11
18016,Francoeur - Caulaincourt,OUI,33,32,1,0,1,OUI,OUI,2025-03-13 11:01:10+00:00,"48.8899944409612, 2.342529706656933",Paris,75056,0.030303030303030304,11
8007,Rome - Provence,OUI,29,8,21,18,3,OUI,OUI,2025-03-13 11:00:20+00:00,"48.874230055580306, 2.325570111724113",Paris,75056,0.7241379310344828,11
19117,Euryale Dehaynin - Loire,OUI,29,23,6,2,4,OUI,OUI,2025-03-13 10:59:34+00:00,"48.886248917304805, 2.3774591088294987",Paris,75056,0.20689655172413793,11
17006,Guy Môquet - Compoint,OUI,35,34,1,1,0,OUI,OUI,2025-03-13 10:56:27+00:00,"48.89213559044868, 2.32321947813034",Paris,75056,0.02857142857142857,11
21022,Dôme - République,OUI,24,2,22,15,7,OUI,OUI,2025-03-13 11:00:15+00:00,"48.832681, 2.250257",Boulogne-Billancourt,92012,0.9166666666666666,11
18101,Championnet.,OUI,20,19,1,0,1,OUI,OUI,2025-03-13 11:00:20+00:00,"48.8953643, 2.3498166",Paris,75056,0.05,11
11022,Roquette - Auguste Laurent,OUI,16,15,1,1,0,OUI,OUI,2025-03-13 11:01:43+00:00,"48.858001906023354, 2.381797702650783",Paris,75056,0.0625,11
6028,Quatre Vents - Carrefour de l'Odéon,OUI,37,10,27,19,8,OUI,OUI,2025-03-13 10:58:36+00:00,"48.851751374458864, 2.338161695134053",Paris,75056,0.7297297297297297,11
41103,Place de la vache noire,OUI,23,22,1,0,1,OUI,OUI,2025-03-13 11:00:14+00:00,"48.81040517059777, 2.327060401439667",Arcueil,94003,0.043478260869565216,11
20005,Reynaldo Hahn - Lagny,OUI,19,17,2,1,1,OUI,OUI,2025-03-13 11:00:51+00:00,"48.849266043601794, 2.412330328844772",Paris,75056,0.10526315789473684,11
41602,Place Charles Digeon,OUI,31,30,1,1,0,OUI,OUI,2025-03-13 11:00:00+00:00,"48.84354203133597, 2.418427169322968",Saint-Mandé,94067,0.03225806451612903,11
21207,Verdier - République,OUI,29,27,2,1,1,OUI,OUI,2025-03-13 11:01:09+00:00,"48.815403766277, 2.31739372015",Montrouge,92049,0.06896551724137931,11
20012,Buzenval - Vignoles,OUI,17,14,3,0,3,OUI,OUI,2025-03-13 10:57:27+00:00,"48.853858171688, 2.4000040814281",Paris,75056,0.17647058823529413,11
15120,Colonel Pierre Avia,OUI,29,15,14,12,2,OUI,OUI,2025-03-13 10:58:54+00:00,"48.8296843300915, 2.275342586850291",Paris,75056,0.4827586206896552,11
14004,Port Royal - Hôpital Cochin,OUI,21,10,11,3,8,OUI,OUI,2025-03-13 11:01:26+00:00,"48.838608030238, 2.3406994164846",Paris,75056,0.5238095238095238,11
21205,Arthur Auger - Jean Jaurès,OUI,22,19,3,3,0,OUI,OUI,2025-03-13 11:01:36+00:00,"48.813736445585235, 2.3069277405738835",Montrouge,92049,0.13636363636363635,11
14027,Gergovie - Alésia,OUI,54,53,1,0,1,OUI,OUI,2025-03-13 10:58:17+00:00,"48.83088717455243, 2.318882101207347",Paris,75056,0.018518518518518517,11
16023,Passy - Place du Costa Rica,OUI,29,26,3,2,1,OUI,OUI,2025-03-13 11:01:10+00:00,"48.8584893, 2.2839655",Paris,75056,0.10344827586206896,11
42303,Place Eustache Deschamps,OUI,20,13,7,4,3,OUI,OUI,2025-03-13 11:00:18+00:00,"48.793855, 2.336637",Cachan,94016,0.35,11
24007,Jean-Baptiste Charcot - Sainte-Geneviève,OUI,21,19,2,2,0,OUI,OUI,2025-03-13 11:00:42+00:00,"48.90310883721567, 2.278892956674099",Courbevoie,92026,0.09523809523809523,11
30003,Moscou - Edouard Vaillant,OUI,29,20,9,4,5,OUI,OUI,2025-03-13 10:59:52+00:00,"48.90755810177, 2.4689837335263",Bobigny,93008,0.3103448275862069,11
15114,Pasteur - Cotentin,OUI,9,9,0,0,0,OUI,OUI,2025-03-13 11:00:23+00:00,"48.8389284, 2.316356",Paris,75056,0.0,11
20020,Pyrénées - Charles Renouvier,OUI,29,29,0,0,0,OUI,OUI,2025-03-13 10:57:08+00:00,"48.86095933229224, 2.400421852042113",Paris,75056,0.0,11
19014,Lorraine - Jean Jaurès,OUI,18,18,0,0,0,OUI,OUI,2025-03-13 11:00:05+00:00,"48.8863865, 2.3825772",Paris,75056,0.0,11
12008,Hector Malot - Daumesnil,OUI,52,1,51,48,3,OUI,OUI,2025-03-13 11:00:55+00:00,"48.84693552991762, 2.3770876228809357",Paris,75056,0.9807692307692307,11
15014,Volontaires - Vaugirard,OUI,33,29,4,1,3,OUI,OUI,2025-03-13 10:58:11+00:00,"48.84132050184004, 2.30808901725357",Paris,75056,0.12121212121212122,11
12102,Bercy - Traversiére,OUI,30,4,26,18,8,OUI,OUI,2025-03-13 10:59:18+00:00,"48.846192642574, 2.3703800886869",Paris,75056,0.8666666666666667,11
13055,M.- A. Lagroua Weill-Hallé -  F. Dolto,OUI,59,13,46,24,22,OUI,OUI,2025-03-13 11:01:40+00:00,"48.828595283857425, 2.380220606266108",Paris,75056,0.7796610169491526,11
13120,Pierre Joseph Desault,OUI,18,9,9,9,0,OUI,OUI,2025-03-13 10:59:50+00:00,"48.82110230800372, 2.378775402903557",Paris,75056,0.5,11
22014,Victor Hugo - Bineau,OUI,24,14,10,5,5,OUI,OUI,2025-03-13 10:58:44+00:00,"48.88758225888669, 2.2783890366554265",Neuilly-sur-Seine,92051,0.4166666666666667,11
15024,Suffren - La Motte-Piquet,OUI,23,10,13,9,4,OUI,OUI,2025-03-13 11:00:38+00:00,"48.850881230919, 2.3012199997902",Paris,75056,0.5652173913043478,11
25002,Hôtel de Ville de Rueil-Malmaison,OUI,19,3,16,10,6,OUI,OUI,2025-03-13 11:00:30+00:00,"48.878194, 2.181724",Rueil-Malmaison,92063,0.8421052631578947,11
13006,Duméril - Jeanne d'Arc,OUI,40,28,12,8,4,OUI,OUI,2025-03-13 11:00:05+00:00,"48.838151608087, 2.3571084495564",Paris,75056,0.3,11
16022,Jean Bologne - Passy,OUI,19,16,3,3,0,OUI,OUI,2025-03-13 10:57:27+00:00,"48.857566889784465, 2.280027395306772",Paris,75056,0.15789473684210525,11
43007,Hôtel de Ville de Vincennes,OUI,26,26,0,0,0,OUI,OUI,2025-03-13 10:53:54+00:00,"48.84827609706963, 2.4398955702781677",Vincennes,94080,0.0,11
20011,Pyrénées - Dagorno,OUI,20,19,1,0,1,OUI,OUI,2025-03-13 11:00:30+00:00,"48.855425770695085, 2.4051643162965775",Paris,75056,0.05,11
13036,Olympiades,OUI,36,32,4,0,4,OUI,OUI,2025-03-13 11:01:23+00:00,"48.826764665199, 2.3650860786438",Paris,75056,0.1111111111111111,11
19001,Crimée - Ourcq,OUI,56,54,2,1,1,OUI,OUI,2025-03-13 10:57:53+00:00,"48.894104140316, 2.3729460884673",Paris,75056,0.03571428571428571,11
43004,Montreuil - République,OUI,22,21,1,1,0,OUI,OUI,2025-03-13 11:00:01+00:00,"48.85026349463687, 2.4345204234123234",Vincennes,94080,0.045454545454545456,11
12040,Porte de Charenton,OUI,66,57,9,4,5,OUI,OUI,2025-03-13 11:01:22+00:00,"48.831240105856, 2.3989107459784",Paris,75056,0.13636363636363635,11
16017,Siam - La Pompe,OUI,16,14,2,0,2,OUI,OUI,2025-03-13 10:58:20+00:00,"48.861720329027264, 2.275346568555312",Paris,75056,0.125,11
21007,Rond-Point Rhin et Danube,OUI,53,34,19,5,14,OUI,OUI,2025-03-13 11:00:23+00:00,"48.840452820991764, 2.2280225157737736",Boulogne-Billancourt,92012,0.3584905660377358,11
16116,George Sand - Jean de La Fontaine,OUI,29,20,9,6,3,OUI,OUI,2025-03-13 10:57:27+00:00,"48.84986918764119, 2.268257387525699",Paris,75056,0.3103448275862069,11
19007,Flandre - Ourcq,OUI,29,25,4,1,3,OUI,OUI,2025-03-13 11:00:25+00:00,"48.89260159189023, 2.3790915682911873",Paris,75056,0.13793103448275862,11
5033,Saint-Séverin - Saint-Michel,OUI,30,6,24,16,8,OUI,OUI,2025-03-13 11:00:33+00:00,"48.852731305488, 2.3440927639604",Paris,75056,0.8,11
5105,Geoffroy-Saint-Hilaire - Saint-Marcel,OUI,17,12,5,4,1,OUI,OUI,2025-03-13 10:58:46+00:00,"48.83907826424974, 2.356877340669728",Paris,75056,0.29411764705882354,11
31701,Mairie de Bagnolet,OUI,28,28,0,0,0,OUI,OUI,2025-03-13 11:00:38+00:00,"48.868421318555, 2.4179587885737",Bagnolet,93006,0.0,11
11018,Saint-Maur - République,OUI,37,33,4,2,2,OUI,OUI,2025-03-13 11:00:50+00:00,"48.864185861455, 2.3783174157143",Paris,75056,0.10810810810810811,11
30004,Jean Jaurès - Place de la Libération,OUI,28,2,26,11,15,OUI,OUI,2025-03-13 10:55:44+00:00,"48.90617751921, 2.4391458057475",Bobigny,93008,0.9285714285714286,11
22007,Commandant Charcot - Bretteville,OUI,31,20,11,10,1,OUI,OUI,2025-03-13 10:57:38+00:00,"48.87530570765423, 2.2558460757136345",Neuilly-sur-Seine,92051,0.3548387096774194,11
20110,Gambetta - Tourelles,OUI,20,20,0,0,0,OUI,OUI,2025-03-13 10:52:36+00:00,"48.875337902264, 2.4059921130538",Paris,75056,0.0,11
12039,Général Michel Bizot - Claude Decaen,OUI,37,29,8,3,5,OUI,OUI,2025-03-13 10:59:01+00:00,"48.83481262982544, 2.400927788127704",Paris,75056,0.21621621621621623,11
14005,René Coty - Place Denfert-Rochereau,OUI,36,32,4,1,3,OUI,OUI,2025-03-13 11:01:37+00:00,"48.833056477316, 2.3329411447048",Paris,75056,0.1111111111111111,11
13037,Ivry - Baudricourt,OUI,20,15,5,4,1,OUI,OUI,2025-03-13 10:59:47+00:00,"48.824695995415006, 2.363106073577468",Paris,75056,0.25,11
21218,Gabriel Péri - Place de la Libération,OUI,17,16,1,1,0,OUI,OUI,2025-03-13 11:01:11+00:00,"48.819828421929, 2.3117361743705",Montrouge,92049,0.058823529411764705,11
12017,Saint-Mandé - Docteur Arnold Netter,OUI,36,25,11,9,2,OUI,OUI,2025-03-13 11:00:45+00:00,"48.84462585769668, 2.404946386814118",Paris,75056,0.3055555555555556,11
11016,Philippe-Auguste,OUI,47,46,1,1,0,OUI,OUI,2025-03-13 11:00:36+00:00,"48.851853488265, 2.3932945355773",Paris,75056,0.02127659574468085,11
42027,Verdun - Pierre et Marie Curie,OUI,26,24,2,1,1,OUI,OUI,2025-03-13 10:59:35+00:00,"48.812822398263286, 2.3707106709480286",Ivry-sur-Seine,94041,0.07692307692307693,11
12122,Bois de Vincennes - Polygone,OUI,51,45,6,2,4,OUI,OUI,2025-03-13 10:59:00+00:00,"48.83544491617421, 2.431421081436563",Paris,75056,0.11764705882352941,11
16104,Paul Valery - Victor Hugo,OUI,34,27,7,1,6,OUI,OUI,2025-03-13 11:01:44+00:00,"48.87137406080164, 2.2887128591537476",Paris,75056,0.20588235294117646,11
16033,Marché d'Auteuil,OUI,31,6,25,23,2,OUI,OUI,2025-03-13 11:00:35+00:00,"48.84842761367387, 2.265253821160005",Paris,75056,0.8064516129032258,11
20033,Etienne Dolet - Place Maurice Chevalier,OUI,47,45,2,1,1,OUI,OUI,2025-03-13 10:55:34+00:00,"48.86798303359366, 2.3851405311143026",Paris,75056,0.0425531914893617,11
6004,Regard - Rennes,OUI,46,29,17,9,8,OUI,OUI,2025-03-13 11:01:27+00:00,"48.847385404956, 2.3268555477262",Paris,75056,0.3695652173913043,11
8044,Alfred de Vigny - Place du Général Brocard,OUI,32,15,17,3,14,OUI,OUI,2025-03-13 11:01:07+00:00,"48.87836138361425, 2.305254448220567",Paris,75056,0.53125,11
11029,Ménilmontant - Oberkampf,OUI,39,34,5,1,4,OUI,OUI,2025-03-13 10:57:18+00:00,"48.866617658681, 2.3830134404158",Paris,75056,0.1282051282051282,11
1201,Perrault - Place du Louvre,OUI,27,3,24,14,10,OUI,OUI,2025-03-13 11:00:40+00:00,"48.860273568996, 2.3412468419093",Paris,75056,0.8888888888888888,11
11028,Guillaume Bertrand - République,OUI,38,35,3,1,2,OUI,OUI,2025-03-13 10:54:45+00:00,"48.863825174341, 2.380906377155",Paris,75056,0.07894736842105263,11
51007,Résistance - Romain Rolland,OUI,28,26,2,0,2,OUI,OUI,2025-03-13 10:57:22+00:00,"48.950873482371, 2.2310190077797",Argenteuil,95018,0.07142857142857142,11
21027,Fief - République,OUI,25,0,25,21,4,OUI,OUI,2025-03-13 11:01:44+00:00,"48.83170888166024, 2.255771979689598",Boulogne-Billancourt,92012,1.0,11
17036,Place Tristan Bernard,OUI,28,25,3,0,3,OUI,OUI,2025-03-13 10:59:32+00:00,"48.8794936, 2.2915423",Paris,75056,0.10714285714285714,11
15044,Dantzig - Lefebvre,OUI,32,32,0,0,0,OUI,OUI,2025-03-13 10:59:39+00:00,"48.83013921586756, 2.295934036374092",Paris,75056,0.0,11
13008,Place d'Italie - Soeur Rosalie,OUI,52,42,10,1,9,OUI,OUI,2025-03-13 11:01:05+00:00,"48.831908520394, 2.3546943448098",Paris,75056,0.19230769230769232,11
15113,Arsonval - Falguière,OUI,24,20,4,0,4,OUI,OUI,2025-03-13 11:01:42+00:00,"48.84040040365445, 2.313117867297474",Paris,75056,0.16666666666666666,11
21033,Sèvres - Maréchal Juin,OUI,18,2,16,12,4,OUI,OUI,2025-03-13 11:00:28+00:00,"48.8324305, 2.2292812",Boulogne-Billancourt,92012,0.8888888888888888,11
6005,Montparnasse -  Square Ozanam,OUI,49,21,28,15,13,OUI,OUI,2025-03-13 11:01:40+00:00,"48.843310567822, 2.3265242949128",Paris,75056,0.5714285714285714,11
21112,Claude Debussy - Marc Bloch,OUI,52,38,14,12,2,OUI,OUI,2025-03-13 11:00:47+00:00,"48.910388180512, 2.3117771744728",Clichy,92024,0.2692307692307692,11
8003,Galilée - Vernet,OUI,47,35,12,1,11,OUI,OUI,2025-03-13 11:01:15+00:00,"48.871715878697, 2.2985444962978",Paris,75056,0.2553191489361702,11
13023,Bobillot - Moulin des Prés,OUI,28,26,2,0,2,OUI,OUI,2025-03-13 10:58:25+00:00,"48.828657346203, 2.353020646317",Paris,75056,0.07142857142857142,11
25009,Place des Arts - Jean Mermoz,OUI,20,6,14,13,1,OUI,OUI,2025-03-13 11:00:38+00:00,"48.880391139734, 2.1832160452221",Rueil-Malmaison,92063,0.7,11
20106,Mairie du 20ème,OUI,27,25,2,0,2,OUI,OUI,2025-03-13 10:55:41+00:00,"48.865302324275, 2.3990669846535",Paris,75056,0.07407407407407407,11
41101,Paul Doumer - Stalingrad,OUI,24,19,5,4,1,OUI,OUI,2025-03-13 10:55:23+00:00,"48.806518992199, 2.3368880152702",Arcueil,94003,0.20833333333333334,11
6020,Place Saint-André des Arts,OUI,33,2,31,17,14,OUI,OUI,2025-03-13 11:00:19+00:00,"48.852886173881, 2.3426544293761",Paris,75056,0.9393939393939394,11
3201,Payenne - Square George Caïn,OUI,22,4,18,15,3,OUI,OUI,2025-03-13 11:01:41+00:00,"48.8578329, 2.3622643",Paris,75056,0.8181818181818182,11
21016,Point du Jour - Jean Jaurès,OUI,39,26,13,12,1,OUI,OUI,2025-03-13 10:57:35+00:00,"48.828753141436465, 2.245911467014621",Boulogne-Billancourt,92012,0.3333333333333333,11
23106,Pavé des Gardes - Charles Vaillant,OUI,20,13,7,7,0,OUI,OUI,2025-03-13 10:57:43+00:00,"48.81168551728, 2.2111820107205",Sèvres,92072,0.35,11
19123,Metz - Marne,OUI,29,27,2,0,2,OUI,OUI,2025-03-13 11:01:21+00:00,"48.891163, 2.3865705",Paris,75056,0.06896551724137931,11
21508,Georges Pompidou - Verdun,OUI,24,2,22,11,11,OUI,OUI,2025-03-13 10:58:03+00:00,"48.875481, 2.232443",Suresnes,92073,0.9166666666666666,11
21107,Bertrand Sincholle - Henri Barbusse,OUI,18,10,8,7,1,OUI,OUI,2025-03-13 11:01:26+00:00,"48.89925982394349, 2.3042294383049016",Clichy,92024,0.4444444444444444,11
20037,Gambetta - Saint Fargeau,OUI,24,22,2,0,2,OUI,OUI,2025-03-13 10:56:04+00:00,"48.871244610447015, 2.4039056897163396",Paris,75056,0.08333333333333333,11
5031,Lacépède - Linné,OUI,49,19,30,19,11,OUI,OUI,2025-03-13 10:59:06+00:00,"48.8437035476636, 2.354651279747486",Paris,75056,0.6122448979591837,11
13053,Chevaleret - Tolbiac,OUI,21,4,17,12,5,OUI,OUI,2025-03-13 11:01:31+00:00,"48.82941, 2.375934",Paris,75056,0.8095238095238095,11
14025,Jacquier - Didot,OUI,30,28,2,0,2,OUI,OUI,2025-03-13 11:01:29+00:00,"48.82953336292279, 2.318179272115231",Paris,75056,0.06666666666666667,11
48011,Epi d'Or - Chevilly,OUI,20,14,6,0,6,OUI,OUI,2025-03-13 10:52:54+00:00,"48.781109786782, 2.3549050362061",Villejuif,94076,0.3,11
6009,Guynemer - Jardin du Luxembourg,OUI,34,20,14,9,5,OUI,OUI,2025-03-13 11:01:29+00:00,"48.8466127, 2.3325478",Paris,75056,0.4117647058823529,11
30005,Convention - Campus de Bobigny,OUI,29,14,15,2,13,OUI,OUI,2025-03-13 10:56:24+00:00,"48.914920058264, 2.4172238067445",Bobigny,93008,0.5172413793103449,11
41212,Nungesser - Santé,OUI,22,20,2,1,1,OUI,OUI,2025-03-13 10:53:14+00:00,"48.852335, 2.448967",Fontenay-sous-Bois,94033,0.09090909090909091,11
41304,Port - Maurice Chevalier,OUI,30,4,26,23,3,OUI,OUI,2025-03-13 10:59:15+00:00,"48.832474421632, 2.490257616467",Nogent-sur-Marne,94052,0.8666666666666667,11
17050,Batignolles - Abel Truchet,OUI,26,19,7,2,5,OUI,OUI,2025-03-13 10:56:02+00:00,"48.883103904582, 2.3238347490884",Paris,75056,0.2692307692307692,11
10151,Gare du Nord - Faubourg Saint-Denis,OUI,28,27,1,0,1,OUI,OUI,2025-03-13 10:57:57+00:00,"48.879612765504, 2.3568402975798",Paris,75056,0.03571428571428571,11
13013,Saint-Marcel - Hôpital,OUI,20,11,9,7,2,OUI,OUI,2025-03-13 10:59:28+00:00,"48.839504424583, 2.3609894170229",Paris,75056,0.45,11
8031,Jean Mermoz - Champs-Elysées,OUI,44,4,40,16,24,OUI,OUI,2025-03-13 11:00:24+00:00,"48.869689856852, 2.3107324540615",Paris,75056,0.9090909090909091,11
21510,Fontaine du Tertre - Calvaire,OUI,23,22,1,0,1,OUI,OUI,2025-03-13 10:52:51+00:00,"48.8702539, 2.2187778",Suresnes,92073,0.043478260869565216,11
26011,Ménil - Argenteuil,OUI,18,10,8,5,3,OUI,OUI,2025-03-13 10:57:22+00:00,"48.925901818305, 2.2741496502338",Asnières-sur-Seine,92004,0.4444444444444444,11
11040,Temple - Jean-Pierre Timbaud,OUI,32,11,21,15,6,OUI,OUI,2025-03-13 11:01:01+00:00,"48.86446597201, 2.3660597205162",Paris,75056,0.65625,11
22208,Stalingrad - Barbara,OUI,19,14,5,0,5,OUI,OUI,2025-03-13 11:01:28+00:00,"48.809223658808, 2.3175904558822",Bagneux,92007,0.2631578947368421,11
11038,Temple - Charlot,OUI,41,1,40,33,7,OUI,OUI,2025-03-13 11:00:06+00:00,"48.865709343796, 2.3652737250724",Paris,75056,0.975609756097561,11
22209,Verdun - Henri Barbusse,OUI,23,20,3,2,1,OUI,OUI,2025-03-13 10:57:59+00:00,"48.802056061754, 2.3159965061736",Bagneux,92007,0.13043478260869565,11
21511,Marcel Monge - Marcel Dassault,OUI,46,10,36,32,4,OUI,OUI,2025-03-13 11:01:30+00:00,"48.86096384533371, 2.2246733296048142",Suresnes,92073,0.782608695652174,11
45005,Stalingrad - Général de Gaulle,OUI,26,12,14,4,10,OUI,OUI,2025-03-13 10:59:17+00:00,"48.823450589614, 2.4965062363218",Champigny-sur-Marne,94017,0.5384615384615384,11
22703,Place Jean Mermoz,OUI,30,23,7,3,4,OUI,OUI,2025-03-13 10:59:55+00:00,"48.9220937, 2.2718348",Bois-Colombes,92009,0.23333333333333334,11
32305,Saint-Germain - Verdun,OUI,29,28,1,0,1,OUI,OUI,2025-03-13 10:57:26+00:00,"48.882877330093, 2.4331868384644",Romainville,93063,0.034482758620689655,11
24010,Charles de Gaulle - Rue de l'Alma,OUI,27,2,25,5,20,OUI,OUI,2025-03-13 11:00:13+00:00,"48.896620592993, 2.252313240191",Courbevoie,92026,0.9259259259259259,11
21954,Val-Fleury,OUI,23,16,7,4,3,OUI,OUI,2025-03-13 10:57:23+00:00,"48.807671407991, 2.2407217696309",Meudon,92048,0.30434782608695654,11
26010,Louis Armand - Bernard Palissy,OUI,17,7,10,8,2,OUI,OUI,2025-03-13 10:55:50+00:00,"48.916974, 2.313384",Asnières-sur-Seine,92004,0.5882352941176471,11
22507,Châteaudun - Place de la Liberté,OUI,25,23,2,2,0,OUI,OUI,2025-03-13 11:00:26+00:00,"48.90970830301211, 2.2454486480600626",La Garenne-Colombes,92035,0.08,11
20030,Ménilmontant - Père Lachaise,OUI,40,39,1,0,1,OUI,OUI,2025-03-13 10:57:42+00:00,"48.863287291502, 2.3869940266013",Paris,75056,0.025,11
11201,Faubourg St-Antoine - Place de la Nation,OUI,15,14,1,0,1,OUI,OUI,2025-03-13 10:59:45+00:00,"48.8487726, 2.393606",Paris,75056,0.06666666666666667,11
16140,Hippodrome de Longchamp,OUI,25,2,23,19,4,OUI,OUI,2025-03-13 10:57:56+00:00,"48.86413226532, 2.239905372262",Paris,75056,0.92,11
32023,Guy Môquet - Jean Moulin,OUI,27,7,20,11,9,OUI,OUI,2025-03-13 11:01:41+00:00,"48.940931521020836, 2.363948999931771",Saint-Denis,93066,0.7407407407407407,11
20035,Pyrénées - Ménilmontant,OUI,25,23,2,0,2,OUI,OUI,2025-03-13 10:58:45+00:00,"48.8693268535238, 2.395084574818611",Paris,75056,0.08,11
25010,Maréchal Leclerc de Hauteclocque - Marché Buzenval,OUI,30,25,5,4,1,OUI,OUI,2025-03-13 10:57:19+00:00,"48.858446, 2.192077",Rueil-Malmaison,92063,0.16666666666666666,11
15032,Félix Faure - Lourmel,OUI,55,33,22,21,1,OUI,OUI,2025-03-13 11:01:07+00:00,"48.83868901709515, 2.2818081825971603",Paris,75056,0.4,11
12165,Champs de Manoeuvre - Cartoucherie,OUI,32,12,20,12,8,OUI,OUI,2025-03-13 10:59:04+00:00,"48.835261, 2.447974",Paris,75056,0.625,11
19045,Macdonald - Césaria Evora,OUI,66,44,22,7,15,OUI,OUI,2025-03-13 11:00:53+00:00,"48.89883, 2.37933",Paris,75056,0.3333333333333333,11
12001,Bastille - Biscornet,OUI,59,5,54,45,9,OUI,OUI,2025-03-13 11:00:54+00:00,"48.851355779579, 2.369220033288",Paris,75056,0.9152542372881356,11
22302,Gare RER - Général de Gaulle,OUI,38,19,19,13,6,OUI,OUI,2025-03-13 10:58:09+00:00,"48.933548439566, 2.3064726536317",Gennevilliers,92036,0.5,11
22018,Charles de Gaulle - Les Sablons,OUI,35,18,17,8,9,OUI,OUI,2025-03-13 11:01:41+00:00,"48.880987514929, 2.2715748726513",Neuilly-sur-Seine,92051,0.4857142857142857,11
9029,Saint-Lazare - Place d'Estienne d'Orves,OUI,39,2,37,20,17,OUI,OUI,2025-03-13 10:59:17+00:00,"48.8768345, 2.3329067",Paris,75056,0.9487179487179487,11
21320,Président Roosevelt - Rouget de Lisle,OUI,40,0,40,23,17,OUI,OUI,2025-03-13 11:01:05+00:00,"48.83047518749, 2.2616135525345",Issy-les-Moulineaux,92040,1.0,11
34009,Dora Maar - Nadia Guendouz,OUI,28,1,27,22,5,OUI,OUI,2025-03-13 11:00:48+00:00,"48.905452421305, 2.3220406472683",Saint-Ouen-sur-Seine,93070,0.9642857142857143,11
23203,Division Leclerc - Kléber,OUI,25,19,6,3,3,OUI,OUI,2025-03-13 10:59:31+00:00,"48.798666226364, 2.2833752789972",Châtillon,92020,0.24,11
7007,Musée d'Orsay,OUI,63,8,55,40,15,OUI,OUI,2025-03-13 11:00:08+00:00,"48.859726157909, 2.3258604481816",Paris,75056,0.873015873015873,11
9035,Gare Saint-Lazare - Place de Budapest,OUI,43,20,23,12,11,OUI,OUI,2025-03-13 11:01:11+00:00,"48.877753, 2.327339",Paris,75056,0.5348837209302325,11
35021,Cartier Bresson - Denis Papin,OUI,31,26,5,2,3,OUI,OUI,2025-03-13 10:55:44+00:00,"48.902616, 2.397814",Pantin,93055,0.16129032258064516,11
17126,Hélène et François Missoffe - Emile Borel,OUI,28,8,20,17,3,OUI,OUI,2025-03-13 11:01:40+00:00,"48.89990653843488, 2.321543991674844",Paris,75056,0.7142857142857143,11
18045,Pierre Ginier - Clichy,OUI,16,15,1,0,1,OUI,OUI,2025-03-13 11:00:15+00:00,"48.8867667, 2.326228",Paris,75056,0.0625,11
17127,Porte de Clichy - Place des Nations Unies,OUI,37,6,31,29,2,OUI,OUI,2025-03-13 11:00:29+00:00,"48.896737263309504, 2.310542999196392",Paris,75056,0.8378378378378378,11
14110,Abbé Carton - Plantes,OUI,25,23,2,1,1,OUI,OUI,2025-03-13 10:59:31+00:00,"48.827673823166, 2.3209181427956",Paris,75056,0.08,11
34008,Garibaldi - Gabriel Péri,OUI,28,21,7,5,2,OUI,OUI,2025-03-13 10:59:03+00:00,"48.905741911394, 2.3316044208059",Saint-Ouen-sur-Seine,93070,0.25,11
18018,Carpeaux - Place Jacques Froment,OUI,17,14,3,0,3,OUI,OUI,2025-03-13 11:01:29+00:00,"48.8906542, 2.3309428",Paris,75056,0.17647058823529413,11
34012,Bateliers - Quai de Seine,OUI,21,11,10,5,5,OUI,OUI,2025-03-13 10:55:58+00:00,"48.915817585516, 2.3239533298594",Saint-Ouen-sur-Seine,93070,0.47619047619047616,11
10025,Jemmapes - Ecluses Saint-Martin,OUI,12,10,2,2,0,OUI,OUI,2025-03-13 10:55:49+00:00,"48.87748519186726, 2.3660067468881607",Paris,75056,0.16666666666666666,11
10026,Gare de l'Est - Chateau Landon,OUI,54,51,3,1,2,OUI,OUI,2025-03-13 10:55:12+00:00,"48.879305, 2.362424",Paris,75056,0.05555555555555555,11
22305,Jean Jaurès - Place du Dr Roux,OUI,34,23,11,8,3,OUI,OUI,2025-03-13 10:58:54+00:00,"48.927567032796, 2.2947337017374",Gennevilliers,92036,0.3235294117647059,11
18023,Ordener - Poissonniers,OUI,34,31,3,1,2,OUI,OUI,2025-03-13 10:57:15+00:00,"48.891213890844654, 2.351288666219873",Paris,75056,0.08823529411764706,11
22602,Place Henri Dunant - Gare RER,OUI,30,29,1,0,1,OUI,OUI,2025-03-13 10:56:35+00:00,"48.788093281931, 2.2909234046643",Fontenay-aux-Roses,92032,0.03333333333333333,11
18026,Ruisseau - Ordener,OUI,33,33,0,0,0,OUI,OUI,2025-03-13 10:55:22+00:00,"48.89299462568024, 2.340144887566567",Paris,75056,0.0,11
12106,Gare de Lyon - Roland Barthes,OUI,68,5,63,61,2,OUI,OUI,2025-03-13 11:00:22+00:00,"48.84395729494058, 2.3790882155299187",Paris,75056,0.9264705882352942,11
18024,Clignancourt - Ordener,OUI,35,35,0,0,0,OUI,OUI,2025-03-13 10:56:38+00:00,"48.891457726153774, 2.348636478060487",Paris,75056,0.0,11
23205,Parc des Pierrettes,OUI,22,22,0,0,0,OUI,OUI,2025-03-13 10:57:24+00:00,"48.7973062, 2.2909969",Châtillon,92020,0.0,11
16006,Lauriston - Copernic,OUI,19,15,4,1,3,OUI,OUI,2025-03-13 11:01:04+00:00,"48.86926, 2.289918",Paris,75056,0.21052631578947367,11
23201,Avenir,OUI,41,33,8,3,5,OUI,OUI,2025-03-13 11:01:25+00:00,"48.8103438, 2.3003776",Châtillon,92020,0.1951219512195122,11
13205,Choisy - Pointe d'Ivry,OUI,24,21,3,2,1,OUI,OUI,2025-03-13 10:59:21+00:00,"48.822154170359, 2.3633708034878",Paris,75056,0.125,11
11001,Richard Lenoir - Place de la Bastille,OUI,45,4,41,25,16,OUI,OUI,2025-03-13 11:01:40+00:00,"48.8538327, 2.3697222",Paris,75056,0.9111111111111111,11
7201,Place De Fontenoy - Saxe,OUI,18,7,11,9,2,OUI,OUI,2025-03-13 10:58:00+00:00,"48.850270554523, 2.3069813815839",Paris,75056,0.6111111111111112,11
21327,Jean Bouin - Gouverneur Général Eboué,OUI,31,0,31,28,3,OUI,OUI,2025-03-13 11:00:42+00:00,"48.824792734266, 2.2651904328524",Issy-les-Moulineaux,92040,1.0,11
15013,Volontaires - Lecourbe,OUI,29,24,5,4,1,OUI,OUI,2025-03-13 10:58:40+00:00,"48.84351378799, 2.3065522313118",Paris,75056,0.1724137931034483,11
19018,Cité de la Musique,OUI,51,35,16,11,5,OUI,OUI,2025-03-13 10:59:40+00:00,"48.888796556487, 2.3925811931922",Paris,75056,0.3137254901960784,11
13204,Tolbiac - Boussingault,OUI,41,37,4,2,2,OUI,OUI,2025-03-13 10:57:34+00:00,"48.826177754027, 2.3420378552202",Paris,75056,0.0975609756097561,11
34005,Adrien Lesesne - Docteur Bauer,OUI,29,27,2,1,1,OUI,OUI,2025-03-13 10:57:57+00:00,"48.90263867304635, 2.348248063431511",Saint-Ouen-sur-Seine,93070,0.06896551724137931,11
26008,Henri Barbusse - Bourguignons,OUI,32,27,5,2,3,OUI,OUI,2025-03-13 10:58:44+00:00,"48.91301722799713, 2.2734212270774417",Asnières-sur-Seine,92004,0.15625,11
15062,Convention - Lourmel,OUI,35,19,16,15,1,OUI,OUI,2025-03-13 10:58:20+00:00,"48.842055041656, 2.2859910875559",Paris,75056,0.45714285714285713,11
26009,Marceau Delorme - Pierre Brossolette,OUI,26,18,8,1,7,OUI,OUI,2025-03-13 10:55:24+00:00,"48.91206062860357, 2.295897423568745",Asnières-sur-Seine,92004,0.3076923076923077,11
10114,Granges aux Belles - Hôpital Saint-Louis,OUI,59,58,1,0,1,OUI,OUI,2025-03-13 11:00:21+00:00,"48.874794994841, 2.366669436985",Paris,75056,0.01694915254237288,11
23204,Roland Garros - Jean Bouin,OUI,28,26,2,0,2,OUI,OUI,2025-03-13 10:53:30+00:00,"48.809460857173, 2.2853198638301",Châtillon,92020,0.07142857142857142,11
13203,Square de Choisy - Eastman,OUI,23,21,2,1,1,OUI,OUI,2025-03-13 11:01:08+00:00,"48.828543456283, 2.3583075090494",Paris,75056,0.08695652173913043,11
31301,Gare RER,OUI,25,19,6,0,6,OUI,OUI,2025-03-13 10:58:34+00:00,"48.896280181078, 2.4581568985227",Noisy-le-Sec,93053,0.24,11
47007,Liberté - Vert-de-Maisons,OUI,20,3,17,15,2,OUI,OUI,2025-03-13 10:59:08+00:00,"48.790147809608, 2.4328628182411",Maisons-Alfort,94046,0.85,11
21514,Place de la Paix - Abbé Saint-Pierre,OUI,24,21,3,3,0,OUI,OUI,2025-03-13 10:56:54+00:00,"48.86462724459225, 2.2047570338469806",Suresnes,92073,0.125,11
13202,Place Farhat Hached,OUI,28,10,18,10,8,OUI,OUI,2025-03-13 11:01:38+00:00,"48.825487045602, 2.3816306985827",Paris,75056,0.6428571428571429,11
31303,Simone Signoret - Paris,OUI,26,19,7,4,3,OUI,OUI,2025-03-13 10:56:47+00:00,"48.903600624712865, 2.465406596265139",Noisy-le-Sec,93053,0.2692307692307692,11
13051,Halle Freyssinet - Parvis Alan Turing,OUI,23,4,19,9,10,OUI,OUI,2025-03-13 10:58:15+00:00,"48.832846814471, 2.3711421713233",Paris,75056,0.8260869565217391,11
5107,Pontoise - La Tournelle,OUI,22,1,21,14,7,OUI,OUI,2025-03-13 11:01:38+00:00,"48.850458009188, 2.3524542754922",Paris,75056,0.9545454545454546,11
21501,Pont de Suresnes,OUI,15,12,3,2,1,OUI,OUI,2025-03-13 10:55:40+00:00,"48.867415092322, 2.2258946679617",Suresnes,92073,0.2,11
17010,Jonquière - Docteur Paul Brousse,OUI,38,32,6,5,1,OUI,OUI,2025-03-13 11:01:24+00:00,"48.894799816683985, 2.318705212173216",Paris,75056,0.15789473684210525,11
19204,Rampal - Belleville,OUI,19,17,2,1,1,OUI,OUI,2025-03-13 11:00:57+00:00,"48.873114661405, 2.3798409114805",Paris,75056,0.10526315789473684,11
8008,Joseph Sansboeuf - Saint Lazare,OUI,31,19,12,6,6,OUI,OUI,2025-03-13 11:01:12+00:00,"48.875315630653, 2.3229019716382",Paris,75056,0.3870967741935484,11
11014,Place de la Nation - Taillebourg,OUI,46,37,9,6,3,OUI,OUI,2025-03-13 11:00:49+00:00,"48.8488408, 2.3973043",Paris,75056,0.1956521739130435,11
31202,Gabriel Péri - Jules Ferry,OUI,27,6,21,15,6,OUI,OUI,2025-03-13 11:01:01+00:00,"48.926182814311, 2.3912295762525",La Courneuve,93027,0.7777777777777778,11
35002,Jean Jaurès - Presles,OUI,31,26,5,3,2,OUI,OUI,2025-03-13 11:00:19+00:00,"48.907134414988, 2.3960057280531",Pantin,93055,0.16129032258064516,11
31201,Suzanne Masson,OUI,33,4,29,14,15,OUI,OUI,2025-03-13 11:00:49+00:00,"48.923306888013, 2.3847292397611",La Courneuve,93027,0.8787878787878788,11
11020,Belfort - Voltaire,OUI,39,33,6,1,5,OUI,OUI,2025-03-13 10:58:48+00:00,"48.8563358, 2.3829901",Paris,75056,0.15384615384615385,11
8039,Colisée - Champs-Elysées,OUI,15,3,12,2,10,OUI,OUI,2025-03-13 10:58:11+00:00,"48.870475399387, 2.3076190799475",Paris,75056,0.8,11
13035,Choisy - Tolbiac,OUI,20,19,1,0,1,OUI,OUI,2025-03-13 11:01:29+00:00,"48.82591155587, 2.3602393269539",Paris,75056,0.05,11
11102,Alexandre Dumas - Voltaire,OUI,58,57,1,0,1,OUI,OUI,2025-03-13 11:00:41+00:00,"48.852888670365, 2.3891476408096",Paris,75056,0.017241379310344827,11
18134,Ney - Porte de Clignancourt,OUI,24,22,2,1,1,OUI,OUI,2025-03-13 10:54:36+00:00,"48.8978867, 2.3458001",Paris,75056,0.08333333333333333,11
16103,Traktir - Foch,OUI,20,6,14,4,10,OUI,OUI,2025-03-13 11:00:46+00:00,"48.872755334614, 2.2915497802487",Paris,75056,0.7,11
8038,François 1er - Montaigne,OUI,51,18,33,20,13,OUI,OUI,2025-03-13 10:59:57+00:00,"48.866887649978, 2.3066755757207",Paris,75056,0.6470588235294118,11
21213,Vanne - Général de Gaulle,OUI,25,22,3,0,3,OUI,OUI,2025-03-13 11:01:09+00:00,"48.815007, 2.328318",Montrouge,92049,0.12,11
5201,Saint-Jacques - Soufflot,OUI,16,1,15,1,14,OUI,OUI,2025-03-13 11:00:53+00:00,"48.846280383395, 2.3430785379567",Paris,75056,0.9375,11
11046,Place de la République - Voltaire,OUI,16,1,15,15,0,OUI,OUI,2025-03-13 10:57:29+00:00,"48.866830968942, 2.3654810339212",Paris,75056,0.9375,11
18042,Place Pigalle,OUI,20,19,1,0,1,OUI,OUI,2025-03-13 11:00:40+00:00,"48.8827555, 2.3361566",Paris,75056,0.05,11
15060,Place de la Montagne du Goulet,OUI,20,5,15,13,2,OUI,OUI,2025-03-13 10:59:45+00:00,"48.8443415, 2.2773844",Paris,75056,0.75,11
11037,Faubourg Du Temple - Republique,OUI,38,0,38,30,8,OUI,OUI,2025-03-13 11:01:24+00:00,"48.867872484749, 2.3648982158072",Paris,75056,1.0,11
11011,Richard Lenoir - Voltaire,OUI,25,17,8,7,1,OUI,OUI,2025-03-13 10:59:37+00:00,"48.86164273878, 2.3727491497993",Paris,75056,0.32,11
18041,Rochechouart - Martyrs,OUI,17,13,4,1,3,OUI,OUI,2025-03-13 10:57:18+00:00,"48.882193779572, 2.3405495658517",Paris,75056,0.23529411764705882,11
7111,Ecole Militaire - Place Joffre,OUI,25,12,13,9,4,OUI,OUI,2025-03-13 11:00:39+00:00,"48.852060203583, 2.3017993569374",Paris,75056,0.52,11
18044,Clichy - Douai,OUI,32,30,2,0,2,OUI,OUI,2025-03-13 10:58:20+00:00,"48.883687771522, 2.328063700029",Paris,75056,0.0625,11
8057,Hoche - Tilsitt,OUI,31,25,6,0,6,OUI,OUI,2025-03-13 11:00:36+00:00,"48.874836457837, 2.2971323132515",Paris,75056,0.1935483870967742,11
12157,Fabre d'Eglantine - Place de la Nation,OUI,66,64,2,0,2,OUI,OUI,2025-03-13 11:00:11+00:00,"48.8471116, 2.3956204",Paris,75056,0.030303030303030304,11
7023,Bourdonnais - Tour Eiffel,OUI,56,13,43,32,11,OUI,OUI,2025-03-13 11:01:30+00:00,"48.860897797941, 2.295599598447",Paris,75056,0.7678571428571429,11
3004,Place de la République - Temple,OUI,16,1,15,11,4,OUI,OUI,2025-03-13 11:01:22+00:00,"48.867211201859, 2.3635464370545",Paris,75056,0.9375,11
7025,Octave Gréard - Tour Eiffel,OUI,32,6,26,15,11,OUI,OUI,2025-03-13 11:01:19+00:00,"48.856502977696, 2.2931787543289",Paris,75056,0.8125,11
11009,Boulets - Voltaire,OUI,24,22,2,1,1,OUI,OUI,2025-03-13 11:01:32+00:00,"48.85218705621, 2.3890301585197",Paris,75056,0.08333333333333333,11
40010,Haut du Mont-Mesly,OUI,21,16,5,3,2,OUI,OUI,2025-03-13 11:00:30+00:00,"48.780191921646, 2.4685737495183",Créteil,94028,0.23809523809523808,11
35001,Jean Jaurès - Ouvrières Pivéreuses,OUI,21,18,3,0,3,OUI,OUI,2025-03-13 10:58:12+00:00,"48.910423437526, 2.3995766043663",Pantin,93055,0.14285714285714285,11
40012,Stade de la Habette,OUI,16,14,2,0,2,OUI,OUI,2025-03-13 11:01:31+00:00,"48.774397033806, 2.4668785263921",Créteil,94028,0.125,11
11012,Montreuil - Voltaire,OUI,33,31,2,1,1,OUI,OUI,2025-03-13 11:00:46+00:00,"48.850507011842, 2.3930755582745",Paris,75056,0.06060606060606061,11
40013,Hôtel de Ville de Créteil,OUI,36,17,19,13,6,OUI,OUI,2025-03-13 10:59:54+00:00,"48.77699496201, 2.4552552404284",Créteil,94028,0.5277777777777778,11
15105,Fédération - Suffren,OUI,24,13,11,10,1,OUI,OUI,2025-03-13 11:00:24+00:00,"48.852828153442, 2.2978776320815",Paris,75056,0.4583333333333333,11
40014,Créteil Pointe du Lac,OUI,28,2,26,9,17,OUI,OUI,2025-03-13 10:59:50+00:00,"48.769807356177, 2.4623027310281",Créteil,94028,0.9285714285714286,11
18205,Mauroy - Cheminots,OUI,30,21,9,3,6,OUI,OUI,2025-03-13 11:01:28+00:00,"48.897715198403, 2.357895075822",Paris,75056,0.3,11
16005,Raymond Poincaré - Place Victor Hugo,OUI,22,19,3,1,2,OUI,OUI,2025-03-13 11:00:43+00:00,"48.87030612437, 2.2850745414202",Paris,75056,0.13636363636363635,11
9025,Taitbout - Châteaudun,OUI,53,0,53,45,8,OUI,OUI,2025-03-13 11:00:25+00:00,"48.876383969379, 2.3353566779335",Paris,75056,1.0,11
12105,Bercy - Villot,OUI,36,10,26,18,8,OUI,OUI,2025-03-13 11:01:00+00:00,"48.841795009027, 2.3767850184816",Paris,75056,0.7222222222222222,11
7109,Place Joffre - Frédéric le Play,OUI,37,18,19,13,6,OUI,OUI,2025-03-13 11:00:02+00:00,"48.853754486938, 2.3044242337346",Paris,75056,0.5135135135135135,11
26005,Hôtel de Ville d'Asnières sur Seine,OUI,25,23,2,0,2,OUI,OUI,2025-03-13 11:01:10+00:00,"48.90999330025577, 2.288238108158112",Asnières-sur-Seine,92004,0.08,11
4108,Quai de Béthune - Pont de la Tournelle,OUI,25,8,17,15,2,OUI,OUI,2025-03-13 11:00:55+00:00,"48.85097433194, 2.3563072085381",Paris,75056,0.68,11
40003,Centre Hospitalier Intercommunal de Créteil,OUI,17,17,0,0,0,OUI,OUI,2025-03-13 10:59:09+00:00,"48.797078298909, 2.463801423807",Créteil,94028,0.0,11
40007,Préfecture de Créteil,OUI,27,7,20,14,6,OUI,OUI,2025-03-13 11:01:01+00:00,"48.783680285918, 2.4544713672215",Créteil,94028,0.7407407407407407,11
23801,Place de la Gare,OUI,20,17,3,1,2,OUI,OUI,2025-03-13 10:53:59+00:00,"48.838513582184, 2.1866139007512",Garches,92033,0.15,11
12107,Diderot - Pierre Bourdan,OUI,21,2,19,8,11,OUI,OUI,2025-03-13 10:59:57+00:00,"48.847648620797, 2.3902582749724",Paris,75056,0.9047619047619048,11
40004,Créteil Village,OUI,25,4,21,7,14,OUI,OUI,2025-03-13 11:01:10+00:00,"48.79122395576, 2.4642198533952",Créteil,94028,0.84,11
23011,Bineau - Louise Michel,OUI,26,17,9,4,5,OUI,OUI,2025-03-13 10:57:12+00:00,"48.88666162207, 2.2843274474144",Levallois-Perret,92044,0.34615384615384615,11
40015,Iles de Loisirs de Créteil,OUI,24,4,20,10,10,OUI,OUI,2025-03-13 11:01:41+00:00,"48.780258200618, 2.4455094301232",Créteil,94028,0.8333333333333334,11
12201,Dugommier,OUI,53,47,6,4,2,OUI,OUI,2025-03-13 11:00:55+00:00,"48.838811048815, 2.3896577954292",Paris,75056,0.11320754716981132,11
51005,Yves Farges - Route d'Enghien,OUI,33,16,17,6,11,OUI,OUI,2025-03-13 11:00:57+00:00,"48.95756799268, 2.2834496977978",Argenteuil,95018,0.5151515151515151,11
23703,Gare de Chaville Rive Gauche,OUI,18,17,1,1,0,OUI,OUI,2025-03-13 10:57:27+00:00,"48.805160304345, 2.188277207315",Chaville,92022,0.05555555555555555,11
32004,Wilson - Landy,OUI,38,17,21,15,6,OUI,OUI,2025-03-13 11:01:03+00:00,"48.91516726221354, 2.357633225619793",Saint-Denis,93066,0.5526315789473685,11
40008,Créteil Pompadour,OUI,44,15,29,11,18,OUI,OUI,2025-03-13 11:01:42+00:00,"48.773011623355, 2.435166164893",Créteil,94028,0.6590909090909091,11
14021,Place de la Porte de Châtillon,OUI,59,56,3,1,2,OUI,OUI,2025-03-13 11:00:43+00:00,"48.8242469, 2.3186306",Paris,75056,0.05084745762711865,11
20137,Borrégo - Gambetta,OUI,25,25,0,0,0,OUI,OUI,2025-03-13 10:54:24+00:00,"48.87330497045532, 2.4014145880937576",Paris,75056,0.0,11
13106,Bobillot - Paulin Mery,OUI,21,18,3,1,2,OUI,OUI,2025-03-13 11:01:28+00:00,"48.829899841747, 2.3543356766749",Paris,75056,0.14285714285714285,11
35014,Charles de Gaulle - Jean Lolive,OUI,26,25,1,1,0,OUI,OUI,2025-03-13 10:56:53+00:00,"48.8932644350857, 2.4126765131950383",Pantin,93055,0.038461538461538464,11
41301,Bois de Vincennes - Gare,OUI,50,46,4,4,0,OUI,OUI,2025-03-13 11:00:16+00:00,"48.836022242887, 2.470833995083",Nogent-sur-Marne,94052,0.08,11
19203,Pailleron - Bouret,OUI,27,24,3,1,2,OUI,OUI,2025-03-13 10:58:56+00:00,"48.880516995482, 2.3763902374411",Paris,75056,0.1111111111111111,11
10031,Louis Blanc - Aqueduc,OUI,36,33,3,3,0,OUI,OUI,2025-03-13 10:57:38+00:00,"48.882030182599, 2.363561578095",Paris,75056,0.08333333333333333,11
18043,Clichy - Place Blanche,OUI,18,14,4,2,2,OUI,OUI,2025-03-13 11:00:40+00:00,"48.883601088297, 2.3332237824798",Paris,75056,0.2222222222222222,11
31708,Noisy le Sec - Jean-Baptiste Clément,OUI,18,18,0,0,0,OUI,OUI,2025-03-13 11:01:11+00:00,"48.874515389637, 2.4152836203575",Bagnolet,93006,0.0,11
32012,Carrefour Pleyel,OUI,65,24,41,14,27,OUI,OUI,2025-03-13 10:59:17+00:00,"48.92034156960326, 2.3438543826341625",Saint-Denis,93066,0.6307692307692307,11
10013,Alibert - Jemmapes,OUI,57,48,9,3,6,OUI,OUI,2025-03-13 10:58:08+00:00,"48.871044051984, 2.3661044619878",Paris,75056,0.15789473684210525,11
27004,Gare de la Garenne-Colombes,OUI,27,19,8,6,2,OUI,OUI,2025-03-13 10:59:29+00:00,"48.909752, 2.239145",Colombes,92025,0.2962962962962963,11
15103,Cauchy - Cévennes,OUI,50,6,44,41,3,OUI,OUI,2025-03-13 10:59:36+00:00,"48.843372571022, 2.2751328349113",Paris,75056,0.88,11
17123,Mstislav Rostropovitch - Berthier,OUI,18,15,3,2,1,OUI,OUI,2025-03-13 10:58:08+00:00,"48.892120821173975, 2.309234105050564",Paris,75056,0.16666666666666666,11
15026,Bir Hakeim,OUI,32,10,22,19,3,OUI,OUI,2025-03-13 11:00:25+00:00,"48.853844054334, 2.289705348222",Paris,75056,0.6875,11
1002,Victoria - Place du Chatelet,OUI,19,4,15,7,8,OUI,OUI,2025-03-13 10:59:38+00:00,"48.857992591527, 2.3469167947769",Paris,75056,0.7894736842105263,11
1022,Danielle Casanova - Place Vendôme,OUI,37,1,36,20,16,OUI,OUI,2025-03-13 10:59:02+00:00,"48.868266498223, 2.3304839059711",Paris,75056,0.972972972972973,11
8052,Balzac - Champs Elysées,OUI,30,13,17,8,9,OUI,OUI,2025-03-13 11:01:04+00:00,"48.872699639621, 2.3001953959465",Paris,75056,0.5666666666666667,11
1003,Saint-Denis - Rivoli,OUI,42,13,29,22,7,OUI,OUI,2025-03-13 11:01:33+00:00,"48.859059340842, 2.3476943001151",Paris,75056,0.6904761904761905,11
4104,Sebastopol - Rambuteau,OUI,15,1,14,9,5,OUI,OUI,2025-03-13 11:01:23+00:00,"48.86181809267, 2.3501381278038",Paris,75056,0.9333333333333333,11
34014,Michelet - Dr Bauer,OUI,29,27,2,0,2,OUI,OUI,2025-03-13 10:52:04+00:00,"48.906125424194, 2.3440374449846",Saint-Ouen-sur-Seine,93070,0.06896551724137931,11
32001,Proudhon - Président Wilson,OUI,30,13,17,10,7,OUI,OUI,2025-03-13 11:01:23+00:00,"48.906442763495, 2.3584905266762",Saint-Denis,93066,0.5666666666666667,11
21404,Jean Jaurès - Gare de Clamart,OUI,20,19,1,1,0,OUI,OUI,2025-03-13 10:53:12+00:00,"48.81321981219, 2.2716768079163",Clamart,92023,0.05,11
33019,Madeleine Vionnet,OUI,46,0,46,16,30,OUI,OUI,2025-03-13 11:01:00+00:00,"48.902519074064, 2.3740895837545",Aubervilliers,93001,1.0,11
6001,Institut de France,OUI,17,4,13,9,4,OUI,OUI,2025-03-13 11:00:51+00:00,"48.857615678565, 2.3358313530377",Paris,75056,0.7647058823529411,11
21302,Aristide Briand - Place de la Résistance,OUI,40,2,38,33,5,OUI,OUI,2025-03-13 11:00:02+00:00,"48.82124248401006, 2.2511002421379094",Issy-les-Moulineaux,92040,0.95,11
17038,Grande Armée - Brunel,OUI,60,30,30,13,17,OUI,OUI,2025-03-13 11:00:00+00:00,"48.876116, 2.288124",Paris,75056,0.5,11
21021,Enfants du Paradis - Peupliers,OUI,61,4,57,28,29,OUI,OUI,2025-03-13 11:01:25+00:00,"48.833122686454, 2.2571459412575",Boulogne-Billancourt,92012,0.9344262295081968,11
12010,Daumesnil - Picpus,OUI,19,7,12,8,4,OUI,OUI,2025-03-13 10:58:56+00:00,"48.8374688, 2.401765",Paris,75056,0.631578947368421,11
15056,Place Balard,OUI,28,8,20,17,3,OUI,OUI,2025-03-13 11:00:27+00:00,"48.836395736424, 2.2784192115068",Paris,75056,0.7142857142857143,11
13123,BNF - Bibliothèque Nationale de France,OUI,45,2,43,28,15,OUI,OUI,2025-03-13 11:01:24+00:00,"48.8350268238, 2.3760157451034",Paris,75056,0.9555555555555556,11
8004,Malesherbes - Place de la Madeleine,OUI,78,3,75,30,45,OUI,OUI,2025-03-13 11:00:27+00:00,"48.870406028483, 2.323243509808",Paris,75056,0.9615384615384616,11
40002,Bleuets - Bordières,OUI,21,17,4,2,2,OUI,OUI,2025-03-13 11:01:04+00:00,"48.802117531472, 2.4543687905029",Créteil,94028,0.19047619047619047,11
8002,Gare Saint-Lazare - Cour du Havre,OUI,42,21,21,8,13,OUI,OUI,2025-03-13 11:01:01+00:00,"48.875674400851, 2.3265598341823",Paris,75056,0.5,11
12127,Tremblay - Lac des Minimes,OUI,52,8,44,15,29,OUI,OUI,2025-03-13 11:00:57+00:00,"48.834131261494, 2.4547516554594",Paris,75056,0.8461538461538461,11
9104,Caumartin - Provence,OUI,22,2,20,15,5,OUI,OUI,2025-03-13 11:00:18+00:00,"48.874422773426545, 2.3284685611724854",Paris,75056,0.9090909090909091,11
44015,Rouget de L'isle - Watteau,OUI,20,10,10,0,10,OUI,OUI,2025-03-13 11:57:10+00:00,"48.778192750803, 2.3963020229163",Vitry-sur-Seine,94081,0.5,12
16107,Benjamin Godard - Victor Hugo,OUI,32,31,1,0,1,OUI,OUI,2025-03-13 12:00:22+00:00,"48.865983, 2.275725",Paris,75056,0.03125,12
9020,Toudouze - Clauzel,OUI,21,15,6,3,3,OUI,OUI,2025-03-13 11:58:28+00:00,"48.87929591733507, 2.3373600840568547",Paris,75056,0.2857142857142857,12
40001,Hôpital Mondor,OUI,28,10,18,9,9,OUI,OUI,2025-03-13 11:59:02+00:00,"48.798922410229, 2.4537451531298",Créteil,94028,0.6428571428571429,12
14111,Cassini - Denfert-Rochereau,OUI,23,20,3,0,3,OUI,OUI,2025-03-13 12:00:57+00:00,"48.837525839067, 2.3360354080796",Paris,75056,0.13043478260869565,12
32017,Basilique,OUI,20,12,8,1,7,OUI,OUI,2025-03-13 12:00:15+00:00,"48.93626891059109, 2.3588666820200914",Saint-Denis,93066,0.4,12
14014,Jourdan - Stade Charléty,OUI,58,51,7,2,5,OUI,OUI,2025-03-13 12:00:28+00:00,"48.819428333369, 2.3433353751898",Paris,75056,0.1206896551724138,12
13007,Le Brun - Gobelins,OUI,47,36,11,10,1,OUI,OUI,2025-03-13 11:55:59+00:00,"48.835092787824, 2.3534681351338",Paris,75056,0.23404255319148937,12
11104,Charonne - Robert et Sonia Delaunay,OUI,20,19,1,1,0,OUI,OUI,2025-03-13 11:54:31+00:00,"48.855907555969, 2.3925706744194",Paris,75056,0.05,12
6003,Saint-Sulpice,OUI,21,10,11,5,6,OUI,OUI,2025-03-13 12:00:39+00:00,"48.85165383178419, 2.3308077827095985",Paris,75056,0.5238095238095238,12
8026,Messine - Place Du Pérou,OUI,12,2,10,4,6,OUI,OUI,2025-03-13 11:59:13+00:00,"48.875448033960744, 2.315508019010038",Paris,75056,0.8333333333333334,12
7002,Vaneau - Sèvres,OUI,35,12,23,17,6,OUI,OUI,2025-03-13 12:01:07+00:00,"48.848563233059, 2.3204218259346",Paris,75056,0.6571428571428571,12
5110,Lacépède - Monge,OUI,23,17,6,2,4,OUI,OUI,2025-03-13 12:01:32+00:00,"48.84389286531899, 2.3519663885235786",Paris,75056,0.2608695652173913,12
6108,Saint-Romain - Cherche-Midi,OUI,16,8,8,3,5,OUI,OUI,2025-03-13 12:00:48+00:00,"48.84708159081946, 2.321374788880348",Paris,75056,0.5,12
42016,Pierre et Marie Curie - Maurice Thorez,OUI,26,21,5,3,2,OUI,OUI,2025-03-13 11:57:41+00:00,"48.81580226360801, 2.376804985105991",Ivry-sur-Seine,94041,0.19230769230769232,12
33006,André Karman - République,OUI,30,23,7,4,3,OUI,OUI,2025-03-13 12:01:31+00:00,"48.91039875761846, 2.3851355910301213",Aubervilliers,93001,0.23333333333333334,12
40011,Bas du Mont-Mesly,OUI,26,18,8,5,3,OUI,OUI,2025-03-13 12:01:40+00:00,"48.779035118572, 2.4609763908985",Créteil,94028,0.3076923076923077,12
21010,Silly - Galliéni,OUI,25,15,10,5,5,OUI,OUI,2025-03-13 11:55:40+00:00,"48.835583838706, 2.2325500845909",Boulogne-Billancourt,92012,0.4,12
30002,Jean Rostand - Paul Vaillant Couturier,OUI,39,25,14,7,7,OUI,OUI,2025-03-13 12:01:25+00:00,"48.908168131015, 2.4530601033354",Bobigny,93008,0.358974358974359,12
25006,Place Nelson Mandela,OUI,22,20,2,2,0,OUI,OUI,2025-03-13 12:00:20+00:00,"48.862453313908, 2.1961666225454",Rueil-Malmaison,92063,0.09090909090909091,12
32304,Charcot - Benfleet,OUI,28,27,1,0,1,NON,NON,2025-03-13 11:52:51+00:00,"48.878370277021, 2.440523876268",Romainville,93063,0.03571428571428571,12
5016,Thouin - Cardinal Lemoine,OUI,16,0,16,1,15,OUI,OUI,2025-03-13 11:59:02+00:00,"48.84504716661511, 2.3494647851273465",Paris,75056,1.0,12
7003,Square Boucicaut,OUI,58,13,45,24,21,OUI,OUI,2025-03-13 12:00:27+00:00,"48.851296433665276, 2.325061820447445",Paris,75056,0.7758620689655172,12
11025,Froment - Bréguet,OUI,43,24,19,15,4,OUI,OUI,2025-03-13 12:01:19+00:00,"48.8570414504784, 2.37289470306807",Paris,75056,0.4418604651162791,12
17041,Guersant - Gouvion-Saint-Cyr,OUI,33,24,9,5,4,OUI,OUI,2025-03-13 11:58:36+00:00,"48.88287775178599, 2.287667370814871",Paris,75056,0.2727272727272727,12
17026,Jouffroy d'Abbans - Wagram,OUI,39,15,24,11,13,OUI,OUI,2025-03-13 11:58:51+00:00,"48.881973298352, 2.301132157445",Paris,75056,0.6153846153846154,12
15047,Morillons - Dantzig,OUI,51,50,1,1,0,OUI,OUI,2025-03-13 11:54:02+00:00,"48.83310149953933, 2.299380004405976",Paris,75056,0.0196078431372549,12
15202,Bracion - Périphérique,OUI,30,28,2,1,1,OUI,OUI,2025-03-13 11:52:57+00:00,"48.826103771275, 2.3004549373748",Paris,75056,0.06666666666666667,12
6021,Beaux-Arts - Bonaparte,OUI,20,0,20,12,8,OUI,OUI,2025-03-13 12:00:55+00:00,"48.856451985396, 2.3348518833518",Paris,75056,1.0,12
8050,Boétie - Ponthieu,OUI,43,2,41,11,30,OUI,OUI,2025-03-13 12:01:20+00:00,"48.871417284355, 2.3076787590981",Paris,75056,0.9534883720930233,12
12109,Mairie du 12ème,OUI,29,27,2,2,0,OUI,OUI,2025-03-13 11:52:21+00:00,"48.840855311763, 2.3875549435616",Paris,75056,0.06896551724137931,12
31024,Romainville - Vaillant-Couturier,OUI,36,34,2,0,2,OUI,OUI,2025-03-13 12:00:23+00:00,"48.86785, 2.446748",Montreuil,93048,0.05555555555555555,12
13101,Croulebarde - Corvisart,OUI,33,26,7,6,1,OUI,OUI,2025-03-13 12:01:13+00:00,"48.830981659316855, 2.3481646925210953",Paris,75056,0.21212121212121213,12
2022,Saint-Fiacre - Poissonière,OUI,33,14,19,11,8,OUI,OUI,2025-03-13 12:00:50+00:00,"48.870828911558, 2.3459213599563",Paris,75056,0.5757575757575758,12
14108,Le Brix et Mesmin - Jourdan,OUI,19,19,0,0,0,OUI,OUI,2025-03-13 11:59:53+00:00,"48.82234096593411, 2.327861653302471",Paris,75056,0.0,12
17025,Chazelles - Courcelles,OUI,33,20,13,2,11,OUI,OUI,2025-03-13 12:01:37+00:00,"48.879406604954, 2.3034455627202988",Paris,75056,0.3939393939393939,12
17044,Porte de Saint-Ouen - Bessières,OUI,42,37,5,3,2,OUI,OUI,2025-03-13 12:00:00+00:00,"48.89792240854517, 2.32851451022192",Paris,75056,0.11904761904761904,12
16138,Saint-Cloud - Hippodrome,OUI,30,22,8,3,5,OUI,OUI,2025-03-13 11:56:39+00:00,"48.85772148887421, 2.2549109905958176",Paris,75056,0.26666666666666666,12
19033,Cambrai - Benjamin Constant,OUI,40,37,3,1,2,OUI,OUI,2025-03-13 12:00:10+00:00,"48.89594736851349, 2.381133802246315",Paris,75056,0.075,12
21216,Louis Lejeune - Barbès,OUI,24,23,1,0,1,OUI,OUI,2025-03-13 12:00:52+00:00,"48.81807418981508, 2.3267009854316716",Montrouge,92049,0.041666666666666664,12
21326,Moulin de Pierre - Abbé Grégoire,OUI,20,17,3,0,3,OUI,OUI,2025-03-13 11:56:51+00:00,"48.822036188382, 2.2754641655975",Issy-les-Moulineaux,92040,0.15,12
17048,De Toqueville - Terrasse,OUI,30,24,6,2,4,OUI,OUI,2025-03-13 12:00:30+00:00,"48.882428, 2.314002",Paris,75056,0.2,12
20143,Ramponeau - Belleville,OUI,44,37,7,2,5,OUI,OUI,2025-03-13 11:59:08+00:00,"48.871031137596, 2.379056852114",Paris,75056,0.1590909090909091,12
44017,Jules Guesde - Pont du Port à l'Anglais,OUI,26,2,24,23,1,OUI,OUI,2025-03-13 12:00:08+00:00,"48.79628807093802, 2.417212128639221",Vitry-sur-Seine,94081,0.9230769230769231,12
43002,Lagny - Victor Basch,OUI,24,19,5,4,1,OUI,OUI,2025-03-13 11:59:23+00:00,"48.84884147189881, 2.426325418925233",Vincennes,94080,0.20833333333333334,12
16118,Michel-Ange - Parent de Rosan,OUI,23,20,3,0,3,OUI,OUI,2025-03-13 12:01:19+00:00,"48.840579923690115, 2.2584119439125065",Paris,75056,0.13043478260869565,12
15068,Général Martial Valin - Pont du Garigliano,OUI,14,6,8,1,7,OUI,OUI,2025-03-13 12:01:26+00:00,"48.83823094269141, 2.270506024360657",Paris,75056,0.5714285714285714,12
2017,Caire - Dussoubs,OUI,39,9,30,25,5,OUI,OUI,2025-03-13 12:01:25+00:00,"48.86785342111862, 2.349364310503006",Paris,75056,0.7692307692307693,12
22207,Rond-point du Dr Albert Schweitzer,OUI,21,18,3,1,2,OUI,OUI,2025-03-13 11:57:54+00:00,"48.78980918988166, 2.3143940046429634",Bagneux,92007,0.14285714285714285,12
9008,Tour d'Auvergne - Rodier,OUI,15,10,5,1,4,OUI,OUI,2025-03-13 12:01:39+00:00,"48.879161, 2.343698",Paris,75056,0.3333333333333333,12
92002,Théâtre des Amandiers - Palais des sports,OUI,23,6,17,8,9,OUI,OUI,2025-03-13 12:01:18+00:00,"48.892648526839, 2.2136941552162",Nanterre,92050,0.7391304347826086,12
13030,Italie - Tolbiac,OUI,21,20,1,1,0,OUI,OUI,2025-03-13 11:53:38+00:00,"48.82557229464416, 2.3576171323657036",Paris,75056,0.047619047619047616,12
19027,Serrurier,OUI,18,18,0,0,0,OUI,OUI,2025-03-13 11:58:39+00:00,"48.880493403246, 2.398064173758",Paris,75056,0.0,12
48003,Youri Gagarine - Karl Marx,OUI,22,20,2,1,1,OUI,OUI,2025-03-13 11:58:45+00:00,"48.78448485079149, 2.35908430069685",Villejuif,94076,0.09090909090909091,12
31028,Raspail Barbès,OUI,28,25,3,2,1,OUI,OUI,2025-03-13 11:56:57+00:00,"48.8529945, 2.4247387",Montreuil,93048,0.10714285714285714,12
43009,Place Jean-Spire-Lemaître,OUI,48,46,2,0,2,OUI,OUI,2025-03-13 11:53:40+00:00,"48.8468428626593, 2.452062070369721",Vincennes,94080,0.041666666666666664,12
9001,Bellefond - Poissonnière,OUI,15,15,0,0,0,OUI,OUI,2025-03-13 12:01:22+00:00,"48.87759897050706, 2.348463758826256",Paris,75056,0.0,12
8103,Artois - Berri,OUI,22,2,20,10,10,OUI,OUI,2025-03-13 12:01:09+00:00,"48.87393521240818, 2.3064258322119713",Paris,75056,0.9090909090909091,12
17032,Jean Oestreicher - Porte de Champerret,OUI,21,11,10,9,1,OUI,OUI,2025-03-13 12:01:30+00:00,"48.88655580065981, 2.288640439510346",Paris,75056,0.47619047619047616,12
8048,Marceau - Chaillot,OUI,19,4,15,3,12,OUI,OUI,2025-03-13 11:58:29+00:00,"48.868834023334, 2.2986030816809",Paris,75056,0.7894736842105263,12
10115,Granges aux Belles,OUI,27,25,2,1,1,OUI,OUI,2025-03-13 12:01:41+00:00,"48.8761373390584, 2.3680844979417",Paris,75056,0.07407407407407407,12
14013,Liard - Amiral Mouchez,OUI,26,23,3,2,1,OUI,OUI,2025-03-13 12:00:18+00:00,"48.8214169, 2.342167",Paris,75056,0.11538461538461539,12
10161,Gare de l'Est - Faubourg-Saint-Martin,OUI,32,27,5,3,2,OUI,OUI,2025-03-13 11:57:46+00:00,"48.875642647477, 2.3594588041306",Paris,75056,0.15625,12
13118,Regnault - Patay,OUI,63,10,53,42,11,OUI,OUI,2025-03-13 12:00:09+00:00,"48.82435782216384, 2.377065159380436",Paris,75056,0.8412698412698413,12
41303,Gare de Nogent-le-Perreux,OUI,31,19,12,10,2,OUI,OUI,2025-03-13 11:54:52+00:00,"48.83842553348809, 2.493693307042122",Nogent-sur-Marne,94052,0.3870967741935484,12
15112,Vigée-Lebrun - Anselme Payen,OUI,23,21,2,0,2,OUI,OUI,2025-03-13 12:01:23+00:00,"48.838683941628375, 2.3110422492027287",Paris,75056,0.08695652173913043,12
1001,Quai de l'Horloge - Pont Neuf,OUI,16,1,15,9,6,OUI,OUI,2025-03-13 11:57:42+00:00,"48.857058739111, 2.3417982839439",Paris,75056,0.9375,12
18111,Félix Ziem - Armand Gauthier,OUI,23,23,0,0,0,OUI,OUI,2025-03-13 11:58:07+00:00,"48.88949630486821, 2.333393658804396",Paris,75056,0.0,12
13104,Gare d'Austerlitz - Quai Saint-Bernard,OUI,26,1,25,15,10,OUI,OUI,2025-03-13 12:01:17+00:00,"48.84369030864, 2.3657163977623",Paris,75056,0.9615384615384616,12
9002,Abbeville - Faubourg Poissonnière,OUI,14,12,2,2,0,OUI,OUI,2025-03-13 11:57:28+00:00,"48.879223, 2.349147",Paris,75056,0.14285714285714285,12
9038,Douai - Bruxelles,OUI,26,23,3,1,2,OUI,OUI,2025-03-13 12:01:42+00:00,"48.88320784122797, 2.3308449949028507",Paris,75056,0.11538461538461539,12
16110,Octave Feuillet - Albéric Magnard,OUI,21,7,14,2,12,OUI,OUI,2025-03-13 12:00:10+00:00,"48.86106902949534, 2.2730283066630363",Paris,75056,0.6666666666666666,12
18203,Lamarck - Saint-Ouen,OUI,40,40,0,0,0,NON,NON,2025-03-13 11:58:10+00:00,"48.891334555236, 2.3272445342326",Paris,75056,0.0,12
8016,Square Louis XVI,OUI,29,4,25,15,10,OUI,OUI,2025-03-13 11:59:18+00:00,"48.87320440102894, 2.323658830743138",Paris,75056,0.8620689655172413,12
5005,Gay Lussac - Saint-Jacques,OUI,24,5,19,5,14,OUI,OUI,2025-03-13 12:00:55+00:00,"48.844730256132, 2.3419239448664",Paris,75056,0.7916666666666666,12
10029,Dunkerque - Rocroy,OUI,24,24,0,0,0,OUI,OUI,2025-03-13 11:58:38+00:00,"48.880726, 2.351464",Paris,75056,0.0,12
21323,Charlot - Stade Gabriel Voisin,OUI,31,0,31,27,4,OUI,OUI,2025-03-13 12:01:42+00:00,"48.827228120536, 2.268122527474",Issy-les-Moulineaux,92040,1.0,12
12031,Gabriel Lamé,OUI,34,28,6,3,3,OUI,OUI,2025-03-13 12:00:55+00:00,"48.8351212784276, 2.385534569621086",Paris,75056,0.17647058823529413,12
31706,Château - République,OUI,24,24,0,0,0,OUI,OUI,2025-03-13 11:51:56+00:00,"48.862923800596, 2.4155035614967",Bagnolet,93006,0.0,12
5022,Boulangers - Cardinal Lemoine,OUI,18,3,15,8,7,OUI,OUI,2025-03-13 11:59:37+00:00,"48.8462904, 2.3521495",Paris,75056,0.8333333333333334,12
22409,Henri Barbusse - Stalingrad,OUI,15,14,1,0,1,OUI,OUI,2025-03-13 11:54:13+00:00,"48.814183748660554, 2.2872862592339516",Malakoff,92046,0.06666666666666667,12
21328,Verger - Colonel Guichard,OUI,29,28,1,0,1,OUI,OUI,2025-03-13 11:52:03+00:00,"48.816376985087, 2.2670380088932",Issy-les-Moulineaux,92040,0.034482758620689655,12
19015,Thionville - Ourcq,OUI,22,21,1,1,0,OUI,OUI,2025-03-13 11:57:29+00:00,"48.88917613743794, 2.3833653330802917",Paris,75056,0.045454545454545456,12
17040,Pereire - Ternes,OUI,48,44,4,2,2,OUI,OUI,2025-03-13 12:01:40+00:00,"48.87973954830735, 2.288012132048607",Paris,75056,0.08333333333333333,12
26003,Argenteuil - Voltaire,OUI,16,15,1,1,0,OUI,OUI,2025-03-13 12:01:04+00:00,"48.91864865955558, 2.2814112156629562",Asnières-sur-Seine,92004,0.0625,12
8009,Gare Saint-Lazare - Isly,OUI,25,12,13,7,6,OUI,OUI,2025-03-13 12:00:53+00:00,"48.874777677621296, 2.326515804784655",Paris,75056,0.52,12
17004,Legendre - Clichy,OUI,38,35,3,2,1,OUI,OUI,2025-03-13 11:59:14+00:00,"48.88896161855884, 2.322528975094376",Paris,75056,0.07894736842105263,12
31103,Gare Rosny-Bois-Perrier,OUI,32,11,21,0,21,OUI,OUI,2025-03-13 11:59:45+00:00,"48.88115023337061, 2.480436824262142",Rosny-sous-Bois,93064,0.65625,12
19003,Quai de la Seine,OUI,24,23,1,1,0,OUI,OUI,2025-03-13 11:59:45+00:00,"48.884492238407525, 2.3703941702842717",Paris,75056,0.041666666666666664,12
17008,Porte Pouchet-Bessières,OUI,23,15,8,7,1,OUI,OUI,2025-03-13 11:58:42+00:00,"48.8978765, 2.3230632",Paris,75056,0.34782608695652173,12
12151,Gare de Lyon - Place Louis Armand,OUI,58,14,44,40,4,OUI,OUI,2025-03-13 12:01:21+00:00,"48.845515089794, 2.3726498446286",Paris,75056,0.7586206896551724,12
7018,Ségur - d'Estrées,OUI,19,6,13,2,11,OUI,OUI,2025-03-13 12:01:42+00:00,"48.851419978983, 2.3097044974566",Paris,75056,0.6842105263157895,12
16026,Ranelagh - Mozart,OUI,7,4,3,2,1,OUI,OUI,2025-03-13 12:00:44+00:00,"48.8554439, 2.2704418",Paris,75056,0.42857142857142855,12
8053,Place Georges Guillaumin,OUI,27,14,13,6,7,OUI,OUI,2025-03-13 11:59:13+00:00,"48.874750203957, 2.301771435326",Paris,75056,0.48148148148148145,12
17043,Belidor - Gouvion-Saint-Cyr,OUI,38,26,12,12,0,OUI,OUI,2025-03-13 11:58:12+00:00,"48.88022154052015, 2.2854680567979813",Paris,75056,0.3157894736842105,12
9014,Faubourg Montmartre - La Fayette,OUI,32,4,28,15,13,OUI,OUI,2025-03-13 12:00:51+00:00,"48.875254549053, 2.3408536612988",Paris,75056,0.875,12
45003,11 Novembre 1918 - 8 Mai 1945,OUI,36,13,23,14,9,OUI,OUI,2025-03-13 11:55:52+00:00,"48.80889533774377, 2.5382421165704727",Champigny-sur-Marne,94017,0.6388888888888888,12
9106,Boudreau - Auber,OUI,27,14,13,3,10,OUI,OUI,2025-03-13 11:59:43+00:00,"48.87219, 2.329423",Paris,75056,0.48148148148148145,12
11002,Roquette - Thiéré,OUI,22,3,19,15,4,OUI,OUI,2025-03-13 12:01:35+00:00,"48.85507930579506, 2.3733686318721463",Paris,75056,0.8636363636363636,12
19105,Ambroise Rendu - Porte Brunet,OUI,17,15,2,1,1,OUI,OUI,2025-03-13 11:56:14+00:00,"48.883667, 2.395733",Paris,75056,0.11764705882352941,12
11047,Amelot - Saint-Sébastien,OUI,29,8,21,13,8,OUI,OUI,2025-03-13 12:01:12+00:00,"48.861142162761, 2.3677996181077",Paris,75056,0.7241379310344828,12
9022,Rossini - Laffitte,OUI,33,2,31,18,13,OUI,OUI,2025-03-13 12:01:40+00:00,"48.87334627510507, 2.337980867701675",Paris,75056,0.9393939393939394,12
19043,Delphine Seyrig - Général Leclerc,OUI,51,49,2,0,2,OUI,OUI,2025-03-13 11:58:32+00:00,"48.893923963057865, 2.39790290594101",Pantin,93055,0.0392156862745098,12
5020,Institut du Monde Arabe - Saint-Germain,OUI,37,1,36,35,1,OUI,OUI,2025-03-13 12:01:23+00:00,"48.849063299501, 2.3558086529374",Paris,75056,0.972972972972973,12
5032,Panthéon - Valette,OUI,39,0,39,4,35,OUI,OUI,2025-03-13 11:59:52+00:00,"48.847020571652, 2.3464982619671",Paris,75056,1.0,12
92007,Pesaro - Préfecture,OUI,21,13,8,2,6,OUI,OUI,2025-03-13 11:57:34+00:00,"48.89577046284005, 2.223908342421055",Nanterre,92050,0.38095238095238093,12
20042,Pyrénées - Emmery,OUI,38,37,1,0,1,OUI,OUI,2025-03-13 11:58:03+00:00,"48.872010281270974, 2.392039597034455",Paris,75056,0.02631578947368421,12
9028,Moncey - Blanche,OUI,17,16,1,0,1,OUI,OUI,2025-03-13 11:59:32+00:00,"48.88006587474148, 2.3310810327529907",Paris,75056,0.058823529411764705,12
15067,Desaix - Edgar Faure,OUI,11,4,7,3,4,OUI,OUI,2025-03-13 11:59:07+00:00,"48.852804604940296, 2.293077029857222",Paris,75056,0.6363636363636364,12
10107,Gare du Nord - Hôpital Lariboisière,OUI,49,48,1,0,1,OUI,OUI,2025-03-13 11:59:23+00:00,"48.881949, 2.352339",Paris,75056,0.02040816326530612,12
8010,Liège - Moscou,OUI,15,13,2,1,1,OUI,OUI,2025-03-13 11:58:43+00:00,"48.8795431, 2.3264628",Paris,75056,0.13333333333333333,12
26002,Redoute - Les Courtilles,OUI,37,17,20,16,4,OUI,OUI,2025-03-13 12:01:29+00:00,"48.929867194519, 2.2836696356535",Asnières-sur-Seine,92004,0.5405405405405406,12
31022,Mairie de Montreuil,OUI,51,49,2,2,0,OUI,OUI,2025-03-13 11:59:31+00:00,"48.86131452758348, 2.440614402294159",Montreuil,93048,0.0392156862745098,12
19026,Place de Rhin et Danube,OUI,14,13,1,0,1,OUI,OUI,2025-03-13 11:55:23+00:00,"48.88192765861766, 2.392586767673493",Paris,75056,0.07142857142857142,12
10016,Récollets - Square Villemin,OUI,17,15,2,0,2,OUI,OUI,2025-03-13 11:56:00+00:00,"48.875034655883944, 2.359801238597928",Paris,75056,0.11764705882352941,12
16039,Exelmans - Versailles,OUI,47,15,32,28,4,OUI,OUI,2025-03-13 12:00:56+00:00,"48.84097491091973, 2.264390252530575",Paris,75056,0.6808510638297872,12
31009,Place Du Général De Gaulle,OUI,25,24,1,0,1,OUI,OUI,2025-03-13 11:59:06+00:00,"48.8687591, 2.4329931",Montreuil,93048,0.04,12
11023,Saint-Maur - Roquette,OUI,46,43,3,1,2,OUI,OUI,2025-03-13 12:01:18+00:00,"48.858688774062955, 2.383553994571467",Paris,75056,0.06521739130434782,12
41302,Charles de Gaulle - Beauté,OUI,48,48,0,0,0,OUI,OUI,2025-03-13 12:00:29+00:00,"48.83649602312711, 2.479562651149885",Nogent-sur-Marne,94052,0.0,12
12111,Claude Decaen - Cannebière,OUI,27,26,1,1,0,OUI,OUI,2025-03-13 12:00:57+00:00,"48.83761417037952, 2.397253782195704",Paris,75056,0.037037037037037035,12
14020,Cimetière de Montrouge,OUI,57,55,2,0,2,OUI,OUI,2025-03-13 11:54:09+00:00,"48.821466904768, 2.3215785772007",Paris,75056,0.03508771929824561,12
8034,Berri - Haussmann,OUI,34,1,33,12,21,OUI,OUI,2025-03-13 11:59:44+00:00,"48.874746047357135, 2.3082953318953514",Paris,75056,0.9705882352941176,12
33017,Anatole France - President Roosevelt,OUI,25,23,2,0,2,OUI,OUI,2025-03-13 11:58:12+00:00,"48.9155156, 2.3814103",Aubervilliers,93001,0.08,12
18107,Chartres - La Charbonnière,OUI,34,33,1,0,1,OUI,OUI,2025-03-13 11:58:33+00:00,"48.8847601, 2.3534657",Paris,75056,0.029411764705882353,12
15042,Henry Farman,OUI,16,5,11,9,2,OUI,OUI,2025-03-13 11:57:15+00:00,"48.83372430280548, 2.2713854536414146",Paris,75056,0.6875,12
17030,Pereire - Rennequin,OUI,22,19,3,1,2,OUI,OUI,2025-03-13 11:58:37+00:00,"48.88364782887555, 2.2952447086572647",Paris,75056,0.13636363636363635,12
21212,Marne - Germain Dardan,OUI,21,17,4,3,1,OUI,OUI,2025-03-13 11:58:19+00:00,"48.81217465201, 2.3035024699104",Montrouge,92049,0.19047619047619047,12
6006,Notre-Dame-des-Champs - Stanislas,OUI,19,6,13,11,2,OUI,OUI,2025-03-13 12:00:38+00:00,"48.84479928858768, 2.329337755887181",Paris,75056,0.6842105263157895,12
44006,Concorde - Stalingrad,OUI,35,35,0,0,0,OUI,OUI,2025-03-13 11:57:47+00:00,"48.7985844, 2.3821302",Vitry-sur-Seine,94081,0.0,12
11027,Saint-Ambroise - Parmentier,OUI,35,32,3,3,0,OUI,OUI,2025-03-13 11:58:19+00:00,"48.862147844548, 2.3772348091006",Paris,75056,0.08571428571428572,12
18003,Cimetière de Montmartre,OUI,43,41,2,0,2,OUI,OUI,2025-03-13 11:59:25+00:00,"48.886472466142, 2.3328901827335",Paris,75056,0.046511627906976744,12
12128,Pyramide - Ecole du Breuil,OUI,33,28,5,1,4,OUI,OUI,2025-03-13 11:54:57+00:00,"48.82237977153955, 2.4586871266365056",Paris,75056,0.15151515151515152,12
14003,Schoelcher - Raspail,OUI,48,45,3,1,2,OUI,OUI,2025-03-13 11:57:11+00:00,"48.83681733526843, 2.3312794080411474",Paris,75056,0.0625,12
46002,Rouget de Lisle,OUI,35,4,31,16,15,OUI,OUI,2025-03-13 11:56:32+00:00,"48.764615483395254, 2.4071189761161804",Choisy-le-Roi,94022,0.8857142857142857,12
43008,Fontenay - Libération,OUI,25,22,3,1,2,OUI,OUI,2025-03-13 12:00:35+00:00,"48.847803063647, 2.4451419711113",Vincennes,94080,0.12,12
18011,Pajol - Place Herbert,OUI,39,39,0,0,0,OUI,OUI,2025-03-13 11:56:26+00:00,"48.8927825, 2.3635598",Paris,75056,0.0,12
5018,Mutualité,OUI,37,1,36,28,8,OUI,OUI,2025-03-13 11:59:24+00:00,"48.848225572724, 2.3502873256803",Paris,75056,0.972972972972973,12
33102,Gabriel Péri - Francisco Ferrer,OUI,17,16,1,0,1,OUI,OUI,2025-03-13 11:54:02+00:00,"48.88633710236977, 2.407338917255402",Le Pré-Saint-Gervais,93061,0.058823529411764705,12
14138,Porte de Vanves,OUI,30,28,2,1,1,OUI,OUI,2025-03-13 12:00:15+00:00,"48.828012849445, 2.3056878894567",Paris,75056,0.06666666666666667,12
42706,Roger Salengro - Fontainebleau,OUI,25,25,0,0,0,OUI,OUI,2025-03-13 11:54:18+00:00,"48.814548697325, 2.3611663654447",Le Kremlin-Bicêtre,94043,0.0,12
12114,Victor Hugo - Jeanne Jugan,OUI,28,26,2,1,1,OUI,OUI,2025-03-13 12:00:57+00:00,"48.843949064031825, 2.415081394834419",Paris,75056,0.07142857142857142,12
19120,Carducci - Place Hannah Arendt,OUI,27,25,2,0,2,OUI,OUI,2025-03-13 12:01:44+00:00,"48.877436681515796, 2.3860743641853337",Paris,75056,0.07407407407407407,12
46003,Conservatoire de Musique,OUI,24,2,22,19,3,OUI,OUI,2025-03-13 12:01:42+00:00,"48.77093586667601, 2.4034014344215398",Choisy-le-Roi,94022,0.9166666666666666,12
11113,Richard Lenoir - Republique,OUI,57,21,36,34,2,OUI,OUI,2025-03-13 12:01:16+00:00,"48.8667175, 2.3692541",Paris,75056,0.631578947368421,12
41209,Cimetière de Fontenay-sous-Bois,OUI,15,15,0,0,0,OUI,OUI,2025-03-13 11:59:49+00:00,"48.84706173362218, 2.4787822365760808",Fontenay-sous-Bois,94033,0.0,12
15104,Hôpital Européen Georges Pompidou,OUI,63,10,53,47,6,OUI,OUI,2025-03-13 12:00:21+00:00,"48.837695319163, 2.2753742337227",Paris,75056,0.8412698412698413,12
15054,Lecourbe - Jean Maridor,OUI,18,15,3,3,0,OUI,OUI,2025-03-13 11:54:14+00:00,"48.83796366147599, 2.2877392172813416",Paris,75056,0.16666666666666666,12
19101,Square Simon Bolivar,OUI,23,20,3,1,2,OUI,OUI,2025-03-13 11:56:44+00:00,"48.875089888322, 2.3826304078102",Paris,75056,0.13043478260869565,12
5124,Erasme - Ulm,OUI,22,10,12,0,12,OUI,OUI,2025-03-13 12:01:10+00:00,"48.84264375274712, 2.3445946723222733",Paris,75056,0.5454545454545454,12
19103,Manin - Carrières d'Amérique,OUI,17,14,3,1,2,OUI,OUI,2025-03-13 11:59:31+00:00,"48.88467214209463, 2.3919698596000676",Paris,75056,0.17647058823529413,12
18046,Etienne Jodelle - Saint Ouen,OUI,32,31,1,1,0,OUI,OUI,2025-03-13 11:57:10+00:00,"48.88794016394694, 2.326124420314341",Paris,75056,0.03125,12
21312,Lucie Aubrac - Fort,OUI,30,26,4,0,4,OUI,OUI,2025-03-13 11:54:27+00:00,"48.818144834008976, 2.271184623241425",Issy-les-Moulineaux,92040,0.13333333333333333,12
22406,Guy Môquet - Etienne Dolet,OUI,22,17,5,1,4,OUI,OUI,2025-03-13 11:59:00+00:00,"48.81527009991819, 2.298078276995073",Malakoff,92046,0.22727272727272727,12
14008,Mouton Duvernet - Général Leclerc,OUI,26,24,2,1,1,OUI,OUI,2025-03-13 11:59:50+00:00,"48.831632518293, 2.3293121159077",Paris,75056,0.07692307692307693,12
31102,Boissière - Etienne Dolet,OUI,20,19,1,1,0,OUI,OUI,2025-03-13 11:57:42+00:00,"48.876111, 2.4677312",Montreuil,93048,0.05,12
13001,Port-Royal - Hôpital du Val-de-Grâce,OUI,17,14,3,0,3,OUI,OUI,2025-03-13 12:01:10+00:00,"48.837668272811, 2.3448138346607",Paris,75056,0.17647058823529413,12
2111,Chabanais - Petits Champs,OUI,29,1,28,20,8,OUI,OUI,2025-03-13 11:58:27+00:00,"48.86703740186721, 2.336716018617153",Paris,75056,0.9655172413793104,12
18028,Championnet - Vauvenargues,OUI,31,29,2,1,1,OUI,OUI,2025-03-13 12:01:18+00:00,"48.89401874744574, 2.3319872841238976",Paris,75056,0.06451612903225806,12
18022,Marcadet - Barbès,OUI,34,33,1,0,1,OUI,OUI,2025-03-13 12:01:17+00:00,"48.890451120965, 2.3490573929687",Paris,75056,0.029411764705882353,12
8017,Rocher - Laborde,OUI,64,50,14,11,3,OUI,OUI,2025-03-13 12:01:08+00:00,"48.87590240712654, 2.322616316378116",Paris,75056,0.21875,12
14012,Sibelle - Alésia,OUI,37,35,2,1,1,OUI,OUI,2025-03-13 11:54:23+00:00,"48.826701758539215, 2.3384983465075493",Paris,75056,0.05405405405405406,12
15106,Grenelle - Violet,OUI,34,18,16,15,1,OUI,OUI,2025-03-13 12:01:29+00:00,"48.84993035512154, 2.294612042605877",Paris,75056,0.47058823529411764,12
35010,Hoche - Jean Lolive,OUI,20,14,6,4,2,OUI,OUI,2025-03-13 12:00:18+00:00,"48.89110239200789, 2.402843534946442",Pantin,93055,0.3,12
14106,Marc Sangnier - Porte de Vanves,OUI,20,19,1,0,1,OUI,OUI,2025-03-13 11:56:56+00:00,"48.825218683556734, 2.3107116669416428",Paris,75056,0.05,12
42014,Place Marcel Cachin,OUI,32,8,24,22,2,OUI,OUI,2025-03-13 12:00:18+00:00,"48.81411442356866, 2.39090770483017",Ivry-sur-Seine,94041,0.75,12
8054,Bertie Albrecht - Hoche,OUI,32,13,19,8,11,OUI,OUI,2025-03-13 12:01:10+00:00,"48.87614039826388, 2.301303138307601",Paris,75056,0.59375,12
4016,Lobau - Hôtel de Ville,OUI,59,2,57,46,11,OUI,OUI,2025-03-13 12:01:40+00:00,"48.8562118, 2.3532536",Paris,75056,0.9661016949152542,12
15109,Cevennes - Bergers,OUI,28,25,3,3,0,OUI,OUI,2025-03-13 11:59:39+00:00,"48.84240765130395, 2.281037718057633",Paris,75056,0.10714285714285714,12
14124,David Weill - Parc Montsouris,OUI,22,14,8,1,7,OUI,OUI,2025-03-13 12:01:37+00:00,"48.821092374256104, 2.333725690841675",Paris,75056,0.36363636363636365,12
21209,Molière - République,OUI,30,30,0,0,0,OUI,OUI,2025-03-13 11:55:11+00:00,"48.81111581390707, 2.3145738624448158",Montrouge,92049,0.0,12
15133,Saint Lambert - Blomet,OUI,26,25,1,0,1,OUI,OUI,2025-03-13 12:00:02+00:00,"48.83659148147257, 2.2930556908249855",Paris,75056,0.038461538461538464,12
21005,Hôtel de Ville de Boulogne Billancourt,OUI,26,3,23,8,15,OUI,OUI,2025-03-13 12:01:40+00:00,"48.83495885166784, 2.2416803240776066",Boulogne-Billancourt,92012,0.8846153846153846,12
15110,Place Robert Guillemard,OUI,22,3,19,16,3,OUI,OUI,2025-03-13 12:00:51+00:00,"48.836191728066666, 2.2811267160086417",Paris,75056,0.8636363636363636,12
10042,Enghien - Faubourg Poissonnière,OUI,32,3,29,22,7,OUI,OUI,2025-03-13 12:00:11+00:00,"48.872420063053, 2.3483952362828",Paris,75056,0.90625,12
17203,Place de la Porte de Champeret,OUI,28,12,16,14,2,OUI,OUI,2025-03-13 12:00:18+00:00,"48.886062068226, 2.2917001576821",Paris,75056,0.5714285714285714,12
44013,Edouard Tremblay - Julian Grimaux,OUI,30,28,2,1,1,OUI,OUI,2025-03-13 11:55:30+00:00,"48.781383825117, 2.3723508417606",Vitry-sur-Seine,94081,0.06666666666666667,12
8045,Place de la Reine Astrid,OUI,57,18,39,22,17,OUI,OUI,2025-03-13 11:59:16+00:00,"48.864920982538, 2.3025491823859",Paris,75056,0.6842105263157895,12
20131,Repos - Cimetière du Père Lachaise,OUI,33,32,1,1,0,OUI,OUI,2025-03-13 11:56:37+00:00,"48.859358523593, 2.3896131366845",Paris,75056,0.030303030303030304,12
21006,Marcelin Berthelot,OUI,27,22,5,3,2,OUI,OUI,2025-03-13 11:55:04+00:00,"48.8415473058801, 2.233161628246308",Boulogne-Billancourt,92012,0.18518518518518517,12
6025,Assas - Rennes,OUI,32,9,23,14,9,OUI,OUI,2025-03-13 11:59:41+00:00,"48.8492084999386, 2.32851454623001",Paris,75056,0.71875,12
21015,Nationale - Place Jules Guesde,OUI,23,12,11,6,5,OUI,OUI,2025-03-13 12:01:37+00:00,"48.82753962462998, 2.2416052222251897",Boulogne-Billancourt,92012,0.4782608695652174,12
44003,Gabriel Péri - Danielle Casanova,OUI,20,7,13,8,5,OUI,OUI,2025-03-13 11:59:10+00:00,"48.790114, 2.4025777",Vitry-sur-Seine,94081,0.65,12
48010,Karl Marx,OUI,16,4,12,2,10,OUI,OUI,2025-03-13 11:54:39+00:00,"48.784527937293184, 2.3646667979455587",Villejuif,94076,0.75,12
15034,Lakanal - Commerce,OUI,49,13,36,34,2,OUI,OUI,2025-03-13 11:55:00+00:00,"48.84442462786544, 2.294059172272682",Paris,75056,0.7346938775510204,12
41202,Gare Rer de Fontenay sous Bois,OUI,59,48,11,3,8,OUI,OUI,2025-03-13 11:57:53+00:00,"48.8436279, 2.4630465",Fontenay-sous-Bois,94033,0.1864406779661017,12
5028,Censier - Jardin des Plantes,OUI,28,8,20,18,2,OUI,OUI,2025-03-13 12:01:18+00:00,"48.84107178161383, 2.355475388467312",Paris,75056,0.7142857142857143,12
1119,Cossonnerie - Sébastopol,OUI,23,3,20,11,9,OUI,OUI,2025-03-13 11:59:00+00:00,"48.86132665908402, 2.349419631063938",Paris,75056,0.8695652173913043,12
22203,Tertres - Fontaine,OUI,27,25,2,0,2,OUI,OUI,2025-03-13 12:00:56+00:00,"48.787553654715644, 2.306235730648041",Bagneux,92007,0.07407407407407407,12
35020,Marcelle - Thalie,OUI,20,20,0,0,0,OUI,OUI,2025-03-13 11:59:32+00:00,"48.8835462, 2.4137883",Pantin,93055,0.0,12
42021,Raspail - Manufacture des Oeillets,OUI,30,10,20,19,1,OUI,OUI,2025-03-13 11:59:42+00:00,"48.8094458, 2.3903009",Ivry-sur-Seine,94041,0.6666666666666666,12
1020,Cambon - Rivoli,OUI,34,3,31,19,12,OUI,OUI,2025-03-13 12:01:23+00:00,"48.866143390992, 2.3251800647137",Paris,75056,0.9117647058823529,12
25003,Henri Ste-Claire Déville - Paul Héroult,OUI,21,7,14,6,8,OUI,OUI,2025-03-13 12:01:35+00:00,"48.892663, 2.172411",Rueil-Malmaison,92063,0.6666666666666666,12
20115,Louis Lumière - Porte de Bagnolet,OUI,20,20,0,0,0,OUI,OUI,2025-03-13 11:54:24+00:00,"48.86431136000005, 2.4105210229754443",Paris,75056,0.0,12
31003,Paris - Emile Zola,OUI,29,23,6,4,2,OUI,OUI,2025-03-13 12:00:11+00:00,"48.854898095789295, 2.4186685681343083",Montreuil,93048,0.20689655172413793,12
22402,Jean Jaurès - Salvador Allende,OUI,42,40,2,1,1,OUI,OUI,2025-03-13 12:00:51+00:00,"48.821475594736775, 2.3026576638221745",Malakoff,92046,0.047619047619047616,12
9116,Victoire - Chaussée d'Antin,OUI,24,1,23,8,15,OUI,OUI,2025-03-13 12:01:12+00:00,"48.875065791004396, 2.3316738009452824",Paris,75056,0.9583333333333334,12
11030,Oberkampf - République,OUI,21,19,2,0,2,OUI,OUI,2025-03-13 11:58:09+00:00,"48.86531608707, 2.37611478491",Paris,75056,0.09523809523809523,12
11039,Richard Lenoir - Jean-Pierre Timbaud,OUI,35,13,22,20,2,OUI,OUI,2025-03-13 12:01:18+00:00,"48.865804276686, 2.3693370749669",Paris,75056,0.6285714285714286,12
11026,Chemin Vert - Saint-Maur,OUI,44,44,0,0,0,OUI,OUI,2025-03-13 11:59:13+00:00,"48.86112461407359, 2.381299026310444",Paris,75056,0.0,12
17013,Legendre - Dulong,OUI,23,20,3,0,3,OUI,OUI,2025-03-13 11:57:52+00:00,"48.885325169402904, 2.316423766314984",Paris,75056,0.13043478260869565,12
19024,Botzaris - Parc des Buttes Chaumont,OUI,20,20,0,0,0,OUI,OUI,2025-03-13 11:54:31+00:00,"48.877951, 2.381464",Paris,75056,0.0,12
32604,Square du Théâtre du Garde-Chasse,OUI,50,49,1,0,1,OUI,OUI,2025-03-13 11:58:22+00:00,"48.881287375060616, 2.420119643211365",Les Lilas,93045,0.02,12
23006,Jules Guesde - Alsace,OUI,24,3,21,12,9,OUI,OUI,2025-03-13 12:01:44+00:00,"48.890566275506, 2.2950777411461",Levallois-Perret,92044,0.875,12
41601,Général De Gaulle - Alouette,OUI,25,20,5,3,2,OUI,OUI,2025-03-13 12:01:21+00:00,"48.839109, 2.4175664",Saint-Mandé,94067,0.2,12
15021,Joseph Liouville - Croix Nivert,OUI,62,38,24,22,2,OUI,OUI,2025-03-13 12:00:46+00:00,"48.844835471244416, 2.297508493065834",Paris,75056,0.3870967741935484,12
17105,Place Madeleine Daniélou,OUI,42,15,27,19,8,OUI,OUI,2025-03-13 12:01:19+00:00,"48.883498, 2.282015",Paris,75056,0.6428571428571429,12
11105,Parmentier - République,OUI,21,18,3,0,3,OUI,OUI,2025-03-13 12:00:43+00:00,"48.8644954, 2.3750124",Paris,75056,0.14285714285714285,12
9010,Rochechouart lamartine,OUI,24,20,4,0,4,OUI,OUI,2025-03-13 11:59:03+00:00,"48.876719895109, 2.344393021854",Paris,75056,0.16666666666666666,12
17125,Marie-Georges Picquart - Pereire,OUI,31,26,5,4,1,OUI,OUI,2025-03-13 11:59:43+00:00,"48.88863669349711, 2.3111706599593163",Paris,75056,0.16129032258064516,12
18009,Jean-François Lépine - Stephenson,OUI,22,20,2,0,2,OUI,OUI,2025-03-13 11:54:42+00:00,"48.88611466796807, 2.356855627529275",Paris,75056,0.09090909090909091,12
43005,Gare RER de Vincennes,OUI,48,27,21,10,11,OUI,OUI,2025-03-13 12:01:29+00:00,"48.847563015126106, 2.433383166790009",Vincennes,94080,0.4375,12
16108,Sablons - Georges Mandel,OUI,38,36,2,1,1,OUI,OUI,2025-03-13 12:00:04+00:00,"48.863875, 2.28189",Paris,75056,0.05263157894736842,12
16136,Théophile Gautier - François Millet,OUI,27,12,15,12,3,OUI,OUI,2025-03-13 12:01:37+00:00,"48.85034821320644, 2.273029983043671",Paris,75056,0.5555555555555556,12
19032,Villette - Belleville,OUI,40,31,9,5,4,OUI,OUI,2025-03-13 12:01:31+00:00,"48.8726877314, 2.376461327076",Paris,75056,0.225,12
19022,Marché Secrétan,OUI,25,22,3,1,2,OUI,OUI,2025-03-13 12:00:55+00:00,"48.88125496379482, 2.373463287949562",Paris,75056,0.12,12
16008,Galilée - Kléber,OUI,30,14,16,2,14,OUI,OUI,2025-03-13 12:01:24+00:00,"48.867411865714, 2.2907813801148",Paris,75056,0.5333333333333333,12
21701,Larmeroux - Baudelaire,OUI,28,25,3,0,3,OUI,OUI,2025-03-13 11:57:42+00:00,"48.816939911292, 2.2809894804846",Vanves,92075,0.10714285714285714,12
22003,Beffroy,OUI,26,4,22,6,16,OUI,OUI,2025-03-13 12:00:01+00:00,"48.886591074488, 2.2613945603371",Neuilly-sur-Seine,92051,0.8461538461538461,12
20134,Lieutenant Chauré - Etienne Marey,OUI,19,17,2,1,1,OUI,OUI,2025-03-13 12:01:30+00:00,"48.86746195408435, 2.405970990657807",Paris,75056,0.10526315789473684,12
11024,Mairie du 11ème,OUI,51,33,18,15,3,OUI,OUI,2025-03-13 12:00:46+00:00,"48.858925, 2.3789759",Paris,75056,0.35294117647058826,12
22016,Charles de Gaulle - Sablonville,OUI,26,11,15,6,9,OUI,OUI,2025-03-13 12:01:22+00:00,"48.87991924860035, 2.2763770446181297",Neuilly-sur-Seine,92051,0.5769230769230769,12
13050,Quai Panhard et Levassor,OUI,57,3,54,29,25,OUI,OUI,2025-03-13 12:01:31+00:00,"48.828374828097, 2.3842737458056",Paris,75056,0.9473684210526315,12
11035,Parmentier - Abel Rabaud,OUI,49,42,7,3,4,OUI,OUI,2025-03-13 11:59:38+00:00,"48.86921273836114, 2.371688821240712",Paris,75056,0.14285714285714285,12
21008,Victor Hugo - Galliéni,OUI,33,14,19,18,1,OUI,OUI,2025-03-13 11:59:34+00:00,"48.838020154411, 2.2460845112801",Boulogne-Billancourt,92012,0.5757575757575758,12
42010,Mairie d'Ivry-sur-Seine,OUI,51,21,30,27,3,OUI,OUI,2025-03-13 12:01:37+00:00,"48.81057120969284, 2.3842826485633855",Ivry-sur-Seine,94041,0.5882352941176471,12
24001,Arche - Léonard de Vinci,OUI,28,17,11,7,4,OUI,OUI,2025-03-13 11:59:09+00:00,"48.89790972494496, 2.2383723043644914",Courbevoie,92026,0.39285714285714285,12
15046,Parc Georges Brassens - Brancion,OUI,28,27,1,0,1,OUI,OUI,2025-03-13 11:52:19+00:00,"48.83227829269761, 2.3022570088505745",Paris,75056,0.03571428571428571,12
14136,Auguste Cain - Jean Moulin,OUI,40,38,2,0,2,OUI,OUI,2025-03-13 11:58:43+00:00,"48.82577028927573, 2.3210415244102482",Paris,75056,0.05,12
16040,Exelmans - Michel-Ange,OUI,31,18,13,11,2,OUI,OUI,2025-03-13 12:00:52+00:00,"48.84309486651855, 2.2597770800669053",Paris,75056,0.41935483870967744,12
32302,Chemin Vert - Fraternité,OUI,20,19,1,0,1,OUI,OUI,2025-03-13 11:59:22+00:00,"48.877141208359035, 2.4461565166711807",Romainville,93063,0.05,12
22006,Pierret - Madrid,OUI,27,1,26,20,6,OUI,OUI,2025-03-13 11:59:50+00:00,"48.882976576876565, 2.260125767248034",Neuilly-sur-Seine,92051,0.9629629629629629,12
10014,Marseille - Beaurepaire,OUI,46,12,34,28,6,OUI,OUI,2025-03-13 12:00:05+00:00,"48.871624306962985, 2.3639265082738348",Paris,75056,0.7391304347826086,12
17028,Reims - Raymond Pitet,OUI,36,14,22,16,6,OUI,OUI,2025-03-13 12:00:53+00:00,"48.8888, 2.296319",Paris,75056,0.6111111111111112,12
46001,Place Paul Eluard,OUI,19,4,15,9,6,OUI,OUI,2025-03-13 11:58:26+00:00,"48.7672039733195, 2.4144977331161503",Choisy-le-Roi,94022,0.7894736842105263,12
21301,Saint-Vincent - Verdun,OUI,33,11,22,20,2,OUI,OUI,2025-03-13 11:58:02+00:00,"48.819211549234495, 2.254007756710053",Issy-les-Moulineaux,92040,0.6666666666666666,12
42302,Aristide Briand - Gare de Bagneux,OUI,20,20,0,0,0,OUI,OUI,2025-03-13 11:58:23+00:00,"48.79387269664978, 2.321148812770844",Cachan,94016,0.0,12
19029,Seine - Flandre,OUI,18,17,1,1,0,OUI,OUI,2025-03-13 11:58:16+00:00,"48.886785741479684, 2.3746193200349808",Paris,75056,0.05555555555555555,12
9032,Mathurins - Auber,OUI,35,5,30,22,8,OUI,OUI,2025-03-13 12:01:38+00:00,"48.872988840744, 2.3294984212276",Paris,75056,0.8571428571428571,12
32003,Wilson - Métallurgie,OUI,28,9,19,12,7,OUI,OUI,2025-03-13 12:01:05+00:00,"48.909423010092326, 2.3584435880184174",Saint-Denis,93066,0.6785714285714286,12
19016,Hautpoul - Jean Jaurès,OUI,30,29,1,0,1,OUI,OUI,2025-03-13 11:55:06+00:00,"48.886393679436, 2.3865414544355",Paris,75056,0.03333333333333333,12
11042,Grand Prieuré - Crussol,OUI,46,19,27,25,2,OUI,OUI,2025-03-13 11:59:59+00:00,"48.864660627935, 2.3692265531829",Paris,75056,0.5869565217391305,12
21104,Madame de Sanzillon - Mozart,OUI,22,1,21,13,8,OUI,OUI,2025-03-13 12:01:14+00:00,"48.90379820774301, 2.3187401890754704",Clichy,92024,0.9545454545454546,12
9005,Square d'Anvers,OUI,31,29,2,1,1,OUI,OUI,2025-03-13 11:54:59+00:00,"48.882633484311, 2.3448844062122",Paris,75056,0.06451612903225806,12
32026,Leroy des Barres - Médiathèque,OUI,27,2,25,11,14,OUI,OUI,2025-03-13 12:01:11+00:00,"48.928253687082, 2.3681719727966",Saint-Denis,93066,0.9259259259259259,12
20121,Boyer - Ménilmontant,OUI,19,18,1,0,1,OUI,OUI,2025-03-13 11:58:24+00:00,"48.868895162679, 2.3919824145635",Paris,75056,0.05263157894736842,12
1013,Place du Palais Royal,OUI,65,2,63,42,21,OUI,OUI,2025-03-13 12:01:32+00:00,"48.862382970647, 2.3384822532535",Paris,75056,0.9692307692307692,12
42504,Gare RER de Gentilly,OUI,30,25,5,2,3,OUI,OUI,2025-03-13 12:00:26+00:00,"48.814280450380224, 2.3410347104072575",Gentilly,94037,0.16666666666666666,12
8025,Miromesnil - La Boétie,OUI,32,6,26,12,14,OUI,OUI,2025-03-13 12:01:43+00:00,"48.873722412917, 2.3158480972052",Paris,75056,0.8125,12
20111,Villiers de l'Isle Adam - Pyrénées,OUI,20,20,0,0,0,OUI,OUI,2025-03-13 11:53:08+00:00,"48.867362, 2.396222",Paris,75056,0.0,12
7102,Mairie du 7ème,OUI,48,6,42,25,17,OUI,OUI,2025-03-13 12:01:15+00:00,"48.8577967, 2.3192664",Paris,75056,0.875,12
20043,Charonne - Avron,OUI,26,25,1,1,0,OUI,OUI,2025-03-13 11:59:39+00:00,"48.851602665222, 2.3984030470379",Paris,75056,0.038461538461538464,12
13002,Arago - Glacière,OUI,26,17,9,7,2,OUI,OUI,2025-03-13 12:01:43+00:00,"48.83486054775774, 2.3445770524322067",Paris,75056,0.34615384615384615,12
15201,Place Amédée Gordini - Lefebvre,OUI,37,33,4,1,3,OUI,OUI,2025-03-13 11:58:16+00:00,"48.83061737745, 2.2920634208276",Paris,75056,0.10810810810810811,12
18201,Tristan Tzara -  Tchaïkovski,OUI,33,32,1,0,1,OUI,OUI,2025-03-13 11:58:25+00:00,"48.89490221746837, 2.3648490384221077",Paris,75056,0.030303030303030304,12
19013,Laumière - Petit,OUI,32,32,0,0,0,OUI,OUI,2025-03-13 11:54:48+00:00,"48.88467368538326, 2.380039058625698",Paris,75056,0.0,12
92008,Hôtel de Ville de Nanterre,OUI,35,13,22,11,11,OUI,OUI,2025-03-13 12:01:24+00:00,"48.892371898250424, 2.205548956990242",Nanterre,92050,0.6285714285714286,12
42301,Gare Arcueil - Cachan,OUI,25,15,10,1,9,OUI,OUI,2025-03-13 12:00:05+00:00,"48.799824, 2.328171",Arcueil,94003,0.4,12
51004,Général Delambre - Prebuard,OUI,28,16,12,2,10,OUI,OUI,2025-03-13 11:55:39+00:00,"48.93870344444, 2.2234171606307",Argenteuil,95018,0.42857142857142855,12
26013,Quai du docteur Dervaux,OUI,26,18,8,8,0,OUI,OUI,2025-03-13 11:58:18+00:00,"48.910482, 2.297998",Asnières-sur-Seine,92004,0.3076923076923077,12
18012,Stephenson - Doudeauville,OUI,35,33,2,0,2,OUI,OUI,2025-03-13 12:01:43+00:00,"48.888537048944826, 2.3561610281467438",Paris,75056,0.05714285714285714,12
42015,Place Jean Ferrat,OUI,23,22,1,0,1,OUI,OUI,2025-03-13 12:00:01+00:00,"48.8184945213025, 2.3744174838066106",Ivry-sur-Seine,94041,0.043478260869565216,12
12009,Charenton - Diderot,OUI,18,7,11,7,4,OUI,OUI,2025-03-13 11:59:47+00:00,"48.846171461187, 2.3793068155646",Paris,75056,0.6111111111111112,12
32016,Place de la Porte de Paris,OUI,35,29,6,2,4,OUI,OUI,2025-03-13 12:01:42+00:00,"48.93009363207303, 2.3564037680625916",Saint-Denis,93066,0.17142857142857143,12
14036,Boulard - Daguerre,OUI,43,42,1,0,1,OUI,OUI,2025-03-13 11:59:38+00:00,"48.83446472680611, 2.3293386027216907",Paris,75056,0.023255813953488372,12
31010,Stalingrad - Désiré Chevalier,OUI,41,41,0,0,0,OUI,OUI,2025-03-13 11:55:52+00:00,"48.85670169739857, 2.445072233676911",Montreuil,93048,0.0,12
5123,Saint-Germain - Thenard,OUI,29,0,29,18,11,OUI,OUI,2025-03-13 12:01:25+00:00,"48.850571, 2.3471015",Paris,75056,1.0,12
19008,Flandre - Alphonse Karr,OUI,26,24,2,0,2,OUI,OUI,2025-03-13 11:57:57+00:00,"48.89465, 2.381868",Paris,75056,0.07692307692307693,12
43003,Hôpital Bégin,OUI,26,26,0,0,0,NON,NON,2025-03-13 11:58:57+00:00,"48.84571672113, 2.4272462725639",Vincennes,94080,0.0,12
11004,Charonne - Faubourg Saint-Antoine,OUI,31,9,22,20,2,OUI,OUI,2025-03-13 12:00:44+00:00,"48.852191909696, 2.3740932717919",Paris,75056,0.7096774193548387,12
9021,Saint Georges - d'Aumale,OUI,23,15,8,4,4,OUI,OUI,2025-03-13 11:57:08+00:00,"48.87778639599673, 2.337429821491241",Paris,75056,0.34782608695652173,12
41402,Victor Hugo - Ecoles,OUI,22,13,9,6,3,OUI,OUI,2025-03-13 11:55:01+00:00,"48.80476007936134, 2.4180373930262093",Alfortville,94002,0.4090909090909091,12
23009,Anatole France - Louise Michel,OUI,47,39,8,1,7,OUI,OUI,2025-03-13 12:00:05+00:00,"48.88873214926474, 2.2881576418876652",Levallois-Perret,92044,0.1702127659574468,12
19125,Place de l'Édit de Nantes,OUI,27,26,1,0,1,OUI,OUI,2025-03-13 12:00:59+00:00,"48.88879, 2.3785",Paris,75056,0.037037037037037035,12
12027,Montgallet - Charenton,OUI,15,7,8,6,2,OUI,OUI,2025-03-13 11:59:16+00:00,"48.842647778701, 2.3861649278137",Paris,75056,0.5333333333333333,12
42029,Stalingrad - Germaine Tailleferre,OUI,28,28,0,0,0,OUI,OUI,2025-03-13 12:01:30+00:00,"48.80257200481316, 2.3786691203713417",Ivry-sur-Seine,94041,0.0,12
19205,Simon Bolivar - Henri Turot,OUI,23,23,0,0,0,OUI,OUI,2025-03-13 11:56:51+00:00,"48.877475489801, 2.3739709492211",Paris,75056,0.0,12
26007,Square Gilbert Thomain,OUI,19,11,8,5,3,OUI,OUI,2025-03-13 11:53:24+00:00,"48.90717373809284, 2.2695400938391685",Asnières-sur-Seine,92004,0.42105263157894735,12
11036,Jules Ferry - Faubourg du Temple Paris,OUI,56,32,24,16,8,OUI,OUI,2025-03-13 12:01:34+00:00,"48.868397, 2.3678933",Paris,75056,0.42857142857142855,12
11007,Jean Macé - Faidherbe,OUI,57,49,8,2,6,OUI,OUI,2025-03-13 12:00:33+00:00,"48.85337548426, 2.3828620836139",Paris,75056,0.14035087719298245,12
8035,Bienfaisance - Place de Narvik,OUI,34,6,28,18,10,OUI,OUI,2025-03-13 12:00:22+00:00,"48.87660163459077, 2.3129771277308464",Paris,75056,0.8235294117647058,12
15025,Dupleix - du Guesclin,OUI,46,17,29,23,6,OUI,OUI,2025-03-13 12:01:37+00:00,"48.85147910413369, 2.296709530055523",Paris,75056,0.6304347826086957,12
21313,Guynemer - Séverine,OUI,24,7,17,16,1,OUI,OUI,2025-03-13 11:59:56+00:00,"48.83091743371036, 2.2790706530213356",Issy-les-Moulineaux,92040,0.7083333333333334,12
35018,Ancien Canal - Hélène Brion,OUI,23,22,1,0,1,OUI,OUI,2025-03-13 11:56:54+00:00,"48.89484799296163, 2.4188338592648506",Pantin,93055,0.043478260869565216,12
17102,Alfred Roll - Berthier,OUI,28,18,10,9,1,OUI,OUI,2025-03-13 11:57:14+00:00,"48.887808570529, 2.3000952981763",Paris,75056,0.35714285714285715,12
18110,Departement - Pajol,OUI,16,14,2,0,2,OUI,OUI,2025-03-13 11:57:06+00:00,"48.886674849730184, 2.3613611608743668",Paris,75056,0.125,12
28001,Richard Wallace - Place du 8 Mai 1945,OUI,29,14,15,10,5,OUI,OUI,2025-03-13 12:01:31+00:00,"48.87866794788021, 2.2420343756675725",Puteaux,92062,0.5172413793103449,12
41606,Pasteur - Gambetta,OUI,19,13,6,3,3,OUI,OUI,2025-03-13 11:57:15+00:00,"48.84572797384512, 2.4236011505126953",Saint-Mandé,94067,0.3157894736842105,12
16111,Faustin Hélie - Desbordes-Valmore,OUI,27,23,4,1,3,OUI,OUI,2025-03-13 11:56:44+00:00,"48.859403, 2.276522",Paris,75056,0.14814814814814814,12
17045,Place des Ternes.,OUI,44,37,7,3,4,OUI,OUI,2025-03-13 12:00:15+00:00,"48.878438631226516, 2.297727763652802",Paris,75056,0.1590909090909091,12
19005,Flandre - Riquet,OUI,19,17,2,2,0,OUI,OUI,2025-03-13 11:58:07+00:00,"48.888013281448, 2.3737595955229",Paris,75056,0.10526315789473684,12
12013,Montgallet - Reuilly,OUI,14,10,4,1,3,OUI,OUI,2025-03-13 11:57:07+00:00,"48.844291, 2.3896481",Paris,75056,0.2857142857142857,12
10113,Parmentier - Hôpital Saint-Louis,OUI,39,36,3,1,2,OUI,OUI,2025-03-13 12:01:42+00:00,"48.871379874257, 2.3698963836667",Paris,75056,0.07692307692307693,12
7015,Varenne,OUI,44,20,24,15,9,OUI,OUI,2025-03-13 12:00:54+00:00,"48.857202661803, 2.3152771219611",Paris,75056,0.5454545454545454,12
17011,Fragonard - Porte de Clichy,OUI,55,31,24,22,2,OUI,OUI,2025-03-13 11:59:42+00:00,"48.894155633419, 2.3143893107772",Paris,75056,0.43636363636363634,12
43402,Place de Verdun,OUI,40,20,20,18,2,OUI,OUI,2025-03-13 11:59:59+00:00,"48.8202823, 2.473775",Joinville-le-Pont,94042,0.5,12
12115,Porte de Vincennes,OUI,32,30,2,1,1,OUI,OUI,2025-03-13 11:58:49+00:00,"48.846454, 2.415514",Paris,75056,0.0625,12
33018,Edouard Poisson - Victor Hugo,OUI,26,23,3,2,1,OUI,OUI,2025-03-13 11:54:26+00:00,"48.91118557052621, 2.379864752692811",Aubervilliers,93001,0.11538461538461539,12
8033,Commandant Rivière,OUI,38,1,37,23,14,OUI,OUI,2025-03-13 12:01:30+00:00,"48.872933, 2.309796",Paris,75056,0.9736842105263158,12
21305,Place Jacques Madaule,OUI,23,5,18,17,1,OUI,OUI,2025-03-13 12:01:29+00:00,"48.823933787309, 2.2606918215752",Issy-les-Moulineaux,92040,0.782608695652174,12
16121,Jardin d'Acclimatation,OUI,30,22,8,7,1,OUI,OUI,2025-03-13 12:00:50+00:00,"48.878772242510465, 2.270772233605385",Paris,75056,0.26666666666666666,12
11115,Montreuil - Gonnet,OUI,24,22,2,0,2,OUI,OUI,2025-03-13 12:01:41+00:00,"48.850500564921, 2.3890856287864",Paris,75056,0.08333333333333333,12
17037,Bayen - Pereire,OUI,21,14,7,5,2,OUI,OUI,2025-03-13 11:59:20+00:00,"48.881804409079656, 2.2921088710427284",Paris,75056,0.3333333333333333,12
5021,Jussieu - Fossés Saint-Bernard,OUI,38,3,35,32,3,OUI,OUI,2025-03-13 12:00:52+00:00,"48.847185510023, 2.3534858599305",Paris,75056,0.9210526315789473,12
18141,Clignancourt - Sofia,OUI,19,17,2,0,2,OUI,OUI,2025-03-13 12:01:08+00:00,"48.88511992309783, 2.34719488842051",Paris,75056,0.10526315789473684,12
6013,Jacques Callot - Mazarine,OUI,27,0,27,25,2,OUI,OUI,2025-03-13 11:57:35+00:00,"48.855280175332, 2.3375743255019",Paris,75056,1.0,12
33003,Bordier - Félix Faure,OUI,43,41,2,2,0,OUI,OUI,2025-03-13 12:00:08+00:00,"48.90390751882016, 2.3830059170722966",Aubervilliers,93001,0.046511627906976744,12
23001,Paul Vaillant Couturier - Chaptal,OUI,36,16,20,15,5,OUI,OUI,2025-03-13 12:01:34+00:00,"48.893479576183, 2.2775253653526",Levallois-Perret,92044,0.5555555555555556,12
33009,Félix Faure - Sadi Carnot,OUI,33,26,7,5,2,OUI,OUI,2025-03-13 12:01:43+00:00,"48.90812110228388, 2.378623187541962",Aubervilliers,93001,0.21212121212121213,12
15010,Square Cambronne,OUI,59,5,54,51,3,OUI,OUI,2025-03-13 12:00:40+00:00,"48.84756654526, 2.3025691509247",Paris,75056,0.9152542372881356,12
13045,Jean Colly - Tolbiac,OUI,36,29,7,5,2,OUI,OUI,2025-03-13 12:01:09+00:00,"48.827817291597846, 2.3705490678548813",Paris,75056,0.19444444444444445,12
41102,Gare de Laplace,OUI,43,42,1,1,0,OUI,OUI,2025-03-13 11:55:46+00:00,"48.80893199114179, 2.3349460959434514",Arcueil,94003,0.023255813953488372,12
14034,Ouest - Château,OUI,23,20,3,3,0,OUI,OUI,2025-03-13 11:58:43+00:00,"48.83617286014242, 2.319392143923804",Paris,75056,0.13043478260869565,12
16124,Route de Sèvres - Porte de Bagatelle,OUI,65,3,62,52,10,OUI,OUI,2025-03-13 12:01:41+00:00,"48.87525984132485, 2.249415814876557",Paris,75056,0.9538461538461539,12
32010,Place aux Étoiles,OUI,37,13,24,5,19,OUI,OUI,2025-03-13 12:01:00+00:00,"48.91835629408464, 2.3523425683379173",Saint-Denis,93066,0.6486486486486487,12
5106,Cujas - Saint-Michel,OUI,19,1,18,2,16,OUI,OUI,2025-03-13 11:59:25+00:00,"48.848191348584, 2.341831654854",Paris,75056,0.9473684210526315,12
16018,Flandrin - Henri Martin,OUI,18,14,4,0,4,OUI,OUI,2025-03-13 12:01:08+00:00,"48.8643275, 2.2724174",Paris,75056,0.2222222222222222,12
25005,18 juin 1940 - Buzenval,OUI,25,16,9,4,5,OUI,OUI,2025-03-13 12:00:41+00:00,"48.868807, 2.185428",Rueil-Malmaison,92063,0.36,12
12034,Pirogues de Bercy - Libourne,OUI,48,28,20,6,14,OUI,OUI,2025-03-13 11:59:40+00:00,"48.832308, 2.38637",Paris,75056,0.4166666666666667,12
22505,Mairie de La Garenne Colombes,OUI,22,16,6,4,2,OUI,OUI,2025-03-13 11:54:36+00:00,"48.90663823468682, 2.24679596722126",La Garenne-Colombes,92035,0.2727272727272727,12
15033,Place Violet,OUI,29,23,6,6,0,OUI,OUI,2025-03-13 12:00:13+00:00,"48.84487893836502, 2.2905756533145905",Paris,75056,0.20689655172413793,12
19115,Porte de la Villette,OUI,26,23,3,3,0,OUI,OUI,2025-03-13 11:56:08+00:00,"48.89835196548483, 2.386150136590004",Paris,75056,0.11538461538461539,12
25008,Place du 8 Mai 1945,OUI,18,14,4,4,0,OUI,OUI,2025-03-13 12:00:15+00:00,"48.871552174017, 2.2025031970585",Rueil-Malmaison,92063,0.2222222222222222,12
33001,Victor Hugo - Magasins Généraux,OUI,34,25,9,4,5,OUI,OUI,2025-03-13 11:57:44+00:00,"48.903281401126755, 2.368072383105755",Aubervilliers,93001,0.2647058823529412,12
19044,Grands Moulins de Pantin,OUI,50,40,10,2,8,OUI,OUI,2025-03-13 12:00:35+00:00,"48.89738369720229, 2.3959985375404362",Paris,75056,0.2,12
92003,Chanzy - Sud-Est,OUI,25,23,2,1,1,OUI,OUI,2025-03-13 11:59:37+00:00,"48.888912037698766, 2.195632159709931",Nanterre,92050,0.08,12
24002,Gare de Courbevoie,OUI,32,27,5,4,1,OUI,OUI,2025-03-13 11:56:23+00:00,"48.8993867, 2.2506506",Courbevoie,92026,0.15625,12
19019,Petit - Manin,OUI,22,22,0,0,0,NON,NON,2025-03-13 11:55:54+00:00,"48.886506875343, 2.3938155401308",Paris,75056,0.0,12
16034,Porte d'Auteuil,OUI,32,25,7,4,3,OUI,OUI,2025-03-13 12:00:51+00:00,"48.8479394142243, 2.2608396783471107",Paris,75056,0.21875,12
8055,Courcelles - Place des Ternes,OUI,28,24,4,2,2,OUI,OUI,2025-03-13 11:58:14+00:00,"48.878199928923124, 2.2992860188665043",Paris,75056,0.14285714285714285,12
41404,Carnot - Pâquerettes,OUI,23,2,21,21,0,OUI,OUI,2025-03-13 12:01:15+00:00,"48.79592939432515, 2.4261841177940373",Alfortville,94002,0.9130434782608695,12
27002,Parc Pierre Lagravère,OUI,30,13,17,9,8,OUI,OUI,2025-03-13 12:00:16+00:00,"48.92650488131725, 2.239069678491417",Colombes,92025,0.5666666666666667,12
7009,Assemblée Nationale,OUI,75,5,70,31,39,OUI,OUI,2025-03-13 11:56:25+00:00,"48.861411014652, 2.3201214185208",Paris,75056,0.9333333333333333,12
21109,Guichet - Jean Jaurès,OUI,23,18,5,3,2,OUI,OUI,2025-03-13 11:57:18+00:00,"48.905169868129036, 2.3023840785026555",Clichy,92024,0.21739130434782608,12
20132,Réunion - Avron,OUI,26,24,2,1,1,OUI,OUI,2025-03-13 11:53:38+00:00,"48.852566752033766, 2.403928068708116",Paris,75056,0.07692307692307693,12
17007,Navier - Epinettes,OUI,36,36,0,0,0,OUI,OUI,2025-03-13 11:54:31+00:00,"48.89587780769155, 2.3226776719093327",Paris,75056,0.0,12
15122,Place Charles Vallin,OUI,26,24,2,1,1,OUI,OUI,2025-03-13 11:59:53+00:00,"48.835523812041, 2.3025986552238",Paris,75056,0.07692307692307693,12
21502,Verdun - Place Henri IV,OUI,25,8,17,14,3,OUI,OUI,2025-03-13 11:59:30+00:00,"48.870797375639214, 2.2277003154158592",Suresnes,92073,0.68,12
42707,Place Jean-Baptiste Clément,OUI,23,23,0,0,0,OUI,OUI,2025-03-13 11:56:16+00:00,"48.81240466867336, 2.3617091774940495",Le Kremlin-Bicêtre,94043,0.0,12
31012,Place Carnot,OUI,23,22,1,0,1,OUI,OUI,2025-03-13 11:57:56+00:00,"48.85593932186797, 2.441531717777252",Montreuil,93048,0.043478260869565216,12
5119,Jussieu - Guy de la Brosse,OUI,40,4,36,26,10,OUI,OUI,2025-03-13 12:01:20+00:00,"48.845665, 2.355653",Paris,75056,0.9,12
16129,Ceinture du Lac Inferieure - Saint-Cloud,OUI,41,38,3,0,3,OUI,OUI,2025-03-13 11:56:13+00:00,"48.86218070933143, 2.2617871686816216",Paris,75056,0.07317073170731707,12
35009,Jean Lolive - Parc Stalingrad,OUI,22,22,0,0,0,OUI,OUI,2025-03-13 11:57:28+00:00,"48.89206174403158, 2.4091735482215886",Pantin,93055,0.0,12
14104,Boyer-Barret - Raymond Losserand,OUI,22,20,2,0,2,OUI,OUI,2025-03-13 12:01:44+00:00,"48.83329880233322, 2.3173383995890617",Paris,75056,0.09090909090909091,12
23701,Parvis Robert Schuman - Roger Salengro,OUI,24,15,9,2,7,OUI,OUI,2025-03-13 12:01:22+00:00,"48.812657470558754, 2.1921751275658607",Chaville,92022,0.375,12
20113,Piat - Parc de Belleville,OUI,21,17,4,1,3,OUI,OUI,2025-03-13 12:00:32+00:00,"48.87195626635528, 2.384981390278095",Paris,75056,0.19047619047619047,12
12024,Gare de Bercy,OUI,35,12,23,20,3,OUI,OUI,2025-03-13 12:00:15+00:00,"48.839794573906, 2.3826066032052",Paris,75056,0.6571428571428571,12
6030,Assas - Vaugirard,OUI,34,15,19,9,10,OUI,OUI,2025-03-13 11:59:42+00:00,"48.848274111398, 2.3292413726449",Paris,75056,0.5588235294117647,12
35019,Anatole France - Jean Lolive,OUI,27,20,7,5,2,OUI,OUI,2025-03-13 11:59:33+00:00,"48.8949922, 2.4253764",Pantin,93055,0.25925925925925924,12
23802,Raymond Poincaré - Allée de la Marche,OUI,22,13,9,7,2,OUI,OUI,2025-03-13 11:58:00+00:00,"48.838634069623, 2.1724102640451",Garches,92033,0.4090909090909091,12
20119,Square des Saint-Simoniens,OUI,25,25,0,0,0,OUI,OUI,2025-03-13 11:57:47+00:00,"48.8701796, 2.3967273",Paris,75056,0.0,12
12126,Gravelle - Route du Bac,OUI,49,44,5,4,1,OUI,OUI,2025-03-13 12:00:42+00:00,"48.824407, 2.418455",Paris,75056,0.10204081632653061,12
31705,Champeaux - Gallieni,OUI,47,45,2,0,2,OUI,OUI,2025-03-13 11:54:21+00:00,"48.864459134684644, 2.4161778017878532",Bagnolet,93006,0.0425531914893617,12
20036,Ménilmontant - Pelleport,OUI,31,31,0,0,0,OUI,OUI,2025-03-13 11:58:26+00:00,"48.870682633845, 2.3989596023316",Paris,75056,0.0,12
18005,Tardieu - Chappe,OUI,16,14,2,1,1,OUI,OUI,2025-03-13 11:56:05+00:00,"48.884146759782, 2.341845408082",Paris,75056,0.125,12
41604,Lagny - Joffre,OUI,30,13,17,15,2,OUI,OUI,2025-03-13 12:01:15+00:00,"48.84930687084088, 2.417949736118317",Saint-Mandé,94067,0.5666666666666667,12
10005,Petites Ecuries - Faubourg Poissonnière,OUI,17,1,16,12,4,OUI,OUI,2025-03-13 11:59:17+00:00,"48.87397217237368, 2.348388757504776",Paris,75056,0.9411764705882353,12
15017,Place Falguière,OUI,23,23,0,0,0,OUI,OUI,2025-03-13 12:01:38+00:00,"48.83629973941847, 2.3104464635252953",Paris,75056,0.0,12
92004,Nanterre - Université,OUI,19,7,12,8,4,OUI,OUI,2025-03-13 11:55:17+00:00,"48.901365, 2.212693",Nanterre,92050,0.631578947368421,12
15029,Emeriau - Place de Brazzaville,OUI,51,15,36,35,1,OUI,OUI,2025-03-13 12:01:39+00:00,"48.850785261674964, 2.2871585190296173",Paris,75056,0.7058823529411765,12
18020,Francoeur - Marcadet,OUI,20,19,1,1,0,OUI,OUI,2025-03-13 12:01:24+00:00,"48.89104123261663, 2.340014585442034",Paris,75056,0.05,12
17018,Parc Monceau,OUI,18,8,10,6,4,OUI,OUI,2025-03-13 11:59:44+00:00,"48.881077914129, 2.3095492646098",Paris,75056,0.5555555555555556,12
20136,Henri Chevreau - Couronnes,OUI,26,25,1,0,1,OUI,OUI,2025-03-13 12:01:26+00:00,"48.87033205312931, 2.388777695596218",Paris,75056,0.038461538461538464,12
26001,Gare d'Asnières sur Seine,OUI,21,11,10,8,2,OUI,OUI,2025-03-13 12:00:45+00:00,"48.90636459217474, 2.2835066914558415",Asnières-sur-Seine,92004,0.47619047619047616,12
5026,Pascal - Claude Bernard,OUI,47,13,34,30,4,OUI,OUI,2025-03-13 12:01:42+00:00,"48.839061952159746, 2.3499782010912895",Paris,75056,0.723404255319149,12
7004,Raspail - Varenne,OUI,16,12,4,3,1,OUI,OUI,2025-03-13 12:01:36+00:00,"48.853147816545, 2.3263905197382",Paris,75056,0.25,12
43006,Vignerons - Minimes,OUI,29,22,7,7,0,OUI,OUI,2025-03-13 11:57:53+00:00,"48.841486, 2.430793",Vincennes,94080,0.2413793103448276,12
42503,Vladimir Ilitch Lénine - Andrée Chedid,OUI,31,25,6,1,5,OUI,OUI,2025-03-13 11:59:31+00:00,"48.813240124373, 2.3319716067039",Gentilly,94037,0.1935483870967742,12
5002,Sommerard - Saint-Jacques,OUI,34,1,33,25,8,OUI,OUI,2025-03-13 12:00:38+00:00,"48.850310432924466, 2.345015835298588",Paris,75056,0.9705882352941176,12
2010,Uzès - Montmartre,OUI,26,2,24,13,11,OUI,OUI,2025-03-13 12:00:49+00:00,"48.870790980240706, 2.3431010171771054",Paris,75056,0.9230769230769231,12
15028,Grenelle - Dr Finlay,OUI,71,11,60,56,4,OUI,OUI,2025-03-13 12:00:58+00:00,"48.851315406715976, 2.2919502854347233",Paris,75056,0.8450704225352113,12
11114,Ledru-Rollin - Charonne,OUI,31,10,21,10,11,OUI,OUI,2025-03-13 11:59:16+00:00,"48.85345855607243, 2.3772463581947094",Paris,75056,0.6774193548387096,12
8102,Lamennais - Washington,OUI,25,2,23,10,13,OUI,OUI,2025-03-13 12:00:19+00:00,"48.87352990026496, 2.303444892168045",Paris,75056,0.92,12
7014,Saint-François-Xavier,OUI,42,9,33,20,13,OUI,OUI,2025-03-13 12:01:26+00:00,"48.85154484769, 2.3146149516106",Paris,75056,0.7857142857142857,12
14018,Porte d'Orléans,OUI,45,43,2,0,2,OUI,OUI,2025-03-13 12:01:31+00:00,"48.8227639, 2.3249313",Paris,75056,0.044444444444444446,12
10023,Gare de l'Est - Verdun,OUI,13,10,3,3,0,OUI,OUI,2025-03-13 12:00:17+00:00,"48.876156054271, 2.3609149083206",Paris,75056,0.23076923076923078,12
31702,Pierre et Marie Curie - Julien Grimau,OUI,18,17,1,0,1,OUI,OUI,2025-03-13 11:55:47+00:00,"48.870714014863225, 2.424097023904324",Bagnolet,93006,0.05555555555555555,12
14139,Pierre Larousse - Raymond Losserand,OUI,30,28,2,0,2,OUI,OUI,2025-03-13 11:58:52+00:00,"48.83059564231877, 2.3119183257222176",Paris,75056,0.06666666666666667,12
21013,Pierre Grenier - Pont de Billancourt,OUI,21,17,4,3,1,OUI,OUI,2025-03-13 11:52:40+00:00,"48.8258020742942, 2.2487989068031315",Boulogne-Billancourt,92012,0.19047619047619047,12
13102,Pitié-Salpêtrière,OUI,49,14,35,16,19,OUI,OUI,2025-03-13 12:01:21+00:00,"48.83748810318667, 2.365213818848133",Paris,75056,0.7142857142857143,12
21111,Professeur René Leriche - Général Leclerc,OUI,50,26,24,20,4,OUI,OUI,2025-03-13 12:00:45+00:00,"48.90782845483013, 2.307887971401215",Clichy,92024,0.48,12
11101,Charles Delescluze,OUI,48,20,28,24,4,OUI,OUI,2025-03-13 12:00:36+00:00,"48.85242200848887, 2.380632497370243",Paris,75056,0.5833333333333334,12
5116,Place Valhubert,OUI,51,0,51,44,7,OUI,OUI,2025-03-13 11:59:38+00:00,"48.844182577315, 2.3640366643667",Paris,75056,1.0,12
14130,Jonquoy - Didot,OUI,30,27,3,0,3,OUI,OUI,2025-03-13 11:54:00+00:00,"48.82890454823947, 2.31648076325655",Paris,75056,0.1,12
7006,Quai Voltaire,OUI,32,1,31,27,4,OUI,OUI,2025-03-13 12:01:03+00:00,"48.858942986179, 2.3314182047146",Paris,75056,0.96875,12
12011,Charenton - Place du Col Bourgoin,OUI,34,21,13,12,1,OUI,OUI,2025-03-13 11:59:52+00:00,"48.844867319554, 2.3825789350545",Paris,75056,0.38235294117647056,12
8012,Batignolles - Place de Clichy,OUI,46,38,8,2,6,OUI,OUI,2025-03-13 12:00:34+00:00,"48.883474535757, 2.326493114233",Paris,75056,0.17391304347826086,12
19037,Belleville - Porte des Lilas,OUI,29,26,3,0,3,OUI,OUI,2025-03-13 11:56:05+00:00,"48.87660391892763, 2.404769691129476",Paris,75056,0.10344827586206896,12
20040,Parc de Belleville - Julien Lacroix,OUI,26,22,4,2,2,OUI,OUI,2025-03-13 11:56:31+00:00,"48.8703459, 2.3842214",Paris,75056,0.15384615384615385,12
21032,Sèvres-Gallieni,OUI,25,5,20,17,3,OUI,OUI,2025-03-13 12:01:13+00:00,"48.837809408957, 2.2281519323587",Boulogne-Billancourt,92012,0.8,12
17017,Gare de Pont-Cardinet,OUI,31,25,6,3,3,OUI,OUI,2025-03-13 12:00:03+00:00,"48.88713901475306, 2.314494143994255",Paris,75056,0.1935483870967742,12
6018,Michelet - Assas,OUI,16,5,11,2,9,OUI,OUI,2025-03-13 11:59:22+00:00,"48.842741502832, 2.3350211977959",Paris,75056,0.6875,12
34002,Capitaine Glarner - Gabriel Péri,OUI,24,18,6,3,3,OUI,OUI,2025-03-13 11:58:59+00:00,"48.902449900418745, 2.3304807533425724",Saint-Ouen-sur-Seine,93070,0.25,12
21105,Morice - Général Leclerc,OUI,25,18,7,6,1,OUI,OUI,2025-03-13 11:56:29+00:00,"48.90245471981591, 2.3128929734230046",Clichy,92024,0.28,12
13026,Place Jean Delay,OUI,33,27,6,1,5,OUI,OUI,2025-03-13 12:00:25+00:00,"48.823316, 2.354336",Paris,75056,0.18181818181818182,12
18032,Porte de Clignancourt.,OUI,55,54,1,0,1,OUI,OUI,2025-03-13 11:54:37+00:00,"48.897488, 2.343996",Paris,75056,0.01818181818181818,12
23002,Pont de Levallois-bécon,OUI,49,15,34,16,18,OUI,OUI,2025-03-13 12:01:13+00:00,"48.8984179, 2.2791311",Levallois-Perret,92044,0.6938775510204082,12
44012,Génie - Mozart,OUI,18,17,1,0,1,OUI,OUI,2025-03-13 11:55:50+00:00,"48.794902381218904, 2.3734183609485626",Vitry-sur-Seine,94081,0.05555555555555555,12
15055,Vasco de Gama,OUI,54,28,26,21,5,OUI,OUI,2025-03-13 12:01:44+00:00,"48.83671783466264, 2.283664085650799",Paris,75056,0.48148148148148145,12
17027,Place du Maréchal Juin - Péreire,OUI,44,26,18,17,1,OUI,OUI,2025-03-13 12:00:55+00:00,"48.885263, 2.298286",Paris,75056,0.4090909090909091,12
10015,Lucien Sampaix - Récollets,OUI,41,36,5,2,3,OUI,OUI,2025-03-13 12:00:55+00:00,"48.874330377560476, 2.3621229082345963",Paris,75056,0.12195121951219512,12
31016,Lucie Aubrac - Franklin,OUI,35,31,4,2,2,OUI,OUI,2025-03-13 12:01:28+00:00,"48.86223916006812, 2.4435862898826604",Montreuil,93048,0.11428571428571428,12
41207,Place du Général de Gaulle,OUI,28,15,13,1,12,OUI,OUI,2025-03-13 11:57:11+00:00,"48.8525288, 2.4877332",Fontenay-sous-Bois,94033,0.4642857142857143,12
22101,Gare Routière de Saint Cloud,OUI,29,5,24,17,7,OUI,OUI,2025-03-13 12:01:02+00:00,"48.84288183896324, 2.222245037555695",Saint-Cloud,92064,0.8275862068965517,12
21308,Bara - Henri Farman,OUI,58,9,49,31,18,OUI,OUI,2025-03-13 11:59:55+00:00,"48.833218027457846, 2.2677567601203923",Issy-les-Moulineaux,92040,0.8448275862068966,12
13016,Primo Levi - Frigos,OUI,33,1,32,23,9,OUI,OUI,2025-03-13 12:01:07+00:00,"48.83094844846017, 2.37965351592796",Paris,75056,0.9696969696969697,12
12032,Porte Dorée,OUI,35,6,29,18,11,OUI,OUI,2025-03-13 12:01:16+00:00,"48.8354337, 2.4077132",Paris,75056,0.8285714285714286,12
13043,Dunois - Clisson,OUI,50,46,4,3,1,OUI,OUI,2025-03-13 12:01:36+00:00,"48.832294, 2.3674523",Paris,75056,0.08,12
6103,Mézières - Rennes,OUI,53,44,9,5,4,OUI,OUI,2025-03-13 11:56:23+00:00,"48.85023459321703, 2.3303819820284843",Paris,75056,0.16981132075471697,12
9115,Milton - Manuel,OUI,21,19,2,0,2,OUI,OUI,2025-03-13 11:59:15+00:00,"48.878249, 2.341181",Paris,75056,0.09523809523809523,12
15038,Place Adolphe Cherioux - Vaugirard,OUI,62,51,11,3,8,OUI,OUI,2025-03-13 12:01:29+00:00,"48.83959442800459, 2.3010657727718353",Paris,75056,0.1774193548387097,12
19039,Edouard Pailleron - Simon Bolivar,OUI,23,22,1,0,1,OUI,OUI,2025-03-13 11:58:41+00:00,"48.87979886049996, 2.374839261174202",Paris,75056,0.043478260869565216,12
20021,Indre - Prairies,OUI,38,38,0,0,0,OUI,OUI,2025-03-13 11:53:21+00:00,"48.86254398506782, 2.403290458023548",Paris,75056,0.0,12
21003,Jean Jaurès - Jean Baptiste Clément,OUI,38,24,14,7,7,OUI,OUI,2025-03-13 11:57:21+00:00,"48.84576261454011, 2.2369650006294255",Boulogne-Billancourt,92012,0.3684210526315789,12
7005,Raspail - Bac,OUI,51,10,41,22,19,OUI,OUI,2025-03-13 12:01:43+00:00,"48.855628721101, 2.3256602883339",Paris,75056,0.803921568627451,12
18025,Mairie du 18ème,OUI,40,37,3,2,1,OUI,OUI,2025-03-13 11:58:47+00:00,"48.892939296937605, 2.3445510864257812",Paris,75056,0.075,12
21019,Edouard Vaillant - Paul-Adolphe Souriau,OUI,26,1,25,17,8,OUI,OUI,2025-03-13 11:59:57+00:00,"48.834845858829, 2.2479459643364",Boulogne-Billancourt,92012,0.9615384615384616,12
17122,Bridaine - Lamandé,OUI,28,26,2,0,2,OUI,OUI,2025-03-13 12:01:28+00:00,"48.8862074, 2.3206239",Paris,75056,0.07142857142857142,12
19109,Tanger - Place du Maroc,OUI,19,18,1,1,0,OUI,OUI,2025-03-13 11:55:30+00:00,"48.8862524447104, 2.3689296841621403",Paris,75056,0.05263157894736842,12
9023,Laffitte - Italiens,OUI,31,2,29,16,13,OUI,OUI,2025-03-13 11:58:39+00:00,"48.871815737396, 2.3372015478451",Paris,75056,0.9354838709677419,12
31019,Vincennes - Douy-Delcupe,OUI,37,37,0,0,0,OUI,OUI,2025-03-13 12:00:30+00:00,"48.85493692155721, 2.436049282550812",Montreuil,93048,0.0,12
16123,Mahatma Gandhi,OUI,24,2,22,17,5,OUI,OUI,2025-03-13 11:58:21+00:00,"48.876356, 2.264205",Paris,75056,0.9166666666666666,12
32014,Place du Cornillon - Stade de France,OUI,32,2,30,20,10,OUI,OUI,2025-03-13 12:01:43+00:00,"48.92540695835961, 2.3644426837563515",Saint-Denis,93066,0.9375,12
31007,Paris - Désiré Préaux,OUI,44,35,9,1,8,OUI,OUI,2025-03-13 12:01:08+00:00,"48.85742876694898, 2.4323049187660217",Montreuil,93048,0.20454545454545456,12
17124,Porte de Saint-Ouen - Henri Huchard,OUI,26,8,18,16,2,OUI,OUI,2025-03-13 11:59:04+00:00,"48.898708366365064, 2.3295360803604126",Paris,75056,0.6923076923076923,12
15108,Lourmel - Marie Skobtsov,OUI,22,15,7,3,4,OUI,OUI,2025-03-13 12:01:26+00:00,"48.844974, 2.287283",Paris,75056,0.3181818181818182,12
51003,Hôtel de Ville d'Argenteuil,OUI,29,12,17,11,6,OUI,OUI,2025-03-13 12:01:31+00:00,"48.946504, 2.2496396",Argenteuil,95018,0.5862068965517241,12
19040,Belleville - Télégraphe,OUI,40,40,0,0,0,OUI,OUI,2025-03-13 11:54:08+00:00,"48.8756045, 2.3995549",Paris,75056,0.0,12
8051,Batignolles - Rome,OUI,11,9,2,0,2,OUI,OUI,2025-03-13 12:01:05+00:00,"48.881823370566806, 2.3202589899301524",Paris,75056,0.18181818181818182,12
17046,Mac-Mahon - Brey,OUI,24,18,6,4,2,OUI,OUI,2025-03-13 11:59:45+00:00,"48.877532084130166, 2.294512536052928",Paris,75056,0.25,12
2009,Filles Saint-Thomas - Place de la Bourse,OUI,58,5,53,23,30,OUI,OUI,2025-03-13 11:59:58+00:00,"48.868899890853, 2.3397543845203",Paris,75056,0.9137931034482759,12
19009,Cité des Sciences et de l'Industrie,OUI,28,21,7,1,6,OUI,OUI,2025-03-13 12:01:02+00:00,"48.89659571178903, 2.384599149227142",Paris,75056,0.25,12
44102,Verdun - Adrien Damalix,OUI,25,14,11,7,4,OUI,OUI,2025-03-13 12:00:29+00:00,"48.8222334178559, 2.4215328320860863",Saint-Maurice,94069,0.44,12
21703,Square du Carrefour de l'Insurrection,OUI,20,16,4,1,3,OUI,OUI,2025-03-13 11:57:45+00:00,"48.820864559770676, 2.291113436222077",Vanves,92075,0.2,12
16032,Eglise d'Auteuil,OUI,20,13,7,1,6,OUI,OUI,2025-03-13 12:01:40+00:00,"48.84749841771691, 2.26848387135299",Paris,75056,0.35,12
35017,Toffier Decaux - Cartier Bresson,OUI,17,13,4,2,2,OUI,OUI,2025-03-13 11:58:07+00:00,"48.90165072551549, 2.4017545580863957",Pantin,93055,0.23529411764705882,12
22001,Château - Bineau,OUI,21,0,21,9,12,OUI,OUI,2025-03-13 12:01:36+00:00,"48.890404028589806, 2.270106375217438",Neuilly-sur-Seine,92051,1.0,12
9031,Provence - Chaussée d'Antin,OUI,25,1,24,16,8,OUI,OUI,2025-03-13 11:56:30+00:00,"48.87428447542072, 2.332976511564311",Paris,75056,0.96,12
20027,Porte de Ménilmontant,OUI,15,15,0,0,0,OUI,OUI,2025-03-13 11:58:19+00:00,"48.8691543609174, 2.40932246879487",Paris,75056,0.0,12
9117,Bellefond - Maubeuge,OUI,28,27,1,1,0,OUI,OUI,2025-03-13 12:01:20+00:00,"48.878255397645, 2.3452642187476",Paris,75056,0.03571428571428571,12
14122,Colonel Monteil - Brune,OUI,19,18,1,1,0,OUI,OUI,2025-03-13 11:56:49+00:00,"48.82650293311, 2.3092747998272",Paris,75056,0.05263157894736842,12
20023,Pelleport - Belgrand,OUI,14,14,0,0,0,OUI,OUI,2025-03-13 11:56:44+00:00,"48.86500081847653, 2.403980836377493",Paris,75056,0.0,12
17047,Courcelles - Pierre Demours,OUI,26,3,23,9,14,OUI,OUI,2025-03-13 12:01:12+00:00,"48.883769733273496, 2.29858466343129",Paris,75056,0.8846153846153846,12
6016,Danton - Serpente,OUI,21,1,20,16,4,OUI,OUI,2025-03-13 11:58:30+00:00,"48.852297362582, 2.3414132371545",Paris,75056,0.9523809523809523,12
11041,Square Saint-Ambroise,OUI,39,6,33,31,2,OUI,OUI,2025-03-13 12:01:41+00:00,"48.860934, 2.375841",Paris,75056,0.8461538461538461,12
41204,République - Danton,OUI,19,18,1,0,1,OUI,OUI,2025-03-13 11:52:05+00:00,"48.85249172181667, 2.462034523487091",Fontenay-sous-Bois,94033,0.05263157894736842,12
31703,Sadi Carnot - François Mitterrand,OUI,26,26,0,0,0,OUI,OUI,2025-03-13 11:55:54+00:00,"48.87532687671517, 2.4241617321968083",Bagnolet,93006,0.0,12
17121,Square des Epinettes,OUI,20,19,1,0,1,OUI,OUI,2025-03-13 11:58:18+00:00,"48.89383909781389, 2.325953990221024",Paris,75056,0.05,12
35003,Gabrielle Josserand - Edouard Vaillant,OUI,24,20,4,2,2,OUI,OUI,2025-03-13 12:01:40+00:00,"48.90271566255436, 2.3933270573616032",Pantin,93055,0.16666666666666666,12
18109,Pajol - Riquet,OUI,46,45,1,0,1,OUI,OUI,2025-03-13 12:01:43+00:00,"48.88960028134536, 2.3628534749150276",Paris,75056,0.021739130434782608,12
21014,Hameau Fleuri - Marché,OUI,21,2,19,8,11,OUI,OUI,2025-03-13 11:58:35+00:00,"48.831448892608314, 2.2412404417991643",Boulogne-Billancourt,92012,0.9047619047619048,12
19038,Lassus - Delouvain,OUI,19,19,0,0,0,OUI,OUI,2025-03-13 11:58:41+00:00,"48.8755044846, 2.3890327325519",Paris,75056,0.0,12
5121,Square René Viviani - Montebello,OUI,33,1,32,31,1,OUI,OUI,2025-03-13 12:01:21+00:00,"48.851904891406, 2.3478421568871",Paris,75056,0.9696969696969697,12
18029,Emile Blemont - Poteau,OUI,39,37,2,1,1,OUI,OUI,2025-03-13 12:01:25+00:00,"48.8943782, 2.3415122",Paris,75056,0.05128205128205128,12
11006,Ledru-Rollin - Place du Père Chaillet,OUI,37,19,18,15,3,OUI,OUI,2025-03-13 12:01:01+00:00,"48.856433706943704, 2.379020587761426",Paris,75056,0.4864864864864865,12
20118,Orteaux - Mouraud,OUI,24,22,2,0,2,OUI,OUI,2025-03-13 11:52:47+00:00,"48.85558642847872, 2.408762907764669",Paris,75056,0.08333333333333333,12
1120,Lavandieres Sainte Opportune - Rivoli,OUI,23,5,18,17,1,OUI,OUI,2025-03-13 11:59:56+00:00,"48.859279702476, 2.3466217517853",Paris,75056,0.782608695652174,12
16021,François Ponsard - La Muette,OUI,23,20,3,1,2,OUI,OUI,2025-03-13 11:58:35+00:00,"48.8583666, 2.2744515",Paris,75056,0.13043478260869565,12
14112,Méchain - Faubourg Saint-Jacques,OUI,15,11,4,1,3,OUI,OUI,2025-03-13 12:00:50+00:00,"48.83586772099485, 2.33798034198275",Paris,75056,0.26666666666666666,12
14002,Edgar Quinet - Raspail,OUI,44,40,4,0,4,OUI,OUI,2025-03-13 11:59:19+00:00,"48.83940266673835, 2.32971478253603",Paris,75056,0.09090909090909091,12
9026,Jean-Baptiste Pigalle - La Bruyere,OUI,16,11,5,3,2,OUI,OUI,2025-03-13 11:58:00+00:00,"48.87939826447722, 2.333709173337285",Paris,75056,0.3125,12
15035,Place Etienne Pernet,OUI,42,15,27,25,2,OUI,OUI,2025-03-13 12:00:59+00:00,"48.84243457133779, 2.2921819612383847",Paris,75056,0.6428571428571429,12
18033,Belliard - Damrémont,OUI,34,33,1,1,0,OUI,OUI,2025-03-13 11:53:51+00:00,"48.89669238777841, 2.338023450388167",Paris,75056,0.029411764705882353,12
18049,Porte d'Aubervilliers,OUI,53,42,11,7,4,OUI,OUI,2025-03-13 12:01:41+00:00,"48.89859661942376, 2.3689722642302513",Paris,75056,0.20754716981132076,12
16122,Route de la Muette - Porte de Neuilly,OUI,49,45,4,2,2,OUI,OUI,2025-03-13 12:01:16+00:00,"48.8798926, 2.2587671",Paris,75056,0.08163265306122448,12
10020,Chabrol - d'Hauteville,OUI,11,2,9,2,7,OUI,OUI,2025-03-13 12:01:26+00:00,"48.877018388033, 2.3513179644942",Paris,75056,0.8181818181818182,12
21310,Kléber - Gouverneur Général Eboué,OUI,22,1,21,15,6,OUI,OUI,2025-03-13 11:57:14+00:00,"48.826885843069796, 2.2723413258790965",Issy-les-Moulineaux,92040,0.9545454545454546,12
18113,Lepic - Armée d'Orient,OUI,24,22,2,0,2,OUI,OUI,2025-03-13 11:53:53+00:00,"48.887536403814, 2.3343077301979",Paris,75056,0.08333333333333333,12
20016,Pyrénées - Maraîchers,OUI,32,31,1,1,0,OUI,OUI,2025-03-13 11:55:12+00:00,"48.85714001395299, 2.4043509364128113",Paris,75056,0.03125,12
15031,Théâtre - Lourmel,OUI,52,11,41,39,2,OUI,OUI,2025-03-13 11:59:34+00:00,"48.8482070397636, 2.2898658737540245",Paris,75056,0.7884615384615384,12
10010,Place Jacques Bonsergent,OUI,33,9,24,19,5,OUI,OUI,2025-03-13 12:01:20+00:00,"48.870948218595, 2.3612049221992",Paris,75056,0.7272727272727273,12
47005,Ecole Vétérinaire,OUI,35,19,16,13,3,OUI,OUI,2025-03-13 12:01:17+00:00,"48.81488859822486, 2.4224362157778994",Maisons-Alfort,94046,0.45714285714285713,12
16027,Mozart - Jasmin,OUI,62,59,3,1,2,OUI,OUI,2025-03-13 11:59:10+00:00,"48.85286124871689, 2.268483570651513",Paris,75056,0.04838709677419355,12
19127,Aubervilliers - Curial,OUI,23,21,2,0,2,OUI,OUI,2025-03-13 11:59:56+00:00,"48.89088305227546, 2.3688579350709915",Paris,75056,0.08695652173913043,12
16029,Maison de Radio - France,OUI,41,0,41,37,4,OUI,OUI,2025-03-13 12:01:38+00:00,"48.85132886434057, 2.277785539627075",Paris,75056,1.0,12
16015,Bassano -  Iéna,OUI,15,0,15,3,12,OUI,OUI,2025-03-13 12:01:36+00:00,"48.868144510482075, 2.296149600985935",Paris,75056,1.0,12
9017,Lallier - Trudaine,OUI,28,21,7,3,4,OUI,OUI,2025-03-13 12:01:25+00:00,"48.88109246617963, 2.3408224806189537",Paris,75056,0.25,12
15070,Balard - Montagne de la Fage,OUI,35,2,33,28,5,OUI,OUI,2025-03-13 12:01:07+00:00,"48.83850740333351, 2.2782871127128606",Paris,75056,0.9428571428571428,12
18008,Square Léon,OUI,33,32,1,0,1,OUI,OUI,2025-03-13 11:57:55+00:00,"48.88667396788626, 2.353205569088459",Paris,75056,0.030303030303030304,12
47004,Stade Auguste Delaune,OUI,21,3,18,18,0,OUI,OUI,2025-03-13 12:01:11+00:00,"48.80896378683884, 2.4345204234123234",Maisons-Alfort,94046,0.8571428571428571,12
7008,Villersexel - Saint-Germain,OUI,16,1,15,9,6,OUI,OUI,2025-03-13 11:58:30+00:00,"48.858297001218, 2.3237934708595",Paris,75056,0.9375,12
21001,Transvaal - Charles de Gaulle,OUI,27,12,15,6,9,OUI,OUI,2025-03-13 11:57:49+00:00,"48.848280403628806, 2.2373420120857195",Boulogne-Billancourt,92012,0.5555555555555556,12
16112,Chernoviz - Raynouard,OUI,36,33,3,1,2,OUI,OUI,2025-03-13 12:00:14+00:00,"48.8569864146289, 2.282173218142987",Paris,75056,0.08333333333333333,12
11010,Boulets - Faubourg Saint-Antoine,OUI,42,39,3,2,1,OUI,OUI,2025-03-13 12:00:05+00:00,"48.849259262115, 2.3917546141943",Paris,75056,0.07142857142857142,12
42703,Fontainebleau - Edmond Michelet,OUI,45,42,3,1,2,OUI,OUI,2025-03-13 11:58:01+00:00,"48.80956436844049, 2.3626908659935",Le Kremlin-Bicêtre,94043,0.06666666666666667,12
15002,Maine - Antoine Bourdelle,OUI,17,11,6,4,2,OUI,OUI,2025-03-13 12:00:09+00:00,"48.84308531746595, 2.320263946784738",Paris,75056,0.35294117647058826,12
20201,Eugène Reisz - Davout,OUI,20,19,1,0,1,OUI,OUI,2025-03-13 11:54:07+00:00,"48.85631874632638, 2.410396970808506",Paris,75056,0.05,12
23007,Président Wilson - Jean Jaures,OUI,25,17,8,5,3,OUI,OUI,2025-03-13 11:59:49+00:00,"48.89034054052266, 2.2920683026313786",Levallois-Perret,92044,0.32,12
13046,Eugène Oudiné - Dessous Des Berges,OUI,44,17,27,16,11,OUI,OUI,2025-03-13 12:00:46+00:00,"48.8256423, 2.3750226",Paris,75056,0.6136363636363636,12
32015,Gare RER de Saint-Denis,OUI,36,28,8,7,1,OUI,OUI,2025-03-13 11:59:22+00:00,"48.93554324248177, 2.3471488058567047",Saint-Denis,93066,0.2222222222222222,12
22102,Mont Valérien - Michel Salles,OUI,24,10,14,11,3,OUI,OUI,2025-03-13 11:58:46+00:00,"48.8561915, 2.2152966",Saint-Cloud,92064,0.5833333333333334,12
16043,Place de Passy,OUI,12,12,0,0,0,OUI,OUI,2025-03-13 12:00:27+00:00,"48.85780291711202, 2.277500546942199",Paris,75056,0.0,12
15003,Gare Montparnasse - Vaugirard,OUI,66,58,8,3,5,OUI,OUI,2025-03-13 11:58:11+00:00,"48.8418071798797, 2.31951002690117",Paris,75056,0.12121212121212122,12
20116,Haies - Réunion,OUI,20,18,2,0,2,OUI,OUI,2025-03-13 11:55:14+00:00,"48.85386896766491, 2.402426162238911",Paris,75056,0.1,12
17022,Pereire - Place de Wagram,OUI,45,42,3,2,1,OUI,OUI,2025-03-13 11:59:52+00:00,"48.887070607581215, 2.304111124531457",Paris,75056,0.06666666666666667,12
42004,Westermeyer - Paul Vaillant-Couturier,OUI,27,5,22,21,1,OUI,OUI,2025-03-13 12:01:24+00:00,"48.819116181578764, 2.3966637253761296",Ivry-sur-Seine,94041,0.8148148148148148,12
10036,Aqueduc - Villette,OUI,24,22,2,0,2,OUI,OUI,2025-03-13 11:54:56+00:00,"48.883886063895, 2.367198803315",Paris,75056,0.08333333333333333,12
6107,Place Alphonse Deville,OUI,22,3,19,11,8,OUI,OUI,2025-03-13 12:00:27+00:00,"48.850188262662, 2.3275961726904",Paris,75056,0.8636363636363636,12
23304,Mairie de Sceaux,OUI,33,30,3,1,2,OUI,OUI,2025-03-13 12:00:20+00:00,"48.778916905132, 2.2887361764861",Sceaux,92071,0.09090909090909091,12
8019,Naples - Rome,OUI,25,25,0,0,0,OUI,OUI,2025-03-13 11:57:11+00:00,"48.879960700846226, 2.321358695626259",Paris,75056,0.0,12
18017,Caulaincourt - Place Constantin Pecqueur,OUI,42,39,3,0,3,OUI,OUI,2025-03-13 11:58:57+00:00,"48.889677905028, 2.3381787144261",Paris,75056,0.07142857142857142,12
14030,Pernety - Raymond Losserand,OUI,32,29,3,0,3,OUI,OUI,2025-03-13 11:59:29+00:00,"48.834254627953, 2.317609339387",Paris,75056,0.09375,12
19041,Belleville - Pyrénées,OUI,38,37,1,0,1,OUI,OUI,2025-03-13 11:58:19+00:00,"48.8741908, 2.3860039",Paris,75056,0.02631578947368421,12
4110,Neuve Saint-Pierre - Beautreillis,OUI,19,7,12,6,6,OUI,OUI,2025-03-13 12:00:48+00:00,"48.85355351439652, 2.3639122769236565",Paris,75056,0.631578947368421,12
1117,Pont Neuf - Rivoli,OUI,24,8,16,12,4,OUI,OUI,2025-03-13 12:01:30+00:00,"48.860089892617, 2.344057559967",Paris,75056,0.6666666666666666,12
6032,Sabot - Rennes,OUI,26,4,22,19,3,OUI,OUI,2025-03-13 12:00:31+00:00,"48.852575112948415, 2.331552766263485",Paris,75056,0.8461538461538461,12
23903,Stade Gaston Bouillant,OUI,29,23,6,3,3,OUI,OUI,2025-03-13 11:59:21+00:00,"48.939958667023, 2.3279571813836",Villeneuve-la-Garenne,92078,0.20689655172413793,12
7020,Champ de Mars - Cler,OUI,39,11,28,25,3,OUI,OUI,2025-03-13 12:01:11+00:00,"48.856691550115315, 2.306646779179573",Paris,75056,0.717948717948718,12
13010,Place d'Italie - Vincent Auriol,OUI,40,28,12,1,11,OUI,OUI,2025-03-13 12:01:07+00:00,"48.831481874467, 2.3567550292319",Paris,75056,0.3,12
6017,Sénat - Condé,OUI,32,0,32,21,11,OUI,OUI,2025-03-13 12:01:15+00:00,"48.84954227788459, 2.337939441204071",Paris,75056,1.0,12
31704,Jeanne Hornet - Girardot,OUI,28,27,1,1,0,OUI,OUI,2025-03-13 11:58:23+00:00,"48.873802681432146, 2.427820265293122",Bagnolet,93006,0.03571428571428571,12
13103,Hôpital Pitié Salpêtrière,OUI,48,38,10,9,1,OUI,OUI,2025-03-13 12:01:40+00:00,"48.8377016, 2.3604946",Paris,75056,0.20833333333333334,12
21311,Parvis Corentin Celton,OUI,52,9,43,40,3,OUI,OUI,2025-03-13 12:01:00+00:00,"48.82747252522725, 2.2784319519996648",Issy-les-Moulineaux,92040,0.8269230769230769,12
12161,Diderot - Reuilly,OUI,44,11,33,32,1,OUI,OUI,2025-03-13 11:59:36+00:00,"48.847208456061, 2.3861273378134",Paris,75056,0.75,12
4013,Vieille du Temple - Francs Bourgeois,OUI,28,1,27,21,6,OUI,OUI,2025-03-13 12:00:08+00:00,"48.858256413365815, 2.35821794718504",Paris,75056,0.9642857142857143,12
15107,Palais des Sports,OUI,20,2,18,18,0,OUI,OUI,2025-03-13 12:01:38+00:00,"48.833468517426, 2.2858720645308",Paris,75056,0.9,12
45001,Hôtel de Ville de Champigny sur Marne,OUI,21,1,20,9,11,OUI,OUI,2025-03-13 12:01:31+00:00,"48.813810628405, 2.5096759200096",Champigny-sur-Marne,94017,0.9523809523809523,12
9101,Cadet - La Fayette,OUI,18,7,11,7,4,OUI,OUI,2025-03-13 11:58:46+00:00,"48.875601632672, 2.3435704037547",Paris,75056,0.6111111111111112,12
9118,Faubourg Poissonniere - Delta,OUI,36,35,1,0,1,OUI,OUI,2025-03-13 12:00:58+00:00,"48.882555807626765, 2.3497482016682625",Paris,75056,0.027777777777777776,12
11043,Place Pasdeloup,OUI,20,0,20,15,5,OUI,OUI,2025-03-13 12:01:40+00:00,"48.862654215631, 2.3670325062844",Paris,75056,1.0,12
21024,Billancourt - Général Leclerc,OUI,22,12,10,5,5,OUI,OUI,2025-03-13 12:00:53+00:00,"48.8322649, 2.2380413",Boulogne-Billancourt,92012,0.45454545454545453,12
32603,Calmette,OUI,31,29,2,1,1,OUI,OUI,2025-03-13 12:01:33+00:00,"48.88104925098552, 2.424993216991425",Les Lilas,93045,0.06451612903225806,12
2001,Greneta - Sebastopol,OUI,32,3,29,23,6,OUI,OUI,2025-03-13 11:58:15+00:00,"48.865242333228, 2.3516669869423",Paris,75056,0.90625,12
17201,Porte Maillot - Perreire,OUI,50,36,14,6,8,OUI,OUI,2025-03-13 11:54:38+00:00,"48.878021154637, 2.2842371277102",Paris,75056,0.28,12
19023,Manin - Simon Bolivar,OUI,24,21,3,0,3,OUI,OUI,2025-03-13 11:55:00+00:00,"48.876499654127, 2.3794073625991",Paris,75056,0.125,12
15059,Parc André Citroën,OUI,64,8,56,53,3,OUI,OUI,2025-03-13 12:01:41+00:00,"48.840639944296655, 2.2780618071556096",Paris,75056,0.875,12
20019,Place du Maquis du Vercors,OUI,30,30,0,0,0,OUI,OUI,2025-03-13 11:52:43+00:00,"48.877321579493575, 2.4083782732486725",Paris,75056,0.0,12
23403,Chateau,OUI,21,18,3,2,1,OUI,OUI,2025-03-13 11:59:46+00:00,"48.774661399959, 2.3135878035462",Bourg-la-Reine,92014,0.14285714285714285,12
18137,Poissonniers - Nord,OUI,28,27,1,1,0,OUI,OUI,2025-03-13 12:01:20+00:00,"48.892511213520656, 2.3522228747606277",Paris,75056,0.03571428571428571,12
31023,Place François Mitterand,OUI,34,33,1,0,1,OUI,OUI,2025-03-13 11:59:05+00:00,"48.86492782016328, 2.442958317697048",Montreuil,93048,0.029411764705882353,12
18138,Station Paris Basketball - Ney - Charles Hermite,OUI,20,12,8,6,2,OUI,OUI,2025-03-13 11:59:40+00:00,"48.898748039775, 2.3645754531026",Paris,75056,0.4,12
10163,Gare du Nord - Demarquay,OUI,28,25,3,1,2,OUI,OUI,2025-03-13 11:58:28+00:00,"48.881154, 2.358411",Paris,75056,0.10714285714285714,12
13041,Porte d'Ivry,OUI,50,42,8,6,2,OUI,OUI,2025-03-13 12:01:41+00:00,"48.821768747596, 2.3688706755638",Paris,75056,0.16,12
7101,Raspail - Chomel,OUI,49,15,34,24,10,OUI,OUI,2025-03-13 12:01:18+00:00,"48.852233164303, 2.3266580700874",Paris,75056,0.6938775510204082,12
7016,Surcouf - Université,OUI,55,10,45,37,8,OUI,OUI,2025-03-13 12:01:09+00:00,"48.861273016278, 2.3094535509142",Paris,75056,0.8181818181818182,12
8056,Beaujon - Wagram,OUI,28,25,3,2,1,OUI,OUI,2025-03-13 12:00:53+00:00,"48.875352455985, 2.2964416444302",Paris,75056,0.10714285714285714,12
12041,Bois de Vincennes.,OUI,58,38,20,7,13,OUI,OUI,2025-03-13 12:00:55+00:00,"48.8338064, 2.4132221",Saint-Mandé,94067,0.3448275862068966,12
17116,Reims - Porte d'Asnières,OUI,26,12,14,7,7,OUI,OUI,2025-03-13 12:01:33+00:00,"48.891834448210986, 2.300144659954865",Paris,75056,0.5384615384615384,12
14006,Saint-Jacques - Tombe Issoire,OUI,20,17,3,1,2,OUI,OUI,2025-03-13 11:58:39+00:00,"48.833206330538864, 2.3369108140468597",Paris,75056,0.15,12
4011,Hôtel de Ville - Pont-Marie,OUI,33,4,29,26,3,OUI,OUI,2025-03-13 12:01:17+00:00,"48.853899645527, 2.3569472506642",Paris,75056,0.8787878787878788,12
31013,Centenaire - Sorins,OUI,42,40,2,0,2,OUI,OUI,2025-03-13 11:55:39+00:00,"48.85853523359734, 2.4273508787155156",Montreuil,93048,0.047619047619047616,12
12108,Bercy.,OUI,64,5,59,46,13,OUI,OUI,2025-03-13 11:59:41+00:00,"48.839966914994, 2.3788625746965",Paris,75056,0.921875,12
20202,Dupont de l'Eure - Gambetta,OUI,29,29,0,0,0,OUI,OUI,2025-03-13 11:54:53+00:00,"48.8679385, 2.4003649",Paris,75056,0.0,12
7013,Duroc - Place de Breteuil,OUI,46,23,23,20,3,OUI,OUI,2025-03-13 11:59:07+00:00,"48.847460641142, 2.3126140236855",Paris,75056,0.5,12
21114,Gustave Eiffel - Parc des Impressionnistes,OUI,30,27,3,1,2,OUI,OUI,2025-03-13 11:55:51+00:00,"48.90390619651018, 2.2946908324956894",Clichy,92024,0.1,12
9012,Rougemont - Poissonnière,OUI,30,7,23,17,6,OUI,OUI,2025-03-13 12:01:09+00:00,"48.871611569354755, 2.345873080193996",Paris,75056,0.7666666666666667,12
32018,Franciade - Gabriel Péri,OUI,25,15,10,8,2,OUI,OUI,2025-03-13 12:00:49+00:00,"48.93261499331498, 2.355954498052597",Saint-Denis,93066,0.4,12
41206,Place des Larris,OUI,34,29,5,1,4,OUI,OUI,2025-03-13 11:57:51+00:00,"48.8568363, 2.4780236",Fontenay-sous-Bois,94033,0.14705882352941177,12
17016,Brochant - Square des Batignolles,OUI,31,27,4,2,2,OUI,OUI,2025-03-13 11:57:59+00:00,"48.88818698581028, 2.316861143151153",Paris,75056,0.12903225806451613,12
19031,Manin - Crimée,OUI,21,21,0,0,0,OUI,OUI,2025-03-13 11:56:33+00:00,"48.8831217743719, 2.3863670602440834",Paris,75056,0.0,12
18019,Square Raymond Souplex,OUI,51,50,1,0,1,OUI,OUI,2025-03-13 11:58:17+00:00,"48.89183721478911, 2.335426103165901",Paris,75056,0.0196078431372549,12
13114,Nationale - Marcel Duchamp,OUI,23,14,9,8,1,OUI,OUI,2025-03-13 11:53:30+00:00,"48.82463749337136, 2.3678014799952507",Paris,75056,0.391304347826087,12
11003,Keller - La Roquette,OUI,34,22,12,11,1,OUI,OUI,2025-03-13 11:59:02+00:00,"48.8555508, 2.3752778",Paris,75056,0.35294117647058826,12
20017,Saint-Blaise - Mouraud,OUI,27,26,1,0,1,OUI,OUI,2025-03-13 12:00:25+00:00,"48.85696177597818, 2.40869477391243",Paris,75056,0.037037037037037035,12
11034,Parmentier - Fontaine au Roi,OUI,45,40,5,3,2,OUI,OUI,2025-03-13 12:01:11+00:00,"48.86787670551736, 2.372705978671471",Paris,75056,0.1111111111111111,12
23008,Hôtel de Ville de Levallois Perret,OUI,26,11,15,9,6,OUI,OUI,2025-03-13 11:59:01+00:00,"48.89314451997415, 2.2888818383216862",Levallois-Perret,92044,0.5769230769230769,12
15020,Mairie du 15ème,OUI,30,23,7,5,2,OUI,OUI,2025-03-13 12:01:06+00:00,"48.8417762, 2.2986539",Paris,75056,0.23333333333333334,12
6014,Pont de Lodi - Dauphine,OUI,21,1,20,9,11,OUI,OUI,2025-03-13 12:00:46+00:00,"48.855296898603285, 2.339947307565249",Paris,75056,0.9523809523809523,12
13113,Vistule - Choisy,OUI,33,32,1,1,0,OUI,OUI,2025-03-13 11:53:13+00:00,"48.82365543660611, 2.3615723848342896",Paris,75056,0.030303030303030304,12
31018,Gambetta - Michelet,OUI,30,25,5,1,4,OUI,OUI,2025-03-13 12:00:57+00:00,"48.85273792380526, 2.429966032505036",Montreuil,93048,0.16666666666666666,12
15061,Square Desnouettes,OUI,21,5,16,13,3,OUI,OUI,2025-03-13 11:58:34+00:00,"48.83476837934194, 2.284142297394666",Paris,75056,0.7619047619047619,12
2110,Jeûneurs - Mulhouse,OUI,27,13,14,8,6,OUI,OUI,2025-03-13 12:00:46+00:00,"48.868997, 2.346925",Paris,75056,0.5185185185185185,12
11019,Charonne - Philippe-Auguste,OUI,31,29,2,1,1,OUI,OUI,2025-03-13 11:58:02+00:00,"48.855603162026, 2.39054639062",Paris,75056,0.06451612903225806,12
7026,Place de Finlande,OUI,24,3,21,18,3,OUI,OUI,2025-03-13 12:01:34+00:00,"48.862408335967, 2.3113624379039",Paris,75056,0.875,12
8015,Roquépine - Malesherbes,OUI,50,2,48,23,25,OUI,OUI,2025-03-13 11:59:35+00:00,"48.87345073390807, 2.320404499769211",Paris,75056,0.96,12
5019,Poissy - Saint-Germain,OUI,24,2,22,18,4,OUI,OUI,2025-03-13 11:57:57+00:00,"48.84969649427, 2.3529685288668",Paris,75056,0.9166666666666666,12
21108,Mairie de Clichy,OUI,44,43,1,1,0,OUI,OUI,2025-03-13 12:01:04+00:00,"48.903653634661, 2.3059353232384",Clichy,92024,0.022727272727272728,12
11107,Faidherbe - Dahomey,OUI,40,17,23,21,2,OUI,OUI,2025-03-13 12:00:02+00:00,"48.851358329771806, 2.383823134795429",Paris,75056,0.575,12
14116,Romain Rolland,OUI,25,25,0,0,0,OUI,OUI,2025-03-13 11:59:51+00:00,"48.820215229662765, 2.3234144234418346",Montrouge,92049,0.0,12
20103,Le Vau - Maurice Bertaux,OUI,23,23,0,0,0,OUI,OUI,2025-03-13 11:53:35+00:00,"48.86803439043193, 2.411030612453627",Paris,75056,0.0,12
47002,Les Juilliottes,OUI,21,7,14,11,3,OUI,OUI,2025-03-13 11:53:56+00:00,"48.8043072, 2.4437362",Maisons-Alfort,94046,0.6666666666666666,12
2014,Daunou - Louis le Grand,OUI,30,0,30,10,20,OUI,OUI,2025-03-13 12:00:35+00:00,"48.869113, 2.332515",Paris,75056,1.0,12
33005,République - Henri Barbusse,OUI,31,17,14,10,4,OUI,OUI,2025-03-13 12:00:47+00:00,"48.90661553626751, 2.389432489871979",Aubervilliers,93001,0.45161290322580644,12
3101,Porte Saint-Martin,OUI,31,1,30,20,10,OUI,OUI,2025-03-13 12:00:55+00:00,"48.86860172112996, 2.35570102930069",Paris,75056,0.967741935483871,12
1016,Thérèse - Opéra,OUI,24,0,24,16,8,OUI,OUI,2025-03-13 11:57:53+00:00,"48.866483514509, 2.3344334212238",Paris,75056,1.0,12
11048,Place Mireille Havet,OUI,42,12,30,24,6,OUI,OUI,2025-03-13 11:59:40+00:00,"48.850533, 2.383756",Paris,75056,0.7142857142857143,12
17033,Carnot - Général Lanrezac,OUI,29,26,3,2,1,OUI,OUI,2025-03-13 12:01:23+00:00,"48.875443870736, 2.2938242935036",Paris,75056,0.10344827586206896,12
2101,Bachaumont - Montmartre,OUI,33,4,29,26,3,OUI,OUI,2025-03-13 12:01:18+00:00,"48.86617395079137, 2.3449775576591496",Paris,75056,0.8787878787878788,12
14007,Ferrus - Saint-Jacques,OUI,33,29,4,2,2,OUI,OUI,2025-03-13 11:59:23+00:00,"48.8313878, 2.3408563",Paris,75056,0.12121212121212122,12
8049,Georges V - François 1er,OUI,20,8,12,3,9,OUI,OUI,2025-03-13 12:01:27+00:00,"48.87034, 2.30082",Paris,75056,0.6,12
10164,Claude Vellefaux - Sambre et Meuse,OUI,32,31,1,1,0,OUI,OUI,2025-03-13 12:00:32+00:00,"48.875022, 2.370478",Paris,75056,0.03125,12
12154,Square Georges Melies,OUI,38,24,14,8,6,OUI,OUI,2025-03-13 12:01:41+00:00,"48.84070239213081, 2.409667745232582",Paris,75056,0.3684210526315789,12
9113,Bleue - Trévise,OUI,27,14,13,6,7,OUI,OUI,2025-03-13 12:00:42+00:00,"48.87578906564573, 2.347289621829987",Paris,75056,0.48148148148148145,12
19021,Mairie du 19ème,OUI,24,24,0,0,0,OUI,OUI,2025-03-13 11:59:19+00:00,"48.88256264247959, 2.3812624812126164",Paris,75056,0.0,12
4109,Mornay - Sully,OUI,13,9,4,1,3,OUI,OUI,2025-03-13 11:59:35+00:00,"48.84970399548416, 2.364460788667202",Paris,75056,0.3076923076923077,12
17104,Jardin Marguerite Long,OUI,21,15,6,2,4,OUI,OUI,2025-03-13 11:58:52+00:00,"48.8816985773914, 2.2836575657129288",Paris,75056,0.2857142857142857,12
8105,François 1er - Lincoln,OUI,29,6,23,1,22,OUI,OUI,2025-03-13 12:01:32+00:00,"48.869517979344, 2.3024262188416",Paris,75056,0.7931034482758621,12
21004,Jean Jaurès - Reine,OUI,31,2,29,22,7,OUI,OUI,2025-03-13 12:01:11+00:00,"48.84009622558849, 2.239872515201569",Boulogne-Billancourt,92012,0.9354838709677419,12
15058,Place du Moulin de Javel,OUI,58,9,49,39,10,OUI,OUI,2025-03-13 12:00:59+00:00,"48.84021670922, 2.2716060653329",Paris,75056,0.8448275862068966,12
13022,Butte aux Cailles - Esperance,OUI,30,28,2,1,1,OUI,OUI,2025-03-13 11:57:51+00:00,"48.82758774190948, 2.3492151126265526",Paris,75056,0.06666666666666667,12
22017,Charles de Gaulle - Louis Philippe,OUI,27,17,10,6,4,OUI,OUI,2025-03-13 12:00:32+00:00,"48.881742142181, 2.2710045335353",Neuilly-sur-Seine,92051,0.37037037037037035,12
20045,Louis Ganne - Davout,OUI,30,30,0,0,0,OUI,OUI,2025-03-13 11:57:43+00:00,"48.86338720692607, 2.409725748002529",Paris,75056,0.0,12
19030,Melun - Jean Jaurès,OUI,27,23,4,3,1,OUI,OUI,2025-03-13 12:01:33+00:00,"48.8837796723475, 2.376477420330048",Paris,75056,0.14814814814814814,12
11044,Square du Bataclan,OUI,16,3,13,12,1,OUI,OUI,2025-03-13 11:59:08+00:00,"48.8633762, 2.3711327",Paris,75056,0.8125,12
22002,Argenson - Château,OUI,24,7,17,11,6,OUI,OUI,2025-03-13 11:59:48+00:00,"48.888559314669514, 2.2642001509666447",Neuilly-sur-Seine,92051,0.7083333333333334,12
5030,Sorbonne - Ecoles,OUI,47,3,44,15,29,OUI,OUI,2025-03-13 12:01:37+00:00,"48.849686566191, 2.3434996604919",Paris,75056,0.9361702127659575,12
35008,Place de l'Eglise - Pantin,OUI,28,27,1,0,1,OUI,OUI,2025-03-13 12:00:32+00:00,"48.892809461520265, 2.4124351143836975",Pantin,93055,0.03571428571428571,12
16041,Versailles - Claude Terrasse,OUI,45,19,26,23,3,OUI,OUI,2025-03-13 12:01:27+00:00,"48.840219338074, 2.263834191153",Paris,75056,0.5777777777777777,12
13019,Fernand Braudel - Vincent Auriol,OUI,36,9,27,19,8,OUI,OUI,2025-03-13 12:00:53+00:00,"48.83637852318147, 2.3723404482007027",Paris,75056,0.75,12
21952,Place Tony de Graaff,OUI,42,22,20,19,1,OUI,OUI,2025-03-13 12:01:05+00:00,"48.8181645, 2.2458109",Meudon,92048,0.47619047619047616,12
8029,Place du Canada,OUI,56,4,52,25,27,OUI,OUI,2025-03-13 12:00:48+00:00,"48.865346269363, 2.3101937879648",Paris,75056,0.9285714285714286,12
9015,Lamartine - Faubourg Montmartre,OUI,30,5,25,14,11,OUI,OUI,2025-03-13 12:00:50+00:00,"48.876613982891, 2.3397656902671",Paris,75056,0.8333333333333334,12
12153,Terroirs de France - Lheureux,OUI,55,14,41,20,21,OUI,OUI,2025-03-13 12:01:22+00:00,"48.83212027074841, 2.388618104159832",Paris,75056,0.7454545454545455,12
11110,Roquette - Folie Regnault,OUI,50,47,3,0,3,OUI,OUI,2025-03-13 11:58:59+00:00,"48.859246959155485, 2.386553623578705",Paris,75056,0.06,12
17005,Brochant - Clichy,OUI,52,52,0,0,0,OUI,OUI,2025-03-13 11:55:12+00:00,"48.89032998912038, 2.319730559929781",Paris,75056,0.0,12
16031,Vignes - Boulainvilliers,OUI,19,16,3,1,2,OUI,OUI,2025-03-13 11:54:51+00:00,"48.856399483950504, 2.275240458548069",Paris,75056,0.15789473684210525,12
21017,Place Marcel Sembat,OUI,55,1,54,45,9,OUI,OUI,2025-03-13 12:01:44+00:00,"48.83328865030686, 2.2441747784614567",Boulogne-Billancourt,92012,0.9818181818181818,12
14127,Odessa - Départ,OUI,39,27,12,6,6,OUI,OUI,2025-03-13 12:01:36+00:00,"48.842885590081, 2.3244281485677",Paris,75056,0.3076923076923077,12
14016,René Coty - Parc Montsouris,OUI,54,54,0,0,0,OUI,OUI,2025-03-13 11:51:57+00:00,"48.82479134498032, 2.336124926805496",Paris,75056,0.0,12
12120,Lac Daumesnil - Saint-Maurice,OUI,49,37,12,9,3,OUI,OUI,2025-03-13 11:59:49+00:00,"48.82774555743318, 2.4183654785156246",Paris,75056,0.24489795918367346,12
12033,François Truffaut - Saint Emilion,OUI,66,18,48,42,6,OUI,OUI,2025-03-13 12:00:55+00:00,"48.83372354344807, 2.386601903271428",Paris,75056,0.7272727272727273,12
18142,Jessaint - Marx Dormoy,OUI,30,29,1,0,1,OUI,OUI,2025-03-13 11:55:55+00:00,"48.88484543106364, 2.358930408954621",Paris,75056,0.03333333333333333,12
22012,Madeleine Michelis - Roule,OUI,23,15,8,5,3,OUI,OUI,2025-03-13 11:58:16+00:00,"48.88260431301364, 2.2773634269833565",Neuilly-sur-Seine,92051,0.34782608695652173,12
18035,René Binet - Porte de Montmartre,OUI,36,26,10,2,8,OUI,OUI,2025-03-13 12:00:56+00:00,"48.89905109950848, 2.3365534096956253",Paris,75056,0.2777777777777778,12
4010,Saint-Antoine Sévigné,OUI,26,10,16,9,7,OUI,OUI,2025-03-13 12:01:42+00:00,"48.8550222, 2.3612322",Paris,75056,0.6153846153846154,12
13110,Moulin de la Pointe,OUI,20,17,3,2,1,OUI,OUI,2025-03-13 11:58:00+00:00,"48.82092946051445, 2.3563179373741145",Paris,75056,0.15,12
20117,Saint-Fargeau - Mortier,OUI,31,31,0,0,0,OUI,OUI,2025-03-13 11:57:32+00:00,"48.87266656122256, 2.407912909984589",Paris,75056,0.0,12
23105,Sèvres Rive Gauche,OUI,33,20,13,13,0,OUI,OUI,2025-03-13 11:43:50+00:00,"48.821443218278, 2.2150785306885",Sèvres,92072,0.3939393939393939,12
48009,République - Auguste Perret,OUI,30,30,0,0,0,OUI,OUI,2025-03-13 11:56:01+00:00,"48.78695280952244, 2.3518594354391094",Villejuif,94076,0.0,12
15009,Suffren - Pérignon,OUI,44,9,35,31,4,OUI,OUI,2025-03-13 12:01:21+00:00,"48.84717561492764, 2.307052147596786",Paris,75056,0.7954545454545454,12
21009,Le Corbusier - Jean Jaurès,OUI,45,17,28,17,11,OUI,OUI,2025-03-13 11:57:42+00:00,"48.83780830557548, 2.2408381104469304",Boulogne-Billancourt,92012,0.6222222222222222,12
23005,Gare de Clichy-Levallois,OUI,25,7,18,14,4,OUI,OUI,2025-03-13 12:01:41+00:00,"48.89679827481989, 2.2984680533409123",Levallois-Perret,92044,0.72,12
18114,Véron - Lepic,OUI,23,20,3,0,3,OUI,OUI,2025-03-13 11:59:50+00:00,"48.88526123395252, 2.334559857845307",Paris,75056,0.13043478260869565,12
21120,Docteur Calmette - Martre,OUI,30,16,14,13,1,OUI,OUI,2025-03-13 11:59:28+00:00,"48.898969358483, 2.3086513252383",Clichy,92024,0.4666666666666667,12
4107,Beaumarchais - Pas de la Mule,OUI,17,3,14,8,6,OUI,OUI,2025-03-13 12:01:41+00:00,"48.855580507049, 2.3684333673431",Paris,75056,0.8235294117647058,12
14125,Dareau - Broussais,OUI,21,19,2,1,1,OUI,OUI,2025-03-13 11:58:10+00:00,"48.8307758, 2.3361804",Paris,75056,0.09523809523809523,12
22403,Pierre Brossolette - Adolphe Pinard,OUI,23,20,3,0,3,OUI,OUI,2025-03-13 11:59:41+00:00,"48.821772279548, 2.3131558299065",Malakoff,92046,0.13043478260869565,12
31017,Jean Moulin - Paul Doumer,OUI,17,17,0,0,0,OUI,OUI,2025-03-13 11:55:59+00:00,"48.8622179854695, 2.45533436536789",Montreuil,93048,0.0,12
20047,Cours de Vincennes - Davout,OUI,48,41,7,4,3,OUI,OUI,2025-03-13 12:01:32+00:00,"48.847238029966, 2.4107042336225",Paris,75056,0.14583333333333334,12
13047,Boutroux - Porte de Vitry,OUI,49,28,21,19,2,OUI,OUI,2025-03-13 11:59:21+00:00,"48.822632, 2.377738",Paris,75056,0.42857142857142855,12
9013,Mairie du 9ème,OUI,24,9,15,14,1,OUI,OUI,2025-03-13 11:56:12+00:00,"48.873267137583, 2.3407534480528",Paris,75056,0.625,12
44103,Pont De Charenton,OUI,18,6,12,12,0,OUI,OUI,2025-03-13 11:51:59+00:00,"48.8179685, 2.4199531",Saint-Maurice,94069,0.6666666666666666,12
92005,Gare de Nanterre Ville,OUI,42,17,25,20,5,OUI,OUI,2025-03-13 12:00:49+00:00,"48.8950295, 2.1957932",Nanterre,92050,0.5952380952380952,12
42011,Quai Marcel Boyer - Victor Hugo,OUI,29,5,24,22,2,OUI,OUI,2025-03-13 12:00:24+00:00,"48.822556366667, 2.3920395970345",Ivry-sur-Seine,94041,0.8275862068965517,12
19113,Pré Saint-Gervais - Lilas,OUI,27,27,0,0,0,OUI,OUI,2025-03-13 11:57:11+00:00,"48.877870626988, 2.3959073424339",Paris,75056,0.0,12
21951,Place Centrale,OUI,22,21,1,1,0,OUI,OUI,2025-03-13 11:52:39+00:00,"48.78740167690531, 2.2278830409049992",Meudon,92048,0.045454545454545456,12
31101,Jules Guesde - Laennec,OUI,19,14,5,0,5,OUI,OUI,2025-03-13 11:55:41+00:00,"48.87628983900398, 2.5006942078471184",Rosny-sous-Bois,93064,0.2631578947368421,12
22103,Senard - Charles Blum,OUI,24,8,16,5,11,OUI,OUI,2025-03-13 11:59:12+00:00,"48.857315824799, 2.221091687679291",Saint-Cloud,92064,0.6666666666666666,12
31026,Demi-Lune - Aristide Briand,OUI,20,18,2,0,2,OUI,OUI,2025-03-13 11:59:25+00:00,"48.87626381919953, 2.4562818557024",Montreuil,93048,0.1,12
14128,Gergovie - Vercingétorix,OUI,29,28,1,0,1,OUI,OUI,2025-03-13 12:01:25+00:00,"48.83453413883994, 2.313154547426182",Paris,75056,0.034482758620689655,12
17001,Guy Môquet - Saint-Ouen,OUI,44,41,3,1,2,OUI,OUI,2025-03-13 11:52:42+00:00,"48.892777719023975, 2.3270335793495183",Paris,75056,0.06818181818181818,12
10039,Sambre et Meuse - Villette,OUI,24,18,6,4,2,OUI,OUI,2025-03-13 12:00:07+00:00,"48.874405666217, 2.3738072379951",Paris,75056,0.25,12
35004,Place du Président Salvador Allende,OUI,58,49,9,1,8,OUI,OUI,2025-03-13 12:01:43+00:00,"48.897307310356055, 2.40079153681279",Pantin,93055,0.15517241379310345,12
19036,Hôpital Robert Debré,OUI,33,30,3,0,3,OUI,OUI,2025-03-13 11:57:15+00:00,"48.88005222200894, 2.4008650346327003",Paris,75056,0.09090909090909091,12
8011,Clapeyron - Moscou,OUI,15,12,3,0,3,OUI,OUI,2025-03-13 12:00:42+00:00,"48.88078819514121, 2.324815057218075",Paris,75056,0.2,12
12129,Bois de Vincennes - Porte Jaune,OUI,35,32,3,2,1,OUI,OUI,2025-03-13 11:56:53+00:00,"48.838751246689455, 2.4605489149689674",Paris,75056,0.08571428571428572,12
13020,Paul Klee - Place Augusta Holmes,OUI,43,14,29,6,23,OUI,OUI,2025-03-13 11:59:29+00:00,"48.838946417408025, 2.3704235663952966",Paris,75056,0.6744186046511628,12
31707,Edouard Vaillant - Galliéni,OUI,48,45,3,0,3,OUI,OUI,2025-03-13 11:55:14+00:00,"48.858462881661, 2.4147954583168",Bagnolet,93006,0.0625,12
7010,Constantine - Université,OUI,59,10,49,39,10,OUI,OUI,2025-03-13 12:01:05+00:00,"48.860680473738, 2.3148481955842",Paris,75056,0.8305084745762712,12
19124,Alexander Fleming - Belvédère,OUI,31,30,1,1,0,OUI,OUI,2025-03-13 11:53:27+00:00,"48.88179064200294, 2.4030599377642674",Paris,75056,0.03225806451612903,12
14113,Santé - Arago,OUI,36,31,5,4,1,OUI,OUI,2025-03-13 12:01:38+00:00,"48.83507657562064, 2.3415737262044938",Paris,75056,0.1388888888888889,12
35015,Averroès - Aimé Césaire,OUI,18,13,5,4,1,OUI,OUI,2025-03-13 11:53:11+00:00,"48.91405323432864, 2.412636950612068",Pantin,93055,0.2777777777777778,12
20203,Evariste Galois,OUI,20,19,1,0,1,OUI,OUI,2025-03-13 11:55:37+00:00,"48.873341356228, 2.4133544409574",Paris,75056,0.05,12
32021,Place du Front Populaire - George Sand,OUI,64,44,20,18,2,OUI,OUI,2025-03-13 12:00:51+00:00,"48.90680713698062, 2.364541214992642",Saint-Denis,93066,0.3125,12
20004,Commandant l'Herminier - Gallieni,OUI,17,17,0,0,0,OUI,OUI,2025-03-13 11:55:21+00:00,"48.847040552603, 2.4160453677177",Paris,75056,0.0,12
15019,Paul Barruel - Vaugirard,OUI,36,32,4,3,1,OUI,OUI,2025-03-13 12:01:05+00:00,"48.84014918546239, 2.3044332861900334",Paris,75056,0.1111111111111111,12
9016,Choron - Martyrs,OUI,17,12,5,2,3,OUI,OUI,2025-03-13 11:57:19+00:00,"48.877851443503, 2.3396701365709",Paris,75056,0.29411764705882354,12
7024,Rapp - Place du Général Gouraud,OUI,29,22,7,6,1,OUI,OUI,2025-03-13 11:58:13+00:00,"48.858102885107, 2.3004072904587",Paris,75056,0.2413793103448276,12
10152,Gare du Nord - Place de Valenciennes,OUI,23,21,2,0,2,OUI,OUI,2025-03-13 12:01:02+00:00,"48.879089, 2.354235",Paris,75056,0.08695652173913043,12
12150,Bastille - Quai de la Rapée,OUI,27,1,26,20,6,OUI,OUI,2025-03-13 12:01:14+00:00,"48.84682410855, 2.3669364675879",Paris,75056,0.9629629629629629,12
10037,Quai de Valmy,OUI,25,23,2,2,0,OUI,OUI,2025-03-13 11:59:51+00:00,"48.88126951579429, 2.368186041712761",Paris,75056,0.08,12
11031,Jacquard - Ternaux,OUI,39,18,21,14,7,OUI,OUI,2025-03-13 11:58:44+00:00,"48.8646605, 2.373162",Paris,75056,0.5384615384615384,12
9036,Athènes - Clichy,OUI,18,9,9,4,5,OUI,OUI,2025-03-13 12:00:27+00:00,"48.878113787876, 2.32956021945824",Paris,75056,0.5,12
12125,Pyramide - Parc Floral,OUI,49,47,2,1,1,OUI,OUI,2025-03-13 12:00:02+00:00,"48.837442, 2.440452",Paris,75056,0.04081632653061224,12
15125,Parc Suzanne Lenglen,OUI,51,1,50,46,4,OUI,OUI,2025-03-13 12:01:20+00:00,"48.833250690537874, 2.2765403240919113",Paris,75056,0.9803921568627451,12
13515,Auguste Blanqui - Glacière,OUI,59,53,6,3,3,OUI,OUI,2025-03-13 11:59:06+00:00,"48.831151602964, 2.343822196126",Paris,75056,0.1016949152542373,12
11103,Pelée - Alphonse Baudin,OUI,35,20,15,11,4,OUI,OUI,2025-03-13 12:01:15+00:00,"48.8600265, 2.3710541",Paris,75056,0.42857142857142855,12
15131,Charles Lecocq - Lecourbe,OUI,28,20,8,8,0,OUI,OUI,2025-03-13 11:59:40+00:00,"48.84044, 2.294867",Paris,75056,0.2857142857142857,12
20039,Belleville - Couronnes,OUI,48,46,2,2,0,OUI,OUI,2025-03-13 11:56:51+00:00,"48.868831082877, 2.3809862136841",Paris,75056,0.041666666666666664,12
13117,Stade Georges Carpentier,OUI,39,29,10,5,5,OUI,OUI,2025-03-13 11:59:37+00:00,"48.820482438381, 2.3668321967125",Paris,75056,0.2564102564102564,12
10017,Gare de l'Est - Fidélité,OUI,12,4,8,5,3,OUI,OUI,2025-03-13 12:01:23+00:00,"48.874575, 2.356796",Paris,75056,0.6666666666666666,12
13027,Mazagran - Pierre de Coubertin,OUI,15,11,4,1,3,OUI,OUI,2025-03-13 11:56:09+00:00,"48.816218640260445, 2.344226874411106",Paris,75056,0.26666666666666666,12
21316,Cimetière d'Issy-les-Moulineaux,OUI,23,23,0,0,0,OUI,OUI,2025-03-13 12:01:42+00:00,"48.817699773925, 2.2609312087297",Issy-les-Moulineaux,92040,0.0,12
17029,Pierre Demours - Laugier,OUI,36,30,6,3,3,OUI,OUI,2025-03-13 12:01:04+00:00,"48.8813072, 2.294846",Paris,75056,0.16666666666666666,12
21029,Cours de l'Ile Seguin - Parc Billancourt,OUI,28,11,17,10,7,OUI,OUI,2025-03-13 12:00:13+00:00,"48.82714055843935, 2.234234511852265",Boulogne-Billancourt,92012,0.6071428571428571,12
10004,Metz - Faubourg Saint-Denis,OUI,44,12,32,22,10,OUI,OUI,2025-03-13 12:00:10+00:00,"48.870893, 2.353521",Paris,75056,0.7272727272727273,12
10153,Gare du Nord - Denain,OUI,20,15,5,0,5,OUI,OUI,2025-03-13 12:00:30+00:00,"48.879595787608, 2.3544725775719",Paris,75056,0.25,12
21118,Neuilly - Petit,OUI,14,7,7,4,3,OUI,OUI,2025-03-13 11:59:06+00:00,"48.898965361341254, 2.29627937078476",Clichy,92024,0.5,12
16003,André Maurois - Joseph et Marie Hackin,OUI,27,9,18,12,6,OUI,OUI,2025-03-13 11:58:59+00:00,"48.8778983, 2.2789591",Paris,75056,0.6666666666666666,12
21203,Place Jules Ferry,OUI,28,27,1,1,0,OUI,OUI,2025-03-13 11:56:28+00:00,"48.812107928414775, 2.325837314128876",Montrouge,92049,0.03571428571428571,12
12006,Gare de Lyon - Van Gogh,OUI,41,6,35,25,10,OUI,OUI,2025-03-13 12:00:20+00:00,"48.843839785643, 2.3704450240357",Paris,75056,0.8536585365853658,12
5034,Censier - Santeuil,OUI,66,18,48,38,10,OUI,OUI,2025-03-13 12:00:09+00:00,"48.840658921385234, 2.3537524044513702",Paris,75056,0.7272727272727273,12
16007,Longchamp - Place d'Iéna,OUI,25,5,20,5,15,OUI,OUI,2025-03-13 12:01:20+00:00,"48.864917233434, 2.2926748171449",Paris,75056,0.8,12
22013,Mairie de Neuilly sur Seine,OUI,30,26,4,3,1,OUI,OUI,2025-03-13 11:59:12+00:00,"48.88494728765838, 2.2677031159400944",Neuilly-sur-Seine,92051,0.13333333333333333,12
10110,Louis Blanc - Jemmapes,OUI,31,25,6,0,6,OUI,OUI,2025-03-13 12:01:38+00:00,"48.879330755297, 2.3684485629201",Paris,75056,0.1935483870967742,12
19025,Botzaris - Crimée,OUI,20,19,1,0,1,OUI,OUI,2025-03-13 11:59:37+00:00,"48.87959698690176, 2.3887913337477067",Paris,75056,0.05,12
21708,Marcel Yol - Jullien,OUI,29,23,6,2,4,OUI,OUI,2025-03-13 12:01:11+00:00,"48.82537611802588, 2.287235018058929",Vanves,92075,0.20689655172413793,12
16009,Saint-Didier - Raymond Poincaré,OUI,17,11,6,0,6,OUI,OUI,2025-03-13 12:01:22+00:00,"48.86642312020962, 2.285863497192411",Paris,75056,0.35294117647058826,12
13048,Wurtz - Tolbiac,OUI,28,28,0,0,0,NON,NON,2025-03-13 11:55:14+00:00,"48.82631195621, 2.344585955143",Paris,75056,0.0,12
15072,Place Fernand Forest,OUI,28,0,28,23,5,OUI,OUI,2025-03-13 12:00:45+00:00,"48.849269143836, 2.281863167882",Paris,75056,1.0,12
41210,Hôtel de ville de Fontenay-sous-Bois,OUI,19,17,2,0,2,OUI,OUI,2025-03-13 11:52:57+00:00,"48.84949749106274, 2.4750164151191716",Fontenay-sous-Bois,94033,0.10526315789473684,12
16014,Eylau - Trocadéro,OUI,22,12,10,1,9,OUI,OUI,2025-03-13 12:00:37+00:00,"48.863354122371, 2.2864209115505",Paris,75056,0.45454545454545453,12
42304,Marc Sangnier - Division Leclerc,OUI,20,7,13,12,1,OUI,OUI,2025-03-13 12:01:23+00:00,"48.78599652305309, 2.329955510795116",Cachan,94016,0.65,12
21115,Chancé Milly - Cimetière Communal Sud,OUI,32,16,16,13,3,OUI,OUI,2025-03-13 11:59:09+00:00,"48.89687189382465, 2.303922325372696",Clichy,92024,0.5,12
15052,Convention - Vaugirard,OUI,44,38,6,4,2,OUI,OUI,2025-03-13 11:56:57+00:00,"48.83767682233156, 2.295586926020252",Paris,75056,0.13636363636363635,12
21702,Gare SNCF Vanves-Malakoff,OUI,49,46,3,2,1,OUI,OUI,2025-03-13 12:01:12+00:00,"48.819002163836444, 2.292150005103606",Vanves,92075,0.061224489795918366,12
31021,Résistance - Hoche,OUI,28,28,0,0,0,OUI,OUI,2025-03-13 11:54:11+00:00,"48.864273423741956, 2.435784414410591",Montreuil,93048,0.0,12
11109,Pierre Levée - Fontaine Timbaud,OUI,21,18,3,0,3,OUI,OUI,2025-03-13 11:55:42+00:00,"48.86632723374305, 2.3711163550615306",Paris,75056,0.14285714285714285,12
13039,Ivry - Simone Weil,OUI,18,12,6,5,1,OUI,OUI,2025-03-13 11:59:02+00:00,"48.823283932030755, 2.3659095168113713",Paris,75056,0.3333333333333333,12
44002,Paul Vaillant-Couturier - Gare RER,OUI,25,1,24,20,4,OUI,OUI,2025-03-13 12:00:57+00:00,"48.80108159069614, 2.402097210288048",Vitry-sur-Seine,94081,0.96,12
21030,Fessart - Château,OUI,20,4,16,15,1,OUI,OUI,2025-03-13 12:01:17+00:00,"48.84245, 2.23989",Boulogne-Billancourt,92012,0.8,12
16115,Raffet - Montmorency,OUI,40,38,2,0,2,OUI,OUI,2025-03-13 12:00:04+00:00,"48.85258670812, 2.2629252456151954",Paris,75056,0.05,12
21031,Cimetière de Boulogne-Billancourt,OUI,40,10,30,23,7,OUI,OUI,2025-03-13 11:59:25+00:00,"48.830764, 2.252024",Boulogne-Billancourt,92012,0.75,12
15123,Commerce - Letellier,OUI,44,28,16,10,6,OUI,OUI,2025-03-13 11:59:09+00:00,"48.84797660373612, 2.2966245196598805",Paris,75056,0.36363636363636365,12
16024,Ranelagh - Maison de la Radio,OUI,20,7,13,11,2,OUI,OUI,2025-03-13 12:00:15+00:00,"48.85293603169479, 2.280449643731117",Paris,75056,0.65,12
15043,Brancion - Lefebvre,OUI,9,9,0,0,0,OUI,OUI,2025-03-13 11:57:00+00:00,"48.82900222785569, 2.301431038163409",Paris,75056,0.0,12
20009,Docteurs Déjérine - Pte de Montreuil,OUI,19,17,2,2,0,OUI,OUI,2025-03-13 12:00:41+00:00,"48.85398448133697, 2.41208288897222",Paris,75056,0.10526315789473684,12
17039,Place Saint-Ferdinand,OUI,38,27,11,1,10,OUI,OUI,2025-03-13 11:56:17+00:00,"48.87815529789739, 2.288518047864942",Paris,75056,0.2894736842105263,12
42305,Vanne - Saussaies,OUI,20,19,1,0,1,OUI,OUI,2025-03-13 12:01:35+00:00,"48.786404, 2.338848",Cachan,94016,0.05,12
22604,Hôtel de Ville de Fontenay-aux-Roses,OUI,32,32,0,0,0,OUI,OUI,2025-03-13 11:52:44+00:00,"48.790844603480856, 2.2871455930319455",Fontenay-aux-Roses,92032,0.0,12
11032,Jean-Pierre Timbaud - Vaucouleurs,OUI,45,39,6,3,3,OUI,OUI,2025-03-13 12:01:13+00:00,"48.867937, 2.377885",Paris,75056,0.13333333333333333,12
8001,Petit Palais,OUI,42,3,39,20,19,OUI,OUI,2025-03-13 12:00:54+00:00,"48.8667692, 2.3157655",Paris,75056,0.9285714285714286,12
21955,Vaugirard - Verrerie,OUI,24,1,23,17,6,OUI,OUI,2025-03-13 11:58:35+00:00,"48.820881336842, 2.2367222622987",Meudon,92048,0.9583333333333334,12
21219,Amaury Duval - Gabriel Péri,OUI,36,36,0,0,0,OUI,OUI,2025-03-13 11:54:26+00:00,"48.81718759671675, 2.323841750621796",Montrouge,92049,0.0,12
16101,Malakoff - Place de la Porte Maillot,OUI,26,16,10,1,9,OUI,OUI,2025-03-13 11:54:34+00:00,"48.876733496638, 2.2834577411413",Paris,75056,0.38461538461538464,12
13011,Hôpital - Campo-Formio,OUI,11,9,2,0,2,OUI,OUI,2025-03-13 12:01:44+00:00,"48.835405, 2.358218",Paris,75056,0.18181818181818182,12
13121,Bruneseau - Quai d'Ivry,OUI,46,0,46,41,5,OUI,OUI,2025-03-13 12:01:28+00:00,"48.824945637583, 2.3885661363602",Ivry-sur-Seine,94041,1.0,12
20007,Buzenval - Avron,OUI,49,46,3,1,2,OUI,OUI,2025-03-13 12:01:41+00:00,"48.851617204999, 2.4015135973077",Paris,75056,0.061224489795918366,12
21307,Victor Cresson - Telles de la Poterie,OUI,29,16,13,9,4,OUI,OUI,2025-03-13 12:01:10+00:00,"48.822698842979, 2.2686498274964",Issy-les-Moulineaux,92040,0.4482758620689655,12
13033,Porte d'Italie,OUI,13,10,3,1,2,OUI,OUI,2025-03-13 11:54:09+00:00,"48.817161987718954, 2.360236309468746",Paris,75056,0.23076923076923078,12
10012,Vinaigriers - Magenta,OUI,24,11,13,9,4,OUI,OUI,2025-03-13 12:00:47+00:00,"48.8731167, 2.3593052",Paris,75056,0.5416666666666666,12
20122,Vitruve - Davout,OUI,23,22,1,0,1,OUI,OUI,2025-03-13 11:58:24+00:00,"48.86053161154489, 2.4091592812626543",Paris,75056,0.043478260869565216,12
21028,Pierre Lefaucheux - Traversière,OUI,34,11,23,15,8,OUI,OUI,2025-03-13 12:01:13+00:00,"48.82435208303827, 2.2417913004755974",Boulogne-Billancourt,92012,0.6764705882352942,12
16020,Place de la Porte de Passy,OUI,34,28,6,3,3,OUI,OUI,2025-03-13 11:59:15+00:00,"48.857341095470794, 2.2644165538827115",Paris,75056,0.17647058823529413,12
4003,Quai aux Fleurs - Pont Saint-Louis,OUI,21,8,13,13,0,OUI,OUI,2025-03-13 11:59:23+00:00,"48.852915956209, 2.3521957173944",Paris,75056,0.6190476190476191,12
14101,Gare Montparnasse - Edgar Quinet,OUI,33,25,8,4,4,OUI,OUI,2025-03-13 11:58:23+00:00,"48.841487851079, 2.3233232282801",Paris,75056,0.24242424242424243,12
10018,Square Alban Satragne,OUI,29,19,10,3,7,OUI,OUI,2025-03-13 12:01:04+00:00,"48.875388227727, 2.3559567333359",Paris,75056,0.3448275862068966,12
8020,Batignolles - Beudant,OUI,43,39,4,2,2,OUI,OUI,2025-03-13 12:01:06+00:00,"48.88216401466375, 2.319852970540523",Paris,75056,0.09302325581395349,12
32301,Mairie de Romainville,OUI,17,16,1,0,1,OUI,OUI,2025-03-13 11:54:22+00:00,"48.885109, 2.435679",Romainville,93063,0.058823529411764705,12
4001,Arcole - Notre-Dame,OUI,27,12,15,5,10,OUI,OUI,2025-03-13 12:01:30+00:00,"48.853883541328, 2.3493797332048",Paris,75056,0.5555555555555556,12
20108,Jardin de l'Hospice Debrousse,OUI,23,23,0,0,0,OUI,OUI,2025-03-13 11:52:14+00:00,"48.861451061938, 2.40568600595",Paris,75056,0.0,12
14131,Jourdan - Monticelli,OUI,30,30,0,0,0,OUI,OUI,2025-03-13 12:01:14+00:00,"48.822032, 2.329095",Paris,75056,0.0,12
31025,Paul Signac - Aristide Briand,OUI,33,31,2,0,2,OUI,OUI,2025-03-13 11:53:35+00:00,"48.86950262156371, 2.4502260982990265",Montreuil,93048,0.06060606060606061,12
17023,Porte d'Asnières,OUI,33,28,5,4,1,OUI,OUI,2025-03-13 11:59:32+00:00,"48.89035817610495, 2.3036286234855656",Paris,75056,0.15151515151515152,12
5014,Jean Calvin - Tournefort,OUI,28,18,10,9,1,OUI,OUI,2025-03-13 12:01:39+00:00,"48.84158856925782, 2.348489575088024",Paris,75056,0.35714285714285715,12
44007,Camille Groult - Guy Môquet,OUI,21,7,14,11,3,OUI,OUI,2025-03-13 11:58:50+00:00,"48.787482746521306, 2.3976725712418556",Vitry-sur-Seine,94081,0.6666666666666666,12
8549,George V - Christophe Colomb,OUI,22,2,20,6,14,OUI,OUI,2025-03-13 12:01:25+00:00,"48.87046, 2.30104",Paris,75056,0.9090909090909091,12
4002,Marché aux fleurs,OUI,20,4,16,8,8,OUI,OUI,2025-03-13 12:01:38+00:00,"48.855258115391, 2.3473754525185",Paris,75056,0.8,12
23902,Gallieni - Lycée Charles Petitet,OUI,44,22,22,17,5,OUI,OUI,2025-03-13 12:00:16+00:00,"48.927640283627, 2.3308986340524",Villeneuve-la-Garenne,92078,0.5,12
21204,Estienne d'Orves - Henri Ginoux,OUI,31,29,2,1,1,OUI,OUI,2025-03-13 11:56:51+00:00,"48.815388220397274, 2.320886790760933",Montrouge,92049,0.06451612903225806,12
42701,Charles Gide - Fort de Bicêtre,OUI,29,13,16,3,13,OUI,OUI,2025-03-13 12:01:15+00:00,"48.8071937956922, 2.353984415531159",Le Kremlin-Bicêtre,94043,0.5517241379310345,12
42209,Place de l'Europe - Quai de Bercy,OUI,15,3,12,11,1,OUI,OUI,2025-03-13 12:00:36+00:00,"48.82529858840266, 2.3945679143071175",Charenton-le-Pont,94018,0.8,12
13126,Place Nationale - Château-des-Rentiers,OUI,18,11,7,3,4,OUI,OUI,2025-03-13 12:01:27+00:00,"48.829268, 2.365212",Paris,75056,0.3888888888888889,12
43001,Paris - Laitières,OUI,22,8,14,4,10,OUI,OUI,2025-03-13 12:01:40+00:00,"48.84630274151258, 2.4207553267478947",Vincennes,94080,0.6363636363636364,12
17015,Place de Lévis,OUI,48,45,3,1,2,OUI,OUI,2025-03-13 11:58:19+00:00,"48.883546851533254, 2.3131933808326726",Paris,75056,0.0625,12
22206,Louis Pasteur - Albert Petit,OUI,30,28,2,0,2,OUI,OUI,2025-03-13 12:00:44+00:00,"48.796261, 2.317289",Bagneux,92007,0.06666666666666667,12
15023,La Motte-Picquet - Grenelle,OUI,34,9,25,22,3,OUI,OUI,2025-03-13 11:56:48+00:00,"48.84858321339195, 2.299347817897797",Paris,75056,0.7352941176470589,12
11021,Charonne - Pierre Bayle,OUI,23,23,0,0,0,OUI,OUI,2025-03-13 11:55:53+00:00,"48.858445054262, 2.3903981223891",Paris,75056,0.0,12
22501,Théâtre de La Garenne,OUI,20,14,6,1,5,OUI,OUI,2025-03-13 11:57:37+00:00,"48.905658361454, 2.2345951981176",La Garenne-Colombes,92035,0.3,12
21217,Louis Rolland - République,OUI,26,25,1,0,1,OUI,OUI,2025-03-13 11:58:27+00:00,"48.81710889740748, 2.3193106434955717",Montrouge,92049,0.038461538461538464,12
42003,Place de l'Insurrection d'Août 1944,OUI,30,1,29,29,0,OUI,OUI,2025-03-13 11:59:28+00:00,"48.81477852751594, 2.398074567317963",Ivry-sur-Seine,94041,0.9666666666666667,12
9114,Faubourg Poissonnière - Dunkerque,OUI,30,26,4,2,2,OUI,OUI,2025-03-13 12:00:55+00:00,"48.880883445404436, 2.349934279918671",Paris,75056,0.13333333333333333,12
40009,Lycée Saint Exupéry - Juliette Savar,OUI,29,19,10,8,2,OUI,OUI,2025-03-13 11:59:30+00:00,"48.783021513972, 2.4637357216879",Créteil,94028,0.3448275862068966,12
25001,Colmar - Victor Hugo,OUI,31,7,24,12,12,OUI,OUI,2025-03-13 11:54:03+00:00,"48.88652251096166, 2.173960916697979",Rueil-Malmaison,92063,0.7741935483870968,12
12043,Daumesnil - Hébrard,OUI,39,18,21,17,4,OUI,OUI,2025-03-13 12:01:31+00:00,"48.8429, 2.38474",Paris,75056,0.5384615384615384,12
44101,Place Mongolfier,OUI,37,14,23,13,10,OUI,OUI,2025-03-13 12:00:15+00:00,"48.815160030060376, 2.4592879414558415",Saint-Maurice,94069,0.6216216216216216,12
15064,Javel - André Citroën,OUI,44,3,41,36,5,OUI,OUI,2025-03-13 11:59:32+00:00,"48.846276485475, 2.2786368057132",Paris,75056,0.9318181818181818,12
23003,Président Wilson - Baudin,OUI,28,9,19,15,4,OUI,OUI,2025-03-13 12:00:56+00:00,"48.89826887103676, 2.2849336266517644",Levallois-Perret,92044,0.6785714285714286,12
14010,Jean Moulin - Place Victor et Hélène Basch,OUI,38,35,3,1,2,OUI,OUI,2025-03-13 12:01:30+00:00,"48.82764910241, 2.3261967301369",Paris,75056,0.07894736842105263,12
19108,Gaston Tessier - Rosa Parks RER,OUI,37,29,8,6,2,OUI,OUI,2025-03-13 11:58:00+00:00,"48.8963765, 2.3743692",Paris,75056,0.21621621621621623,12
22303,Lucien Lanternier - Le Luth,OUI,25,10,15,12,3,OUI,OUI,2025-03-13 12:00:16+00:00,"48.93159430558871, 2.2889783978462224",Gennevilliers,92036,0.6,12
10105,Mazagran - Bonne Nouvelle,OUI,25,10,15,9,6,OUI,OUI,2025-03-13 11:59:13+00:00,"48.870047123655, 2.3511248454452",Paris,75056,0.6,12
43010,La Jarry - Place Diderot,OUI,25,22,3,0,3,OUI,OUI,2025-03-13 11:54:46+00:00,"48.849726940367326, 2.452013790607453",Vincennes,94080,0.12,12
17003,Jacques Kellner - Saint-Ouen,OUI,43,41,2,0,2,OUI,OUI,2025-03-13 11:58:22+00:00,"48.895809485802886, 2.327897409164145",Paris,75056,0.046511627906976744,12
15057,Lucien Bossoutrot - Général Martial Vallin,OUI,38,12,26,16,10,OUI,OUI,2025-03-13 12:01:09+00:00,"48.836956046311, 2.2741072252393",Paris,75056,0.6842105263157895,12
42501,Raspail - Albert Schweitzer,OUI,27,10,17,17,0,OUI,OUI,2025-03-13 12:01:01+00:00,"48.81031545, 2.34395871",Gentilly,94037,0.6296296296296297,12
16002,Pergolèse - Malakoff,OUI,37,30,7,2,5,OUI,OUI,2025-03-13 11:59:09+00:00,"48.87521088779225, 2.2842781618237495",Paris,75056,0.1891891891891892,12
6008,Assas - Luxembourg,OUI,32,13,19,8,11,OUI,OUI,2025-03-13 12:01:01+00:00,"48.843734468779, 2.3334283818759",Paris,75056,0.59375,12
15004,Vaugirard - Pasteur,OUI,21,19,2,0,2,OUI,OUI,2025-03-13 11:59:35+00:00,"48.84040868803496, 2.3154367133975033",Paris,75056,0.09523809523809523,12
13109,Brillat-Savarin - Küss,OUI,21,17,4,3,1,OUI,OUI,2025-03-13 11:56:45+00:00,"48.822203, 2.350422",Paris,75056,0.19047619047619047,12
6027,Blaise-Desgoffe - Vaugirard,OUI,32,19,13,7,6,OUI,OUI,2025-03-13 11:58:47+00:00,"48.846128877747, 2.3242672160268",Paris,75056,0.40625,12
15030,Emeriau - Beaugrenelle,OUI,73,11,62,56,6,OUI,OUI,2025-03-13 12:00:29+00:00,"48.84791249714942, 2.2843059897422795",Paris,75056,0.8493150684931506,12
15005,Place Jacques et Thérèse Tréfouël,OUI,42,22,20,12,8,OUI,OUI,2025-03-13 12:01:27+00:00,"48.842726498317, 2.3125657439232",Paris,75056,0.47619047619047616,12
16011,Victor Hugo - La Pompe,OUI,40,35,5,0,5,OUI,OUI,2025-03-13 12:00:56+00:00,"48.86795222470859, 2.28146318346262",Paris,75056,0.125,12
13044,Place Jeanne d'Arc,OUI,35,34,1,1,0,OUI,OUI,2025-03-13 11:53:41+00:00,"48.829575, 2.369126",Paris,75056,0.02857142857142857,12
12007,Gare de Lyon - Chalon,OUI,45,20,25,14,11,OUI,OUI,2025-03-13 12:00:12+00:00,"48.845666194202, 2.3741452395916",Paris,75056,0.5555555555555556,12
17108,Bessières - Porte de Clichy,OUI,30,10,20,13,7,OUI,OUI,2025-03-13 11:58:33+00:00,"48.89611762451474, 2.31790903955698",Paris,75056,0.6666666666666666,12
35007,Benjamin Delessert - Jean Lolive,OUI,20,20,0,0,0,OUI,OUI,2025-03-13 11:58:52+00:00,"48.89392043619345, 2.417981922626496",Pantin,93055,0.0,12
47001,Place de la Gare,OUI,45,5,40,37,3,OUI,OUI,2025-03-13 12:00:51+00:00,"48.80253358011283, 2.4275037646293645",Maisons-Alfort,94046,0.8888888888888888,12
15022,Emile Zola - Fondary,OUI,41,6,35,31,4,OUI,OUI,2025-03-13 12:00:40+00:00,"48.847051143113745, 2.2953405976295476",Paris,75056,0.8536585365853658,12
13032,Italie - Jardin Joan Miro,OUI,24,20,4,2,2,OUI,OUI,2025-03-13 12:01:31+00:00,"48.81990914045756, 2.3592948541045193",Paris,75056,0.16666666666666666,12
23004,Paul Vaillant-Couturier - Victor Hugo,OUI,34,2,32,25,7,OUI,OUI,2025-03-13 11:59:32+00:00,"48.89819702263572, 2.293848017974069",Levallois-Perret,92044,0.9411764705882353,12
10165,Gare de l'Est - Place du 11 Novembre 1918,OUI,39,36,3,2,1,OUI,OUI,2025-03-13 12:00:01+00:00,"48.876327, 2.3585464",Paris,75056,0.07692307692307693,12
5012,Estrapade - Ulm,OUI,16,1,15,2,13,OUI,OUI,2025-03-13 12:01:39+00:00,"48.84512772828, 2.3454568170362",Paris,75056,0.9375,12
13128,Quai de la Gare - Pont de Bercy,OUI,29,1,28,26,2,OUI,OUI,2025-03-13 12:01:37+00:00,"48.83730787972, 2.3740861260598",Paris,75056,0.9655172413793104,12
11017,Charonne - Bureau,OUI,44,43,1,0,1,OUI,OUI,2025-03-13 12:00:38+00:00,"48.854176, 2.396093",Paris,75056,0.022727272727272728,12
92001,Mairie de quartier du Plateau - Mont-Valérien,OUI,20,13,7,4,3,OUI,OUI,2025-03-13 11:57:16+00:00,"48.8799933, 2.2072437",Nanterre,92050,0.35,12
21306,Place Lafayette,OUI,61,8,53,46,7,OUI,OUI,2025-03-13 12:00:44+00:00,"48.829654975522, 2.2638675570488",Issy-les-Moulineaux,92040,0.8688524590163934,12
17107,Berthier - Place Stuart Merril,OUI,35,18,17,14,3,OUI,OUI,2025-03-13 12:00:08+00:00,"48.885927922355044, 2.2933450341224675",Paris,75056,0.4857142857142857,12
1021,Halles - Bourdonnais,OUI,18,2,16,13,3,OUI,OUI,2025-03-13 11:59:03+00:00,"48.860448992575, 2.3460162431002",Paris,75056,0.8888888888888888,12
23010,Voltaire - Anatole France,OUI,26,3,23,15,8,OUI,OUI,2025-03-13 12:00:51+00:00,"48.891999360256904, 2.284262739121914",Levallois-Perret,92044,0.8846153846153846,12
33015,Charles Tillon - Cimetière Communal,OUI,26,2,24,6,18,OUI,OUI,2025-03-13 12:00:24+00:00,"48.91844023641836, 2.3935630917549138",Aubervilliers,93001,0.9230769230769231,12
18007,Goutte d'or - Barbès,OUI,20,19,1,0,1,OUI,OUI,2025-03-13 11:57:50+00:00,"48.885124323627, 2.3496962338686",Paris,75056,0.05,12
15311,Quai du Président Roosevelt - Pont Aval,OUI,30,0,30,20,10,OUI,OUI,2025-03-13 11:59:48+00:00,"48.8343883676388, 2.2656820714473724",Paris,75056,1.0,12
19128,Quai de l'Oise - Aisne,OUI,28,25,3,1,2,OUI,OUI,2025-03-13 12:00:11+00:00,"48.8906231, 2.3833701",Paris,75056,0.10714285714285714,12
41205,Maréchal Joffre - Verdun,OUI,20,19,1,0,1,OUI,OUI,2025-03-13 12:01:00+00:00,"48.85385, 2.470307",Fontenay-sous-Bois,94033,0.05,12
18006,Square Louise Michel,OUI,35,32,3,0,3,OUI,OUI,2025-03-13 11:59:04+00:00,"48.884687354509, 2.3441386967897",Paris,75056,0.08571428571428572,12
22015,Île de la Jatte,OUI,23,10,13,5,8,OUI,OUI,2025-03-13 12:01:24+00:00,"48.894036161302104, 2.2666339203715324",Neuilly-sur-Seine,92051,0.5652173913043478,12
21401,Mairie de Clamart,OUI,31,27,4,0,4,OUI,OUI,2025-03-13 12:00:37+00:00,"48.800612, 2.262151",Clamart,92023,0.12903225806451613,12
17119,Toqueville - Cardinet,OUI,31,27,4,1,3,OUI,OUI,2025-03-13 12:01:16+00:00,"48.88490187110713, 2.3109393194317818",Paris,75056,0.12903225806451613,12
9027,Douai - Pierre Fontaine,OUI,23,20,3,0,3,OUI,OUI,2025-03-13 12:01:42+00:00,"48.88229101148092, 2.33324121683836",Paris,75056,0.13043478260869565,12
15011,Cambronne - Villa Croix Nivert,OUI,61,47,14,12,2,OUI,OUI,2025-03-13 12:00:30+00:00,"48.845847561366, 2.3017574474216",Paris,75056,0.22950819672131148,12
4020,Place Edmond Michelet,OUI,23,9,14,12,2,OUI,OUI,2025-03-13 11:58:48+00:00,"48.860134890542, 2.3500636965036",Paris,75056,0.6086956521739131,12
9004,Gérando - Rochechouart,OUI,21,19,2,1,1,OUI,OUI,2025-03-13 11:58:55+00:00,"48.88294340845, 2.3464846238494",Paris,75056,0.09523809523809523,12
22408,Place du 14 Juillet,OUI,22,20,2,1,1,OUI,OUI,2025-03-13 12:01:42+00:00,"48.819266959525, 2.3011998832226",Malakoff,92046,0.09090909090909091,12
51002,Placette Grégoire Collas,OUI,25,15,10,4,6,OUI,OUI,2025-03-13 11:53:38+00:00,"48.94342014002797, 2.2487476095557213",Argenteuil,95018,0.4,12
8037,Monceau - Malesherbes,OUI,37,29,8,3,5,OUI,OUI,2025-03-13 12:01:23+00:00,"48.8795079, 2.3145456",Paris,75056,0.21621621621621623,12
32601,Porte des Lilas - Faidherbe,OUI,39,38,1,1,0,OUI,OUI,2025-03-13 11:53:59+00:00,"48.87861855668978, 2.4120327830314636",Les Lilas,93045,0.02564102564102564,12
7017,La Motte-Picquet - La Tour Maubourg,OUI,40,17,23,15,8,OUI,OUI,2025-03-13 11:59:34+00:00,"48.856926701847, 2.3096215831203",Paris,75056,0.575,12
12026,Place Ginette Hamelin,OUI,50,22,28,24,4,OUI,OUI,2025-03-13 11:59:58+00:00,"48.837853, 2.382064",Paris,75056,0.56,12
35006,Delizy - Louis Nadot,OUI,21,16,5,5,0,OUI,OUI,2025-03-13 11:54:21+00:00,"48.896212845581346, 2.4094578623771667",Pantin,93055,0.23809523809523808,12
13009,Auguste Blanqui - Corvisart,OUI,25,20,5,2,3,OUI,OUI,2025-03-13 11:56:00+00:00,"48.8300989, 2.3502726",Paris,75056,0.2,12
12018,Saint-Mandé - Fabre d'Eglantine,OUI,33,26,7,3,4,OUI,OUI,2025-03-13 11:59:54+00:00,"48.8453579, 2.3965022",Paris,75056,0.21212121212121213,12
27005,Gare du Stade,OUI,18,13,5,2,3,OUI,OUI,2025-03-13 11:55:25+00:00,"48.9312676, 2.2603778",Colombes,92025,0.2777777777777778,12
44016,Balzac - Olympes de Gouges,OUI,28,12,16,8,8,OUI,OUI,2025-03-13 11:58:37+00:00,"48.77850332486751, 2.4006786569952965",Vitry-sur-Seine,94081,0.5714285714285714,12
15071,Suffren - Champ de Mars,OUI,23,10,13,13,0,OUI,OUI,2025-03-13 11:59:44+00:00,"48.8547194, 2.2952168",Paris,75056,0.5652173913043478,12
44005,Place Saint-Just,OUI,21,13,8,5,3,OUI,OUI,2025-03-13 11:58:18+00:00,"48.790379518724265, 2.3895226791501045",Vitry-sur-Seine,94081,0.38095238095238093,12
9024,Taitbout - La Fayette,OUI,51,3,48,22,26,OUI,OUI,2025-03-13 12:01:36+00:00,"48.8733298892, 2.3352625966072",Paris,75056,0.9411764705882353,12
33016,Fort d'Aubervilliers,OUI,20,10,10,7,3,OUI,OUI,2025-03-13 11:59:52+00:00,"48.91502382370325, 2.4035281687974925",Aubervilliers,93001,0.5,12
8201,Arsène Houssaye - Friedland,OUI,29,20,9,2,7,OUI,OUI,2025-03-13 12:01:30+00:00,"48.874510616163, 2.2994716674148",Paris,75056,0.3103448275862069,12
10162,Alexandre Parodi - Quai de Valmy,OUI,24,22,2,1,1,OUI,OUI,2025-03-13 12:00:28+00:00,"48.879359419425, 2.3665961623192",Paris,75056,0.08333333333333333,12
9102,Londres - Place d'Estienne d'Orves,OUI,24,0,24,12,12,OUI,OUI,2025-03-13 12:01:44+00:00,"48.876693805756986, 2.3305362090468407",Paris,75056,1.0,12
6012,Saint-Germain - Ciseaux,OUI,18,1,17,10,7,OUI,OUI,2025-03-13 12:00:13+00:00,"48.853305277595, 2.3344654618827",Paris,75056,0.9444444444444444,12
9006,Dunkerque - Trudaine,OUI,15,15,0,0,0,OUI,OUI,2025-03-13 11:54:16+00:00,"48.88215166773376, 2.3463253676891327",Paris,75056,0.0,12
17111,Lemercier - Cardinet,OUI,24,24,0,0,0,OUI,OUI,2025-03-13 11:57:36+00:00,"48.890097168851746, 2.317377626895905",Paris,75056,0.0,12
18030,Joseph Dijon - Ornano,OUI,36,35,1,1,0,OUI,OUI,2025-03-13 11:59:38+00:00,"48.89374453351521, 2.3476678133010864",Paris,75056,0.027777777777777776,12
21319,Esplanade du Foncet - Camille Desmoulins,OUI,27,3,24,19,5,OUI,OUI,2025-03-13 12:01:20+00:00,"48.827090233494964, 2.2606857866048813",Issy-les-Moulineaux,92040,0.8888888888888888,12
92006,Place Nelson Mandela,OUI,30,19,11,2,9,OUI,OUI,2025-03-13 12:01:34+00:00,"48.897874318180556, 2.2182820737361912",Nanterre,92050,0.36666666666666664,12
8116,Champs-Elysees - Bassano,OUI,25,25,0,0,0,NON,NON,2021-02-21 19:09:18+00:00,"48.871811807816, 2.300238981843",Paris,75056,0.0,19
5024,Place Monge,OUI,21,15,6,2,4,OUI,OUI,2025-03-13 12:00:01+00:00,"48.842761803051, 2.3524079471827",Paris,75056,0.2857142857142857,12
21314,Chemin de Bretagne,OUI,28,3,25,18,7,OUI,OUI,2025-03-13 12:01:40+00:00,"48.824753068884, 2.2588385956052",Issy-les-Moulineaux,92040,0.8928571428571429,12
31005,Square Denise Buisson,OUI,45,44,1,0,1,OUI,OUI,2025-03-13 11:59:35+00:00,"48.8562322730982, 2.426436245441437",Montreuil,93048,0.022222222222222223,12
12005,Crozatier - Faubourg Saint-Antoine,OUI,40,12,28,21,7,OUI,OUI,2025-03-13 12:01:27+00:00,"48.850440013405, 2.378901366211",Paris,75056,0.7,12
12038,Picpus - Louis Braille,OUI,43,41,2,2,0,OUI,OUI,2025-03-13 11:59:44+00:00,"48.839988788912, 2.4005256685521",Paris,75056,0.046511627906976744,12
12028,Vivaldi - Antoine-Julien Hénard,OUI,27,25,2,2,0,OUI,OUI,2025-03-13 12:01:30+00:00,"48.841923663276546, 2.389728979467376",Paris,75056,0.07407407407407407,12
13516,Glacière - Soeur Catherine Marie,OUI,40,36,4,2,2,OUI,OUI,2025-03-13 11:55:25+00:00,"48.829522989420596, 2.343570403754711",Paris,75056,0.1,12
10021,Marché Saint-Quentin,OUI,14,14,0,0,0,OUI,OUI,2025-03-13 12:00:54+00:00,"48.877356057652, 2.3545114456374",Paris,75056,0.0,12
12155,Rottembourg - Général Michel Bizot,OUI,42,37,5,4,1,OUI,OUI,2025-03-13 12:00:59+00:00,"48.83787825992554, 2.4044052511453633",Paris,75056,0.11904761904761904,12
5115,Buffon - Jardin des Plantes,OUI,29,11,18,16,2,OUI,OUI,2025-03-13 11:59:27+00:00,"48.842668466104875, 2.3618587106466293",Paris,75056,0.6206896551724138,12
9011,Geoffroy - Marie,OUI,18,6,12,7,5,OUI,OUI,2025-03-13 11:58:27+00:00,"48.873781940593325, 2.344513876337893",Paris,75056,0.6666666666666666,12
41211,Louis Xavier de Ricard - Ancienne Mairie,OUI,34,33,1,1,0,OUI,OUI,2025-03-13 11:58:27+00:00,"48.84629899065091, 2.472420372068882",Fontenay-sous-Bois,94033,0.029411764705882353,12
9034,Godot de Mauroy - Madeleine,OUI,21,0,21,6,15,OUI,OUI,2025-03-13 12:01:01+00:00,"48.869789, 2.326347",Paris,75056,1.0,12
44011,Lebrun - Colonel Fabien,OUI,27,26,1,0,1,OUI,OUI,2025-03-13 12:01:42+00:00,"48.78266870733145, 2.381317801773548",Vitry-sur-Seine,94081,0.037037037037037035,12
12035,Madagascar - Meuniers,OUI,31,26,5,2,3,OUI,OUI,2025-03-13 11:59:43+00:00,"48.83460464474706, 2.3970650508999825",Paris,75056,0.16129032258064516,12
2108,Vivienne - Montmartre,OUI,37,4,33,15,18,OUI,OUI,2025-03-13 12:00:14+00:00,"48.871347597383, 2.3414588347077",Paris,75056,0.8918918918918919,12
15129,Hôpital Necker,OUI,38,18,20,16,4,OUI,OUI,2025-03-13 12:00:10+00:00,"48.846043490118454, 2.313245013356209",Paris,75056,0.5263157894736842,12
12101,Charenton - Prague,OUI,28,4,24,15,9,OUI,OUI,2025-03-13 12:01:34+00:00,"48.848175129981, 2.3763584494312",Paris,75056,0.8571428571428571,12
8027,Mairie du 8ème,OUI,14,4,10,7,3,OUI,OUI,2025-03-13 12:01:03+00:00,"48.877932, 2.318264",Paris,75056,0.7142857142857143,12
21707,Square Etienne Jarousse,OUI,22,20,2,0,2,OUI,OUI,2025-03-13 12:00:17+00:00,"48.82485182597129, 2.2925933450460434",Vanves,92075,0.09090909090909091,12
21315,Jules Guesdes - Général de Gaulle,OUI,24,23,1,1,0,OUI,OUI,2025-03-13 11:58:32+00:00,"48.81930581291959, 2.278934195637703",Issy-les-Moulineaux,92040,0.041666666666666664,12
4019,Cloître Saint-Merri - Renard,OUI,29,2,27,22,5,OUI,OUI,2025-03-13 12:00:46+00:00,"48.858835448898, 2.3518279194832",Paris,75056,0.9310344827586207,12
23102,Hôtel de Ville de Sèvres,OUI,31,18,13,12,1,OUI,OUI,2025-03-13 12:01:13+00:00,"48.824363561289, 2.2131047397852",Sèvres,92072,0.41935483870967744,12
5001,Harpe - Saint-Germain,OUI,43,27,16,14,2,OUI,OUI,2025-03-13 12:01:43+00:00,"48.851518815017, 2.3436703160405",Paris,75056,0.37209302325581395,12
15036,Croix Nivert - Square Saint-Lambert,OUI,47,47,0,0,0,NON,NON,2025-03-03 09:03:43+00:00,"48.843051521591, 2.2952004522085",Paris,75056,0.0,9
51001,Gare d'Argenteuil,OUI,37,19,18,4,14,OUI,OUI,2025-03-13 11:57:37+00:00,"48.947022436806705, 2.256898172199726",Argenteuil,95018,0.4864864864864865,12
21402,Place Aimé Césaire,OUI,27,23,4,0,4,OUI,OUI,2025-03-13 11:52:46+00:00,"48.783194713067815, 2.2429127991199493",Clamart,92023,0.14814814814814814,12
15039,Abbé Groult - Convention,OUI,12,10,2,0,2,OUI,OUI,2025-03-13 11:59:54+00:00,"48.83596927866069, 2.302064039509349",Paris,75056,0.16666666666666666,12
41403,Gare RER - Malleret-Joinville,OUI,20,7,13,9,4,OUI,OUI,2025-03-13 12:00:06+00:00,"48.802936, 2.42531",Alfortville,94002,0.65,12
6022,Marché Saint-Germain,OUI,19,6,13,5,8,OUI,OUI,2025-03-13 11:59:37+00:00,"48.85165625855281, 2.335500307381153",Paris,75056,0.6842105263157895,12
13018,Bruant - Vincent Auriol,OUI,25,8,17,13,4,OUI,OUI,2025-03-13 12:01:22+00:00,"48.834848452929, 2.3668264996271",Paris,75056,0.68,12
15006,Cherche-Midi - Hôpital Necker,OUI,35,28,7,4,3,OUI,OUI,2025-03-13 12:01:04+00:00,"48.84461063309956, 2.317914068698883",Paris,75056,0.2,12
21303,Jean Monnet - Iles,OUI,32,3,29,26,3,OUI,OUI,2025-03-13 12:01:39+00:00,"48.823393984057304, 2.2497073194874866",Issy-les-Moulineaux,92040,0.90625,12
15127,Place Charles Michels,OUI,35,3,32,21,11,OUI,OUI,2025-03-13 11:58:55+00:00,"48.846401, 2.28502",Paris,75056,0.9142857142857143,12
33014,Parc Eli Lotar,OUI,19,13,6,3,3,OUI,OUI,2025-03-13 11:59:37+00:00,"48.91844993053703, 2.3727085813879967",Aubervilliers,93001,0.3157894736842105,12
33103,Jean Jaurès - Jules Jacquemin,OUI,22,21,1,0,1,OUI,OUI,2025-03-13 11:55:52+00:00,"48.88433053604843, 2.4082902455152104",Le Pré-Saint-Gervais,93061,0.045454545454545456,12
9007,Condorcet - Turgot,OUI,19,17,2,0,2,OUI,OUI,2025-03-13 12:01:43+00:00,"48.87985155789093, 2.345232367515564",Paris,75056,0.10526315789473684,12
2013,Favart - Italiens,OUI,17,2,15,3,12,OUI,OUI,2025-03-13 12:01:21+00:00,"48.871446353921, 2.3382901058508",Paris,75056,0.8823529411764706,12
13052,Leredde - Tolbiac,OUI,43,14,29,12,17,OUI,OUI,2025-03-13 12:00:13+00:00,"48.82887629664, 2.3744382709265",Paris,75056,0.6744186046511628,12
10019,Paradis - Hauteville,OUI,31,5,26,16,10,OUI,OUI,2025-03-13 12:00:01+00:00,"48.874999954666755, 2.3522757401923404",Paris,75056,0.8387096774193549,12
17024,Villiers - Batignolles,OUI,23,21,2,0,2,OUI,OUI,2025-03-13 11:58:59+00:00,"48.88125253846116, 2.31653843075037",Paris,75056,0.08695652173913043,12
41203,Stalingrad - Rigollots,OUI,50,49,1,0,1,OUI,OUI,2025-03-13 12:00:33+00:00,"48.84997403844251, 2.45557576417923",Fontenay-sous-Bois,94033,0.02,12
20105,Benoît Frachon - République,OUI,28,25,3,1,2,OUI,OUI,2025-03-13 12:00:01+00:00,"48.85230729014318, 2.415605485439301",Paris,75056,0.10714285714285714,12
10033,Gare du Nord - Saint-Vincent de Paul,OUI,24,24,0,0,0,OUI,OUI,2025-03-13 11:55:33+00:00,"48.880955741648, 2.3524305148385",Paris,75056,0.0,12
14032,Mairie du 14ème,OUI,32,31,1,0,1,OUI,OUI,2025-03-13 11:58:31+00:00,"48.83254578123, 2.3254923149943",Paris,75056,0.03125,12
18039,Jardins d'Eole,OUI,19,19,0,0,0,OUI,OUI,2025-03-13 12:00:04+00:00,"48.8869703, 2.3668488",Paris,75056,0.0,12
14011,Place des Droits de l'Enfant,OUI,39,37,2,0,2,OUI,OUI,2025-03-13 11:59:03+00:00,"48.8274804, 2.3319217",Paris,75056,0.05128205128205128,12
41401,Marne - Charles de Gaulle,OUI,25,16,9,9,0,OUI,OUI,2025-03-13 12:00:17+00:00,"48.815071719544434, 2.4121668934822087",Alfortville,94002,0.36,12
14026,Plantes - Moulin Vert,OUI,45,40,5,0,5,OUI,OUI,2025-03-13 12:00:04+00:00,"48.83005755305626, 2.3232302069664006",Paris,75056,0.1111111111111111,12
6002,Saint-Benoît - Jacob,OUI,22,0,22,13,9,OUI,OUI,2025-03-13 12:01:13+00:00,"48.85545136013941, 2.3334722220897675",Paris,75056,1.0,12
8117,Place de la Madeleine - Royale,OUI,41,3,38,25,13,OUI,OUI,2025-03-13 12:01:32+00:00,"48.869228052648, 2.324421107769",Paris,75056,0.926829268292683,12
14031,Didot - Place de Moro-Giafferi,OUI,20,19,1,1,0,OUI,OUI,2025-03-13 11:59:46+00:00,"48.8337, 2.3215",Paris,75056,0.05,12
10032,Claude Vellefaux - Hôpital Saint-Louis,OUI,31,27,4,2,2,OUI,OUI,2025-03-13 12:01:30+00:00,"48.872859139003, 2.3700717069851",Paris,75056,0.12903225806451613,12
20044,Davout - Volga,OUI,27,25,2,0,2,OUI,OUI,2025-03-13 11:59:40+00:00,"48.852919679957296, 2.410522909779111",Paris,75056,0.07407407407407407,12
48004,Maxime Gorki - Louis Aragon,OUI,20,19,1,0,1,OUI,OUI,2025-03-13 12:01:27+00:00,"48.78909814728443, 2.368387877941132",Villejuif,94076,0.05,12
16019,Porte de la Muette,OUI,34,10,24,4,20,OUI,OUI,2025-03-13 12:00:32+00:00,"48.86302317841182, 2.2687188170157406",Paris,75056,0.7058823529411765,12
26004,Gare RER les Grésillons,OUI,22,15,7,7,0,OUI,OUI,2025-03-13 11:58:17+00:00,"48.919898633572764, 2.31458459136273",Asnières-sur-Seine,92004,0.3181818181818182,12
33012,Landy - Heurtault,OUI,29,28,1,1,0,OUI,OUI,2025-03-13 11:58:25+00:00,"48.915096534520316, 2.375951372087002",Aubervilliers,93001,0.034482758620689655,12
18139,Poissonniers - Championnet,OUI,28,27,1,0,1,OUI,OUI,2025-03-13 12:01:34+00:00,"48.89543299733937, 2.3530178144574165",Paris,75056,0.03571428571428571,12
3102,Bourg l'Abbé - Saint-Martin,OUI,36,14,22,14,8,OUI,OUI,2025-03-13 12:00:30+00:00,"48.86393331949257, 2.352406270802021",Paris,75056,0.6111111111111112,12
16042,Murat - Porte de Saint-Cloud,OUI,38,2,36,32,4,OUI,OUI,2025-03-13 12:00:04+00:00,"48.83750862621299, 2.2577651962637906",Paris,75056,0.9473684210526315,12
11033,Bréguet - Sabin,OUI,29,5,24,19,5,OUI,OUI,2025-03-13 12:01:30+00:00,"48.856931678257, 2.3706749462105",Paris,75056,0.8275862068965517,12
15001,Gare Montparnasse - Arrivée,OUI,42,29,13,5,8,OUI,OUI,2025-03-13 11:59:49+00:00,"48.843827994315, 2.3225811123848",Paris,75056,0.30952380952380953,12
15008,Sèvres - Lecourbe,OUI,60,42,18,16,2,OUI,OUI,2025-03-13 12:00:26+00:00,"48.8447677, 2.3110086",Paris,75056,0.3,12
20022,Porte de Bagnolet,OUI,33,32,1,1,0,OUI,OUI,2025-03-13 11:59:56+00:00,"48.864707139122984, 2.408344637349607",Paris,75056,0.030303030303030304,12
11112,Jules Vallès - Charonne,OUI,23,15,8,3,5,OUI,OUI,2025-03-13 11:54:17+00:00,"48.854284379935, 2.3847674578428",Paris,75056,0.34782608695652173,12
12036,Reuilly - Place Felix Eboue,OUI,41,39,2,2,0,OUI,OUI,2025-03-13 12:00:56+00:00,"48.84030274499962, 2.394630398715453",Paris,75056,0.04878048780487805,12
5007,Ecoles - Carmes,OUI,34,0,34,18,16,OUI,OUI,2025-03-13 12:00:34+00:00,"48.848904447989405, 2.3473486304283147",Paris,75056,1.0,12
10008,Cité Riverin - Château d'Eau,OUI,17,0,17,6,11,OUI,OUI,2025-03-13 12:01:28+00:00,"48.870702423554306, 2.358739863900845",Paris,75056,1.0,12
16105,Crevaux - Bugeaud,OUI,31,29,2,0,2,OUI,OUI,2025-03-13 11:55:27+00:00,"48.87080942867, 2.2811490076919",Paris,75056,0.06451612903225806,12
16012,Flandrin - Longchamp,OUI,40,8,32,14,18,OUI,OUI,2025-03-13 12:00:40+00:00,"48.86877849178477, 2.274354539176829",Paris,75056,0.8,12
4006,Bourdon - Pont Morland,OUI,49,24,25,22,3,OUI,OUI,2025-03-13 12:01:35+00:00,"48.8478103, 2.3659356",Paris,75056,0.5102040816326531,12
16036,Porte Molitor,OUI,59,3,56,41,15,OUI,OUI,2025-03-13 12:00:41+00:00,"48.84524763511433, 2.2569015249609947",Paris,75056,0.9491525423728814,12
15128,Cadix - Hameau,OUI,36,29,7,3,4,OUI,OUI,2025-03-13 11:57:50+00:00,"48.8340107632249, 2.289516180753708",Paris,75056,0.19444444444444445,12
42505,Charles Frérot - Albert Guilpin,OUI,29,24,5,3,2,OUI,OUI,2025-03-13 12:00:11+00:00,"48.8155839183714, 2.3505029082298283",Gentilly,94037,0.1724137931034483,12
1007,Turbigo - Française,OUI,16,2,14,12,2,OUI,OUI,2025-03-13 11:59:15+00:00,"48.86358858111446, 2.3477794602513313",Paris,75056,0.875,12
12015,Place de la Nation - Picpus,OUI,36,31,5,3,2,OUI,OUI,2025-03-13 11:59:54+00:00,"48.846821681548, 2.4001130461693",Paris,75056,0.1388888888888889,12
18004,Place des Abbesses,OUI,12,10,2,0,2,OUI,OUI,2025-03-13 11:56:58+00:00,"48.884542726149725, 2.3386867716908455",Paris,75056,0.16666666666666666,12
14001,Edgar Quinet - Gaité,OUI,27,17,10,2,8,OUI,OUI,2025-03-13 11:55:32+00:00,"48.841160928966, 2.324595451355",Paris,75056,0.37037037037037035,12
16013,Mairie du 16ème,OUI,35,34,1,0,1,OUI,OUI,2025-03-13 11:57:21+00:00,"48.863936848471994, 2.2765953093767166",Paris,75056,0.02857142857142857,12
1006,Grande Truanderie - Saint-Denis,OUI,27,10,17,13,4,OUI,OUI,2025-03-13 12:00:41+00:00,"48.8626302, 2.3498075",Paris,75056,0.6296296296296297,12
7012,Cité Vaneau,OUI,23,4,19,10,9,OUI,OUI,2025-03-13 12:01:01+00:00,"48.8542210666207, 2.319614924490452",Paris,75056,0.8260869565217391,12
19110,Square Claude Bernard,OUI,29,17,12,7,5,OUI,OUI,2025-03-13 12:01:11+00:00,"48.89876016219984, 2.375325746834278",Paris,75056,0.41379310344827586,12
20001,Place de la Nation - Charonne,OUI,35,28,7,6,1,OUI,OUI,2025-03-13 12:00:12+00:00,"48.848364667777, 2.3997623859813",Paris,75056,0.2,12
22201,Henri Ravera - Gabriel Péri,OUI,28,27,1,0,1,OUI,OUI,2025-03-13 11:57:10+00:00,"48.79722273833844, 2.302115857601166",Bagneux,92007,0.03571428571428571,12
18034,Leibniz - Jean Dollfus,OUI,32,30,2,1,1,OUI,OUI,2025-03-13 11:56:45+00:00,"48.896328348515986, 2.333390423834684",Paris,75056,0.0625,12
18202,Diane Arbus,OUI,37,33,4,3,1,OUI,OUI,2025-03-13 11:53:41+00:00,"48.898800717199, 2.3524022474885",Paris,75056,0.10810810810810811,12
8110,Gare Saint-Lazare - Stockholm,OUI,30,25,5,2,3,OUI,OUI,2025-03-13 11:55:22+00:00,"48.877127316667654, 2.322417162358761",Paris,75056,0.16666666666666666,12
3008,Perle - Vieille du Temple,OUI,35,2,33,22,11,OUI,OUI,2025-03-13 12:01:38+00:00,"48.8601346, 2.3611206",Paris,75056,0.9428571428571428,12
20024,Gambetta - Père Lachaise,OUI,27,27,0,0,0,OUI,OUI,2025-03-13 12:01:37+00:00,"48.864295696165875, 2.398228667282044",Paris,75056,0.0,12
6010,Chevreuse - Montparnasse,OUI,15,12,3,0,3,OUI,OUI,2025-03-13 12:01:09+00:00,"48.841739161231, 2.3315522167367",Paris,75056,0.2,12
5015,Epée de Bois - Mouffetard,OUI,62,48,14,8,6,OUI,OUI,2025-03-13 11:56:11+00:00,"48.841508690388835, 2.350066713988781",Paris,75056,0.22580645161290322,12
9009,Square Montholon,OUI,19,11,8,2,6,OUI,OUI,2025-03-13 11:56:08+00:00,"48.876620377545024, 2.3457641154527664",Paris,75056,0.42105263157894735,12
45002,Roger Salengro - Général de Gaulle,OUI,27,14,13,4,9,OUI,OUI,2025-03-13 11:58:38+00:00,"48.820029010376956, 2.4846760556101803",Champigny-sur-Marne,94017,0.48148148148148145,12
10034,Louis Blanc - La Chapelle,OUI,21,20,1,1,0,OUI,OUI,2025-03-13 11:58:38+00:00,"48.884008964514, 2.3599335551262",Paris,75056,0.047619047619047616,12
44014,Camille Risch - Paul Armangot,OUI,25,16,9,5,4,OUI,OUI,2025-03-13 11:52:57+00:00,"48.774703, 2.373685",Vitry-sur-Seine,94081,0.36,12
6104,Herschel - Observatoire,OUI,36,17,19,4,15,OUI,OUI,2025-03-13 12:01:18+00:00,"48.84342376221923, 2.3376645147800446",Paris,75056,0.5277777777777778,12
12037,Reuilly - Daumesnil,OUI,36,33,3,2,1,OUI,OUI,2025-03-13 12:01:10+00:00,"48.8395385, 2.3972516",Paris,75056,0.08333333333333333,12
4021,Centre Georges Pompidou,OUI,24,3,21,19,2,OUI,OUI,2025-03-13 12:00:12+00:00,"48.861419, 2.352581",Paris,75056,0.875,12
47003,Charentonneau - Maisons Alfort,OUI,20,16,4,4,0,OUI,OUI,2025-03-13 12:00:39+00:00,"48.809932980484355, 2.443288456496946",Maisons-Alfort,94046,0.2,12
20034,Sorbier - Ménilmontant,OUI,24,22,2,0,2,OUI,OUI,2025-03-13 12:00:19+00:00,"48.868542395661, 2.3897721245885",Paris,75056,0.08333333333333333,12
20008,Pyrénées - Avron,OUI,31,30,1,0,1,OUI,OUI,2025-03-13 11:57:46+00:00,"48.853246898211985, 2.405871044529538",Paris,75056,0.03225806451612903,12
13005,Cordelières - Arago,OUI,45,24,21,20,1,OUI,OUI,2025-03-13 12:01:42+00:00,"48.83548071896613, 2.348572461702221",Paris,75056,0.4666666666666667,12
12019,Gare de Reuilly - Picpus,OUI,26,25,1,0,1,OUI,OUI,2025-03-13 12:00:41+00:00,"48.84267354116789, 2.3972943797707558",Paris,75056,0.038461538461538464,12
17019,Phalsbourg - Villiers,OUI,19,9,10,6,4,OUI,OUI,2025-03-13 11:59:44+00:00,"48.88242307900951, 2.3090453445911407",Paris,75056,0.5263157894736842,12
20104,Louis Lumière.,OUI,22,22,0,0,0,OUI,OUI,2025-03-13 11:56:55+00:00,"48.86216198070008, 2.41112578185621",Paris,75056,0.0,12
15132,Bargue -  Dutot,OUI,21,17,4,2,2,OUI,OUI,2025-03-13 11:57:52+00:00,"48.837884, 2.308876",Paris,75056,0.19047619047619047,12
14135,Jourdan - Cité Universitaire,OUI,39,32,7,5,2,OUI,OUI,2025-03-13 12:01:09+00:00,"48.819897343156676, 2.3397007964124366",Paris,75056,0.1794871794871795,12
8028,Arsène Houssaye - Champs-Elysées,OUI,28,5,23,1,22,OUI,OUI,2025-03-13 11:59:19+00:00,"48.873409276267, 2.2977904602885",Paris,75056,0.8214285714285714,12
3010,Beaubourg - Michel-le-Comte,OUI,14,1,13,9,4,OUI,OUI,2025-03-13 12:01:36+00:00,"48.862534941806, 2.3543103039265",Paris,75056,0.9285714285714286,12
10011,Bourse du Travail,OUI,15,3,12,11,1,OUI,OUI,2025-03-13 11:56:32+00:00,"48.868976638826, 2.3623438552022",Paris,75056,0.8,12
12156,Niger - Soult,OUI,23,18,5,3,2,OUI,OUI,2025-03-13 12:01:40+00:00,"48.84369906369085, 2.410361237220498",Paris,75056,0.21739130434782608,12
21953,Gare de Bellevue,OUI,20,17,3,0,3,OUI,OUI,2025-03-13 11:57:00+00:00,"48.8192404685572, 2.2295309230685234",Meudon,92048,0.15,12
18140,Porte de Clignancourt - Ney,OUI,38,29,9,2,7,OUI,OUI,2025-03-13 11:58:57+00:00,"48.899641123987095, 2.344321422278881",Paris,75056,0.23684210526315788,12
14137,Maurice d'Ocagne - General Maudhuy,OUI,28,26,2,1,1,OUI,OUI,2025-03-13 12:01:36+00:00,"48.82414282524159, 2.3158789426088333",Paris,75056,0.07142857142857142,12
21309,Mairie d'Issy,OUI,39,30,9,7,2,OUI,OUI,2025-03-13 12:01:28+00:00,"48.823767792468, 2.2723111510277",Issy-les-Moulineaux,92040,0.23076923076923078,12
14019,Sarrette - Général Leclerc,OUI,22,20,2,0,2,OUI,OUI,2025-03-13 11:57:01+00:00,"48.825030852925, 2.3264128693982",Paris,75056,0.09090909090909091,12
16102,Pergolèse - Marbeau,OUI,26,21,5,0,5,OUI,OUI,2025-03-13 11:53:57+00:00,"48.873568706869, 2.2815125225299",Paris,75056,0.19230769230769232,12
3011,Turbigo - Réaumur,OUI,31,3,28,24,4,OUI,OUI,2025-03-13 12:01:43+00:00,"48.865574047531, 2.3564198613167",Paris,75056,0.9032258064516129,12
19002,Centquatre,OUI,38,32,6,0,6,NON,NON,2025-03-13 11:58:42+00:00,"48.889333538455, 2.3707854375243",Paris,75056,0.15789473684210525,12
10027,Dunkerque - Alsace,OUI,20,18,2,2,0,OUI,OUI,2025-03-13 12:00:31+00:00,"48.879355, 2.358379",Paris,75056,0.1,12
19201,Petit - Georges Thill,OUI,23,22,1,0,1,OUI,OUI,2025-03-13 11:52:08+00:00,"48.88603131999171, 2.3895753175020222",Paris,75056,0.043478260869565216,12
10006,Petites Ecuries - Faubourg Saint-Denis,OUI,26,12,14,9,5,OUI,OUI,2025-03-13 11:59:46+00:00,"48.87287120589831, 2.3542150855064397",Paris,75056,0.5384615384615384,12
19010,Emile Reynaud - Porte de la Villette,OUI,22,22,0,0,0,OUI,OUI,2025-03-13 11:57:34+00:00,"48.90098953630053, 2.3887022584676743",Paris,75056,0.0,12
4103,Archives - Rivoli,OUI,19,1,18,10,8,OUI,OUI,2025-03-13 11:58:42+00:00,"48.857346707443, 2.3539767041802",Paris,75056,0.9473684210526315,12
10009,Mairie du 10ème,OUI,18,3,15,11,4,OUI,OUI,2025-03-13 11:59:49+00:00,"48.872089449907, 2.3575825989246",Paris,75056,0.8333333333333334,12
3001,Beaumarchais - Saint-Gilles,OUI,44,32,12,4,8,OUI,OUI,2025-03-13 11:59:02+00:00,"48.8580378, 2.3679352",Paris,75056,0.2727272727272727,12
22301,Chausson - Gabriel Péri,OUI,20,13,7,7,0,OUI,OUI,2025-03-13 12:01:32+00:00,"48.921891003481115, 2.2952306270599365",Gennevilliers,92036,0.35,12
2015,Louis le Grand - Italiens,OUI,33,0,33,17,16,OUI,OUI,2025-03-13 12:01:43+00:00,"48.870508937204, 2.3340544619393",Paris,75056,1.0,12
41405,Place de l'Europe - Alfortville,OUI,24,6,18,18,0,OUI,OUI,2025-03-13 12:01:15+00:00,"48.78913702405837, 2.4284800887107854",Alfortville,94002,0.75,12
32013,Saint-Denis - Université,OUI,19,1,18,7,11,OUI,OUI,2025-03-13 11:58:24+00:00,"48.94563430946964, 2.3638297989964485",Saint-Denis,93066,0.9473684210526315,12
20006,Pyrénées - Plaine,OUI,12,12,0,0,0,OUI,OUI,2025-03-13 11:51:56+00:00,"48.85026702458, 2.4062821269035",Paris,75056,0.0,12
22503,Joffre - Aigle,OUI,19,12,7,3,4,OUI,OUI,2025-03-13 11:59:22+00:00,"48.904033, 2.245096",La Garenne-Colombes,92035,0.3684210526315789,12
31709,Place de la Fraternité,OUI,22,22,0,0,0,OUI,OUI,2025-03-13 11:55:21+00:00,"48.85716405838368, 2.422847449779511",Montreuil,93048,0.0,12
1102,Française - Etienne Marcel,OUI,35,18,17,15,2,OUI,OUI,2025-03-13 12:00:10+00:00,"48.864053304653766, 2.347587011754513",Paris,75056,0.4857142857142857,12
22401,Charles de Gaulle - Plateau de Vanves,OUI,32,26,6,4,2,OUI,OUI,2025-03-13 12:00:44+00:00,"48.82233088973263, 2.298571803412886",Malakoff,92046,0.1875,12
24006,Adolphe Lalyre - Armand Silvestre,OUI,39,35,4,1,3,OUI,OUI,2025-03-13 11:59:04+00:00,"48.90406266961591, 2.273416221141815",Courbevoie,92026,0.10256410256410256,12
12002,Lacuée - Lyon,OUI,16,1,15,9,6,OUI,OUI,2025-03-13 11:59:18+00:00,"48.849268481958, 2.3704585433006",Paris,75056,0.9375,12
2005,Montmartre - Etienne Marcel,OUI,16,7,9,8,1,OUI,OUI,2025-03-13 11:58:27+00:00,"48.86502194581, 2.3450684401448",Paris,75056,0.5625,12
21506,Maurice Payret-Dortail,OUI,22,18,4,0,4,OUI,OUI,2025-03-13 11:56:39+00:00,"48.87811957063342, 2.2233625128865246",Suresnes,92073,0.18181818181818182,12
3012,Square Emile - Chautemps,OUI,24,2,22,19,3,OUI,OUI,2025-03-13 12:01:40+00:00,"48.867433724231, 2.3536357283592",Paris,75056,0.9166666666666666,12
14103,Maine - Liancourt,OUI,25,24,1,0,1,OUI,OUI,2025-03-13 11:59:51+00:00,"48.835064363954, 2.323731449974",Paris,75056,0.04,12
23702,Hôtel de Ville de Chaville,OUI,20,19,1,0,1,OUI,OUI,2025-03-13 11:57:27+00:00,"48.80887149094033, 2.188134044408798",Chaville,92022,0.05,12
9037,Parme - Clichy,OUI,24,21,3,1,2,OUI,OUI,2025-03-13 11:58:23+00:00,"48.881266424227, 2.3281970934506",Paris,75056,0.125,12
19012,Lally-Tollendal - Armand Carrel,OUI,27,27,0,0,0,OUI,OUI,2025-03-13 12:00:44+00:00,"48.88270066221072, 2.374717555940151",Paris,75056,0.0,12
7021,Bosquet - Saint-Dominique,OUI,28,21,7,4,3,OUI,OUI,2025-03-13 12:00:42+00:00,"48.858651709526, 2.3037165802346",Paris,75056,0.25,12
21507,Gardenat-Lapostol - Velettes,OUI,20,12,8,1,7,OUI,OUI,2025-03-13 11:58:05+00:00,"48.87387, 2.224185",Suresnes,92073,0.4,12
21026,Sèvres - Général Leclerc,OUI,29,4,25,18,7,OUI,OUI,2025-03-13 12:00:58+00:00,"48.830121559055, 2.2314262390137",Boulogne-Billancourt,92012,0.8620689655172413,12
22306,Place du 17 Octobre,OUI,16,14,2,2,0,OUI,OUI,2025-03-13 11:56:44+00:00,"48.91962690034779, 2.2978286134199792",Gennevilliers,92036,0.125,12
19129,Solitaires - Place des Fêtes,OUI,29,29,0,0,0,NON,NON,2025-02-23 09:26:05+00:00,"48.876601, 2.391769",Paris,75056,0.0,9
22502,Kléber - National,OUI,20,12,8,6,2,OUI,OUI,2025-03-13 11:58:09+00:00,"48.906333898712234, 2.2393910586833954",La Garenne-Colombes,92035,0.4,12
20029,Frères Flavien - Porte des Lilas,OUI,23,23,0,0,0,OUI,OUI,2025-03-13 11:57:17+00:00,"48.8780992764359, 2.41104629853209",Paris,75056,0.0,12
3006,Mairie du 3ème,OUI,23,3,20,16,4,OUI,OUI,2025-03-13 12:01:04+00:00,"48.86446178139141, 2.361762821674347",Paris,75056,0.8695652173913043,12
2003,Saint-Denis - Réaumur,OUI,31,10,21,9,12,OUI,OUI,2025-03-13 12:01:36+00:00,"48.8661116315789, 2.3507790675507594",Paris,75056,0.6774193548387096,12
4015,Mairie du 4ème,OUI,41,0,41,28,13,OUI,OUI,2025-03-13 12:00:49+00:00,"48.855949910497, 2.3563823103905",Paris,75056,1.0,12
13017,Nationale - Vincent Auriol,OUI,33,27,6,1,5,OUI,OUI,2025-03-13 11:59:42+00:00,"48.83252708397293, 2.362354410392119",Paris,75056,0.18181818181818182,12
3003,Fille du Calvaire - Turenne,OUI,26,5,21,18,3,OUI,OUI,2025-03-13 11:57:18+00:00,"48.86210505412563, 2.3649600148200993",Paris,75056,0.8076923076923077,12
15111,Olivier de Serres - Leriche,OUI,24,22,2,1,1,OUI,OUI,2025-03-13 11:58:20+00:00,"48.83460221715206, 2.2957482933998112",Paris,75056,0.08333333333333333,12
9111,Victoire - Laffitte,OUI,19,3,16,15,1,OUI,OUI,2025-03-13 11:59:52+00:00,"48.87514373494672, 2.338118505144376",Paris,75056,0.8421052631578947,12
12020,Cours de Vincennes - Soult,OUI,44,41,3,3,0,OUI,OUI,2025-03-13 12:01:40+00:00,"48.846918761569, 2.4105220288038",Paris,75056,0.06818181818181818,12
5122,Saint-Michel - Luxembourg,OUI,28,12,16,0,16,OUI,OUI,2025-03-13 12:01:36+00:00,"48.84501507626, 2.3394941166043",Paris,75056,0.5714285714285714,12
2021,Cléry - Montmartre,OUI,58,32,26,16,10,OUI,OUI,2025-03-13 11:59:29+00:00,"48.867458, 2.3445211",Paris,75056,0.4482758620689655,12
13125,Gare d'Austerlitz - Pont Charles de Gaulle,OUI,55,16,39,20,19,OUI,OUI,2025-03-13 12:01:23+00:00,"48.842319830109, 2.3670300096273",Paris,75056,0.7090909090909091,12
3009,Temple - Haudriettes,OUI,19,2,17,14,3,OUI,OUI,2025-03-13 11:59:54+00:00,"48.861636880212, 2.3566960206458",Paris,75056,0.8947368421052632,12
21110,Parc Roger Salengro,OUI,30,7,23,20,3,OUI,OUI,2025-03-13 11:56:39+00:00,"48.905303858642, 2.31055945158",Clichy,92024,0.7666666666666667,12
14132,Bézout - Général Leclerc,OUI,28,24,4,0,4,OUI,OUI,2025-03-13 11:59:41+00:00,"48.82884804502439, 2.3285973072052",Paris,75056,0.14285714285714285,12
48005,Eugène Varlin - Place de la Paix,OUI,23,20,3,1,2,OUI,OUI,2025-03-13 11:53:21+00:00,"48.792862, 2.363093",Villejuif,94076,0.13043478260869565,12
4014,Blancs-Manteaux - Archives,OUI,28,2,26,24,2,OUI,OUI,2025-03-13 11:59:37+00:00,"48.85941800703, 2.3559471219778",Paris,75056,0.9285714285714286,12
21215,Verdier - Jean Jaurès,OUI,32,31,1,1,0,OUI,OUI,2025-03-13 11:56:09+00:00,"48.81614048711214, 2.3123561963438988",Montrouge,92049,0.03125,12
14022,Didot - Mariniers,OUI,35,33,2,0,2,OUI,OUI,2025-03-13 11:59:10+00:00,"48.82650543613106, 2.313136198271666",Paris,75056,0.05714285714285714,12
41208,Alouettes - Maréchal de Lattre de Tassigny,OUI,21,10,11,2,9,OUI,OUI,2025-03-13 12:00:53+00:00,"48.85511009293948, 2.4930700287222862",Fontenay-sous-Bois,94033,0.5238095238095238,12
2002,Etienne Marcel - Montorgueil,OUI,25,4,21,19,2,OUI,OUI,2025-03-13 12:01:05+00:00,"48.86450567259199, 2.3461959511041637",Paris,75056,0.84,12
42704,Mairie du Kremlin-Bicêtre,OUI,25,25,0,0,0,OUI,OUI,2025-03-13 11:56:46+00:00,"48.81191981537702, 2.3570189997553825",Le Kremlin-Bicêtre,94043,0.0,12
31001,Lagny - Auguste Blanqui,OUI,26,14,12,10,2,OUI,OUI,2025-03-13 11:59:53+00:00,"48.84922568052601, 2.4218603968620305",Montreuil,93048,0.46153846153846156,12
42211,Séminaire de Conflans - Liberté,OUI,24,6,18,8,10,OUI,OUI,2025-03-13 11:59:44+00:00,"48.823194, 2.404179",Charenton-le-Pont,94018,0.75,12
14023,Adolphe Pinard - Victor Hugo,OUI,51,50,1,0,1,OUI,OUI,2025-03-13 11:56:51+00:00,"48.8236825874564, 2.3077843710780144",Malakoff,92046,0.0196078431372549,12
2012,Choiseul - Quatre Septembre,OUI,44,2,42,17,25,OUI,OUI,2025-03-13 12:01:30+00:00,"48.8699355331869, 2.3359975218772893",Paris,75056,0.9545454545454546,12
12163,Hippodrome Paris-Vincennes,OUI,42,40,2,1,1,OUI,OUI,2025-03-13 11:54:18+00:00,"48.82048387758518, 2.446271181106568",Paris,75056,0.047619047619047616,12
19111,Cesaria Evora - Rosa Parks,OUI,35,26,9,6,3,OUI,OUI,2025-03-13 12:01:27+00:00,"48.89717672825043, 2.3745173960924144",Paris,75056,0.2571428571428571,12
3002,Saint-Gilles - Turenne,OUI,15,6,9,5,4,OUI,OUI,2025-03-13 12:00:51+00:00,"48.858158956779, 2.3647149920992",Paris,75056,0.6,12
8036,Lisbonne - Monceau,OUI,46,8,38,14,24,OUI,OUI,2025-03-13 12:00:43+00:00,"48.877455676814, 2.3096942214195",Paris,75056,0.8260869565217391,12
21509,Gardenat Lapostol - Franklin Roosevelt,OUI,24,23,1,0,1,OUI,OUI,2025-03-13 11:56:29+00:00,"48.871839, 2.222505",Suresnes,92073,0.041666666666666664,12
6031,Pierre Sarrazin - Saint-Michel,OUI,31,2,29,21,8,OUI,OUI,2025-03-13 12:01:09+00:00,"48.850908146398, 2.342130728066",Paris,75056,0.9354838709677419,12
13054,Pau Casals - Neuve Tolbiac,OUI,53,0,53,19,34,OUI,OUI,2025-03-13 12:01:42+00:00,"48.8311602, 2.3774395",Paris,75056,1.0,12
14133,Froidevaux - Boulard,OUI,35,35,0,0,0,OUI,OUI,2025-03-13 11:55:06+00:00,"48.835147319625, 2.3294411972165",Paris,75056,0.0,12
19130,Place Paul Delouvrier,OUI,26,25,1,0,1,OUI,OUI,2025-03-13 11:56:25+00:00,"48.89197621431365, 2.3851288855075836",Paris,75056,0.038461538461538464,12
4012,Tiron - Rivoli,OUI,27,0,27,17,10,OUI,OUI,2025-03-13 12:01:38+00:00,"48.855692253233, 2.3579058051109",Paris,75056,1.0,12
35012,Candale - Mehul,OUI,25,21,4,1,3,OUI,OUI,2025-03-13 11:56:05+00:00,"48.8893935006175, 2.414379715919495",Pantin,93055,0.16,12
21706,Jean Bleuzen - Square du 11 Novembre,OUI,45,37,8,7,1,OUI,OUI,2025-03-13 11:59:56+00:00,"48.8232579, 2.2965213",Vanves,92075,0.17777777777777778,12
21505,Édouard Vaillant - Place Jean Jaurès,OUI,20,19,1,1,0,OUI,OUI,2025-03-13 11:55:57+00:00,"48.86265537999924, 2.2089037319128613",Suresnes,92073,0.05,12
1014,Rivoli - Musée du Louvre,OUI,20,3,17,8,9,OUI,OUI,2025-03-13 12:00:55+00:00,"48.86364636851945, 2.33409583568573",Paris,75056,0.85,12
16044,Porte de Saint Cloud - Parc des Princes,OUI,31,19,12,6,6,OUI,OUI,2025-03-13 11:58:46+00:00,"48.838662757066, 2.2525164484978",Paris,75056,0.3870967741935484,12
4017,Place de l'Hôtel de Ville,OUI,13,0,13,12,1,OUI,OUI,2025-03-13 11:59:45+00:00,"48.8573314, 2.351458",Paris,75056,1.0,12
4007,Place de la Bastille - Bourdon,OUI,33,3,30,13,17,OUI,OUI,2025-03-13 12:00:06+00:00,"48.852364355271, 2.3681089282036",Paris,75056,0.9090909090909091,12
26006,Bas - Gabriel Péri,OUI,30,15,15,15,0,OUI,OUI,2025-03-13 11:57:15+00:00,"48.91585580539625, 2.2948095202445984",Asnières-sur-Seine,92004,0.5,12
4009,Village Saint-Paul,OUI,27,5,22,21,1,OUI,OUI,2025-03-13 12:00:21+00:00,"48.852639866625, 2.3607301712036",Paris,75056,0.8148148148148148,12
42026,Barbès - Monique Maunoury,OUI,40,40,0,0,0,OUI,OUI,2025-03-13 12:01:29+00:00,"48.81552718820216, 2.3687169334905405",Ivry-sur-Seine,94041,0.0,12
4101,Bastille - Beaumarchais,OUI,20,0,20,16,4,OUI,OUI,2025-03-13 12:00:29+00:00,"48.853833463852, 2.3685702681541",Paris,75056,1.0,12
1012,Jean-Jacques Rousseau - Deux Ecus,OUI,21,1,20,12,8,OUI,OUI,2025-03-13 11:59:22+00:00,"48.86297805972131, 2.3414635285735126",Paris,75056,0.9523809523809523,12
33020,Waldeck Rochet - Germaine Tillon,OUI,30,2,28,15,13,OUI,OUI,2025-03-13 12:00:07+00:00,"48.91105960199651, 2.3676301538944244",Aubervilliers,93001,0.9333333333333333,12
2004,Square Pierre Lazareff,OUI,17,4,13,5,8,OUI,OUI,2025-03-13 12:00:28+00:00,"48.867141720746, 2.3483933508396",Paris,75056,0.7647058823529411,12
32019,Place du 8 mai 1945.,OUI,28,22,6,5,1,OUI,OUI,2025-03-13 11:57:26+00:00,"48.938882272105, 2.3566243797541",Saint-Denis,93066,0.21428571428571427,12
2016,Aboukir - Alexandrie,OUI,21,8,13,13,0,OUI,OUI,2025-03-13 12:01:29+00:00,"48.86868344444473, 2.3502043269474897",Paris,75056,0.6190476190476191,12
9039,Chaussée d'Antin - Haussmann,OUI,23,4,19,13,6,OUI,OUI,2025-03-13 12:00:26+00:00,"48.87243, 2.33359",Paris,75056,0.8260869565217391,12
4018,Saint-Bon - Rivoli,OUI,15,0,15,11,4,OUI,OUI,2025-03-13 11:59:54+00:00,"48.857999643315, 2.3502172809763",Paris,75056,1.0,12
22506,Gare des Vallées,OUI,18,11,7,5,2,OUI,OUI,2025-03-13 11:59:33+00:00,"48.913179, 2.257726",La Garenne-Colombes,92035,0.3888888888888889,12
44001,Quai Jules Guesde - Saint-Simon,OUI,30,2,28,26,2,OUI,OUI,2025-03-13 12:01:00+00:00,"48.80391487219, 2.4089661620274",Vitry-sur-Seine,94081,0.9333333333333333,12
23101,Grande Rue - Europe,OUI,25,18,7,5,2,OUI,OUI,2025-03-13 12:01:08+00:00,"48.8218104687602, 2.205879874527455",Sèvres,92072,0.28,12
5004,Saint-Jacques - Val de Grâce,OUI,19,1,18,2,16,OUI,OUI,2025-03-13 12:00:49+00:00,"48.8417514, 2.3413893",Paris,75056,0.9473684210526315,12
1017,Saint-Honoré - 29 juillet,OUI,18,2,16,11,5,OUI,OUI,2025-03-13 12:00:50+00:00,"48.86557114282421, 2.330567417577153",Paris,75056,0.8888888888888888,12
10041,Gare du Nord - La Chapelle,OUI,18,17,1,1,0,OUI,OUI,2025-03-13 11:57:37+00:00,"48.884178287286, 2.3561057075858",Paris,75056,0.05555555555555555,12
6201,Saint Pères - Saint Germain,OUI,22,13,9,7,2,OUI,OUI,2025-03-13 11:56:02+00:00,"48.853729675265, 2.3300181032703",Paris,75056,0.4090909090909091,12
1025,Oratoire - Rivoli,OUI,17,1,16,9,7,OUI,OUI,2025-03-13 11:53:37+00:00,"48.861342760889, 2.3400047421455",Paris,75056,0.9411764705882353,12
12164,Stade Pershing,OUI,26,26,0,0,0,NON,NON,2025-02-26 05:58:32+00:00,"48.829107826857, 2.4583535268903",Paris,75056,0.0,6
1018,Alger - Rivoli,OUI,14,1,13,8,5,OUI,OUI,2025-03-13 11:58:21+00:00,"48.864773553495, 2.3294493936128",Paris,75056,0.9285714285714286,12
1023,Saint-Honoré - Musée du Louvre,OUI,21,1,20,9,11,OUI,OUI,2025-03-13 12:01:07+00:00,"48.863443132848, 2.3348781846405",Paris,75056,0.9523809523809523,12
2008,Mairie du 2ème,OUI,28,3,25,12,13,OUI,OUI,2025-03-13 11:56:20+00:00,"48.8672190355135, 2.3404625437747044",Paris,75056,0.8928571428571429,12
19202,Marseillaise - Grenade,OUI,43,42,1,0,1,OUI,OUI,2025-03-13 12:01:42+00:00,"48.889371092747, 2.3979396821544",Paris,75056,0.023255813953488372,12
1026,Place du Lieutenant Henri Karcher,OUI,29,0,29,23,6,OUI,OUI,2025-03-13 12:01:21+00:00,"48.863490871724466, 2.3400671035051346",Paris,75056,1.0,12
14201,Decrès - Alésia,OUI,30,30,0,0,0,OUI,OUI,2025-03-13 11:53:34+00:00,"48.832200060759, 2.3139070151575",Paris,75056,0.0,12
18015,Custine - Ramey,OUI,40,38,2,0,2,OUI,OUI,2025-03-13 12:01:35+00:00,"48.888735896947, 2.3469526693225",Paris,75056,0.05,12
5003,Le Goff - Gay-Lussac,OUI,34,12,22,8,14,OUI,OUI,2025-03-13 12:01:09+00:00,"48.846102400979, 2.3412207886577",Paris,75056,0.6470588235294118,12
17106,Berthier - Porte de Clichy,OUI,24,18,6,5,1,OUI,OUI,2025-03-13 12:01:39+00:00,"48.894222687781, 2.3125872006816",Paris,75056,0.25,12
27001,Square Victor Basch,OUI,19,6,13,10,3,OUI,OUI,2025-03-13 12:01:36+00:00,"48.914304862261, 2.2289156913757",Colombes,92025,0.6842105263157895,12
1116,Ventadour - Opéra,OUI,25,3,22,10,12,OUI,OUI,2025-03-13 11:59:20+00:00,"48.866810653323, 2.3343884482519",Paris,75056,0.88,12
28005,Jean Jaurès - Paul Lafargue,OUI,25,4,21,5,16,OUI,OUI,2025-03-13 11:59:25+00:00,"48.884933177666, 2.2484488785267",Puteaux,92062,0.84,12
32024,Port - Confluence,OUI,23,19,4,3,1,OUI,OUI,2025-03-13 12:00:00+00:00,"48.936093926526, 2.3436167797955",Saint-Denis,93066,0.17391304347826086,12
6007,Bréa - Raspail,OUI,23,7,16,6,10,OUI,OUI,2025-03-13 11:58:47+00:00,"48.842738478258, 2.3297942217634",Paris,75056,0.6956521739130435,12
15040,Saint-Amand - Labrouste,OUI,34,31,3,2,1,OUI,OUI,2025-03-13 11:57:17+00:00,"48.834097274832295, 2.3087677359581",Paris,75056,0.08823529411764706,12
42028,Verdun - Carnot,OUI,28,25,3,3,0,OUI,OUI,2025-03-13 12:01:30+00:00,"48.808439376064946, 2.373795211315155",Ivry-sur-Seine,94041,0.10714285714285714,12
23107,Gare de Sèvres - Ville d'Avray,OUI,22,17,5,3,2,OUI,OUI,2025-03-13 11:54:58+00:00,"48.826262366227, 2.2001516849313",Sèvres,92072,0.22727272727272727,12
12166,Parc Floral du Bel Air,OUI,24,12,12,6,6,OUI,OUI,2025-03-13 12:01:07+00:00,"48.839285711865735, 2.438560165464878",Paris,75056,0.5,12
6026,Saint-Placide - Cherche Midi,OUI,66,42,24,15,9,OUI,OUI,2025-03-13 12:01:01+00:00,"48.8490535919234, 2.325317971408367",Paris,75056,0.36363636363636365,12
12113,Cardinal Lavigerie,OUI,46,7,39,28,11,OUI,OUI,2025-03-13 12:01:26+00:00,"48.832934193699835, 2.402636749399156",Paris,75056,0.8478260869565217,12
22601,Marx Dormoy - Château Sainte-Barbe,OUI,20,19,1,0,1,OUI,OUI,2025-03-13 11:52:19+00:00,"48.791782341055324, 2.297856844961643",Fontenay-aux-Roses,92032,0.05,12
21119,Belfort - Victor Hugo,OUI,21,5,16,13,3,OUI,OUI,2025-03-13 12:01:15+00:00,"48.9018492, 2.3172724",Clichy,92024,0.7619047619047619,12
42018,Amédée Huon - Fort d'Ivry,OUI,31,26,5,1,4,OUI,OUI,2025-03-13 12:01:24+00:00,"48.805131376899986, 2.388489693403244",Ivry-sur-Seine,94041,0.16129032258064516,12
16201,Porte Dauphine,OUI,60,38,22,6,16,OUI,OUI,2025-03-13 12:00:19+00:00,"48.871139344351, 2.2749781616017",Paris,75056,0.36666666666666664,12
48008,Guy Môquet - Parvis Georges Marchais,OUI,30,30,0,0,0,OUI,OUI,2025-03-13 12:01:15+00:00,"48.79518840095975, 2.35943466424942",Villejuif,94076,0.0,12
23042,André Theuriet - Blagis,OUI,30,18,12,8,4,OUI,OUI,2025-03-13 11:59:45+00:00,"48.77977325745441, 2.3130525648593903",Bourg-la-Reine,92014,0.4,12
17021,Jouffroy d'Abbans - Villiers,OUI,30,22,8,7,1,OUI,OUI,2025-03-13 12:01:11+00:00,"48.884215547037, 2.3056533560157",Paris,75056,0.26666666666666666,12
42019,Lampes,OUI,43,4,39,36,3,OUI,OUI,2025-03-13 11:59:31+00:00,"48.81152481985875, 2.4017931148409843",Ivry-sur-Seine,94041,0.9069767441860465,12
32020,Jules Guesdes - Carnot,OUI,14,14,0,0,0,OUI,OUI,2025-03-13 11:54:53+00:00,"48.93828169931872, 2.3508992046117783",Saint-Denis,93066,0.0,12
3007,Archives - Pastourelle,OUI,26,3,23,13,10,OUI,OUI,2025-03-13 12:00:42+00:00,"48.8623615, 2.3595041",Paris,75056,0.8846153846153846,12
27006,Victor Hugo - Gare,OUI,19,15,4,3,1,OUI,OUI,2025-03-13 11:55:12+00:00,"48.923133952658, 2.2600970417261",Colombes,92025,0.21052631578947367,12
31020,Résistance - Parmentier,OUI,32,32,0,0,0,OUI,OUI,2025-03-13 11:54:43+00:00,"48.85965138131299, 2.436705082654953",Montreuil,93048,0.0,12
1015,Place André Malraux,OUI,16,3,13,8,5,OUI,OUI,2025-03-13 11:59:35+00:00,"48.863925158727, 2.3356226831675",Paris,75056,0.8125,12
35005,Quai de l'Aisne - Général Leclerc,OUI,26,24,2,0,2,OUI,OUI,2025-03-13 12:00:36+00:00,"48.895713, 2.400571",Pantin,93055,0.07692307692307693,12
1008,Les Halles - Saint-Eustache,OUI,32,6,26,14,12,OUI,OUI,2025-03-13 11:58:30+00:00,"48.86362695901683, 2.342623919248581",Paris,75056,0.8125,12
18112,Arthur Ranc - Hôpital Bichat,OUI,23,13,10,5,5,OUI,OUI,2025-03-13 12:00:56+00:00,"48.8978712500682, 2.333521842956543",Paris,75056,0.43478260869565216,12
1024,Coquillière - Louvre,OUI,17,0,17,4,13,OUI,OUI,2025-03-13 11:58:31+00:00,"48.863795909662, 2.3425736278296",Paris,75056,1.0,12
16139,Suresnes - Muette à Neuilly,OUI,26,23,3,2,1,OUI,OUI,2025-03-13 11:54:32+00:00,"48.868570404348, 2.266000919044",Paris,75056,0.11538461538461539,12
19046,Porte de Pantin.,OUI,33,32,1,0,1,OUI,OUI,2025-03-13 11:52:44+00:00,"48.889199725577, 2.3950181901455",Paris,75056,0.030303030303030304,12
22603,Place de la Division Leclerc,OUI,33,33,0,0,0,OUI,OUI,2025-03-13 11:59:57+00:00,"48.793824988636516, 2.2731140430551027",Fontenay-aux-Roses,92032,0.0,12
23301,Les Blagis,OUI,24,10,14,12,2,OUI,OUI,2025-03-13 12:01:09+00:00,"48.785205, 2.302526",Sceaux,92071,0.5833333333333334,12
16010,Belles Feuilles - Place de Mexico,OUI,22,15,7,2,5,OUI,OUI,2025-03-13 12:01:37+00:00,"48.865804746474, 2.2829206287861",Paris,75056,0.3181818181818182,12
34013,Blanqui - Docteur Bauer,OUI,20,5,15,7,8,OUI,OUI,2025-03-13 12:01:43+00:00,"48.907735489085, 2.3407192814591",Saint-Ouen-sur-Seine,93070,0.75,12
44008,Youri Gagarine - Commune de Paris,OUI,32,14,18,10,8,OUI,OUI,2025-03-13 11:58:53+00:00,"48.782427463041, 2.3939734697342",Vitry-sur-Seine,94081,0.5625,12
2006,Place des Victoires,OUI,23,4,19,14,5,OUI,OUI,2025-03-13 12:01:41+00:00,"48.8660354, 2.3420333",Paris,75056,0.8260869565217391,12
23104,Quai de Sèvres - Manufacture Nationale,OUI,27,14,13,5,8,OUI,OUI,2025-03-13 12:00:40+00:00,"48.828688, 2.22499",Sèvres,92072,0.48148148148148145,12
9019,Victor Massé - Jean-Baptiste Pigalle,OUI,18,15,3,0,3,OUI,OUI,2025-03-13 11:58:22+00:00,"48.8811043724, 2.3366955667734",Paris,75056,0.16666666666666666,12
21011,Silly - Louis Blériot,OUI,23,0,23,8,15,OUI,OUI,2025-03-13 12:00:48+00:00,"48.83219045374266, 2.2340199351310734",Boulogne-Billancourt,92012,1.0,12
44004,Place de l'Eglise - Vitry-sur-Seine,OUI,28,4,24,22,2,OUI,OUI,2025-03-13 12:00:55+00:00,"48.791922819921815, 2.395057752728462",Vitry-sur-Seine,94081,0.8571428571428571,12
20010,Sorbier - Gasnier-Guy,OUI,34,34,0,0,0,OUI,OUI,2025-03-13 12:00:10+00:00,"48.865217631011, 2.3936596512794",Paris,75056,0.0,12
2102,Saint-Marc - Feydeau,OUI,36,9,27,14,13,OUI,OUI,2025-03-13 12:01:05+00:00,"48.870326843044, 2.3418715826353",Paris,75056,0.75,12
42022,Gare RER - Maurice Grandcoing,OUI,37,5,32,29,3,OUI,OUI,2025-03-13 11:59:40+00:00,"48.813881, 2.392429",Ivry-sur-Seine,94041,0.8648648648648649,12
2020,Danielle Casanova - Opéra,OUI,20,1,19,8,11,OUI,OUI,2025-03-13 12:01:17+00:00,"48.867643242297, 2.3333894088864",Paris,75056,0.95,12
26012,Jardin Modèle - Pierre Boudou,OUI,15,13,2,0,2,OUI,OUI,2025-03-13 12:00:30+00:00,"48.914866710946, 2.3057010525935",Asnières-sur-Seine,92004,0.13333333333333333,12
20048,Bagnolet - Place Saint-Blaise,OUI,27,26,1,1,0,OUI,OUI,2025-03-13 12:00:32+00:00,"48.85973, 2.40334",Paris,75056,0.037037037037037035,12
10201,Magenta - Chabrol,OUI,23,20,3,1,2,OUI,OUI,2025-03-13 11:56:03+00:00,"48.876495350882, 2.3560990020633",Paris,75056,0.13043478260869565,12
45004,République - Louis Loucheur,OUI,37,5,32,4,28,OUI,OUI,2025-03-13 12:01:05+00:00,"48.823549261189, 2.5101865455508",Champigny-sur-Marne,94017,0.8648648648648649,12
6029,Vaugirard - Monsieur le Prince,OUI,24,3,21,9,12,OUI,OUI,2025-03-13 12:01:34+00:00,"48.848951441614, 2.3411329463124",Paris,75056,0.875,12
13049,Vincent Auriol - Louise Weiss,OUI,22,6,16,10,6,OUI,OUI,2025-03-13 12:00:16+00:00,"48.834001935501, 2.3703888058662",Paris,75056,0.7272727272727273,12
12016,Saint-Mande - Picpus,OUI,34,30,4,1,3,OUI,OUI,2025-03-13 12:01:25+00:00,"48.845127728278, 2.4015686296482",Paris,75056,0.11764705882352941,12
32605,Mairie,OUI,19,18,1,0,1,OUI,OUI,2025-03-13 12:00:01+00:00,"48.87914304162, 2.4163350908311",Les Lilas,93045,0.05263157894736842,12
42210,Victor Hugo - Paul Eluard,OUI,31,6,25,23,2,OUI,OUI,2025-03-13 11:56:56+00:00,"48.819602554907, 2.4114319673051",Charenton-le-Pont,94018,0.8064516129032258,12
8202,Londres - Europe,OUI,27,22,5,2,3,OUI,OUI,2025-03-13 11:57:18+00:00,"48.878618556803, 2.3248164693922",Paris,75056,0.18518518518518517,12
20140,Paganini - Davout,OUI,21,18,3,2,1,OUI,OUI,2025-03-13 11:55:21+00:00,"48.85135, 2.412021",Paris,75056,0.14285714285714285,12
17020,Jouffroy d'Abbans - Malesherbes,OUI,26,21,5,1,4,OUI,OUI,2025-03-13 11:56:50+00:00,"48.8850134, 2.3070717",Paris,75056,0.19230769230769232,12
48012,Stalingrad - Henri Luisette,OUI,26,23,3,2,1,OUI,OUI,2025-03-13 12:01:17+00:00,"48.78363092456589, 2.366935946761926",Villejuif,94076,0.11538461538461539,12
12202,Charenton - Wattignies,OUI,40,38,2,2,0,OUI,OUI,2025-03-13 12:00:39+00:00,"48.836919119234, 2.3916775206425",Paris,75056,0.05,12
23303,Gare de Robinson,OUI,29,29,0,0,0,OUI,OUI,2025-03-13 11:53:54+00:00,"48.7799259211605, 2.281828634440899",Sceaux,92071,0.0,12
10202,Bichat - Grange aux Belles,OUI,28,26,2,1,1,OUI,OUI,2025-03-13 11:59:33+00:00,"48.873688, 2.365015",Paris,75056,0.07142857142857142,12
15018,Dutot - Place Alleray,OUI,56,51,5,0,5,OUI,OUI,2025-03-13 12:00:23+00:00,"48.836826091766, 2.3071701095578",Paris,75056,0.08928571428571429,12
8018,Saint-Augustin,OUI,29,1,28,12,16,OUI,OUI,2025-03-13 12:01:29+00:00,"48.8762009747008, 2.319786250591278",Paris,75056,0.9655172413793104,12
10166,Strasbourg - Saint-Denis,OUI,16,3,13,6,7,OUI,OUI,2025-03-13 12:01:40+00:00,"48.869601642433, 2.3542908579111",Paris,75056,0.8125,12
23202,Henri Barbusse - Gabriel Péri,OUI,17,14,3,0,3,OUI,OUI,2025-03-13 11:57:09+00:00,"48.801773795836, 2.2874166362216",Châtillon,92020,0.17647058823529413,12
48001,Chastenet de Géry - Marcel Paul,OUI,25,24,1,0,1,OUI,OUI,2025-03-13 11:58:51+00:00,"48.800123, 2.3567359",Villejuif,94076,0.04,12
6015,André Mazet - Saint-André des Arts,OUI,55,0,55,49,6,OUI,OUI,2025-03-13 12:01:27+00:00,"48.85375581057431, 2.3390958085656166",Paris,75056,1.0,12
18135,Ney - Porte de Montmartre,OUI,23,18,5,2,3,OUI,OUI,2025-03-13 12:01:27+00:00,"48.897918, 2.3364872",Paris,75056,0.21739130434782608,12
17202,Mariotte - Batignolles,OUI,18,14,4,1,3,OUI,OUI,2025-03-13 12:00:22+00:00,"48.884571659595, 2.321469503475",Paris,75056,0.2222222222222222,12
24101,Place Charles de Gaulle,OUI,24,22,2,0,2,OUI,OUI,2025-03-13 11:59:50+00:00,"48.826073335699, 2.1894485725692",Ville-d'Avray,92077,0.08333333333333333,12
32011,Stade de France - Francis de Pressensé,OUI,43,0,43,6,37,OUI,OUI,2025-03-13 12:01:42+00:00,"48.919141953558, 2.3620655760169",Saint-Denis,93066,1.0,12
34011,Clef des Champs - Albert Dhalenne,OUI,25,1,24,13,11,OUI,OUI,2025-03-13 11:58:03+00:00,"48.914938, 2.330665",Saint-Ouen-sur-Seine,93070,0.96,12
23206,Béranger - Félix Faure,OUI,26,26,0,0,0,OUI,OUI,2025-03-13 11:53:55+00:00,"48.80404828621485, 2.2848263373723436",Châtillon,92020,0.0,12
21329,Gare - Aristide Briand,OUI,28,7,21,16,5,OUI,OUI,2025-03-13 12:01:25+00:00,"48.821410564722, 2.2555950104387",Issy-les-Moulineaux,92040,0.75,12
8040,Pierre Charron - Champs-Elysées,OUI,30,2,28,11,17,OUI,OUI,2025-03-13 11:58:54+00:00,"48.870103359864, 2.3043501377106",Paris,75056,0.9333333333333333,12
21704,Place du Maréchal de Lattre de Tassigny,OUI,27,23,4,1,3,OUI,OUI,2025-03-13 12:00:43+00:00,"48.821707715257055, 2.2853431485432423",Vanves,92075,0.14814814814814814,12
42030,Stéphanie Bouvard - Gambetta,OUI,30,21,9,7,2,OUI,OUI,2025-03-13 11:59:54+00:00,"48.814548138856, 2.4024386957288",Ivry-sur-Seine,94041,0.3,12
19121,Belleville -  Pré Saint-Gervais,OUI,21,21,0,0,0,OUI,OUI,2025-03-13 11:57:37+00:00,"48.875565910073, 2.3930460959673",Paris,75056,0.0,12
19114,Manin - Secrétan,OUI,20,20,0,0,0,OUI,OUI,2025-03-13 11:53:27+00:00,"48.8791665, 2.3787959",Paris,75056,0.0,12
20142,Mûriers - Père Lachaise,OUI,19,18,1,1,0,OUI,OUI,2025-03-13 11:55:32+00:00,"48.864130509668044, 2.39164982067019",Paris,75056,0.05263157894736842,12
12123,Château de Vincennes,OUI,49,40,9,4,5,OUI,OUI,2025-03-13 12:00:26+00:00,"48.84423193255657, 2.439209537709179",Paris,75056,0.1836734693877551,12
51008,Martyrs de Châteaubriant - Jean Grandel,OUI,38,27,11,1,10,OUI,OUI,2025-03-13 11:57:14+00:00,"48.951432, 2.211214",Argenteuil,95018,0.2894736842105263,12
5027,Gobelins - Port-Royal,OUI,36,6,30,25,5,OUI,OUI,2025-03-13 12:01:29+00:00,"48.837135900263, 2.3515201359987",Paris,75056,0.8333333333333334,12
13015,Chevaleret - Louise Weiss,OUI,35,8,27,13,14,OUI,OUI,2025-03-13 12:00:42+00:00,"48.832586513351, 2.37121138812",Paris,75056,0.7714285714285715,12
11111,Léon Frot - Charonne,OUI,18,14,4,0,4,OUI,OUI,2025-03-13 11:59:57+00:00,"48.854963800335234, 2.387217085372007",Paris,75056,0.2222222222222222,12
25007,Bons Raisins - Voltaire,OUI,24,22,2,1,1,OUI,OUI,2025-03-13 12:00:16+00:00,"48.87282451461399, 2.1947155570850896",Rueil-Malmaison,92063,0.08333333333333333,12
48006,Maxime Gorki - Paul Vaillant-Couturier,OUI,19,19,0,0,0,OUI,OUI,2025-03-13 12:00:51+00:00,"48.79673508795443, 2.3683342337608337",Villejuif,94076,0.0,12
21002,Place Denfert-Rochereau,OUI,19,8,11,4,7,OUI,OUI,2025-03-13 11:59:39+00:00,"48.843252536286684, 2.245987951755524",Boulogne-Billancourt,92012,0.5789473684210527,12
15012,Cambronne - Mademoiselle,OUI,66,60,6,4,2,OUI,OUI,2025-03-13 12:00:55+00:00,"48.843277330035214, 2.30230766886348",Paris,75056,0.09090909090909091,12
13024,Bobillot - Tolbiac,OUI,33,28,5,0,5,OUI,OUI,2025-03-13 11:59:28+00:00,"48.8255961335041, 2.350204177200794",Paris,75056,0.15151515151515152,12
18016,Francoeur - Caulaincourt,OUI,33,32,1,0,1,OUI,OUI,2025-03-13 11:56:58+00:00,"48.8899944409612, 2.342529706656933",Paris,75056,0.030303030303030304,12
24004,Paix - Verdun,OUI,33,29,4,1,3,OUI,OUI,2025-03-13 12:00:19+00:00,"48.900504, 2.261173",Courbevoie,92026,0.12121212121212122,12
19117,Euryale Dehaynin - Loire,OUI,29,24,5,1,4,OUI,OUI,2025-03-13 12:01:41+00:00,"48.886248917304805, 2.3774591088294987",Paris,75056,0.1724137931034483,12
23041,Général Leclerc - Bièvre,OUI,24,17,7,3,4,OUI,OUI,2025-03-13 12:00:55+00:00,"48.782414428747316, 2.3166695237159733",Bourg-la-Reine,92014,0.2916666666666667,12
20003,Pyrénées - Cours de Vincennes,OUI,19,12,7,2,5,OUI,OUI,2025-03-13 12:01:32+00:00,"48.847796779935, 2.4061721563339",Paris,75056,0.3684210526315789,12
24005,Edith Cavell - Volta,OUI,32,29,3,0,3,OUI,OUI,2025-03-13 12:01:43+00:00,"48.901616564286975, 2.269354350864887",Courbevoie,92026,0.09375,12
10003,Hauteville - Bonne Nouvelle,OUI,17,4,13,6,7,OUI,OUI,2025-03-13 11:57:30+00:00,"48.87077436024, 2.3496496368327",Paris,75056,0.7647058823529411,12
31104,Mairie de Rosny-sous-Bois,OUI,26,14,12,10,2,OUI,OUI,2025-03-13 11:59:34+00:00,"48.871256519012, 2.4865807592869",Rosny-sous-Bois,93064,0.46153846153846156,12
13028,Gouthière - Poterne des Peupliers,OUI,32,28,4,2,2,OUI,OUI,2025-03-13 11:58:43+00:00,"48.820507, 2.351342",Paris,75056,0.125,12
42024,Danielle Casanova - Ledru-Rollin,OUI,28,7,21,19,2,OUI,OUI,2025-03-13 11:56:18+00:00,"48.815783497876815, 2.383259721100331",Ivry-sur-Seine,94041,0.75,12
20012,Buzenval - Vignoles,OUI,17,16,1,0,1,OUI,OUI,2025-03-13 11:57:22+00:00,"48.853858171688, 2.4000040814281",Paris,75056,0.058823529411764705,12
15203,Porte de Versailles,OUI,27,18,9,3,6,OUI,OUI,2025-03-13 12:01:42+00:00,"48.832324016657, 2.2875617349045",Paris,75056,0.3333333333333333,12
14027,Gergovie - Alésia,OUI,54,52,2,0,2,OUI,OUI,2025-03-13 12:00:39+00:00,"48.83088717455243, 2.318882101207347",Paris,75056,0.037037037037037035,12
13116,Place du Docteur Yersin,OUI,50,49,1,0,1,OUI,OUI,2025-03-13 12:00:48+00:00,"48.82010494991975, 2.3725583776831627",Paris,75056,0.02,12
42303,Place Eustache Deschamps,OUI,20,14,6,4,2,OUI,OUI,2025-03-13 12:01:03+00:00,"48.793855, 2.336637",Cachan,94016,0.3,12
15053,Lecourbe - Convention,OUI,44,37,7,6,1,OUI,OUI,2025-03-13 11:58:43+00:00,"48.83923319241899, 2.2915197908878326",Paris,75056,0.1590909090909091,12
48002,LCL Campus - Place Oscar Niemeyer,OUI,37,37,0,0,0,OUI,OUI,2025-03-13 11:55:41+00:00,"48.805342480621576, 2.363983690738678",Villejuif,94076,0.0,12
21022,Dôme - République,OUI,24,0,24,15,9,OUI,OUI,2025-03-13 11:53:48+00:00,"48.832681, 2.250257",Boulogne-Billancourt,92012,1.0,12
41605,Général De Gaulle - Vivien,OUI,20,19,1,0,1,OUI,OUI,2025-03-13 11:52:21+00:00,"48.83607420090204, 2.4189166724681854",Saint-Mandé,94067,0.05,12
15041,Franquet - Labrouste,OUI,37,37,0,0,0,OUI,OUI,2025-03-13 12:01:36+00:00,"48.83287705011431, 2.306762784719467",Paris,75056,0.0,12
30003,Moscou - Edouard Vaillant,OUI,29,20,9,4,5,OUI,OUI,2025-03-13 12:00:02+00:00,"48.90755810177, 2.4689837335263",Bobigny,93008,0.3103448275862069,12
11022,Roquette - Auguste Laurent,OUI,16,16,0,0,0,OUI,OUI,2025-03-13 12:01:37+00:00,"48.858001906023354, 2.381797702650783",Paris,75056,0.0,12
12008,Hector Malot - Daumesnil,OUI,52,1,51,47,4,OUI,OUI,2025-03-13 12:00:53+00:00,"48.84693552991762, 2.3770876228809357",Paris,75056,0.9807692307692307,12
41103,Place de la vache noire,OUI,23,21,2,1,1,OUI,OUI,2025-03-13 12:00:44+00:00,"48.81040517059777, 2.327060401439667",Arcueil,94003,0.08695652173913043,12
15024,Suffren - La Motte-Piquet,OUI,23,10,13,10,3,OUI,OUI,2025-03-13 12:00:48+00:00,"48.850881230919, 2.3012199997902",Paris,75056,0.5652173913043478,12
41602,Place Charles Digeon,OUI,31,27,4,4,0,OUI,OUI,2025-03-13 12:00:31+00:00,"48.84354203133597, 2.418427169322968",Saint-Mandé,94067,0.12903225806451613,12
16017,Siam - La Pompe,OUI,16,13,3,0,3,OUI,OUI,2025-03-13 11:52:39+00:00,"48.861720329027264, 2.275346568555312",Paris,75056,0.1875,12
15069,Félix Faure - Convention,OUI,44,25,19,15,4,OUI,OUI,2025-03-13 12:01:39+00:00,"48.841249336041, 2.2883866008495",Paris,75056,0.4318181818181818,12
20013,Alexandre Dumas - Place de la Réunion,OUI,45,44,1,0,1,OUI,OUI,2025-03-13 11:56:14+00:00,"48.85533710742046, 2.3997703687646292",Paris,75056,0.022222222222222223,12
14004,Port Royal - Hôpital Cochin,OUI,22,9,13,6,7,OUI,OUI,2025-03-13 12:00:00+00:00,"48.838608030238, 2.3406994164846",Paris,75056,0.5909090909090909,12
25004,Marcel Pourtout - Édouard Manet,OUI,24,6,18,17,1,OUI,OUI,2025-03-13 11:59:20+00:00,"48.87555620763429, 2.1655967831611638",Rueil-Malmaison,92063,0.75,12
35013,Guillaume Tell - Parc Henri Barbusse,OUI,20,18,2,0,2,OUI,OUI,2025-03-13 11:56:13+00:00,"48.88958925894009, 2.4198862910270695",Pantin,93055,0.1,12
12022,Sahel - Général Michel Bizot,OUI,30,28,2,2,0,OUI,OUI,2025-03-13 12:00:38+00:00,"48.840872964793355, 2.4044444784522057",Paris,75056,0.06666666666666667,12
20020,Pyrénées - Charles Renouvier,OUI,29,28,1,0,1,OUI,OUI,2025-03-13 11:57:38+00:00,"48.86095933229224, 2.400421852042113",Paris,75056,0.034482758620689655,12
21023,Ancienne Mairie - André Morizet,OUI,25,11,14,8,6,OUI,OUI,2025-03-13 12:01:26+00:00,"48.838311, 2.234077",Boulogne-Billancourt,92012,0.56,12
12102,Bercy - Traversiére,OUI,30,1,29,22,7,OUI,OUI,2025-03-13 12:00:49+00:00,"48.846192642574, 2.3703800886869",Paris,75056,0.9666666666666667,12
31105,Lavoisier - Missak Manouchian,OUI,13,9,4,1,3,OUI,OUI,2025-03-13 12:01:06+00:00,"48.86286468896063, 2.495676465332508",Rosny-sous-Bois,93064,0.3076923076923077,12
13120,Pierre Joseph Desault,OUI,18,8,10,10,0,OUI,OUI,2025-03-13 12:01:27+00:00,"48.82110230800372, 2.378775402903557",Paris,75056,0.5555555555555556,12
17110,Legendre - Nollet,OUI,29,23,6,2,4,OUI,OUI,2025-03-13 11:59:25+00:00,"48.887742186754224, 2.320293079881375",Paris,75056,0.20689655172413793,12
12119,Dom-Pérignon - Gravelle,OUI,45,25,20,18,2,OUI,OUI,2025-03-13 12:01:18+00:00,"48.825481574435, 2.409880310297",Paris,75056,0.4444444444444444,12
31701,Mairie de Bagnolet,OUI,28,28,0,0,0,OUI,OUI,2025-03-13 12:01:09+00:00,"48.868421318555, 2.4179587885737",Bagnolet,93006,0.0,12
13006,Duméril - Jeanne d'Arc,OUI,40,26,14,9,5,OUI,OUI,2025-03-13 12:00:39+00:00,"48.838151608087, 2.3571084495564",Paris,75056,0.35,12
22404,Pierre Brossolette - 12 Février 1934,OUI,23,20,3,2,1,OUI,OUI,2025-03-13 11:59:34+00:00,"48.8176962416867, 2.3076123744249344",Malakoff,92046,0.13043478260869565,12
43007,Hôtel de Ville de Vincennes,OUI,26,25,1,1,0,OUI,OUI,2025-03-13 12:00:18+00:00,"48.84827609706963, 2.4398955702781677",Vincennes,94080,0.038461538461538464,12
20032,Square des Amandiers,OUI,26,26,0,0,0,OUI,OUI,2025-03-13 11:52:52+00:00,"48.86615630668046, 2.3891324177384377",Paris,75056,0.0,12
15050,Dominique Pado - Croix Nivert,OUI,22,17,5,1,4,OUI,OUI,2025-03-13 11:58:55+00:00,"48.83648798164934, 2.2897250577807426",Paris,75056,0.22727272727272727,12
20014,Charonne - Alexandre Dumas,OUI,34,31,3,0,3,OUI,OUI,2025-03-13 12:00:37+00:00,"48.856077415056, 2.3948693275452",Paris,75056,0.08823529411764706,12
16025,Jean de la Fontaine - Boulainvilliers,OUI,66,7,59,45,14,OUI,OUI,2025-03-13 12:01:20+00:00,"48.85264791461651, 2.2758664190769196",Paris,75056,0.8939393939393939,12
14035,Maine - Jean Zay,OUI,47,38,9,4,5,OUI,OUI,2025-03-13 12:00:27+00:00,"48.837925263898, 2.3225428909063",Paris,75056,0.19148936170212766,12
13036,Olympiades,OUI,36,32,4,0,4,OUI,OUI,2025-03-13 12:00:47+00:00,"48.826764665199, 2.3650860786438",Paris,75056,0.1111111111111111,12
8046,Marceau - Président Wilson,OUI,29,6,23,17,6,OUI,OUI,2025-03-13 12:00:49+00:00,"48.8652359, 2.3002513",Paris,75056,0.7931034482758621,12
43004,Montreuil - République,OUI,22,20,2,2,0,OUI,OUI,2025-03-13 12:00:42+00:00,"48.85026349463687, 2.4345204234123234",Vincennes,94080,0.09090909090909091,12
17006,Guy Môquet - Compoint,OUI,35,34,1,1,0,OUI,OUI,2025-03-13 11:56:56+00:00,"48.89213559044868, 2.32321947813034",Paris,75056,0.02857142857142857,12
14009,Tombe Issoire - René Coty,OUI,35,34,1,1,0,OUI,OUI,2025-03-13 11:57:23+00:00,"48.830512876709, 2.3343613743782",Paris,75056,0.02857142857142857,12
6028,Quatre Vents - Carrefour de l'Odéon,OUI,37,11,26,17,9,OUI,OUI,2025-03-13 11:59:13+00:00,"48.851751374458864, 2.338161695134053",Paris,75056,0.7027027027027027,12
17117,Pereire - Saussure,OUI,31,27,4,1,3,OUI,OUI,2025-03-13 11:57:41+00:00,"48.888229075478, 2.3101296275854",Paris,75056,0.12903225806451613,12
21207,Verdier - République,OUI,29,27,2,1,1,OUI,OUI,2025-03-13 11:59:20+00:00,"48.815403766277, 2.31739372015",Montrouge,92049,0.06896551724137931,12
18021,Marcadet - Ramey,OUI,21,20,1,0,1,OUI,OUI,2025-03-13 11:59:16+00:00,"48.890875, 2.3449019",Paris,75056,0.047619047619047616,12
15120,Colonel Pierre Avia,OUI,28,17,11,11,0,OUI,OUI,2025-03-13 12:01:29+00:00,"48.8296843300915, 2.275342586850291",Paris,75056,0.39285714285714285,12
16116,George Sand - Jean de La Fontaine,OUI,29,20,9,6,3,OUI,OUI,2025-03-13 11:57:36+00:00,"48.84986918764119, 2.268257387525699",Paris,75056,0.3103448275862069,12
21205,Arthur Auger - Jean Jaurès,OUI,22,19,3,3,0,OUI,OUI,2025-03-13 11:51:58+00:00,"48.813736445585235, 2.3069277405738835",Montrouge,92049,0.13636363636363635,12
5033,Saint-Séverin - Saint-Michel,OUI,30,4,26,17,9,OUI,OUI,2025-03-13 12:00:39+00:00,"48.852731305488, 2.3440927639604",Paris,75056,0.8666666666666667,12
24007,Jean-Baptiste Charcot - Sainte-Geneviève,OUI,21,19,2,2,0,OUI,OUI,2025-03-13 12:01:09+00:00,"48.90310883721567, 2.278892956674099",Courbevoie,92026,0.09523809523809523,12
15045,Porte de la Plaine,OUI,35,32,3,2,1,OUI,OUI,2025-03-13 11:58:04+00:00,"48.82805169605981, 2.2924277186393742",Paris,75056,0.08571428571428572,12
15014,Volontaires - Vaugirard,OUI,33,27,6,2,4,OUI,OUI,2025-03-13 12:00:28+00:00,"48.84132050184004, 2.30808901725357",Paris,75056,0.18181818181818182,12
15027,Duhamel - André Gide,OUI,20,20,0,0,0,OUI,OUI,2025-03-13 11:53:50+00:00,"48.8365662244334, 2.312707121097412",Paris,75056,0.0,12
13055,M.- A. Lagroua Weill-Hallé -  F. Dolto,OUI,59,15,44,23,21,OUI,OUI,2025-03-13 12:01:05+00:00,"48.828595283857425, 2.380220606266108",Paris,75056,0.7457627118644068,12
42205,Place Aristide Briand,OUI,35,21,14,11,3,OUI,OUI,2025-03-13 12:00:00+00:00,"48.82189236575831, 2.413003742694855",Charenton-le-Pont,94018,0.4,12
21027,Fief - République,OUI,25,0,25,21,4,OUI,OUI,2025-03-13 12:01:41+00:00,"48.83170888166024, 2.255771979689598",Boulogne-Billancourt,92012,1.0,12
22701,Général Leclerc - République,OUI,28,11,17,16,1,OUI,OUI,2025-03-13 11:59:38+00:00,"48.915885074177, 2.2682306702811",Bois-Colombes,92009,0.6071428571428571,12
15113,Arsonval - Falguière,OUI,24,20,4,0,4,OUI,OUI,2025-03-13 11:57:40+00:00,"48.84040040365445, 2.313117867297474",Paris,75056,0.16666666666666666,12
30004,Jean Jaurès - Place de la Libération,OUI,28,3,25,11,14,OUI,OUI,2025-03-13 11:59:58+00:00,"48.90617751921, 2.4391458057475",Bobigny,93008,0.8928571428571429,12
16022,Jean Bologne - Passy,OUI,19,17,2,1,1,OUI,OUI,2025-03-13 11:59:24+00:00,"48.857566889784465, 2.280027395306772",Paris,75056,0.10526315789473684,12
20110,Gambetta - Tourelles,OUI,20,19,1,0,1,OUI,OUI,2025-03-13 11:53:07+00:00,"48.875337902264, 2.4059921130538",Paris,75056,0.05,12
20011,Pyrénées - Dagorno,OUI,20,19,1,0,1,OUI,OUI,2025-03-13 12:01:24+00:00,"48.855425770695085, 2.4051643162965775",Paris,75056,0.05,12
14005,René Coty - Place Denfert-Rochereau,OUI,36,30,6,1,5,OUI,OUI,2025-03-13 11:59:29+00:00,"48.833056477316, 2.3329411447048",Paris,75056,0.16666666666666666,12
12040,Porte de Charenton,OUI,66,56,10,5,5,OUI,OUI,2025-03-13 12:01:07+00:00,"48.831240105856, 2.3989107459784",Paris,75056,0.15151515151515152,12
8007,Rome - Provence,OUI,29,9,20,19,1,OUI,OUI,2025-03-13 12:00:51+00:00,"48.874230055580306, 2.325570111724113",Paris,75056,0.6896551724137931,12
20106,Mairie du 20ème,OUI,27,24,3,1,2,OUI,OUI,2025-03-13 11:59:18+00:00,"48.865302324275, 2.3990669846535",Paris,75056,0.1111111111111111,12
21218,Gabriel Péri - Place de la Libération,OUI,17,15,2,2,0,OUI,OUI,2025-03-13 12:01:16+00:00,"48.819828421929, 2.3117361743705",Montrouge,92049,0.11764705882352941,12
6020,Place Saint-André des Arts,OUI,33,3,30,17,13,OUI,OUI,2025-03-13 12:00:55+00:00,"48.852886173881, 2.3426544293761",Paris,75056,0.9090909090909091,12
18101,Championnet.,OUI,20,19,1,0,1,OUI,OUI,2025-03-13 11:54:54+00:00,"48.8953643, 2.3498166",Paris,75056,0.05,12
5105,Geoffroy-Saint-Hilaire - Saint-Marcel,OUI,17,8,9,4,5,OUI,OUI,2025-03-13 12:00:38+00:00,"48.83907826424974, 2.356877340669728",Paris,75056,0.5294117647058824,12
20005,Reynaldo Hahn - Lagny,OUI,19,17,2,1,1,OUI,OUI,2025-03-13 11:56:56+00:00,"48.849266043601794, 2.412330328844772",Paris,75056,0.10526315789473684,12
21107,Bertrand Sincholle - Henri Barbusse,OUI,18,10,8,5,3,OUI,OUI,2025-03-13 12:01:34+00:00,"48.89925982394349, 2.3042294383049016",Clichy,92024,0.4444444444444444,12
11016,Philippe-Auguste,OUI,47,47,0,0,0,OUI,OUI,2025-03-13 12:00:28+00:00,"48.851853488265, 2.3932945355773",Paris,75056,0.0,12
22007,Commandant Charcot - Bretteville,OUI,31,18,13,11,2,OUI,OUI,2025-03-13 12:00:57+00:00,"48.87530570765423, 2.2558460757136345",Neuilly-sur-Seine,92051,0.41935483870967744,12
12122,Bois de Vincennes - Polygone,OUI,51,45,6,2,4,OUI,OUI,2025-03-13 11:59:38+00:00,"48.83544491617421, 2.431421081436563",Paris,75056,0.11764705882352941,12
12039,Général Michel Bizot - Claude Decaen,OUI,37,30,7,4,3,OUI,OUI,2025-03-13 11:53:47+00:00,"48.83481262982544, 2.400927788127704",Paris,75056,0.1891891891891892,12
16033,Marché d'Auteuil,OUI,31,7,24,22,2,OUI,OUI,2025-03-13 12:00:44+00:00,"48.84842761367387, 2.265253821160005",Paris,75056,0.7741935483870968,12
5031,Lacépède - Linné,OUI,49,16,33,23,10,OUI,OUI,2025-03-13 12:01:38+00:00,"48.8437035476636, 2.354651279747486",Paris,75056,0.673469387755102,12
16023,Passy - Place du Costa Rica,OUI,29,26,3,0,3,OUI,OUI,2025-03-13 12:01:18+00:00,"48.8584893, 2.2839655",Paris,75056,0.10344827586206896,12
12017,Saint-Mandé - Docteur Arnold Netter,OUI,36,28,8,7,1,OUI,OUI,2025-03-13 12:01:14+00:00,"48.84462585769668, 2.404946386814118",Paris,75056,0.2222222222222222,12
6004,Regard - Rennes,OUI,46,28,18,8,10,OUI,OUI,2025-03-13 12:01:14+00:00,"48.847385404956, 2.3268555477262",Paris,75056,0.391304347826087,12
14025,Jacquier - Didot,OUI,30,30,0,0,0,OUI,OUI,2025-03-13 12:00:30+00:00,"48.82953336292279, 2.318179272115231",Paris,75056,0.0,12
15114,Pasteur - Cotentin,OUI,9,9,0,0,0,OUI,OUI,2025-03-13 12:00:51+00:00,"48.8389284, 2.316356",Paris,75056,0.0,12
16104,Paul Valery - Victor Hugo,OUI,34,27,7,1,6,OUI,OUI,2025-03-13 11:57:34+00:00,"48.87137406080164, 2.2887128591537476",Paris,75056,0.20588235294117646,12
11029,Ménilmontant - Oberkampf,OUI,39,35,4,1,3,OUI,OUI,2025-03-13 12:00:20+00:00,"48.866617658681, 2.3830134404158",Paris,75056,0.10256410256410256,12
20033,Etienne Dolet - Place Maurice Chevalier,OUI,47,46,1,0,1,OUI,OUI,2025-03-13 11:53:12+00:00,"48.86798303359366, 2.3851405311143026",Paris,75056,0.02127659574468085,12
19014,Lorraine - Jean Jaurès,OUI,18,18,0,0,0,OUI,OUI,2025-03-13 11:58:43+00:00,"48.8863865, 2.3825772",Paris,75056,0.0,12
30005,Convention - Campus de Bobigny,OUI,29,16,13,2,11,OUI,OUI,2025-03-13 11:57:53+00:00,"48.914920058264, 2.4172238067445",Bobigny,93008,0.4482758620689655,12
11028,Guillaume Bertrand - République,OUI,38,33,5,2,3,OUI,OUI,2025-03-13 12:01:28+00:00,"48.863825174341, 2.380906377155",Paris,75056,0.13157894736842105,12
17050,Batignolles - Abel Truchet,OUI,26,21,5,1,4,OUI,OUI,2025-03-13 12:00:35+00:00,"48.883103904582, 2.3238347490884",Paris,75056,0.19230769230769232,12
22014,Victor Hugo - Bineau,OUI,24,13,11,5,6,OUI,OUI,2025-03-13 12:00:17+00:00,"48.88758225888669, 2.2783890366554265",Neuilly-sur-Seine,92051,0.4583333333333333,12
13013,Saint-Marcel - Hôpital,OUI,20,10,10,5,5,OUI,OUI,2025-03-13 12:00:16+00:00,"48.839504424583, 2.3609894170229",Paris,75056,0.5,12
15044,Dantzig - Lefebvre,OUI,32,32,0,0,0,OUI,OUI,2025-03-13 11:57:10+00:00,"48.83013921586756, 2.295934036374092",Paris,75056,0.0,12
8044,Alfred de Vigny - Place du Général Brocard,OUI,32,15,17,4,13,OUI,OUI,2025-03-13 12:01:34+00:00,"48.87836138361425, 2.305254448220567",Paris,75056,0.53125,12
25002,Hôtel de Ville de Rueil-Malmaison,OUI,19,4,15,10,5,OUI,OUI,2025-03-13 12:01:19+00:00,"48.878194, 2.181724",Rueil-Malmaison,92063,0.7894736842105263,12
1201,Perrault - Place du Louvre,OUI,27,4,23,14,9,OUI,OUI,2025-03-13 12:01:08+00:00,"48.860273568996, 2.3412468419093",Paris,75056,0.8518518518518519,12
6005,Montparnasse -  Square Ozanam,OUI,49,20,29,14,15,OUI,OUI,2025-03-13 12:00:31+00:00,"48.843310567822, 2.3265242949128",Paris,75056,0.5918367346938775,12
21510,Fontaine du Tertre - Calvaire,OUI,23,22,1,0,1,OUI,OUI,2025-03-13 11:53:24+00:00,"48.8702539, 2.2187778",Suresnes,92073,0.043478260869565216,12
19001,Crimée - Ourcq,OUI,56,56,0,0,0,OUI,OUI,2025-03-13 11:57:58+00:00,"48.894104140316, 2.3729460884673",Paris,75056,0.0,12
17036,Place Tristan Bernard,OUI,28,24,4,1,3,OUI,OUI,2025-03-13 12:00:44+00:00,"48.8794936, 2.2915423",Paris,75056,0.14285714285714285,12
21033,Sèvres - Maréchal Juin,OUI,18,5,13,11,2,OUI,OUI,2025-03-13 12:00:35+00:00,"48.8324305, 2.2292812",Boulogne-Billancourt,92012,0.7222222222222222,12
13023,Bobillot - Moulin des Prés,OUI,28,25,3,0,3,OUI,OUI,2025-03-13 12:00:18+00:00,"48.828657346203, 2.353020646317",Paris,75056,0.10714285714285714,12
21112,Claude Debussy - Marc Bloch,OUI,52,39,13,11,2,OUI,OUI,2025-03-13 12:01:43+00:00,"48.910388180512, 2.3117771744728",Clichy,92024,0.25,12
21007,Rond-Point Rhin et Danube,OUI,53,40,13,4,9,OUI,OUI,2025-03-13 11:57:50+00:00,"48.840452820991764, 2.2280225157737736",Boulogne-Billancourt,92012,0.24528301886792453,12
41101,Paul Doumer - Stalingrad,OUI,24,19,5,4,1,OUI,OUI,2025-03-13 11:55:50+00:00,"48.806518992199, 2.3368880152702",Arcueil,94003,0.20833333333333334,12
19007,Flandre - Ourcq,OUI,29,25,4,2,2,OUI,OUI,2025-03-13 12:01:32+00:00,"48.89260159189023, 2.3790915682911873",Paris,75056,0.13793103448275862,12
20030,Ménilmontant - Père Lachaise,OUI,40,40,0,0,0,OUI,OUI,2025-03-13 11:56:19+00:00,"48.863287291502, 2.3869940266013",Paris,75056,0.0,12
21016,Point du Jour - Jean Jaurès,OUI,39,23,16,12,4,OUI,OUI,2025-03-13 12:00:05+00:00,"48.828753141436465, 2.245911467014621",Boulogne-Billancourt,92012,0.41025641025641024,12
3201,Payenne - Square George Caïn,OUI,22,1,21,16,5,OUI,OUI,2025-03-13 12:00:21+00:00,"48.8578329, 2.3622643",Paris,75056,0.9545454545454546,12
11018,Saint-Maur - République,OUI,37,33,4,2,2,OUI,OUI,2025-03-13 12:01:24+00:00,"48.864185861455, 2.3783174157143",Paris,75056,0.10810810810810811,12
23106,Pavé des Gardes - Charles Vaillant,OUI,20,13,7,7,0,OUI,OUI,2025-03-13 11:53:01+00:00,"48.81168551728, 2.2111820107205",Sèvres,92072,0.35,12
19123,Metz - Marne,OUI,29,27,2,1,1,OUI,OUI,2025-03-13 11:56:29+00:00,"48.891163, 2.3865705",Paris,75056,0.06896551724137931,12
15032,Félix Faure - Lourmel,OUI,55,33,22,21,1,OUI,OUI,2025-03-13 12:01:16+00:00,"48.83868901709515, 2.2818081825971603",Paris,75056,0.4,12
13037,Ivry - Baudricourt,OUI,20,16,4,3,1,OUI,OUI,2025-03-13 12:01:26+00:00,"48.824695995415006, 2.363106073577468",Paris,75056,0.2,12
13053,Chevaleret - Tolbiac,OUI,21,5,16,11,5,OUI,OUI,2025-03-13 12:01:29+00:00,"48.82941, 2.375934",Paris,75056,0.7619047619047619,12
6009,Guynemer - Jardin du Luxembourg,OUI,34,16,18,12,6,OUI,OUI,2025-03-13 12:01:23+00:00,"48.8466127, 2.3325478",Paris,75056,0.5294117647058824,12
42027,Verdun - Pierre et Marie Curie,OUI,26,23,3,1,2,OUI,OUI,2025-03-13 12:00:02+00:00,"48.812822398263286, 2.3707106709480286",Ivry-sur-Seine,94041,0.11538461538461539,12
41212,Nungesser - Santé,OUI,22,20,2,1,1,OUI,OUI,2025-03-13 11:53:43+00:00,"48.852335, 2.448967",Fontenay-sous-Bois,94033,0.09090909090909091,12
26011,Ménil - Argenteuil,OUI,18,9,9,5,4,OUI,OUI,2025-03-13 11:57:29+00:00,"48.925901818305, 2.2741496502338",Asnières-sur-Seine,92004,0.5,12
51007,Résistance - Romain Rolland,OUI,28,26,2,0,2,OUI,OUI,2025-03-13 11:57:56+00:00,"48.950873482371, 2.2310190077797",Argenteuil,95018,0.07142857142857142,12
22208,Stalingrad - Barbara,OUI,19,14,5,0,5,OUI,OUI,2025-03-13 11:54:40+00:00,"48.809223658808, 2.3175904558822",Bagneux,92007,0.2631578947368421,12
11040,Temple - Jean-Pierre Timbaud,OUI,32,12,20,16,4,OUI,OUI,2025-03-13 12:01:11+00:00,"48.86446597201, 2.3660597205162",Paris,75056,0.625,12
22209,Verdun - Henri Barbusse,OUI,23,21,2,1,1,OUI,OUI,2025-03-13 11:58:32+00:00,"48.802056061754, 2.3159965061736",Bagneux,92007,0.08695652173913043,12
13008,Place d'Italie - Soeur Rosalie,OUI,52,40,12,1,11,OUI,OUI,2025-03-13 11:59:28+00:00,"48.831908520394, 2.3546943448098",Paris,75056,0.23076923076923078,12
35021,Cartier Bresson - Denis Papin,OUI,31,25,6,2,4,OUI,OUI,2025-03-13 12:00:02+00:00,"48.902616, 2.397814",Pantin,93055,0.1935483870967742,12
11038,Temple - Charlot,OUI,41,1,40,33,7,OUI,OUI,2025-03-13 12:00:14+00:00,"48.865709343796, 2.3652737250724",Paris,75056,0.975609756097561,12
18018,Carpeaux - Place Jacques Froment,OUI,17,14,3,0,3,OUI,OUI,2025-03-13 12:01:29+00:00,"48.8906542, 2.3309428",Paris,75056,0.17647058823529413,12
21511,Marcel Monge - Marcel Dassault,OUI,46,10,36,32,4,OUI,OUI,2025-03-13 12:01:13+00:00,"48.86096384533371, 2.2246733296048142",Suresnes,92073,0.782608695652174,12
21954,Val-Fleury,OUI,23,16,7,4,3,OUI,OUI,2025-03-13 11:57:52+00:00,"48.807671407991, 2.2407217696309",Meudon,92048,0.30434782608695654,12
8003,Galilée - Vernet,OUI,47,33,14,4,10,OUI,OUI,2025-03-13 11:58:45+00:00,"48.871715878697, 2.2985444962978",Paris,75056,0.2978723404255319,12
11201,Faubourg St-Antoine - Place de la Nation,OUI,15,12,3,1,2,OUI,OUI,2025-03-13 11:54:49+00:00,"48.8487726, 2.393606",Paris,75056,0.2,12
22703,Place Jean Mermoz,OUI,30,23,7,3,4,OUI,OUI,2025-03-13 12:00:23+00:00,"48.9220937, 2.2718348",Bois-Colombes,92009,0.23333333333333334,12
22602,Place Henri Dunant - Gare RER,OUI,30,29,1,0,1,OUI,OUI,2025-03-13 11:57:16+00:00,"48.788093281931, 2.2909234046643",Fontenay-aux-Roses,92032,0.03333333333333333,12
24010,Charles de Gaulle - Rue de l'Alma,OUI,27,2,25,6,19,OUI,OUI,2025-03-13 12:00:23+00:00,"48.896620592993, 2.252313240191",Courbevoie,92026,0.9259259259259259,12
23205,Parc des Pierrettes,OUI,22,21,1,1,0,OUI,OUI,2025-03-13 11:58:07+00:00,"48.7973062, 2.2909969",Châtillon,92020,0.045454545454545456,12
25009,Place des Arts - Jean Mermoz,OUI,20,6,14,13,1,OUI,OUI,2025-03-13 12:00:45+00:00,"48.880391139734, 2.1832160452221",Rueil-Malmaison,92063,0.7,12
25010,Maréchal Leclerc de Hauteclocque - Marché Buzenval,OUI,30,26,4,4,0,OUI,OUI,2025-03-13 11:58:48+00:00,"48.858446, 2.192077",Rueil-Malmaison,92063,0.13333333333333333,12
26010,Louis Armand - Bernard Palissy,OUI,17,7,10,8,2,OUI,OUI,2025-03-13 11:56:00+00:00,"48.916974, 2.313384",Asnières-sur-Seine,92004,0.5882352941176471,12
12165,Champs de Manoeuvre - Cartoucherie,OUI,32,12,20,12,8,OUI,OUI,2025-03-13 11:59:44+00:00,"48.835261, 2.447974",Paris,75056,0.625,12
16140,Hippodrome de Longchamp,OUI,24,3,21,17,4,OUI,OUI,2025-03-13 11:58:07+00:00,"48.86413226532, 2.239905372262",Paris,75056,0.875,12
12001,Bastille - Biscornet,OUI,59,2,57,46,11,OUI,OUI,2025-03-13 12:01:02+00:00,"48.851355779579, 2.369220033288",Paris,75056,0.9661016949152542,12
20035,Pyrénées - Ménilmontant,OUI,25,22,3,1,2,OUI,OUI,2025-03-13 11:54:01+00:00,"48.8693268535238, 2.395084574818611",Paris,75056,0.12,12
22018,Charles de Gaulle - Les Sablons,OUI,35,17,18,9,9,OUI,OUI,2025-03-13 12:00:28+00:00,"48.880987514929, 2.2715748726513",Neuilly-sur-Seine,92051,0.5142857142857142,12
21508,Georges Pompidou - Verdun,OUI,24,3,21,11,10,OUI,OUI,2025-03-13 11:58:13+00:00,"48.875481, 2.232443",Suresnes,92073,0.875,12
11001,Richard Lenoir - Place de la Bastille,OUI,46,2,44,26,18,OUI,OUI,2025-03-13 12:01:22+00:00,"48.8538327, 2.3697222",Paris,75056,0.9565217391304348,12
20037,Gambetta - Saint Fargeau,OUI,24,23,1,0,1,OUI,OUI,2025-03-13 12:00:32+00:00,"48.871244610447015, 2.4039056897163396",Paris,75056,0.041666666666666664,12
21327,Jean Bouin - Gouverneur Général Eboué,OUI,31,1,30,27,3,OUI,OUI,2025-03-13 12:00:48+00:00,"48.824792734266, 2.2651904328524",Issy-les-Moulineaux,92040,0.967741935483871,12
19045,Macdonald - Césaria Evora,OUI,66,42,24,7,17,OUI,OUI,2025-03-13 12:01:03+00:00,"48.89883, 2.37933",Paris,75056,0.36363636363636365,12
23203,Division Leclerc - Kléber,OUI,25,20,5,2,3,OUI,OUI,2025-03-13 11:59:59+00:00,"48.798666226364, 2.2833752789972",Châtillon,92020,0.2,12
22302,Gare RER - Général de Gaulle,OUI,38,20,18,13,5,OUI,OUI,2025-03-13 12:00:25+00:00,"48.933548439566, 2.3064726536317",Gennevilliers,92036,0.47368421052631576,12
34005,Adrien Lesesne - Docteur Bauer,OUI,29,26,3,1,2,OUI,OUI,2025-03-13 12:01:23+00:00,"48.90263867304635, 2.348248063431511",Saint-Ouen-sur-Seine,93070,0.10344827586206896,12
9029,Saint-Lazare - Place d'Estienne d'Orves,OUI,39,1,38,21,17,OUI,OUI,2025-03-13 11:59:26+00:00,"48.8768345, 2.3329067",Paris,75056,0.9743589743589743,12
17127,Porte de Clichy - Place des Nations Unies,OUI,37,5,32,29,3,OUI,OUI,2025-03-13 12:00:36+00:00,"48.896737263309504, 2.310542999196392",Paris,75056,0.8648648648648649,12
48011,Epi d'Or - Chevilly,OUI,20,14,6,0,6,OUI,OUI,2025-03-13 11:53:24+00:00,"48.781109786782, 2.3549050362061",Villejuif,94076,0.3,12
34008,Garibaldi - Gabriel Péri,OUI,28,19,9,6,3,OUI,OUI,2025-03-13 12:01:31+00:00,"48.905741911394, 2.3316044208059",Saint-Ouen-sur-Seine,93070,0.32142857142857145,12
34009,Dora Maar - Nadia Guendouz,OUI,28,1,27,22,5,OUI,OUI,2025-03-13 12:01:37+00:00,"48.905452421305, 2.3220406472683",Saint-Ouen-sur-Seine,93070,0.9642857142857143,12
34012,Bateliers - Quai de Seine,OUI,21,11,10,5,5,OUI,OUI,2025-03-13 11:56:06+00:00,"48.915817585516, 2.3239533298594",Saint-Ouen-sur-Seine,93070,0.47619047619047616,12
41304,Port - Maurice Chevalier,OUI,30,4,26,23,3,OUI,OUI,2025-03-13 11:59:47+00:00,"48.832474421632, 2.490257616467",Nogent-sur-Marne,94052,0.8666666666666667,12
21514,Place de la Paix - Abbé Saint-Pierre,OUI,24,21,3,3,0,OUI,OUI,2025-03-13 11:57:21+00:00,"48.86462724459225, 2.2047570338469806",Suresnes,92073,0.125,12
10151,Gare du Nord - Faubourg Saint-Denis,OUI,28,27,1,0,1,OUI,OUI,2025-03-13 11:54:39+00:00,"48.879612765504, 2.3568402975798",Paris,75056,0.03571428571428571,12
10026,Gare de l'Est - Chateau Landon,OUI,54,49,5,2,3,OUI,OUI,2025-03-13 12:01:40+00:00,"48.879305, 2.362424",Paris,75056,0.09259259259259259,12
7007,Musée d'Orsay,OUI,63,6,57,42,15,OUI,OUI,2025-03-13 12:00:54+00:00,"48.859726157909, 2.3258604481816",Paris,75056,0.9047619047619048,12
17010,Jonquière - Docteur Paul Brousse,OUI,38,32,6,5,1,OUI,OUI,2025-03-13 12:01:24+00:00,"48.894799816683985, 2.318705212173216",Paris,75056,0.15789473684210525,12
8031,Jean Mermoz - Champs-Elysées,OUI,44,3,41,18,23,OUI,OUI,2025-03-13 12:01:30+00:00,"48.869689856852, 2.3107324540615",Paris,75056,0.9318181818181818,12
18023,Ordener - Poissonniers,OUI,34,33,1,0,1,OUI,OUI,2025-03-13 11:56:54+00:00,"48.891213890844654, 2.351288666219873",Paris,75056,0.029411764705882353,12
45005,Stalingrad - Général de Gaulle,OUI,26,12,14,4,10,OUI,OUI,2025-03-13 11:59:28+00:00,"48.823450589614, 2.4965062363218",Champigny-sur-Marne,94017,0.5384615384615384,12
18026,Ruisseau - Ordener,OUI,33,33,0,0,0,OUI,OUI,2025-03-13 11:55:47+00:00,"48.89299462568024, 2.340144887566567",Paris,75056,0.0,12
18045,Pierre Ginier - Clichy,OUI,16,15,1,1,0,OUI,OUI,2025-03-13 11:58:40+00:00,"48.8867667, 2.326228",Paris,75056,0.0625,12
18024,Clignancourt - Ordener,OUI,35,35,0,0,0,OUI,OUI,2025-03-13 11:56:32+00:00,"48.891457726153774, 2.348636478060487",Paris,75056,0.0,12
14110,Abbé Carton - Plantes,OUI,25,22,3,1,2,OUI,OUI,2025-03-13 11:59:59+00:00,"48.827673823166, 2.3209181427956",Paris,75056,0.12,12
16006,Lauriston - Copernic,OUI,19,15,4,1,3,OUI,OUI,2025-03-13 12:01:14+00:00,"48.86926, 2.289918",Paris,75056,0.21052631578947367,12
10025,Jemmapes - Ecluses Saint-Martin,OUI,13,12,1,0,1,OUI,OUI,2025-03-13 12:01:09+00:00,"48.87748519186726, 2.3660067468881607",Paris,75056,0.07692307692307693,12
8008,Joseph Sansboeuf - Saint Lazare,OUI,31,20,11,6,5,OUI,OUI,2025-03-13 12:01:38+00:00,"48.875315630653, 2.3229019716382",Paris,75056,0.3548387096774194,12
32305,Saint-Germain - Verdun,OUI,29,28,1,0,1,OUI,OUI,2025-03-13 11:57:36+00:00,"48.882877330093, 2.4331868384644",Romainville,93063,0.034482758620689655,12
13205,Choisy - Pointe d'Ivry,OUI,24,20,4,3,1,OUI,OUI,2025-03-13 12:00:05+00:00,"48.822154170359, 2.3633708034878",Paris,75056,0.16666666666666666,12
22305,Jean Jaurès - Place du Dr Roux,OUI,34,24,10,8,2,OUI,OUI,2025-03-13 11:57:00+00:00,"48.927567032796, 2.2947337017374",Gennevilliers,92036,0.29411764705882354,12
31202,Gabriel Péri - Jules Ferry,OUI,27,8,19,15,4,OUI,OUI,2025-03-13 12:01:10+00:00,"48.926182814311, 2.3912295762525",La Courneuve,93027,0.7037037037037037,12
22507,Châteaudun - Place de la Liberté,OUI,25,23,2,2,0,OUI,OUI,2025-03-13 12:01:03+00:00,"48.90970830301211, 2.2454486480600626",La Garenne-Colombes,92035,0.08,12
31201,Suzanne Masson,OUI,33,6,27,14,13,OUI,OUI,2025-03-13 11:57:57+00:00,"48.923306888013, 2.3847292397611",La Courneuve,93027,0.8181818181818182,12
12106,Gare de Lyon - Roland Barthes,OUI,68,5,63,61,2,OUI,OUI,2025-03-13 12:00:30+00:00,"48.84395729494058, 2.3790882155299187",Paris,75056,0.9264705882352942,12
13204,Tolbiac - Boussingault,OUI,41,37,4,3,1,OUI,OUI,2025-03-13 11:57:39+00:00,"48.826177754027, 2.3420378552202",Paris,75056,0.0975609756097561,12
32023,Guy Môquet - Jean Moulin,OUI,27,7,20,10,10,OUI,OUI,2025-03-13 11:58:10+00:00,"48.940931521020836, 2.363948999931771",Saint-Denis,93066,0.7407407407407407,12
23201,Avenir,OUI,41,34,7,4,3,OUI,OUI,2025-03-13 12:01:29+00:00,"48.8103438, 2.3003776",Châtillon,92020,0.17073170731707318,12
15062,Convention - Lourmel,OUI,35,18,17,16,1,OUI,OUI,2025-03-13 11:58:49+00:00,"48.842055041656, 2.2859910875559",Paris,75056,0.4857142857142857,12
21320,Président Roosevelt - Rouget de Lisle,OUI,40,1,39,23,16,OUI,OUI,2025-03-13 12:01:13+00:00,"48.83047518749, 2.2616135525345",Issy-les-Moulineaux,92040,0.975,12
10114,Granges aux Belles - Hôpital Saint-Louis,OUI,59,55,4,1,3,OUI,OUI,2025-03-13 12:00:30+00:00,"48.874794994841, 2.366669436985",Paris,75056,0.06779661016949153,12
9035,Gare Saint-Lazare - Place de Budapest,OUI,43,23,20,11,9,OUI,OUI,2025-03-13 12:01:41+00:00,"48.877753, 2.327339",Paris,75056,0.46511627906976744,12
18134,Ney - Porte de Clignancourt,OUI,24,22,2,1,1,OUI,OUI,2025-03-13 11:55:03+00:00,"48.8978867, 2.3458001",Paris,75056,0.08333333333333333,12
17126,Hélène et François Missoffe - Emile Borel,OUI,28,9,19,17,2,OUI,OUI,2025-03-13 11:58:27+00:00,"48.89990653843488, 2.321543991674844",Paris,75056,0.6785714285714286,12
13203,Square de Choisy - Eastman,OUI,23,21,2,0,2,OUI,OUI,2025-03-13 11:52:23+00:00,"48.828543456283, 2.3583075090494",Paris,75056,0.08695652173913043,12
26008,Henri Barbusse - Bourguignons,OUI,32,27,5,2,3,OUI,OUI,2025-03-13 11:55:26+00:00,"48.91301722799713, 2.2734212270774417",Asnières-sur-Seine,92004,0.15625,12
47007,Liberté - Vert-de-Maisons,OUI,20,3,17,15,2,OUI,OUI,2025-03-13 11:59:35+00:00,"48.790147809608, 2.4328628182411",Maisons-Alfort,94046,0.85,12
26009,Marceau Delorme - Pierre Brossolette,OUI,26,22,4,0,4,OUI,OUI,2025-03-13 11:58:08+00:00,"48.91206062860357, 2.295897423568745",Asnières-sur-Seine,92004,0.15384615384615385,12
13202,Place Farhat Hached,OUI,28,9,19,10,9,OUI,OUI,2025-03-13 12:00:52+00:00,"48.825487045602, 2.3816306985827",Paris,75056,0.6785714285714286,12
23204,Roland Garros - Jean Bouin,OUI,28,27,1,0,1,OUI,OUI,2025-03-13 11:51:53+00:00,"48.809460857173, 2.2853198638301",Châtillon,92020,0.03571428571428571,12
13051,Halle Freyssinet - Parvis Alan Turing,OUI,23,5,18,8,10,OUI,OUI,2025-03-13 11:59:31+00:00,"48.832846814471, 2.3711421713233",Paris,75056,0.782608695652174,12
31301,Gare RER,OUI,25,17,8,0,8,OUI,OUI,2025-03-13 11:59:22+00:00,"48.896280181078, 2.4581568985227",Noisy-le-Sec,93053,0.32,12
8038,François 1er - Montaigne,OUI,51,16,35,22,13,OUI,OUI,2025-03-13 12:00:02+00:00,"48.866887649978, 2.3066755757207",Paris,75056,0.6862745098039216,12
31303,Simone Signoret - Paris,OUI,26,21,5,4,1,OUI,OUI,2025-03-13 11:57:11+00:00,"48.903600624712865, 2.465406596265139",Noisy-le-Sec,93053,0.19230769230769232,12
19204,Rampal - Belleville,OUI,19,17,2,2,0,OUI,OUI,2025-03-13 12:00:00+00:00,"48.873114661405, 2.3798409114805",Paris,75056,0.10526315789473684,12
5107,Pontoise - La Tournelle,OUI,22,2,20,13,7,OUI,OUI,2025-03-13 11:59:00+00:00,"48.850458009188, 2.3524542754922",Paris,75056,0.9090909090909091,12
35002,Jean Jaurès - Presles,OUI,31,26,5,2,3,OUI,OUI,2025-03-13 12:00:53+00:00,"48.907134414988, 2.3960057280531",Pantin,93055,0.16129032258064516,12
19018,Cité de la Musique,OUI,51,36,15,10,5,OUI,OUI,2025-03-13 11:58:47+00:00,"48.888796556487, 2.3925811931922",Paris,75056,0.29411764705882354,12
11102,Alexandre Dumas - Voltaire,OUI,58,53,5,4,1,OUI,OUI,2025-03-13 12:01:12+00:00,"48.852888670365, 2.3891476408096",Paris,75056,0.08620689655172414,12
7201,Place De Fontenoy - Saxe,OUI,18,4,14,10,4,OUI,OUI,2025-03-13 11:59:04+00:00,"48.850270554523, 2.3069813815839",Paris,75056,0.7777777777777778,12
18044,Clichy - Douai,OUI,32,30,2,0,2,OUI,OUI,2025-03-13 12:00:43+00:00,"48.883687771522, 2.328063700029",Paris,75056,0.0625,12
15013,Volontaires - Lecourbe,OUI,29,21,8,4,4,OUI,OUI,2025-03-13 12:01:43+00:00,"48.84351378799, 2.3065522313118",Paris,75056,0.27586206896551724,12
12157,Fabre d'Eglantine - Place de la Nation,OUI,66,64,2,0,2,OUI,OUI,2025-03-13 12:00:54+00:00,"48.8471116, 2.3956204",Paris,75056,0.030303030303030304,12
21213,Vanne - Général de Gaulle,OUI,24,22,2,0,2,OUI,OUI,2025-03-13 12:00:38+00:00,"48.815007, 2.328318",Montrouge,92049,0.08333333333333333,12
13035,Choisy - Tolbiac,OUI,20,19,1,0,1,OUI,OUI,2025-03-13 11:55:52+00:00,"48.82591155587, 2.3602393269539",Paris,75056,0.05,12
11009,Boulets - Voltaire,OUI,24,22,2,1,1,OUI,OUI,2025-03-13 11:56:24+00:00,"48.85218705621, 2.3890301585197",Paris,75056,0.08333333333333333,12
21501,Pont de Suresnes,OUI,15,12,3,2,1,OUI,OUI,2025-03-13 11:56:09+00:00,"48.867415092322, 2.2258946679617",Suresnes,92073,0.2,12
35001,Jean Jaurès - Ouvrières Pivéreuses,OUI,21,17,4,0,4,OUI,OUI,2025-03-13 12:01:37+00:00,"48.910423437526, 2.3995766043663",Pantin,93055,0.19047619047619047,12
5201,Saint-Jacques - Soufflot,OUI,16,1,15,4,11,OUI,OUI,2025-03-13 12:00:17+00:00,"48.846280383395, 2.3430785379567",Paris,75056,0.9375,12
11012,Montreuil - Voltaire,OUI,32,31,1,1,0,OUI,OUI,2025-03-13 11:58:44+00:00,"48.850507011842, 2.3930755582745",Paris,75056,0.03125,12
18042,Place Pigalle,OUI,20,20,0,0,0,OUI,OUI,2025-03-13 12:01:11+00:00,"48.8827555, 2.3361566",Paris,75056,0.0,12
18205,Mauroy - Cheminots,OUI,30,20,10,3,7,OUI,OUI,2025-03-13 11:59:29+00:00,"48.897715198403, 2.357895075822",Paris,75056,0.3333333333333333,12
11037,Faubourg Du Temple - Republique,OUI,38,0,38,32,6,OUI,OUI,2025-03-13 12:01:33+00:00,"48.867872484749, 2.3648982158072",Paris,75056,1.0,12
7109,Place Joffre - Frédéric le Play,OUI,37,17,20,14,6,OUI,OUI,2025-03-13 11:59:57+00:00,"48.853754486938, 2.3044242337346",Paris,75056,0.5405405405405406,12
18041,Rochechouart - Martyrs,OUI,17,11,6,1,5,OUI,OUI,2025-03-13 11:57:50+00:00,"48.882193779572, 2.3405495658517",Paris,75056,0.35294117647058826,12
4108,Quai de Béthune - Pont de la Tournelle,OUI,25,11,14,13,1,OUI,OUI,2025-03-13 11:59:55+00:00,"48.85097433194, 2.3563072085381",Paris,75056,0.56,12
11014,Place de la Nation - Taillebourg,OUI,46,42,4,3,1,OUI,OUI,2025-03-13 11:59:28+00:00,"48.8488408, 2.3973043",Paris,75056,0.08695652173913043,12
12105,Bercy - Villot,OUI,36,12,24,16,8,OUI,OUI,2025-03-13 12:00:19+00:00,"48.841795009027, 2.3767850184816",Paris,75056,0.6666666666666666,12
11020,Belfort - Voltaire,OUI,39,35,4,1,3,OUI,OUI,2025-03-13 11:58:48+00:00,"48.8563358, 2.3829901",Paris,75056,0.10256410256410256,12
40007,Préfecture de Créteil,OUI,27,6,21,15,6,OUI,OUI,2025-03-13 12:01:06+00:00,"48.783680285918, 2.4544713672215",Créteil,94028,0.7777777777777778,12
8039,Colisée - Champs-Elysées,OUI,15,1,14,2,12,OUI,OUI,2025-03-13 11:55:04+00:00,"48.870475399387, 2.3076190799475",Paris,75056,0.9333333333333333,12
40012,Stade de la Habette,OUI,16,14,2,0,2,OUI,OUI,2025-03-13 11:56:14+00:00,"48.774397033806, 2.4668785263921",Créteil,94028,0.125,12
16103,Traktir - Foch,OUI,20,5,15,4,11,OUI,OUI,2025-03-13 12:00:50+00:00,"48.872755334614, 2.2915497802487",Paris,75056,0.75,12
40013,Hôtel de Ville de Créteil,OUI,36,16,20,14,6,OUI,OUI,2025-03-13 11:59:55+00:00,"48.77699496201, 2.4552552404284",Créteil,94028,0.5555555555555556,12
3004,Place de la République - Temple,OUI,16,3,13,9,4,OUI,OUI,2025-03-13 11:58:56+00:00,"48.867211201859, 2.3635464370545",Paris,75056,0.8125,12
12107,Diderot - Pierre Bourdan,OUI,21,4,17,8,9,OUI,OUI,2025-03-13 12:01:00+00:00,"48.847648620797, 2.3902582749724",Paris,75056,0.8095238095238095,12
11046,Place de la République - Voltaire,OUI,16,1,15,13,2,OUI,OUI,2025-03-13 11:59:49+00:00,"48.866830968942, 2.3654810339212",Paris,75056,0.9375,12
23011,Bineau - Louise Michel,OUI,26,19,7,3,4,OUI,OUI,2025-03-13 11:55:15+00:00,"48.88666162207, 2.2843274474144",Levallois-Perret,92044,0.2692307692307692,12
15060,Place de la Montagne du Goulet,OUI,20,6,14,12,2,OUI,OUI,2025-03-13 12:00:15+00:00,"48.8443415, 2.2773844",Paris,75056,0.7,12
16005,Raymond Poincaré - Place Victor Hugo,OUI,22,19,3,1,2,OUI,OUI,2025-03-13 11:57:58+00:00,"48.87030612437, 2.2850745414202",Paris,75056,0.13636363636363635,12
11011,Richard Lenoir - Voltaire,OUI,24,15,9,8,1,OUI,OUI,2025-03-13 11:59:06+00:00,"48.86164273878, 2.3727491497993",Paris,75056,0.375,12
12201,Dugommier,OUI,53,49,4,3,1,OUI,OUI,2025-03-13 11:58:37+00:00,"48.838811048815, 2.3896577954292",Paris,75056,0.07547169811320754,12
7111,Ecole Militaire - Place Joffre,OUI,25,12,13,9,4,OUI,OUI,2025-03-13 11:59:41+00:00,"48.852060203583, 2.3017993569374",Paris,75056,0.52,12
40003,Centre Hospitalier Intercommunal de Créteil,OUI,17,17,0,0,0,OUI,OUI,2025-03-13 11:59:41+00:00,"48.797078298909, 2.463801423807",Créteil,94028,0.0,12
15105,Fédération - Suffren,OUI,24,15,9,9,0,OUI,OUI,2025-03-13 12:00:32+00:00,"48.852828153442, 2.2978776320815",Paris,75056,0.375,12
23801,Place de la Gare,OUI,20,17,3,1,2,OUI,OUI,2025-03-13 11:54:26+00:00,"48.838513582184, 2.1866139007512",Garches,92033,0.15,12
8057,Hoche - Tilsitt,OUI,31,25,6,0,6,OUI,OUI,2025-03-13 12:00:44+00:00,"48.874836457837, 2.2971323132515",Paris,75056,0.1935483870967742,12
40004,Créteil Village,OUI,25,7,18,7,11,OUI,OUI,2025-03-13 12:01:19+00:00,"48.79122395576, 2.4642198533952",Créteil,94028,0.72,12
7023,Bourdonnais - Tour Eiffel,OUI,56,3,53,37,16,OUI,OUI,2025-03-13 12:01:38+00:00,"48.860897797941, 2.295599598447",Paris,75056,0.9464285714285714,12
40008,Créteil Pompadour,OUI,44,14,30,11,19,OUI,OUI,2025-03-13 12:01:00+00:00,"48.773011623355, 2.435166164893",Créteil,94028,0.6818181818181818,12
9025,Taitbout - Châteaudun,OUI,53,2,51,45,6,OUI,OUI,2025-03-13 12:01:39+00:00,"48.876383969379, 2.3353566779335",Paris,75056,0.9622641509433962,12
14021,Place de la Porte de Châtillon,OUI,59,54,5,1,4,OUI,OUI,2025-03-13 12:00:50+00:00,"48.8242469, 2.3186306",Paris,75056,0.0847457627118644,12
7025,Octave Gréard - Tour Eiffel,OUI,32,6,26,15,11,OUI,OUI,2025-03-13 12:01:29+00:00,"48.856502977696, 2.2931787543289",Paris,75056,0.8125,12
40015,Iles de Loisirs de Créteil,OUI,24,4,20,10,10,OUI,OUI,2025-03-13 12:00:55+00:00,"48.780258200618, 2.4455094301232",Créteil,94028,0.8333333333333334,12
40010,Haut du Mont-Mesly,OUI,21,17,4,3,1,OUI,OUI,2025-03-13 12:00:29+00:00,"48.780191921646, 2.4685737495183",Créteil,94028,0.19047619047619047,12
51005,Yves Farges - Route d'Enghien,OUI,33,16,17,6,11,OUI,OUI,2025-03-13 12:01:31+00:00,"48.95756799268, 2.2834496977978",Argenteuil,95018,0.5151515151515151,12
40014,Créteil Pointe du Lac,OUI,28,2,26,9,17,OUI,OUI,2025-03-13 11:59:59+00:00,"48.769807356177, 2.4623027310281",Créteil,94028,0.9285714285714286,12
26005,Hôtel de Ville d'Asnières sur Seine,OUI,25,23,2,0,2,OUI,OUI,2025-03-13 12:01:41+00:00,"48.90999330025577, 2.288238108158112",Asnières-sur-Seine,92004,0.08,12
20137,Borrégo - Gambetta,OUI,25,25,0,0,0,OUI,OUI,2025-03-13 11:54:48+00:00,"48.87330497045532, 2.4014145880937576",Paris,75056,0.0,12
23703,Gare de Chaville Rive Gauche,OUI,18,16,2,1,1,OUI,OUI,2025-03-13 11:57:35+00:00,"48.805160304345, 2.188277207315",Chaville,92022,0.1111111111111111,12
31708,Noisy le Sec - Jean-Baptiste Clément,OUI,18,17,1,0,1,OUI,OUI,2025-03-13 12:01:36+00:00,"48.874515389637, 2.4152836203575",Bagnolet,93006,0.05555555555555555,12
13106,Bobillot - Paulin Mery,OUI,21,18,3,0,3,OUI,OUI,2025-03-13 11:58:45+00:00,"48.829899841747, 2.3543356766749",Paris,75056,0.14285714285714285,12
15103,Cauchy - Cévennes,OUI,50,6,44,40,4,OUI,OUI,2025-03-13 12:01:23+00:00,"48.843372571022, 2.2751328349113",Paris,75056,0.88,12
15026,Bir Hakeim,OUI,32,9,23,17,6,OUI,OUI,2025-03-13 11:58:26+00:00,"48.853844054334, 2.289705348222",Paris,75056,0.71875,12
1022,Danielle Casanova - Place Vendôme,OUI,37,0,37,21,16,OUI,OUI,2025-03-13 11:59:13+00:00,"48.868266498223, 2.3304839059711",Paris,75056,1.0,12
10031,Louis Blanc - Aqueduc,OUI,36,33,3,2,1,OUI,OUI,2025-03-13 12:00:24+00:00,"48.882030182599, 2.363561578095",Paris,75056,0.08333333333333333,12
41301,Bois de Vincennes - Gare,OUI,50,46,4,3,1,OUI,OUI,2025-03-13 12:00:01+00:00,"48.836022242887, 2.470833995083",Nogent-sur-Marne,94052,0.08,12
32004,Wilson - Landy,OUI,38,14,24,16,8,OUI,OUI,2025-03-13 12:01:15+00:00,"48.91516726221354, 2.357633225619793",Saint-Denis,93066,0.631578947368421,12
18043,Clichy - Place Blanche,OUI,18,15,3,2,1,OUI,OUI,2025-03-13 12:00:49+00:00,"48.883601088297, 2.3332237824798",Paris,75056,0.16666666666666666,12
35014,Charles de Gaulle - Jean Lolive,OUI,26,25,1,1,0,OUI,OUI,2025-03-13 11:57:29+00:00,"48.8932644350857, 2.4126765131950383",Pantin,93055,0.038461538461538464,12
1003,Saint-Denis - Rivoli,OUI,42,13,29,20,9,OUI,OUI,2025-03-13 12:01:03+00:00,"48.859059340842, 2.3476943001151",Paris,75056,0.6904761904761905,12
10013,Alibert - Jemmapes,OUI,57,54,3,1,2,OUI,OUI,2025-03-13 11:59:17+00:00,"48.871044051984, 2.3661044619878",Paris,75056,0.05263157894736842,12
6001,Institut de France,OUI,17,1,16,9,7,OUI,OUI,2025-03-13 11:59:22+00:00,"48.857615678565, 2.3358313530377",Paris,75056,0.9411764705882353,12
19203,Pailleron - Bouret,OUI,27,23,4,1,3,OUI,OUI,2025-03-13 12:01:22+00:00,"48.880516995482, 2.3763902374411",Paris,75056,0.14814814814814814,12
17038,Grande Armée - Brunel,OUI,60,29,31,13,18,OUI,OUI,2025-03-13 12:00:44+00:00,"48.876116, 2.288124",Paris,75056,0.5166666666666667,12
32012,Carrefour Pleyel,OUI,65,27,38,12,26,OUI,OUI,2025-03-13 11:59:20+00:00,"48.92034156960326, 2.3438543826341625",Saint-Denis,93066,0.5846153846153846,12
4104,Sebastopol - Rambuteau,OUI,15,2,13,10,3,OUI,OUI,2025-03-13 12:01:32+00:00,"48.86181809267, 2.3501381278038",Paris,75056,0.8666666666666667,12
34014,Michelet - Dr Bauer,OUI,29,27,2,0,2,OUI,OUI,2025-03-13 12:01:15+00:00,"48.906125424194, 2.3440374449846",Saint-Ouen-sur-Seine,93070,0.06896551724137931,12
33019,Madeleine Vionnet,OUI,45,0,45,16,29,OUI,OUI,2025-03-13 12:01:10+00:00,"48.902519074064, 2.3740895837545",Aubervilliers,93001,1.0,12
27004,Gare de la Garenne-Colombes,OUI,27,19,8,6,2,OUI,OUI,2025-03-13 12:00:07+00:00,"48.909752, 2.239145",Colombes,92025,0.2962962962962963,12
21302,Aristide Briand - Place de la Résistance,OUI,40,3,37,33,4,OUI,OUI,2025-03-13 12:00:11+00:00,"48.82124248401006, 2.2511002421379094",Issy-les-Moulineaux,92040,0.925,12
21404,Jean Jaurès - Gare de Clamart,OUI,20,20,0,0,0,OUI,OUI,2025-03-13 11:59:04+00:00,"48.81321981219, 2.2716768079163",Clamart,92023,0.0,12
21021,Enfants du Paradis - Peupliers,OUI,59,5,54,26,28,OUI,OUI,2025-03-13 12:01:35+00:00,"48.833122686454, 2.2571459412575",Boulogne-Billancourt,92012,0.9152542372881356,12
17123,Mstislav Rostropovitch - Berthier,OUI,18,14,4,3,1,OUI,OUI,2025-03-13 11:57:01+00:00,"48.892120821173975, 2.309234105050564",Paris,75056,0.2222222222222222,12
15056,Place Balard,OUI,28,6,22,18,4,OUI,OUI,2025-03-13 12:01:09+00:00,"48.836395736424, 2.2784192115068",Paris,75056,0.7857142857142857,12
1002,Victoria - Place du Chatelet,OUI,19,2,17,10,7,OUI,OUI,2025-03-13 12:01:33+00:00,"48.857992591527, 2.3469167947769",Paris,75056,0.8947368421052632,12
9104,Caumartin - Provence,OUI,22,4,18,15,3,OUI,OUI,2025-03-13 12:00:39+00:00,"48.874422773426545, 2.3284685611724854",Paris,75056,0.8181818181818182,12
8052,Balzac - Champs Elysées,OUI,30,13,17,7,10,OUI,OUI,2025-03-13 12:01:31+00:00,"48.872699639621, 2.3001953959465",Paris,75056,0.5666666666666667,12
12010,Daumesnil - Picpus,OUI,19,8,11,8,3,OUI,OUI,2025-03-13 11:57:10+00:00,"48.8374688, 2.401765",Paris,75056,0.5789473684210527,12
13123,BNF - Bibliothèque Nationale de France,OUI,44,3,41,27,14,OUI,OUI,2025-03-13 12:01:33+00:00,"48.8350268238, 2.3760157451034",Paris,75056,0.9318181818181818,12
32001,Proudhon - Président Wilson,OUI,30,12,18,11,7,OUI,OUI,2025-03-13 12:01:34+00:00,"48.906442763495, 2.3584905266762",Saint-Denis,93066,0.6,12
40002,Bleuets - Bordières,OUI,21,17,4,2,2,OUI,OUI,2025-03-13 12:01:38+00:00,"48.802117531472, 2.4543687905029",Créteil,94028,0.19047619047619047,12
8002,Gare Saint-Lazare - Cour du Havre,OUI,42,24,18,5,13,OUI,OUI,2025-03-13 12:01:02+00:00,"48.875674400851, 2.3265598341823",Paris,75056,0.42857142857142855,12
12127,Tremblay - Lac des Minimes,OUI,52,8,44,16,28,OUI,OUI,2025-03-13 12:00:39+00:00,"48.834131261494, 2.4547516554594",Paris,75056,0.8461538461538461,12
8004,Malesherbes - Place de la Madeleine,OUI,78,3,75,29,46,OUI,OUI,2025-03-13 12:00:02+00:00,"48.870406028483, 2.323243509808",Paris,75056,0.9615384615384616,12
16107,Benjamin Godard - Victor Hugo,OUI,32,29,3,1,2,OUI,OUI,2025-03-13 13:00:48+00:00,"48.865983, 2.275725",Paris,75056,0.09375,13
40001,Hôpital Mondor,OUI,28,8,20,10,10,OUI,OUI,2025-03-13 12:59:33+00:00,"48.798922410229, 2.4537451531298",Créteil,94028,0.7142857142857143,13
14111,Cassini - Denfert-Rochereau,OUI,23,20,3,0,3,OUI,OUI,2025-03-13 13:01:22+00:00,"48.837525839067, 2.3360354080796",Paris,75056,0.13043478260869565,13
44015,Rouget de L'isle - Watteau,OUI,20,9,11,0,11,OUI,OUI,2025-03-13 12:57:47+00:00,"48.778192750803, 2.3963020229163",Vitry-sur-Seine,94081,0.55,13
14014,Jourdan - Stade Charléty,OUI,59,50,9,3,6,OUI,OUI,2025-03-13 13:00:52+00:00,"48.819428333369, 2.3433353751898",Paris,75056,0.15254237288135594,13
9020,Toudouze - Clauzel,OUI,21,16,5,3,2,OUI,OUI,2025-03-13 12:57:48+00:00,"48.87929591733507, 2.3373600840568547",Paris,75056,0.23809523809523808,13
32017,Basilique,OUI,20,11,9,4,5,OUI,OUI,2025-03-13 13:00:24+00:00,"48.93626891059109, 2.3588666820200914",Saint-Denis,93066,0.45,13
6003,Saint-Sulpice,OUI,21,7,14,6,8,OUI,OUI,2025-03-13 13:01:04+00:00,"48.85165383178419, 2.3308077827095985",Paris,75056,0.6666666666666666,13
11104,Charonne - Robert et Sonia Delaunay,OUI,20,18,2,1,1,OUI,OUI,2025-03-13 13:01:12+00:00,"48.855907555969, 2.3925706744194",Paris,75056,0.1,13
7002,Vaneau - Sèvres,OUI,35,17,18,15,3,OUI,OUI,2025-03-13 13:01:23+00:00,"48.848563233059, 2.3204218259346",Paris,75056,0.5142857142857142,13
8026,Messine - Place Du Pérou,OUI,12,0,12,4,8,OUI,OUI,2025-03-13 12:56:48+00:00,"48.875448033960744, 2.315508019010038",Paris,75056,1.0,13
5110,Lacépède - Monge,OUI,23,16,7,2,5,OUI,OUI,2025-03-13 13:01:02+00:00,"48.84389286531899, 2.3519663885235786",Paris,75056,0.30434782608695654,13
13007,Le Brun - Gobelins,OUI,47,37,10,10,0,OUI,OUI,2025-03-13 12:56:21+00:00,"48.835092787824, 2.3534681351338",Paris,75056,0.2127659574468085,13
33006,André Karman - République,OUI,30,29,1,0,1,OUI,OUI,2025-03-13 12:57:11+00:00,"48.91039875761846, 2.3851355910301213",Aubervilliers,93001,0.03333333333333333,13
6108,Saint-Romain - Cherche-Midi,OUI,16,14,2,1,1,OUI,OUI,2025-03-13 13:00:54+00:00,"48.84708159081946, 2.321374788880348",Paris,75056,0.125,13
42016,Pierre et Marie Curie - Maurice Thorez,OUI,26,21,5,3,2,OUI,OUI,2025-03-13 12:58:06+00:00,"48.81580226360801, 2.376804985105991",Ivry-sur-Seine,94041,0.19230769230769232,13
21010,Silly - Galliéni,OUI,25,15,10,5,5,OUI,OUI,2025-03-13 12:56:06+00:00,"48.835583838706, 2.2325500845909",Boulogne-Billancourt,92012,0.4,13
40011,Bas du Mont-Mesly,OUI,26,18,8,5,3,OUI,OUI,2025-03-13 13:01:48+00:00,"48.779035118572, 2.4609763908985",Créteil,94028,0.3076923076923077,13
25006,Place Nelson Mandela,OUI,22,21,1,1,0,OUI,OUI,2025-03-13 13:00:46+00:00,"48.862453313908, 2.1961666225454",Rueil-Malmaison,92063,0.045454545454545456,13
32304,Charcot - Benfleet,OUI,28,27,1,0,1,NON,NON,2025-03-13 12:53:23+00:00,"48.878370277021, 2.440523876268",Romainville,93063,0.03571428571428571,13
30002,Jean Rostand - Paul Vaillant Couturier,OUI,39,27,12,7,5,OUI,OUI,2025-03-13 13:01:36+00:00,"48.908168131015, 2.4530601033354",Bobigny,93008,0.3076923076923077,13
5016,Thouin - Cardinal Lemoine,OUI,16,0,16,0,16,OUI,OUI,2025-03-13 12:59:12+00:00,"48.84504716661511, 2.3494647851273465",Paris,75056,1.0,13
7003,Square Boucicaut,OUI,58,16,42,25,17,OUI,OUI,2025-03-13 13:01:50+00:00,"48.851296433665276, 2.325061820447445",Paris,75056,0.7241379310344828,13
11025,Froment - Bréguet,OUI,43,27,16,14,2,OUI,OUI,2025-03-13 13:01:49+00:00,"48.8570414504784, 2.37289470306807",Paris,75056,0.37209302325581395,13
17041,Guersant - Gouvion-Saint-Cyr,OUI,33,21,12,4,8,OUI,OUI,2025-03-13 12:58:17+00:00,"48.88287775178599, 2.287667370814871",Paris,75056,0.36363636363636365,13
15047,Morillons - Dantzig,OUI,51,50,1,0,1,OUI,OUI,2025-03-13 12:54:31+00:00,"48.83310149953933, 2.299380004405976",Paris,75056,0.0196078431372549,13
17026,Jouffroy d'Abbans - Wagram,OUI,39,22,17,10,7,OUI,OUI,2025-03-13 13:01:36+00:00,"48.881973298352, 2.301132157445",Paris,75056,0.4358974358974359,13
6021,Beaux-Arts - Bonaparte,OUI,20,0,20,14,6,OUI,OUI,2025-03-13 13:01:20+00:00,"48.856451985396, 2.3348518833518",Paris,75056,1.0,13
15202,Bracion - Périphérique,OUI,30,28,2,1,1,OUI,OUI,2025-03-13 12:58:26+00:00,"48.826103771275, 2.3004549373748",Paris,75056,0.06666666666666667,13
8050,Boétie - Ponthieu,OUI,43,4,39,12,27,OUI,OUI,2025-03-13 13:00:41+00:00,"48.871417284355, 2.3076787590981",Paris,75056,0.9069767441860465,13
12109,Mairie du 12ème,OUI,29,22,7,6,1,OUI,OUI,2025-03-13 12:52:37+00:00,"48.840855311763, 2.3875549435616",Paris,75056,0.2413793103448276,13
17044,Porte de Saint-Ouen - Bessières,OUI,42,36,6,3,3,OUI,OUI,2025-03-13 13:00:42+00:00,"48.89792240854517, 2.32851451022192",Paris,75056,0.14285714285714285,13
13101,Croulebarde - Corvisart,OUI,33,23,10,8,2,OUI,OUI,2025-03-13 13:01:12+00:00,"48.830981659316855, 2.3481646925210953",Paris,75056,0.30303030303030304,13
19033,Cambrai - Benjamin Constant,OUI,40,35,5,3,2,OUI,OUI,2025-03-13 13:00:34+00:00,"48.89594736851349, 2.381133802246315",Paris,75056,0.125,13
14108,Le Brix et Mesmin - Jourdan,OUI,19,18,1,0,1,OUI,OUI,2025-03-13 12:56:56+00:00,"48.82234096593411, 2.327861653302471",Paris,75056,0.05263157894736842,13
43002,Lagny - Victor Basch,OUI,24,21,3,3,0,OUI,OUI,2025-03-13 12:59:48+00:00,"48.84884147189881, 2.426325418925233",Vincennes,94080,0.125,13
31024,Romainville - Vaillant-Couturier,OUI,36,33,3,0,3,OUI,OUI,2025-03-13 13:00:31+00:00,"48.86785, 2.446748",Montreuil,93048,0.08333333333333333,13
16138,Saint-Cloud - Hippodrome,OUI,30,20,10,4,6,OUI,OUI,2025-03-13 12:57:11+00:00,"48.85772148887421, 2.2549109905958176",Paris,75056,0.3333333333333333,13
2022,Saint-Fiacre - Poissonière,OUI,33,4,29,13,16,OUI,OUI,2025-03-13 13:01:09+00:00,"48.870828911558, 2.3459213599563",Paris,75056,0.8787878787878788,13
15068,Général Martial Valin - Pont du Garigliano,OUI,14,6,8,3,5,OUI,OUI,2025-03-13 12:56:44+00:00,"48.83823094269141, 2.270506024360657",Paris,75056,0.5714285714285714,13
17025,Chazelles - Courcelles,OUI,33,23,10,3,7,OUI,OUI,2025-03-13 13:01:52+00:00,"48.879406604954, 2.3034455627202988",Paris,75056,0.30303030303030304,13
22207,Rond-point du Dr Albert Schweitzer,OUI,21,17,4,1,3,OUI,OUI,2025-03-13 12:58:21+00:00,"48.78980918988166, 2.3143940046429634",Bagneux,92007,0.19047619047619047,13
21326,Moulin de Pierre - Abbé Grégoire,OUI,20,14,6,0,6,OUI,OUI,2025-03-13 12:57:21+00:00,"48.822036188382, 2.2754641655975",Issy-les-Moulineaux,92040,0.3,13
92002,Théâtre des Amandiers - Palais des sports,OUI,23,6,17,8,9,OUI,OUI,2025-03-13 13:01:47+00:00,"48.892648526839, 2.2136941552162",Nanterre,92050,0.7391304347826086,13
20143,Ramponeau - Belleville,OUI,44,42,2,1,1,OUI,OUI,2025-03-13 12:59:34+00:00,"48.871031137596, 2.379056852114",Paris,75056,0.045454545454545456,13
19027,Serrurier,OUI,18,18,0,0,0,OUI,OUI,2025-03-13 12:59:11+00:00,"48.880493403246, 2.398064173758",Paris,75056,0.0,13
21216,Louis Lejeune - Barbès,OUI,24,23,1,0,1,OUI,OUI,2025-03-13 12:53:42+00:00,"48.81807418981508, 2.3267009854316716",Montrouge,92049,0.041666666666666664,13
31028,Raspail Barbès,OUI,28,22,6,3,3,OUI,OUI,2025-03-13 13:01:27+00:00,"48.8529945, 2.4247387",Montreuil,93048,0.21428571428571427,13
17048,De Toqueville - Terrasse,OUI,30,27,3,1,2,OUI,OUI,2025-03-13 13:01:00+00:00,"48.882428, 2.314002",Paris,75056,0.1,13
44017,Jules Guesde - Pont du Port à l'Anglais,OUI,26,1,25,25,0,OUI,OUI,2025-03-13 13:00:33+00:00,"48.79628807093802, 2.417212128639221",Vitry-sur-Seine,94081,0.9615384615384616,13
16118,Michel-Ange - Parent de Rosan,OUI,23,21,2,1,1,OUI,OUI,2025-03-13 13:00:55+00:00,"48.840579923690115, 2.2584119439125065",Paris,75056,0.08695652173913043,13
2017,Caire - Dussoubs,OUI,39,10,29,27,2,OUI,OUI,2025-03-13 13:01:36+00:00,"48.86785342111862, 2.349364310503006",Paris,75056,0.7435897435897436,13
14013,Liard - Amiral Mouchez,OUI,26,24,2,1,1,OUI,OUI,2025-03-13 13:00:24+00:00,"48.8214169, 2.342167",Paris,75056,0.07692307692307693,13
9008,Tour d'Auvergne - Rodier,OUI,16,15,1,0,1,OUI,OUI,2025-03-13 12:52:18+00:00,"48.879161, 2.343698",Paris,75056,0.0625,13
13030,Italie - Tolbiac,OUI,21,21,0,0,0,OUI,OUI,2025-03-13 12:54:04+00:00,"48.82557229464416, 2.3576171323657036",Paris,75056,0.0,13
8103,Artois - Berri,OUI,22,1,21,11,10,OUI,OUI,2025-03-13 13:01:22+00:00,"48.87393521240818, 2.3064258322119713",Paris,75056,0.9545454545454546,13
9002,Abbeville - Faubourg Poissonnière,OUI,14,11,3,1,2,OUI,OUI,2025-03-13 13:00:38+00:00,"48.879223, 2.349147",Paris,75056,0.21428571428571427,13
8048,Marceau - Chaillot,OUI,19,4,15,2,13,OUI,OUI,2025-03-13 12:59:55+00:00,"48.868834023334, 2.2986030816809",Paris,75056,0.7894736842105263,13
16110,Octave Feuillet - Albéric Magnard,OUI,21,12,9,2,7,OUI,OUI,2025-03-13 12:58:39+00:00,"48.86106902949534, 2.2730283066630363",Paris,75056,0.42857142857142855,13
13118,Regnault - Patay,OUI,63,9,54,45,9,OUI,OUI,2025-03-13 13:01:55+00:00,"48.82435782216384, 2.377065159380436",Paris,75056,0.8571428571428571,13
43009,Place Jean-Spire-Lemaître,OUI,48,46,2,0,2,OUI,OUI,2025-03-13 12:54:28+00:00,"48.8468428626593, 2.452062070369721",Vincennes,94080,0.041666666666666664,13
15112,Vigée-Lebrun - Anselme Payen,OUI,23,22,1,0,1,OUI,OUI,2025-03-13 13:01:02+00:00,"48.838683941628375, 2.3110422492027287",Paris,75056,0.043478260869565216,13
9001,Bellefond - Poissonnière,OUI,15,11,4,0,4,OUI,OUI,2025-03-13 13:01:01+00:00,"48.87759897050706, 2.348463758826256",Paris,75056,0.26666666666666666,13
18111,Félix Ziem - Armand Gauthier,OUI,23,22,1,1,0,OUI,OUI,2025-03-13 12:58:33+00:00,"48.88949630486821, 2.333393658804396",Paris,75056,0.043478260869565216,13
41303,Gare de Nogent-le-Perreux,OUI,31,18,13,10,3,OUI,OUI,2025-03-13 12:55:17+00:00,"48.83842553348809, 2.493693307042122",Nogent-sur-Marne,94052,0.41935483870967744,13
48003,Youri Gagarine - Karl Marx,OUI,22,20,2,1,1,OUI,OUI,2025-03-13 12:57:06+00:00,"48.78448485079149, 2.35908430069685",Villejuif,94076,0.09090909090909091,13
13104,Gare d'Austerlitz - Quai Saint-Bernard,OUI,26,1,25,15,10,OUI,OUI,2025-03-13 13:01:48+00:00,"48.84369030864, 2.3657163977623",Paris,75056,0.9615384615384616,13
17032,Jean Oestreicher - Porte de Champerret,OUI,21,0,21,10,11,OUI,OUI,2025-03-13 13:01:04+00:00,"48.88655580065981, 2.288640439510346",Paris,75056,1.0,13
17040,Pereire - Ternes,OUI,48,43,5,2,3,OUI,OUI,2025-03-13 12:59:34+00:00,"48.87973954830735, 2.288012132048607",Paris,75056,0.10416666666666667,13
8016,Square Louis XVI,OUI,29,1,28,18,10,OUI,OUI,2025-03-13 13:00:02+00:00,"48.87320440102894, 2.323658830743138",Paris,75056,0.9655172413793104,13
31103,Gare Rosny-Bois-Perrier,OUI,32,11,21,0,21,OUI,OUI,2025-03-13 12:59:56+00:00,"48.88115023337061, 2.480436824262142",Rosny-sous-Bois,93064,0.65625,13
10115,Granges aux Belles,OUI,27,24,3,1,2,OUI,OUI,2025-03-13 12:57:49+00:00,"48.8761373390584, 2.3680844979417",Paris,75056,0.1111111111111111,13
7018,Ségur - d'Estrées,OUI,19,0,19,6,13,OUI,OUI,2025-03-13 12:58:43+00:00,"48.851419978983, 2.3097044974566",Paris,75056,1.0,13
10029,Dunkerque - Rocroy,OUI,24,24,0,0,0,OUI,OUI,2025-03-13 12:59:04+00:00,"48.880726, 2.351464",Paris,75056,0.0,13
18203,Lamarck - Saint-Ouen,OUI,40,40,0,0,0,NON,NON,2025-03-13 12:58:34+00:00,"48.891334555236, 2.3272445342326",Paris,75056,0.0,13
10161,Gare de l'Est - Faubourg-Saint-Martin,OUI,32,28,4,2,2,OUI,OUI,2025-03-13 12:48:10+00:00,"48.875642647477, 2.3594588041306",Paris,75056,0.125,13
21323,Charlot - Stade Gabriel Voisin,OUI,31,1,30,27,3,OUI,OUI,2025-03-13 13:01:52+00:00,"48.827228120536, 2.268122527474",Issy-les-Moulineaux,92040,0.967741935483871,13
12031,Gabriel Lamé,OUI,34,26,8,7,1,OUI,OUI,2025-03-13 13:01:04+00:00,"48.8351212784276, 2.385534569621086",Paris,75056,0.23529411764705882,13
9014,Faubourg Montmartre - La Fayette,OUI,33,1,32,19,13,OUI,OUI,2025-03-13 13:01:19+00:00,"48.875254549053, 2.3408536612988",Paris,75056,0.9696969696969697,13
1001,Quai de l'Horloge - Pont Neuf,OUI,16,0,16,10,6,OUI,OUI,2025-03-13 12:57:47+00:00,"48.857058739111, 2.3417982839439",Paris,75056,1.0,13
19105,Ambroise Rendu - Porte Brunet,OUI,17,14,3,1,2,OUI,OUI,2025-03-13 12:57:57+00:00,"48.883667, 2.395733",Paris,75056,0.17647058823529413,13
5022,Boulangers - Cardinal Lemoine,OUI,18,0,18,10,8,OUI,OUI,2025-03-13 12:59:46+00:00,"48.8462904, 2.3521495",Paris,75056,1.0,13
22409,Henri Barbusse - Stalingrad,OUI,15,14,1,0,1,OUI,OUI,2025-03-13 12:54:21+00:00,"48.814183748660554, 2.2872862592339516",Malakoff,92046,0.06666666666666667,13
21328,Verger - Colonel Guichard,OUI,29,26,3,0,3,OUI,OUI,2025-03-13 12:54:51+00:00,"48.816376985087, 2.2670380088932",Issy-les-Moulineaux,92040,0.10344827586206896,13
12151,Gare de Lyon - Place Louis Armand,OUI,58,13,45,40,5,OUI,OUI,2025-03-13 13:01:57+00:00,"48.845515089794, 2.3726498446286",Paris,75056,0.7758620689655172,13
9038,Douai - Bruxelles,OUI,26,20,6,1,5,OUI,OUI,2025-03-13 13:00:16+00:00,"48.88320784122797, 2.3308449949028507",Paris,75056,0.23076923076923078,13
5020,Institut du Monde Arabe - Saint-Germain,OUI,37,1,36,31,5,OUI,OUI,2025-03-13 13:01:30+00:00,"48.849063299501, 2.3558086529374",Paris,75056,0.972972972972973,13
8009,Gare Saint-Lazare - Isly,OUI,25,13,12,6,6,OUI,OUI,2025-03-13 13:00:59+00:00,"48.874777677621296, 2.326515804784655",Paris,75056,0.48,13
92007,Pesaro - Préfecture,OUI,21,15,6,2,4,OUI,OUI,2025-03-13 13:01:50+00:00,"48.89577046284005, 2.223908342421055",Nanterre,92050,0.2857142857142857,13
17008,Porte Pouchet-Bessières,OUI,23,11,12,7,5,OUI,OUI,2025-03-13 12:59:08+00:00,"48.8978765, 2.3230632",Paris,75056,0.5217391304347826,13
16026,Ranelagh - Mozart,OUI,7,0,7,2,5,OUI,OUI,2025-03-13 13:01:10+00:00,"48.8554439, 2.2704418",Paris,75056,1.0,13
5005,Gay Lussac - Saint-Jacques,OUI,24,8,16,4,12,OUI,OUI,2025-03-13 13:01:39+00:00,"48.844730256132, 2.3419239448664",Paris,75056,0.6666666666666666,13
10107,Gare du Nord - Hôpital Lariboisière,OUI,49,45,4,1,3,OUI,OUI,2025-03-13 13:00:03+00:00,"48.881949, 2.352339",Paris,75056,0.08163265306122448,13
8053,Place Georges Guillaumin,OUI,27,18,9,6,3,OUI,OUI,2025-03-13 13:01:56+00:00,"48.874750203957, 2.301771435326",Paris,75056,0.3333333333333333,13
17043,Belidor - Gouvion-Saint-Cyr,OUI,38,23,15,12,3,OUI,OUI,2025-03-13 12:58:08+00:00,"48.88022154052015, 2.2854680567979813",Paris,75056,0.39473684210526316,13
9106,Boudreau - Auber,OUI,27,10,17,7,10,OUI,OUI,2025-03-13 13:01:53+00:00,"48.87219, 2.329423",Paris,75056,0.6296296296296297,13
16039,Exelmans - Versailles,OUI,47,17,30,26,4,OUI,OUI,2025-03-13 13:01:01+00:00,"48.84097491091973, 2.264390252530575",Paris,75056,0.6382978723404256,13
31706,Château - République,OUI,24,21,3,0,3,OUI,OUI,2025-03-13 12:58:27+00:00,"48.862923800596, 2.4155035614967",Bagnolet,93006,0.125,13
11023,Saint-Maur - Roquette,OUI,46,38,8,5,3,OUI,OUI,2025-03-13 13:01:47+00:00,"48.858688774062955, 2.383553994571467",Paris,75056,0.17391304347826086,13
19015,Thionville - Ourcq,OUI,22,17,5,1,4,OUI,OUI,2025-03-13 12:57:55+00:00,"48.88917613743794, 2.3833653330802917",Paris,75056,0.22727272727272727,13
45003,11 Novembre 1918 - 8 Mai 1945,OUI,36,13,23,14,9,OUI,OUI,2025-03-13 12:56:02+00:00,"48.80889533774377, 2.5382421165704727",Champigny-sur-Marne,94017,0.6388888888888888,13
9022,Rossini - Laffitte,OUI,33,0,33,20,13,OUI,OUI,2025-03-13 12:58:53+00:00,"48.87334627510507, 2.337980867701675",Paris,75056,1.0,13
11002,Roquette - Thiéré,OUI,22,1,21,16,5,OUI,OUI,2025-03-13 12:57:59+00:00,"48.85507930579506, 2.3733686318721463",Paris,75056,0.9545454545454546,13
26003,Argenteuil - Voltaire,OUI,16,10,6,3,3,OUI,OUI,2025-03-13 12:59:10+00:00,"48.91864865955558, 2.2814112156629562",Asnières-sur-Seine,92004,0.375,13
12111,Claude Decaen - Cannebière,OUI,27,25,2,2,0,OUI,OUI,2025-03-13 13:01:23+00:00,"48.83761417037952, 2.397253782195704",Paris,75056,0.07407407407407407,13
17004,Legendre - Clichy,OUI,38,36,2,2,0,OUI,OUI,2025-03-13 12:57:18+00:00,"48.88896161855884, 2.322528975094376",Paris,75056,0.05263157894736842,13
11047,Amelot - Saint-Sébastien,OUI,29,4,25,16,9,OUI,OUI,2025-03-13 12:58:48+00:00,"48.861142162761, 2.3677996181077",Paris,75056,0.8620689655172413,13
19003,Quai de la Seine,OUI,24,24,0,0,0,OUI,OUI,2025-03-13 13:00:15+00:00,"48.884492238407525, 2.3703941702842717",Paris,75056,0.0,13
19043,Delphine Seyrig - Général Leclerc,OUI,51,45,6,3,3,OUI,OUI,2025-03-13 12:58:42+00:00,"48.893923963057865, 2.39790290594101",Pantin,93055,0.11764705882352941,13
9028,Moncey - Blanche,OUI,17,17,0,0,0,OUI,OUI,2025-03-13 13:00:33+00:00,"48.88006587474148, 2.3310810327529907",Paris,75056,0.0,13
20042,Pyrénées - Emmery,OUI,39,36,3,0,3,OUI,OUI,2025-03-13 12:58:46+00:00,"48.872010281270974, 2.392039597034455",Paris,75056,0.07692307692307693,13
26002,Redoute - Les Courtilles,OUI,37,15,22,17,5,OUI,OUI,2025-03-13 13:01:39+00:00,"48.929867194519, 2.2836696356535",Asnières-sur-Seine,92004,0.5945945945945946,13
15067,Desaix - Edgar Faure,OUI,11,5,6,3,3,OUI,OUI,2025-03-13 12:59:33+00:00,"48.852804604940296, 2.293077029857222",Paris,75056,0.5454545454545454,13
19026,Place de Rhin et Danube,OUI,14,14,0,0,0,OUI,OUI,2025-03-13 12:54:50+00:00,"48.88192765861766, 2.392586767673493",Paris,75056,0.0,13
11027,Saint-Ambroise - Parmentier,OUI,35,27,8,6,2,OUI,OUI,2025-03-13 13:00:28+00:00,"48.862147844548, 2.3772348091006",Paris,75056,0.22857142857142856,13
8034,Berri - Haussmann,OUI,34,2,32,12,20,OUI,OUI,2025-03-13 13:00:18+00:00,"48.874746047357135, 2.3082953318953514",Paris,75056,0.9411764705882353,13
8010,Liège - Moscou,OUI,15,7,8,3,5,OUI,OUI,2025-03-13 13:00:47+00:00,"48.8795431, 2.3264628",Paris,75056,0.5333333333333333,13
5032,Panthéon - Valette,OUI,39,5,34,1,33,OUI,OUI,2025-03-13 12:59:55+00:00,"48.847020571652, 2.3464982619671",Paris,75056,0.8717948717948718,13
10016,Récollets - Square Villemin,OUI,16,14,2,0,2,OUI,OUI,2025-03-13 12:56:30+00:00,"48.875034655883944, 2.359801238597928",Paris,75056,0.125,13
18107,Chartres - La Charbonnière,OUI,34,34,0,0,0,OUI,OUI,2025-03-13 12:58:59+00:00,"48.8847601, 2.3534657",Paris,75056,0.0,13
31009,Place Du Général De Gaulle,OUI,25,23,2,0,2,OUI,OUI,2025-03-13 12:59:36+00:00,"48.8687591, 2.4329931",Montreuil,93048,0.08,13
17030,Pereire - Rennequin,OUI,22,21,1,1,0,OUI,OUI,2025-03-13 12:59:05+00:00,"48.88364782887555, 2.2952447086572647",Paris,75056,0.045454545454545456,13
41302,Charles de Gaulle - Beauté,OUI,48,48,0,0,0,OUI,OUI,2025-03-13 13:01:15+00:00,"48.83649602312711, 2.479562651149885",Nogent-sur-Marne,94052,0.0,13
6006,Notre-Dame-des-Champs - Stanislas,OUI,19,6,13,9,4,OUI,OUI,2025-03-13 12:58:42+00:00,"48.84479928858768, 2.329337755887181",Paris,75056,0.6842105263157895,13
33017,Anatole France - President Roosevelt,OUI,25,18,7,1,6,OUI,OUI,2025-03-13 12:59:17+00:00,"48.9155156, 2.3814103",Aubervilliers,93001,0.28,13
12128,Pyramide - Ecole du Breuil,OUI,33,32,1,0,1,OUI,OUI,2025-03-13 12:54:00+00:00,"48.82237977153955, 2.4586871266365056",Paris,75056,0.030303030303030304,13
15042,Henry Farman,OUI,16,1,15,11,4,OUI,OUI,2025-03-13 12:57:23+00:00,"48.83372430280548, 2.2713854536414146",Paris,75056,0.9375,13
31022,Mairie de Montreuil,OUI,51,48,3,2,1,OUI,OUI,2025-03-13 13:01:09+00:00,"48.86131452758348, 2.440614402294159",Montreuil,93048,0.058823529411764705,13
18011,Pajol - Place Herbert,OUI,39,37,2,1,1,OUI,OUI,2025-03-13 13:00:36+00:00,"48.8927825, 2.3635598",Paris,75056,0.05128205128205128,13
46002,Rouget de Lisle,OUI,35,4,31,16,15,OUI,OUI,2025-03-13 12:56:56+00:00,"48.764615483395254, 2.4071189761161804",Choisy-le-Roi,94022,0.8857142857142857,13
42706,Roger Salengro - Fontainebleau,OUI,25,16,9,2,7,OUI,OUI,2025-03-13 13:01:02+00:00,"48.814548697325, 2.3611663654447",Le Kremlin-Bicêtre,94043,0.36,13
14020,Cimetière de Montrouge,OUI,57,56,1,0,1,OUI,OUI,2025-03-13 12:54:35+00:00,"48.821466904768, 2.3215785772007",Paris,75056,0.017543859649122806,13
19101,Square Simon Bolivar,OUI,23,19,4,1,3,OUI,OUI,2025-03-13 12:56:56+00:00,"48.875089888322, 2.3826304078102",Paris,75056,0.17391304347826086,13
33102,Gabriel Péri - Francisco Ferrer,OUI,17,15,2,0,2,OUI,OUI,2025-03-13 12:59:47+00:00,"48.88633710236977, 2.407338917255402",Le Pré-Saint-Gervais,93061,0.11764705882352941,13
14138,Porte de Vanves,OUI,30,28,2,1,1,OUI,OUI,2025-03-13 12:53:18+00:00,"48.828012849445, 2.3056878894567",Paris,75056,0.06666666666666667,13
21212,Marne - Germain Dardan,OUI,21,18,3,2,1,OUI,OUI,2025-03-13 12:56:34+00:00,"48.81217465201, 2.3035024699104",Montrouge,92049,0.14285714285714285,13
46003,Conservatoire de Musique,OUI,24,2,22,19,3,OUI,OUI,2025-03-13 13:01:51+00:00,"48.77093586667601, 2.4034014344215398",Choisy-le-Roi,94022,0.9166666666666666,13
44006,Concorde - Stalingrad,OUI,35,34,1,0,1,OUI,OUI,2025-03-13 12:59:44+00:00,"48.7985844, 2.3821302",Vitry-sur-Seine,94081,0.02857142857142857,13
41209,Cimetière de Fontenay-sous-Bois,OUI,15,15,0,0,0,OUI,OUI,2025-03-13 13:00:21+00:00,"48.84706173362218, 2.4787822365760808",Fontenay-sous-Bois,94033,0.0,13
19120,Carducci - Place Hannah Arendt,OUI,27,26,1,0,1,OUI,OUI,2025-03-13 12:51:57+00:00,"48.877436681515796, 2.3860743641853337",Paris,75056,0.037037037037037035,13
21312,Lucie Aubrac - Fort,OUI,30,28,2,0,2,OUI,OUI,2025-03-13 12:54:19+00:00,"48.818144834008976, 2.271184623241425",Issy-les-Moulineaux,92040,0.06666666666666667,13
18003,Cimetière de Montmartre,OUI,43,42,1,0,1,OUI,OUI,2025-03-13 12:55:20+00:00,"48.886472466142, 2.3328901827335",Paris,75056,0.023255813953488372,13
14008,Mouton Duvernet - Général Leclerc,OUI,26,23,3,0,3,OUI,OUI,2025-03-13 13:00:15+00:00,"48.831632518293, 2.3293121159077",Paris,75056,0.11538461538461539,13
11113,Richard Lenoir - Republique,OUI,57,22,35,34,1,OUI,OUI,2025-03-13 13:01:26+00:00,"48.8667175, 2.3692541",Paris,75056,0.6140350877192983,13
13001,Port-Royal - Hôpital du Val-de-Grâce,OUI,17,10,7,2,5,OUI,OUI,2025-03-13 13:01:38+00:00,"48.837668272811, 2.3448138346607",Paris,75056,0.4117647058823529,13
15104,Hôpital Européen Georges Pompidou,OUI,63,12,51,49,2,OUI,OUI,2025-03-13 13:01:56+00:00,"48.837695319163, 2.2753742337227",Paris,75056,0.8095238095238095,13
8017,Rocher - Laborde,OUI,64,53,11,10,1,OUI,OUI,2025-03-13 13:01:13+00:00,"48.87590240712654, 2.322616316378116",Paris,75056,0.171875,13
14003,Schoelcher - Raspail,OUI,47,43,4,1,3,OUI,OUI,2025-03-13 13:00:51+00:00,"48.83681733526843, 2.3312794080411474",Paris,75056,0.0851063829787234,13
15054,Lecourbe - Jean Maridor,OUI,18,12,6,4,2,OUI,OUI,2025-03-13 12:57:25+00:00,"48.83796366147599, 2.2877392172813416",Paris,75056,0.3333333333333333,13
43008,Fontenay - Libération,OUI,25,18,7,2,5,OUI,OUI,2025-03-13 13:01:55+00:00,"48.847803063647, 2.4451419711113",Vincennes,94080,0.28,13
15106,Grenelle - Violet,OUI,34,17,17,16,1,OUI,OUI,2025-03-13 13:01:42+00:00,"48.84993035512154, 2.294612042605877",Paris,75056,0.5,13
5018,Mutualité,OUI,37,0,37,31,6,OUI,OUI,2025-03-13 12:58:45+00:00,"48.848225572724, 2.3502873256803",Paris,75056,1.0,13
14106,Marc Sangnier - Porte de Vanves,OUI,20,19,1,0,1,OUI,OUI,2025-03-13 12:52:45+00:00,"48.825218683556734, 2.3107116669416428",Paris,75056,0.05,13
19103,Manin - Carrières d'Amérique,OUI,17,15,2,1,1,OUI,OUI,2025-03-13 12:59:42+00:00,"48.88467214209463, 2.3919698596000676",Paris,75056,0.11764705882352941,13
18046,Etienne Jodelle - Saint Ouen,OUI,32,31,1,0,1,OUI,OUI,2025-03-13 12:59:22+00:00,"48.88794016394694, 2.326124420314341",Paris,75056,0.03125,13
12114,Victor Hugo - Jeanne Jugan,OUI,28,26,2,1,1,OUI,OUI,2025-03-13 12:56:05+00:00,"48.843949064031825, 2.415081394834419",Paris,75056,0.07142857142857142,13
22406,Guy Môquet - Etienne Dolet,OUI,22,18,4,1,3,OUI,OUI,2025-03-13 12:59:30+00:00,"48.81527009991819, 2.298078276995073",Malakoff,92046,0.18181818181818182,13
18028,Championnet - Vauvenargues,OUI,31,28,3,1,2,OUI,OUI,2025-03-13 13:01:09+00:00,"48.89401874744574, 2.3319872841238976",Paris,75056,0.0967741935483871,13
8054,Bertie Albrecht - Hoche,OUI,32,16,16,8,8,OUI,OUI,2025-03-13 12:59:09+00:00,"48.87614039826388, 2.301303138307601",Paris,75056,0.5,13
5124,Erasme - Ulm,OUI,22,1,21,3,18,OUI,OUI,2025-03-13 13:00:52+00:00,"48.84264375274712, 2.3445946723222733",Paris,75056,0.9545454545454546,13
21005,Hôtel de Ville de Boulogne Billancourt,OUI,26,2,24,6,18,OUI,OUI,2025-03-13 13:01:11+00:00,"48.83495885166784, 2.2416803240776066",Boulogne-Billancourt,92012,0.9230769230769231,13
31102,Boissière - Etienne Dolet,OUI,20,15,5,1,4,OUI,OUI,2025-03-13 12:58:07+00:00,"48.876111, 2.4677312",Montreuil,93048,0.25,13
17203,Place de la Porte de Champeret,OUI,28,10,18,15,3,OUI,OUI,2025-03-13 13:00:27+00:00,"48.886062068226, 2.2917001576821",Paris,75056,0.6428571428571429,13
2111,Chabanais - Petits Champs,OUI,29,3,26,18,8,OUI,OUI,2025-03-13 12:58:36+00:00,"48.86703740186721, 2.336716018617153",Paris,75056,0.896551724137931,13
8045,Place de la Reine Astrid,OUI,57,16,41,24,17,OUI,OUI,2025-03-13 12:58:25+00:00,"48.864920982538, 2.3025491823859",Paris,75056,0.7192982456140351,13
18022,Marcadet - Barbès,OUI,34,29,5,0,5,OUI,OUI,2025-03-13 13:01:38+00:00,"48.890451120965, 2.3490573929687",Paris,75056,0.14705882352941177,13
15133,Saint Lambert - Blomet,OUI,26,25,1,1,0,OUI,OUI,2025-03-13 13:00:12+00:00,"48.83659148147257, 2.2930556908249855",Paris,75056,0.038461538461538464,13
15109,Cevennes - Bergers,OUI,28,22,6,4,2,OUI,OUI,2025-03-13 12:58:10+00:00,"48.84240765130395, 2.281037718057633",Paris,75056,0.21428571428571427,13
15110,Place Robert Guillemard,OUI,22,0,22,17,5,OUI,OUI,2025-03-13 13:01:06+00:00,"48.836191728066666, 2.2811267160086417",Paris,75056,1.0,13
21209,Molière - République,OUI,30,28,2,0,2,OUI,OUI,2025-03-13 12:59:31+00:00,"48.81111581390707, 2.3145738624448158",Montrouge,92049,0.06666666666666667,13
21006,Marcelin Berthelot,OUI,27,21,6,2,4,OUI,OUI,2025-03-13 12:55:10+00:00,"48.8415473058801, 2.233161628246308",Boulogne-Billancourt,92012,0.2222222222222222,13
14012,Sibelle - Alésia,OUI,37,35,2,0,2,OUI,OUI,2025-03-13 12:54:23+00:00,"48.826701758539215, 2.3384983465075493",Paris,75056,0.05405405405405406,13
35010,Hoche - Jean Lolive,OUI,20,17,3,0,3,OUI,OUI,2025-03-13 12:59:33+00:00,"48.89110239200789, 2.402843534946442",Pantin,93055,0.15,13
20131,Repos - Cimetière du Père Lachaise,OUI,33,33,0,0,0,OUI,OUI,2025-03-13 12:55:19+00:00,"48.859358523593, 2.3896131366845",Paris,75056,0.0,13
10042,Enghien - Faubourg Poissonnière,OUI,32,15,17,16,1,OUI,OUI,2025-03-13 12:59:01+00:00,"48.872420063053, 2.3483952362828",Paris,75056,0.53125,13
6025,Assas - Rennes,OUI,31,12,19,10,9,OUI,OUI,2025-03-13 13:01:03+00:00,"48.8492084999386, 2.32851454623001",Paris,75056,0.6129032258064516,13
42014,Place Marcel Cachin,OUI,32,10,22,21,1,OUI,OUI,2025-03-13 12:59:10+00:00,"48.81411442356866, 2.39090770483017",Ivry-sur-Seine,94041,0.6875,13
21015,Nationale - Place Jules Guesde,OUI,23,10,13,9,4,OUI,OUI,2025-03-13 13:01:57+00:00,"48.82753962462998, 2.2416052222251897",Boulogne-Billancourt,92012,0.5652173913043478,13
4016,Lobau - Hôtel de Ville,OUI,59,3,56,45,11,OUI,OUI,2025-03-13 13:01:50+00:00,"48.8562118, 2.3532536",Paris,75056,0.9491525423728814,13
44003,Gabriel Péri - Danielle Casanova,OUI,20,8,12,8,4,OUI,OUI,2025-03-13 12:59:37+00:00,"48.790114, 2.4025777",Vitry-sur-Seine,94081,0.6,13
14124,David Weill - Parc Montsouris,OUI,22,19,3,0,3,OUI,OUI,2025-03-13 12:57:34+00:00,"48.821092374256104, 2.333725690841675",Paris,75056,0.13636363636363635,13
5028,Censier - Jardin des Plantes,OUI,28,11,17,15,2,OUI,OUI,2025-03-13 12:59:27+00:00,"48.84107178161383, 2.355475388467312",Paris,75056,0.6071428571428571,13
44013,Edouard Tremblay - Julian Grimaux,OUI,30,29,1,1,0,OUI,OUI,2025-03-13 12:55:10+00:00,"48.781383825117, 2.3723508417606",Vitry-sur-Seine,94081,0.03333333333333333,13
48010,Karl Marx,OUI,16,5,11,2,9,OUI,OUI,2025-03-13 12:55:06+00:00,"48.784527937293184, 2.3646667979455587",Villejuif,94076,0.6875,13
15034,Lakanal - Commerce,OUI,48,14,34,31,3,OUI,OUI,2025-03-13 12:59:55+00:00,"48.84442462786544, 2.294059172272682",Paris,75056,0.7083333333333334,13
22203,Tertres - Fontaine,OUI,27,26,1,0,1,OUI,OUI,2025-03-13 13:01:25+00:00,"48.787553654715644, 2.306235730648041",Bagneux,92007,0.037037037037037035,13
31003,Paris - Emile Zola,OUI,29,26,3,0,3,OUI,OUI,2025-03-13 13:00:40+00:00,"48.854898095789295, 2.4186685681343083",Montreuil,93048,0.10344827586206896,13
41202,Gare Rer de Fontenay sous Bois,OUI,59,53,6,3,3,OUI,OUI,2025-03-13 12:59:59+00:00,"48.8436279, 2.4630465",Fontenay-sous-Bois,94033,0.1016949152542373,13
22402,Jean Jaurès - Salvador Allende,OUI,42,41,1,0,1,OUI,OUI,2025-03-13 13:01:20+00:00,"48.821475594736775, 2.3026576638221745",Malakoff,92046,0.023809523809523808,13
42021,Raspail - Manufacture des Oeillets,OUI,30,7,23,21,2,OUI,OUI,2025-03-13 12:59:50+00:00,"48.8094458, 2.3903009",Ivry-sur-Seine,94041,0.7666666666666667,13
11030,Oberkampf - République,OUI,20,17,3,0,3,OUI,OUI,2025-03-13 12:57:59+00:00,"48.86531608707, 2.37611478491",Paris,75056,0.15,13
1119,Cossonnerie - Sébastopol,OUI,23,3,20,14,6,OUI,OUI,2025-03-13 12:59:10+00:00,"48.86132665908402, 2.349419631063938",Paris,75056,0.8695652173913043,13
32604,Square du Théâtre du Garde-Chasse,OUI,50,49,1,0,1,OUI,OUI,2025-03-13 12:54:09+00:00,"48.881287375060616, 2.420119643211365",Les Lilas,93045,0.02,13
35020,Marcelle - Thalie,OUI,20,20,0,0,0,OUI,OUI,2025-03-13 13:00:00+00:00,"48.8835462, 2.4137883",Pantin,93055,0.0,13
41601,Général De Gaulle - Alouette,OUI,25,15,10,5,5,OUI,OUI,2025-03-13 13:01:33+00:00,"48.839109, 2.4175664",Saint-Mandé,94067,0.4,13
1020,Cambon - Rivoli,OUI,34,7,27,14,13,OUI,OUI,2025-03-13 13:01:54+00:00,"48.866143390992, 2.3251800647137",Paris,75056,0.7941176470588235,13
23006,Jules Guesde - Alsace,OUI,24,5,19,12,7,OUI,OUI,2025-03-13 13:01:50+00:00,"48.890566275506, 2.2950777411461",Levallois-Perret,92044,0.7916666666666666,13
25003,Henri Ste-Claire Déville - Paul Héroult,OUI,21,7,14,6,8,OUI,OUI,2025-03-13 13:01:44+00:00,"48.892663, 2.172411",Rueil-Malmaison,92063,0.6666666666666666,13
15021,Joseph Liouville - Croix Nivert,OUI,62,30,32,27,5,OUI,OUI,2025-03-13 12:58:34+00:00,"48.844835471244416, 2.297508493065834",Paris,75056,0.5161290322580645,13
20115,Louis Lumière - Porte de Bagnolet,OUI,20,20,0,0,0,OUI,OUI,2025-03-13 12:54:51+00:00,"48.86431136000005, 2.4105210229754443",Paris,75056,0.0,13
17105,Place Madeleine Daniélou,OUI,42,21,21,17,4,OUI,OUI,2025-03-13 13:01:27+00:00,"48.883498, 2.282015",Paris,75056,0.5,13
9116,Victoire - Chaussée d'Antin,OUI,24,2,22,6,16,OUI,OUI,2025-03-13 13:00:07+00:00,"48.875065791004396, 2.3316738009452824",Paris,75056,0.9166666666666666,13
9010,Rochechouart lamartine,OUI,24,13,11,3,8,OUI,OUI,2025-03-13 12:59:45+00:00,"48.876719895109, 2.344393021854",Paris,75056,0.4583333333333333,13
11039,Richard Lenoir - Jean-Pierre Timbaud,OUI,35,20,15,14,1,OUI,OUI,2025-03-13 12:54:34+00:00,"48.865804276686, 2.3693370749669",Paris,75056,0.42857142857142855,13
18009,Jean-François Lépine - Stephenson,OUI,20,18,2,1,1,OUI,OUI,2025-03-13 12:55:09+00:00,"48.88611466796807, 2.356855627529275",Paris,75056,0.1,13
17013,Legendre - Dulong,OUI,23,20,3,1,2,OUI,OUI,2025-03-13 12:58:10+00:00,"48.885325169402904, 2.316423766314984",Paris,75056,0.13043478260869565,13
11105,Parmentier - République,OUI,22,19,3,0,3,OUI,OUI,2025-03-13 13:01:08+00:00,"48.8644954, 2.3750124",Paris,75056,0.13636363636363635,13
11026,Chemin Vert - Saint-Maur,OUI,44,39,5,0,5,OUI,OUI,2025-03-13 13:01:32+00:00,"48.86112461407359, 2.381299026310444",Paris,75056,0.11363636363636363,13
16108,Sablons - Georges Mandel,OUI,38,34,4,3,1,OUI,OUI,2025-03-13 12:56:34+00:00,"48.863875, 2.28189",Paris,75056,0.10526315789473684,13
19024,Botzaris - Parc des Buttes Chaumont,OUI,20,18,2,1,1,OUI,OUI,2025-03-13 13:00:11+00:00,"48.877951, 2.381464",Paris,75056,0.1,13
17125,Marie-Georges Picquart - Pereire,OUI,31,26,5,4,1,OUI,OUI,2025-03-13 13:00:09+00:00,"48.88863669349711, 2.3111706599593163",Paris,75056,0.16129032258064516,13
43005,Gare RER de Vincennes,OUI,47,31,16,7,9,OUI,OUI,2025-03-13 13:01:15+00:00,"48.847563015126106, 2.433383166790009",Vincennes,94080,0.3404255319148936,13
16008,Galilée - Kléber,OUI,30,9,21,4,17,OUI,OUI,2025-03-13 13:01:52+00:00,"48.867411865714, 2.2907813801148",Paris,75056,0.7,13
16136,Théophile Gautier - François Millet,OUI,27,3,24,17,7,OUI,OUI,2025-03-13 13:01:33+00:00,"48.85034821320644, 2.273029983043671",Paris,75056,0.8888888888888888,13
11024,Mairie du 11ème,OUI,51,43,8,6,2,OUI,OUI,2025-03-13 13:01:36+00:00,"48.858925, 2.3789759",Paris,75056,0.1568627450980392,13
19032,Villette - Belleville,OUI,39,33,6,4,2,OUI,OUI,2025-03-13 13:01:28+00:00,"48.8726877314, 2.376461327076",Paris,75056,0.15384615384615385,13
13050,Quai Panhard et Levassor,OUI,57,0,57,31,26,OUI,OUI,2025-03-13 13:00:59+00:00,"48.828374828097, 2.3842737458056",Paris,75056,1.0,13
19022,Marché Secrétan,OUI,25,20,5,1,4,OUI,OUI,2025-03-13 13:01:52+00:00,"48.88125496379482, 2.373463287949562",Paris,75056,0.2,13
32302,Chemin Vert - Fraternité,OUI,20,18,2,0,2,OUI,OUI,2025-03-13 12:59:50+00:00,"48.877141208359035, 2.4461565166711807",Romainville,93063,0.1,13
21701,Larmeroux - Baudelaire,OUI,28,23,5,0,5,OUI,OUI,2025-03-13 12:58:26+00:00,"48.816939911292, 2.2809894804846",Vanves,92075,0.17857142857142858,13
10014,Marseille - Beaurepaire,OUI,46,5,41,35,6,OUI,OUI,2025-03-13 13:01:32+00:00,"48.871624306962985, 2.3639265082738348",Paris,75056,0.8913043478260869,13
22003,Beffroy,OUI,26,2,24,6,18,OUI,OUI,2025-03-13 12:58:06+00:00,"48.886591074488, 2.2613945603371",Neuilly-sur-Seine,92051,0.9230769230769231,13
11035,Parmentier - Abel Rabaud,OUI,49,46,3,1,2,OUI,OUI,2025-03-13 12:58:10+00:00,"48.86921273836114, 2.371688821240712",Paris,75056,0.061224489795918366,13
42010,Mairie d'Ivry-sur-Seine,OUI,51,22,29,28,1,OUI,OUI,2025-03-13 13:01:27+00:00,"48.81057120969284, 2.3842826485633855",Ivry-sur-Seine,94041,0.5686274509803921,13
21008,Victor Hugo - Galliéni,OUI,33,17,16,15,1,OUI,OUI,2025-03-13 12:59:40+00:00,"48.838020154411, 2.2460845112801",Boulogne-Billancourt,92012,0.48484848484848486,13
15046,Parc Georges Brassens - Brancion,OUI,28,25,3,1,2,OUI,OUI,2025-03-13 12:59:45+00:00,"48.83227829269761, 2.3022570088505745",Paris,75056,0.10714285714285714,13
20134,Lieutenant Chauré - Etienne Marey,OUI,19,19,0,0,0,OUI,OUI,2025-03-13 13:01:56+00:00,"48.86746195408435, 2.405970990657807",Paris,75056,0.0,13
16040,Exelmans - Michel-Ange,OUI,31,14,17,12,5,OUI,OUI,2025-03-13 12:58:21+00:00,"48.84309486651855, 2.2597770800669053",Paris,75056,0.5483870967741935,13
24001,Arche - Léonard de Vinci,OUI,27,21,6,5,1,OUI,OUI,2025-03-13 13:00:48+00:00,"48.89790972494496, 2.2383723043644914",Courbevoie,92026,0.2222222222222222,13
19029,Seine - Flandre,OUI,18,17,1,0,1,OUI,OUI,2025-03-13 12:58:44+00:00,"48.886785741479684, 2.3746193200349808",Paris,75056,0.05555555555555555,13
22016,Charles de Gaulle - Sablonville,OUI,26,13,13,6,7,OUI,OUI,2025-03-13 12:59:27+00:00,"48.87991924860035, 2.2763770446181297",Neuilly-sur-Seine,92051,0.5,13
19016,Hautpoul - Jean Jaurès,OUI,30,27,3,2,1,OUI,OUI,2025-03-13 12:55:31+00:00,"48.886393679436, 2.3865414544355",Paris,75056,0.1,13
14136,Auguste Cain - Jean Moulin,OUI,40,38,2,1,1,OUI,OUI,2025-03-13 12:59:10+00:00,"48.82577028927573, 2.3210415244102482",Paris,75056,0.05,13
21104,Madame de Sanzillon - Mozart,OUI,22,1,21,15,6,OUI,OUI,2025-03-13 13:01:23+00:00,"48.90379820774301, 2.3187401890754704",Clichy,92024,0.9545454545454546,13
46001,Place Paul Eluard,OUI,19,4,15,9,6,OUI,OUI,2025-03-13 12:58:52+00:00,"48.7672039733195, 2.4144977331161503",Choisy-le-Roi,94022,0.7894736842105263,13
32026,Leroy des Barres - Médiathèque,OUI,27,3,24,10,14,OUI,OUI,2025-03-13 13:01:21+00:00,"48.928253687082, 2.3681719727966",Saint-Denis,93066,0.8888888888888888,13
22006,Pierret - Madrid,OUI,27,1,26,20,6,OUI,OUI,2025-03-13 13:00:18+00:00,"48.882976576876565, 2.260125767248034",Neuilly-sur-Seine,92051,0.9629629629629629,13
7102,Mairie du 7ème,OUI,48,3,45,26,19,OUI,OUI,2025-03-13 13:01:25+00:00,"48.8577967, 2.3192664",Paris,75056,0.9375,13
17028,Reims - Raymond Pitet,OUI,36,16,20,17,3,OUI,OUI,2025-03-13 13:01:00+00:00,"48.8888, 2.296319",Paris,75056,0.5555555555555556,13
21301,Saint-Vincent - Verdun,OUI,33,15,18,15,3,OUI,OUI,2025-03-13 12:58:11+00:00,"48.819211549234495, 2.254007756710053",Issy-les-Moulineaux,92040,0.5454545454545454,13
19013,Laumière - Petit,OUI,32,30,2,1,1,OUI,OUI,2025-03-13 13:00:04+00:00,"48.88467368538326, 2.380039058625698",Paris,75056,0.0625,13
42302,Aristide Briand - Gare de Bagneux,OUI,20,20,0,0,0,OUI,OUI,2025-03-13 12:58:49+00:00,"48.79387269664978, 2.321148812770844",Cachan,94016,0.0,13
42301,Gare Arcueil - Cachan,OUI,25,19,6,1,5,OUI,OUI,2025-03-13 12:59:59+00:00,"48.799824, 2.328171",Arcueil,94003,0.24,13
9032,Mathurins - Auber,OUI,35,7,28,21,7,OUI,OUI,2025-03-13 13:01:37+00:00,"48.872988840744, 2.3294984212276",Paris,75056,0.8,13
42504,Gare RER de Gentilly,OUI,30,26,4,2,2,OUI,OUI,2025-03-13 12:53:06+00:00,"48.814280450380224, 2.3410347104072575",Gentilly,94037,0.13333333333333333,13
32003,Wilson - Métallurgie,OUI,28,13,15,10,5,OUI,OUI,2025-03-13 13:01:16+00:00,"48.909423010092326, 2.3584435880184174",Saint-Denis,93066,0.5357142857142857,13
20043,Charonne - Avron,OUI,25,23,2,0,2,OUI,OUI,2025-03-13 13:01:34+00:00,"48.851602665222, 2.3984030470379",Paris,75056,0.08,13
11042,Grand Prieuré - Crussol,OUI,46,25,21,19,2,OUI,OUI,2025-03-13 13:00:12+00:00,"48.864660627935, 2.3692265531829",Paris,75056,0.45652173913043476,13
42015,Place Jean Ferrat,OUI,23,17,6,1,5,OUI,OUI,2025-03-13 13:00:27+00:00,"48.8184945213025, 2.3744174838066106",Ivry-sur-Seine,94041,0.2608695652173913,13
9005,Square d'Anvers,OUI,31,30,1,0,1,OUI,OUI,2025-03-13 13:01:39+00:00,"48.882633484311, 2.3448844062122",Paris,75056,0.03225806451612903,13
32016,Place de la Porte de Paris,OUI,35,27,8,3,5,OUI,OUI,2025-03-13 13:01:33+00:00,"48.93009363207303, 2.3564037680625916",Saint-Denis,93066,0.22857142857142856,13
1013,Place du Palais Royal,OUI,65,1,64,42,22,OUI,OUI,2025-03-13 13:01:56+00:00,"48.862382970647, 2.3384822532535",Paris,75056,0.9846153846153847,13
31010,Stalingrad - Désiré Chevalier,OUI,41,39,2,1,1,OUI,OUI,2025-03-13 12:56:20+00:00,"48.85670169739857, 2.445072233676911",Montreuil,93048,0.04878048780487805,13
8025,Miromesnil - La Boétie,OUI,32,5,27,14,13,OUI,OUI,2025-03-13 13:01:51+00:00,"48.873722412917, 2.3158480972052",Paris,75056,0.84375,13
19008,Flandre - Alphonse Karr,OUI,26,19,7,1,6,OUI,OUI,2025-03-13 12:58:22+00:00,"48.89465, 2.381868",Paris,75056,0.2692307692307692,13
13002,Arago - Glacière,OUI,26,17,9,6,3,OUI,OUI,2025-03-13 13:00:55+00:00,"48.83486054775774, 2.3445770524322067",Paris,75056,0.34615384615384615,13
18201,Tristan Tzara -  Tchaïkovski,OUI,33,29,4,2,2,OUI,OUI,2025-03-13 12:57:39+00:00,"48.89490221746837, 2.3648490384221077",Paris,75056,0.12121212121212122,13
20121,Boyer - Ménilmontant,OUI,19,19,0,0,0,OUI,OUI,2025-03-13 12:53:10+00:00,"48.868895162679, 2.3919824145635",Paris,75056,0.0,13
41402,Victor Hugo - Ecoles,OUI,22,11,11,6,5,OUI,OUI,2025-03-13 12:55:18+00:00,"48.80476007936134, 2.4180373930262093",Alfortville,94002,0.5,13
26013,Quai du docteur Dervaux,OUI,26,17,9,8,1,OUI,OUI,2025-03-13 12:58:47+00:00,"48.910482, 2.297998",Asnières-sur-Seine,92004,0.34615384615384615,13
18012,Stephenson - Doudeauville,OUI,35,32,3,1,2,OUI,OUI,2025-03-13 13:00:06+00:00,"48.888537048944826, 2.3561610281467438",Paris,75056,0.08571428571428572,13
20111,Villiers de l'Isle Adam - Pyrénées,OUI,20,19,1,0,1,OUI,OUI,2025-03-13 13:01:11+00:00,"48.867362, 2.396222",Paris,75056,0.05,13
15201,Place Amédée Gordini - Lefebvre,OUI,37,33,4,1,3,OUI,OUI,2025-03-13 13:01:40+00:00,"48.83061737745, 2.2920634208276",Paris,75056,0.10810810810810811,13
5123,Saint-Germain - Thenard,OUI,29,3,26,14,12,OUI,OUI,2025-03-13 13:00:48+00:00,"48.850571, 2.3471015",Paris,75056,0.896551724137931,13
11004,Charonne - Faubourg Saint-Antoine,OUI,32,13,19,18,1,OUI,OUI,2025-03-13 13:01:42+00:00,"48.852191909696, 2.3740932717919",Paris,75056,0.59375,13
11036,Jules Ferry - Faubourg du Temple Paris,OUI,56,32,24,20,4,OUI,OUI,2025-03-13 12:59:39+00:00,"48.868397, 2.3678933",Paris,75056,0.42857142857142855,13
92008,Hôtel de Ville de Nanterre,OUI,35,13,22,11,11,OUI,OUI,2025-03-13 13:01:33+00:00,"48.892371898250424, 2.205548956990242",Nanterre,92050,0.6285714285714286,13
9021,Saint Georges - d'Aumale,OUI,23,16,7,4,3,OUI,OUI,2025-03-13 13:01:36+00:00,"48.87778639599673, 2.337429821491241",Paris,75056,0.30434782608695654,13
51004,Général Delambre - Prebuard,OUI,28,17,11,2,9,OUI,OUI,2025-03-13 12:56:10+00:00,"48.93870344444, 2.2234171606307",Argenteuil,95018,0.39285714285714285,13
12027,Montgallet - Charenton,OUI,15,4,11,10,1,OUI,OUI,2025-03-13 13:01:55+00:00,"48.842647778701, 2.3861649278137",Paris,75056,0.7333333333333333,13
12009,Charenton - Diderot,OUI,18,14,4,2,2,OUI,OUI,2025-03-13 13:00:35+00:00,"48.846171461187, 2.3793068155646",Paris,75056,0.2222222222222222,13
8035,Bienfaisance - Place de Narvik,OUI,34,5,29,19,10,OUI,OUI,2025-03-13 13:01:33+00:00,"48.87660163459077, 2.3129771277308464",Paris,75056,0.8529411764705882,13
19125,Place de l'Édit de Nantes,OUI,27,23,4,2,2,OUI,OUI,2025-03-13 13:00:29+00:00,"48.88879, 2.3785",Paris,75056,0.14814814814814814,13
28001,Richard Wallace - Place du 8 Mai 1945,OUI,29,9,20,13,7,OUI,OUI,2025-03-13 13:01:39+00:00,"48.87866794788021, 2.2420343756675725",Puteaux,92062,0.6896551724137931,13
14036,Boulard - Daguerre,OUI,43,43,0,0,0,OUI,OUI,2025-03-13 13:00:45+00:00,"48.83446472680611, 2.3293386027216907",Paris,75056,0.0,13
11007,Jean Macé - Faidherbe,OUI,57,51,6,1,5,OUI,OUI,2025-03-13 13:00:39+00:00,"48.85337548426, 2.3828620836139",Paris,75056,0.10526315789473684,13
19205,Simon Bolivar - Henri Turot,OUI,23,21,2,0,2,OUI,OUI,2025-03-13 12:57:18+00:00,"48.877475489801, 2.3739709492211",Paris,75056,0.08695652173913043,13
15025,Dupleix - du Guesclin,OUI,46,21,25,21,4,OUI,OUI,2025-03-13 13:01:49+00:00,"48.85147910413369, 2.296709530055523",Paris,75056,0.5434782608695652,13
43003,Hôpital Bégin,OUI,26,26,0,0,0,NON,NON,2025-03-13 12:59:25+00:00,"48.84571672113, 2.4272462725639",Vincennes,94080,0.0,13
35018,Ancien Canal - Hélène Brion,OUI,23,23,0,0,0,OUI,OUI,2025-03-13 12:57:25+00:00,"48.89484799296163, 2.4188338592648506",Pantin,93055,0.0,13
23009,Anatole France - Louise Michel,OUI,47,44,3,1,2,OUI,OUI,2025-03-13 13:01:36+00:00,"48.88873214926474, 2.2881576418876652",Levallois-Perret,92044,0.06382978723404255,13
19005,Flandre - Riquet,OUI,19,18,1,0,1,OUI,OUI,2025-03-13 13:00:28+00:00,"48.888013281448, 2.3737595955229",Paris,75056,0.05263157894736842,13
42029,Stalingrad - Germaine Tailleferre,OUI,28,28,0,0,0,OUI,OUI,2025-03-13 13:01:54+00:00,"48.80257200481316, 2.3786691203713417",Ivry-sur-Seine,94041,0.0,13
41606,Pasteur - Gambetta,OUI,19,8,11,6,5,OUI,OUI,2025-03-13 13:00:18+00:00,"48.84572797384512, 2.4236011505126953",Saint-Mandé,94067,0.5789473684210527,13
21313,Guynemer - Séverine,OUI,24,1,23,17,6,OUI,OUI,2025-03-13 13:00:18+00:00,"48.83091743371036, 2.2790706530213356",Issy-les-Moulineaux,92040,0.9583333333333334,13
17011,Fragonard - Porte de Clichy,OUI,55,26,29,23,6,OUI,OUI,2025-03-13 12:59:50+00:00,"48.894155633419, 2.3143893107772",Paris,75056,0.5272727272727272,13
17102,Alfred Roll - Berthier,OUI,28,20,8,7,1,OUI,OUI,2025-03-13 13:01:09+00:00,"48.887808570529, 2.3000952981763",Paris,75056,0.2857142857142857,13
33018,Edouard Poisson - Victor Hugo,OUI,26,23,3,2,1,OUI,OUI,2025-03-13 13:01:01+00:00,"48.91118557052621, 2.379864752692811",Aubervilliers,93001,0.11538461538461539,13
26007,Square Gilbert Thomain,OUI,19,10,9,5,4,OUI,OUI,2025-03-13 12:53:34+00:00,"48.90717373809284, 2.2695400938391685",Asnières-sur-Seine,92004,0.47368421052631576,13
11115,Montreuil - Gonnet,OUI,24,22,2,1,1,OUI,OUI,2025-03-13 13:01:10+00:00,"48.850500564921, 2.3890856287864",Paris,75056,0.08333333333333333,13
16111,Faustin Hélie - Desbordes-Valmore,OUI,27,23,4,0,4,OUI,OUI,2025-03-13 12:56:56+00:00,"48.859403, 2.276522",Paris,75056,0.14814814814814814,13
8033,Commandant Rivière,OUI,38,4,34,21,13,OUI,OUI,2025-03-13 13:01:27+00:00,"48.872933, 2.309796",Paris,75056,0.8947368421052632,13
18110,Departement - Pajol,OUI,16,15,1,0,1,OUI,OUI,2025-03-13 13:00:54+00:00,"48.886674849730184, 2.3613611608743668",Paris,75056,0.0625,13
16121,Jardin d'Acclimatation,OUI,30,22,8,5,3,OUI,OUI,2025-03-13 13:00:59+00:00,"48.878772242510465, 2.270772233605385",Paris,75056,0.26666666666666666,13
10113,Parmentier - Hôpital Saint-Louis,OUI,39,36,3,2,1,OUI,OUI,2025-03-13 12:53:21+00:00,"48.871379874257, 2.3698963836667",Paris,75056,0.07692307692307693,13
15010,Square Cambronne,OUI,59,5,54,53,1,OUI,OUI,2025-03-13 13:00:49+00:00,"48.84756654526, 2.3025691509247",Paris,75056,0.9152542372881356,13
17045,Place des Ternes.,OUI,44,40,4,2,2,OUI,OUI,2025-03-13 13:00:22+00:00,"48.878438631226516, 2.297727763652802",Paris,75056,0.09090909090909091,13
41102,Gare de Laplace,OUI,43,40,3,2,1,OUI,OUI,2025-03-13 12:56:12+00:00,"48.80893199114179, 2.3349460959434514",Arcueil,94003,0.06976744186046512,13
43402,Place de Verdun,OUI,40,19,21,19,2,OUI,OUI,2025-03-13 13:00:08+00:00,"48.8202823, 2.473775",Joinville-le-Pont,94042,0.525,13
17037,Bayen - Pereire,OUI,21,11,10,6,4,OUI,OUI,2025-03-13 12:57:36+00:00,"48.881804409079656, 2.2921088710427284",Paris,75056,0.47619047619047616,13
12013,Montgallet - Reuilly,OUI,14,9,5,2,3,OUI,OUI,2025-03-13 12:55:10+00:00,"48.844291, 2.3896481",Paris,75056,0.35714285714285715,13
18141,Clignancourt - Sofia,OUI,19,19,0,0,0,OUI,OUI,2025-03-13 13:01:40+00:00,"48.88511992309783, 2.34719488842051",Paris,75056,0.0,13
21305,Place Jacques Madaule,OUI,23,4,19,18,1,OUI,OUI,2025-03-13 13:01:38+00:00,"48.823933787309, 2.2606918215752",Issy-les-Moulineaux,92040,0.8260869565217391,13
33003,Bordier - Félix Faure,OUI,44,40,4,3,1,OUI,OUI,2025-03-13 13:01:47+00:00,"48.90390751882016, 2.3830059170722966",Aubervilliers,93001,0.09090909090909091,13
7015,Varenne,OUI,44,17,27,20,7,OUI,OUI,2025-03-13 13:01:02+00:00,"48.857202661803, 2.3152771219611",Paris,75056,0.6136363636363636,13
25005,18 juin 1940 - Buzenval,OUI,25,18,7,4,3,OUI,OUI,2025-03-13 12:54:43+00:00,"48.868807, 2.185428",Rueil-Malmaison,92063,0.28,13
13045,Jean Colly - Tolbiac,OUI,35,31,4,1,3,OUI,OUI,2025-03-13 12:59:58+00:00,"48.827817291597846, 2.3705490678548813",Paris,75056,0.11428571428571428,13
5021,Jussieu - Fossés Saint-Bernard,OUI,38,2,36,33,3,OUI,OUI,2025-03-13 13:00:59+00:00,"48.847185510023, 2.3534858599305",Paris,75056,0.9473684210526315,13
19115,Porte de la Villette,OUI,26,21,5,3,2,OUI,OUI,2025-03-13 12:56:11+00:00,"48.89835196548483, 2.386150136590004",Paris,75056,0.19230769230769232,13
6013,Jacques Callot - Mazarine,OUI,27,1,26,23,3,OUI,OUI,2025-03-13 12:57:31+00:00,"48.855280175332, 2.3375743255019",Paris,75056,0.9629629629629629,13
14034,Ouest - Château,OUI,23,21,2,0,2,OUI,OUI,2025-03-13 13:01:07+00:00,"48.83617286014242, 2.319392143923804",Paris,75056,0.08695652173913043,13
12115,Porte de Vincennes,OUI,32,26,6,3,3,OUI,OUI,2025-03-13 12:59:33+00:00,"48.846454, 2.415514",Paris,75056,0.1875,13
32010,Place aux Étoiles,OUI,37,10,27,5,22,OUI,OUI,2025-03-13 13:00:46+00:00,"48.91835629408464, 2.3523425683379173",Saint-Denis,93066,0.7297297297297297,13
23001,Paul Vaillant Couturier - Chaptal,OUI,36,5,31,21,10,OUI,OUI,2025-03-13 13:01:42+00:00,"48.893479576183, 2.2775253653526",Levallois-Perret,92044,0.8611111111111112,13
16018,Flandrin - Henri Martin,OUI,17,16,1,0,1,OUI,OUI,2025-03-13 13:01:34+00:00,"48.8643275, 2.2724174",Paris,75056,0.058823529411764705,13
16124,Route de Sèvres - Porte de Bagatelle,OUI,65,4,61,52,9,OUI,OUI,2025-03-13 13:00:00+00:00,"48.87525984132485, 2.249415814876557",Paris,75056,0.9384615384615385,13
15033,Place Violet,OUI,28,21,7,6,1,OUI,OUI,2025-03-13 13:00:25+00:00,"48.84487893836502, 2.2905756533145905",Paris,75056,0.25,13
33009,Félix Faure - Sadi Carnot,OUI,33,29,4,3,1,OUI,OUI,2025-03-13 12:58:00+00:00,"48.90812110228388, 2.378623187541962",Aubervilliers,93001,0.12121212121212122,13
25008,Place du 8 Mai 1945,OUI,18,14,4,4,0,OUI,OUI,2025-03-13 13:00:46+00:00,"48.871552174017, 2.2025031970585",Rueil-Malmaison,92063,0.2222222222222222,13
5106,Cujas - Saint-Michel,OUI,19,2,17,1,16,OUI,OUI,2025-03-13 12:59:34+00:00,"48.848191348584, 2.341831654854",Paris,75056,0.8947368421052632,13
16034,Porte d'Auteuil,OUI,32,27,5,2,3,OUI,OUI,2025-03-13 12:56:09+00:00,"48.8479394142243, 2.2608396783471107",Paris,75056,0.15625,13
22505,Mairie de La Garenne Colombes,OUI,22,17,5,4,1,OUI,OUI,2025-03-13 12:57:35+00:00,"48.90663823468682, 2.24679596722126",La Garenne-Colombes,92035,0.22727272727272727,13
20132,Réunion - Avron,OUI,26,25,1,1,0,OUI,OUI,2025-03-13 12:56:49+00:00,"48.852566752033766, 2.403928068708116",Paris,75056,0.038461538461538464,13
12034,Pirogues de Bercy - Libourne,OUI,48,26,22,8,14,OUI,OUI,2025-03-13 12:59:49+00:00,"48.832308, 2.38637",Paris,75056,0.4583333333333333,13
42707,Place Jean-Baptiste Clément,OUI,23,22,1,1,0,OUI,OUI,2025-03-13 12:55:12+00:00,"48.81240466867336, 2.3617091774940495",Le Kremlin-Bicêtre,94043,0.043478260869565216,13
19044,Grands Moulins de Pantin,OUI,50,41,9,4,5,OUI,OUI,2025-03-13 12:58:13+00:00,"48.89738369720229, 2.3959985375404362",Paris,75056,0.18,13
92003,Chanzy - Sud-Est,OUI,25,23,2,0,2,OUI,OUI,2025-03-13 13:00:04+00:00,"48.888912037698766, 2.195632159709931",Nanterre,92050,0.08,13
24002,Gare de Courbevoie,OUI,32,22,10,5,5,OUI,OUI,2025-03-13 13:01:18+00:00,"48.8993867, 2.2506506",Courbevoie,92026,0.3125,13
5119,Jussieu - Guy de la Brosse,OUI,39,2,37,26,11,OUI,OUI,2025-03-13 13:01:50+00:00,"48.845665, 2.355653",Paris,75056,0.9487179487179487,13
33001,Victor Hugo - Magasins Généraux,OUI,34,21,13,4,9,OUI,OUI,2025-03-13 13:00:54+00:00,"48.903281401126755, 2.368072383105755",Aubervilliers,93001,0.38235294117647056,13
21109,Guichet - Jean Jaurès,OUI,23,19,4,3,1,OUI,OUI,2025-03-13 12:56:33+00:00,"48.905169868129036, 2.3023840785026555",Clichy,92024,0.17391304347826086,13
41404,Carnot - Pâquerettes,OUI,23,2,21,20,1,OUI,OUI,2025-03-13 13:01:23+00:00,"48.79592939432515, 2.4261841177940373",Alfortville,94002,0.9130434782608695,13
21502,Verdun - Place Henri IV,OUI,25,6,19,14,5,OUI,OUI,2025-03-13 13:00:13+00:00,"48.870797375639214, 2.2277003154158592",Suresnes,92073,0.76,13
7009,Assemblée Nationale,OUI,75,5,70,31,39,OUI,OUI,2025-03-13 12:56:52+00:00,"48.861411014652, 2.3201214185208",Paris,75056,0.9333333333333333,13
31012,Place Carnot,OUI,23,22,1,0,1,OUI,OUI,2025-03-13 13:00:15+00:00,"48.85593932186797, 2.441531717777252",Montreuil,93048,0.043478260869565216,13
15122,Place Charles Vallin,OUI,26,22,4,3,1,OUI,OUI,2025-03-13 13:01:20+00:00,"48.835523812041, 2.3025986552238",Paris,75056,0.15384615384615385,13
12024,Gare de Bercy,OUI,35,12,23,20,3,OUI,OUI,2025-03-13 13:00:43+00:00,"48.839794573906, 2.3826066032052",Paris,75056,0.6571428571428571,13
35009,Jean Lolive - Parc Stalingrad,OUI,22,21,1,0,1,OUI,OUI,2025-03-13 12:57:54+00:00,"48.89206174403158, 2.4091735482215886",Pantin,93055,0.045454545454545456,13
35019,Anatole France - Jean Lolive,OUI,27,21,6,4,2,OUI,OUI,2025-03-13 12:59:59+00:00,"48.8949922, 2.4253764",Pantin,93055,0.2222222222222222,13
19019,Petit - Manin,OUI,22,22,0,0,0,NON,NON,2025-03-13 12:56:19+00:00,"48.886506875343, 2.3938155401308",Paris,75056,0.0,13
14104,Boyer-Barret - Raymond Losserand,OUI,22,20,2,0,2,OUI,OUI,2025-03-13 12:56:17+00:00,"48.83329880233322, 2.3173383995890617",Paris,75056,0.09090909090909091,13
8055,Courcelles - Place des Ternes,OUI,28,21,7,4,3,OUI,OUI,2025-03-13 12:58:57+00:00,"48.878199928923124, 2.2992860188665043",Paris,75056,0.25,13
20113,Piat - Parc de Belleville,OUI,21,19,2,0,2,OUI,OUI,2025-03-13 13:00:42+00:00,"48.87195626635528, 2.384981390278095",Paris,75056,0.09523809523809523,13
27002,Parc Pierre Lagravère,OUI,30,9,21,9,12,OUI,OUI,2025-03-13 13:00:25+00:00,"48.92650488131725, 2.239069678491417",Colombes,92025,0.7,13
20119,Square des Saint-Simoniens,OUI,25,24,1,0,1,OUI,OUI,2025-03-13 12:58:14+00:00,"48.8701796, 2.3967273",Paris,75056,0.04,13
23701,Parvis Robert Schuman - Roger Salengro,OUI,24,15,9,2,7,OUI,OUI,2025-03-13 13:00:02+00:00,"48.812657470558754, 2.1921751275658607",Chaville,92022,0.375,13
23802,Raymond Poincaré - Allée de la Marche,OUI,22,14,8,7,1,OUI,OUI,2025-03-13 12:58:43+00:00,"48.838634069623, 2.1724102640451",Garches,92033,0.36363636363636365,13
17007,Navier - Epinettes,OUI,36,33,3,2,1,OUI,OUI,2025-03-13 12:54:57+00:00,"48.89587780769155, 2.3226776719093327",Paris,75056,0.08333333333333333,13
41604,Lagny - Joffre,OUI,30,16,14,13,1,OUI,OUI,2025-03-13 13:01:24+00:00,"48.84930687084088, 2.417949736118317",Saint-Mandé,94067,0.4666666666666667,13
16129,Ceinture du Lac Inferieure - Saint-Cloud,OUI,41,37,4,0,4,OUI,OUI,2025-03-13 12:56:24+00:00,"48.86218070933143, 2.2617871686816216",Paris,75056,0.0975609756097561,13
15029,Emeriau - Place de Brazzaville,OUI,51,15,36,34,2,OUI,OUI,2025-03-13 13:01:57+00:00,"48.850785261674964, 2.2871585190296173",Paris,75056,0.7058823529411765,13
31705,Champeaux - Gallieni,OUI,47,46,1,0,1,OUI,OUI,2025-03-13 12:56:46+00:00,"48.864459134684644, 2.4161778017878532",Bagnolet,93006,0.02127659574468085,13
17018,Parc Monceau,OUI,18,7,11,8,3,OUI,OUI,2025-03-13 12:54:17+00:00,"48.881077914129, 2.3095492646098",Paris,75056,0.6111111111111112,13
6030,Assas - Vaugirard,OUI,34,13,21,6,15,OUI,OUI,2025-03-13 13:00:55+00:00,"48.848274111398, 2.3292413726449",Paris,75056,0.6176470588235294,13
10005,Petites Ecuries - Faubourg Poissonnière,OUI,17,4,13,13,0,OUI,OUI,2025-03-13 13:00:35+00:00,"48.87397217237368, 2.348388757504776",Paris,75056,0.7647058823529411,13
12126,Gravelle - Route du Bac,OUI,49,42,7,5,2,OUI,OUI,2025-03-13 13:00:58+00:00,"48.824407, 2.418455",Paris,75056,0.14285714285714285,13
92004,Nanterre - Université,OUI,19,7,12,8,4,OUI,OUI,2025-03-13 12:55:43+00:00,"48.901365, 2.212693",Nanterre,92050,0.631578947368421,13
20036,Ménilmontant - Pelleport,OUI,31,31,0,0,0,OUI,OUI,2025-03-13 12:53:29+00:00,"48.870682633845, 2.3989596023316",Paris,75056,0.0,13
5002,Sommerard - Saint-Jacques,OUI,34,2,32,25,7,OUI,OUI,2025-03-13 13:00:51+00:00,"48.850310432924466, 2.345015835298588",Paris,75056,0.9411764705882353,13
15017,Place Falguière,OUI,23,20,3,1,2,OUI,OUI,2025-03-13 13:01:34+00:00,"48.83629973941847, 2.3104464635252953",Paris,75056,0.13043478260869565,13
15028,Grenelle - Dr Finlay,OUI,71,8,63,56,7,OUI,OUI,2025-03-13 13:01:06+00:00,"48.851315406715976, 2.2919502854347233",Paris,75056,0.8873239436619719,13
18005,Tardieu - Chappe,OUI,16,16,0,0,0,OUI,OUI,2025-03-13 12:56:22+00:00,"48.884146759782, 2.341845408082",Paris,75056,0.0,13
14018,Porte d'Orléans,OUI,45,43,2,0,2,OUI,OUI,2025-03-13 13:00:48+00:00,"48.8227639, 2.3249313",Paris,75056,0.044444444444444446,13
26001,Gare d'Asnières sur Seine,OUI,21,12,9,9,0,OUI,OUI,2025-03-13 13:01:14+00:00,"48.90636459217474, 2.2835066914558415",Asnières-sur-Seine,92004,0.42857142857142855,13
31702,Pierre et Marie Curie - Julien Grimau,OUI,18,14,4,0,4,OUI,OUI,2025-03-13 12:56:13+00:00,"48.870714014863225, 2.424097023904324",Bagnolet,93006,0.2222222222222222,13
18020,Francoeur - Marcadet,OUI,20,19,1,0,1,OUI,OUI,2025-03-13 13:01:49+00:00,"48.89104123261663, 2.340014585442034",Paris,75056,0.05,13
7004,Raspail - Varenne,OUI,16,7,9,2,7,OUI,OUI,2025-03-13 13:01:26+00:00,"48.853147816545, 2.3263905197382",Paris,75056,0.5625,13
20136,Henri Chevreau - Couronnes,OUI,26,26,0,0,0,OUI,OUI,2025-03-13 12:57:04+00:00,"48.87033205312931, 2.388777695596218",Paris,75056,0.0,13
11114,Ledru-Rollin - Charonne,OUI,32,13,19,12,7,OUI,OUI,2025-03-13 12:59:26+00:00,"48.85345855607243, 2.3772463581947094",Paris,75056,0.59375,13
5026,Pascal - Claude Bernard,OUI,48,19,29,23,6,OUI,OUI,2025-03-13 12:59:38+00:00,"48.839061952159746, 2.3499782010912895",Paris,75056,0.6041666666666666,13
8012,Batignolles - Place de Clichy,OUI,46,42,4,1,3,OUI,OUI,2025-03-13 12:58:51+00:00,"48.883474535757, 2.326493114233",Paris,75056,0.08695652173913043,13
43006,Vignerons - Minimes,OUI,29,18,11,10,1,OUI,OUI,2025-03-13 12:58:26+00:00,"48.841486, 2.430793",Vincennes,94080,0.3793103448275862,13
10023,Gare de l'Est - Verdun,OUI,13,9,4,1,3,OUI,OUI,2025-03-13 12:58:45+00:00,"48.876156054271, 2.3609149083206",Paris,75056,0.3076923076923077,13
8102,Lamennais - Washington,OUI,25,1,24,12,12,OUI,OUI,2025-03-13 13:00:43+00:00,"48.87352990026496, 2.303444892168045",Paris,75056,0.96,13
34002,Capitaine Glarner - Gabriel Péri,OUI,24,18,6,4,2,OUI,OUI,2025-03-13 12:59:08+00:00,"48.902449900418745, 2.3304807533425724",Saint-Ouen-sur-Seine,93070,0.25,13
21013,Pierre Grenier - Pont de Billancourt,OUI,21,17,4,3,1,OUI,OUI,2025-03-13 12:53:08+00:00,"48.8258020742942, 2.2487989068031315",Boulogne-Billancourt,92012,0.19047619047619047,13
23002,Pont de Levallois-bécon,OUI,49,16,33,17,16,OUI,OUI,2025-03-13 13:01:31+00:00,"48.8984179, 2.2791311",Levallois-Perret,92044,0.673469387755102,13
42503,Vladimir Ilitch Lénine - Andrée Chedid,OUI,31,31,0,0,0,OUI,OUI,2025-03-13 12:59:53+00:00,"48.813240124373, 2.3319716067039",Gentilly,94037,0.0,13
11101,Charles Delescluze,OUI,48,21,27,26,1,OUI,OUI,2025-03-13 13:00:44+00:00,"48.85242200848887, 2.380632497370243",Paris,75056,0.5625,13
21111,Professeur René Leriche - Général Leclerc,OUI,50,35,15,13,2,OUI,OUI,2025-03-13 12:57:20+00:00,"48.90782845483013, 2.307887971401215",Clichy,92024,0.3,13
15055,Vasco de Gama,OUI,54,21,33,26,7,OUI,OUI,2025-03-13 13:00:39+00:00,"48.83671783466264, 2.283664085650799",Paris,75056,0.6111111111111112,13
2010,Uzès - Montmartre,OUI,26,0,26,13,13,OUI,OUI,2025-03-13 13:00:02+00:00,"48.870790980240706, 2.3431010171771054",Paris,75056,1.0,13
14130,Jonquoy - Didot,OUI,30,26,4,0,4,OUI,OUI,2025-03-13 12:58:53+00:00,"48.82890454823947, 2.31648076325655",Paris,75056,0.13333333333333333,13
5116,Place Valhubert,OUI,51,1,50,45,5,OUI,OUI,2025-03-13 12:59:49+00:00,"48.844182577315, 2.3640366643667",Paris,75056,0.9803921568627451,13
41207,Place du Général de Gaulle,OUI,28,15,13,0,13,OUI,OUI,2025-03-13 13:00:59+00:00,"48.8525288, 2.4877332",Fontenay-sous-Bois,94033,0.4642857142857143,13
7006,Quai Voltaire,OUI,31,2,29,27,2,OUI,OUI,2025-03-13 13:01:13+00:00,"48.858942986179, 2.3314182047146",Paris,75056,0.9354838709677419,13
12011,Charenton - Place du Col Bourgoin,OUI,34,28,6,6,0,OUI,OUI,2025-03-13 13:00:22+00:00,"48.844867319554, 2.3825789350545",Paris,75056,0.17647058823529413,13
7014,Saint-François-Xavier,OUI,42,4,38,26,12,OUI,OUI,2025-03-13 13:00:42+00:00,"48.85154484769, 2.3146149516106",Paris,75056,0.9047619047619048,13
21308,Bara - Henri Farman,OUI,58,3,55,34,21,OUI,OUI,2025-03-13 13:00:46+00:00,"48.833218027457846, 2.2677567601203923",Issy-les-Moulineaux,92040,0.9482758620689655,13
20040,Parc de Belleville - Julien Lacroix,OUI,26,24,2,1,1,OUI,OUI,2025-03-13 12:56:59+00:00,"48.8703459, 2.3842214",Paris,75056,0.07692307692307693,13
12032,Porte Dorée,OUI,35,10,25,19,6,OUI,OUI,2025-03-13 13:01:47+00:00,"48.8354337, 2.4077132",Paris,75056,0.7142857142857143,13
17017,Gare de Pont-Cardinet,OUI,31,26,5,0,5,OUI,OUI,2025-03-13 13:00:33+00:00,"48.88713901475306, 2.314494143994255",Paris,75056,0.16129032258064516,13
6018,Michelet - Assas,OUI,16,2,14,4,10,OUI,OUI,2025-03-13 12:58:15+00:00,"48.842741502832, 2.3350211977959",Paris,75056,0.875,13
13026,Place Jean Delay,OUI,33,32,1,0,1,OUI,OUI,2025-03-13 13:00:50+00:00,"48.823316, 2.354336",Paris,75056,0.030303030303030304,13
31019,Vincennes - Douy-Delcupe,OUI,37,32,5,0,5,OUI,OUI,2025-03-13 12:56:35+00:00,"48.85493692155721, 2.436049282550812",Montreuil,93048,0.13513513513513514,13
14139,Pierre Larousse - Raymond Losserand,OUI,30,29,1,0,1,OUI,OUI,2025-03-13 12:59:22+00:00,"48.83059564231877, 2.3119183257222176",Paris,75056,0.03333333333333333,13
44012,Génie - Mozart,OUI,18,18,0,0,0,OUI,OUI,2025-03-13 12:57:45+00:00,"48.794902381218904, 2.3734183609485626",Vitry-sur-Seine,94081,0.0,13
13102,Pitié-Salpêtrière,OUI,49,13,36,18,18,OUI,OUI,2025-03-13 13:01:29+00:00,"48.83748810318667, 2.365213818848133",Paris,75056,0.7346938775510204,13
31016,Lucie Aubrac - Franklin,OUI,35,31,4,2,2,OUI,OUI,2025-03-13 13:01:36+00:00,"48.86223916006812, 2.4435862898826604",Montreuil,93048,0.11428571428571428,13
10015,Lucien Sampaix - Récollets,OUI,41,37,4,1,3,OUI,OUI,2025-03-13 12:59:31+00:00,"48.874330377560476, 2.3621229082345963",Paris,75056,0.0975609756097561,13
22101,Gare Routière de Saint Cloud,OUI,29,6,23,16,7,OUI,OUI,2025-03-13 13:01:01+00:00,"48.84288183896324, 2.222245037555695",Saint-Cloud,92064,0.7931034482758621,13
19037,Belleville - Porte des Lilas,OUI,29,27,2,0,2,OUI,OUI,2025-03-13 12:54:54+00:00,"48.87660391892763, 2.404769691129476",Paris,75056,0.06896551724137931,13
13016,Primo Levi - Frigos,OUI,33,0,33,24,9,OUI,OUI,2025-03-13 13:01:57+00:00,"48.83094844846017, 2.37965351592796",Paris,75056,1.0,13
6103,Mézières - Rennes,OUI,53,46,7,5,2,OUI,OUI,2025-03-13 13:00:16+00:00,"48.85023459321703, 2.3303819820284843",Paris,75056,0.1320754716981132,13
13043,Dunois - Clisson,OUI,50,43,7,2,5,OUI,OUI,2025-03-13 13:01:08+00:00,"48.832294, 2.3674523",Paris,75056,0.14,13
15038,Place Adolphe Cherioux - Vaugirard,OUI,62,53,9,2,7,OUI,OUI,2025-03-13 12:58:46+00:00,"48.83959442800459, 2.3010657727718353",Paris,75056,0.14516129032258066,13
8051,Batignolles - Rome,OUI,11,8,3,0,3,OUI,OUI,2025-03-13 12:59:09+00:00,"48.881823370566806, 2.3202589899301524",Paris,75056,0.2727272727272727,13
21032,Sèvres-Gallieni,OUI,25,0,25,19,6,OUI,OUI,2025-03-13 13:01:17+00:00,"48.837809408957, 2.2281519323587",Boulogne-Billancourt,92012,1.0,13
9115,Milton - Manuel,OUI,21,18,3,0,3,OUI,OUI,2025-03-13 13:01:22+00:00,"48.878249, 2.341181",Paris,75056,0.14285714285714285,13
20021,Indre - Prairies,OUI,38,38,0,0,0,OUI,OUI,2025-03-13 12:58:01+00:00,"48.86254398506782, 2.403290458023548",Paris,75056,0.0,13
22001,Château - Bineau,OUI,21,3,18,9,9,OUI,OUI,2025-03-13 13:01:54+00:00,"48.890404028589806, 2.270106375217438",Neuilly-sur-Seine,92051,0.8571428571428571,13
7005,Raspail - Bac,OUI,51,4,47,30,17,OUI,OUI,2025-03-13 12:58:55+00:00,"48.855628721101, 2.3256602883339",Paris,75056,0.9215686274509803,13
20027,Porte de Ménilmontant,OUI,15,15,0,0,0,OUI,OUI,2025-03-13 12:58:50+00:00,"48.8691543609174, 2.40932246879487",Paris,75056,0.0,13
21019,Edouard Vaillant - Paul-Adolphe Souriau,OUI,26,0,26,19,7,OUI,OUI,2025-03-13 13:00:27+00:00,"48.834845858829, 2.2479459643364",Boulogne-Billancourt,92012,1.0,13
9023,Laffitte - Italiens,OUI,31,0,31,17,14,OUI,OUI,2025-03-13 12:58:49+00:00,"48.871815737396, 2.3372015478451",Paris,75056,1.0,13
21105,Morice - Général Leclerc,OUI,25,22,3,3,0,OUI,OUI,2025-03-13 12:58:05+00:00,"48.90245471981591, 2.3128929734230046",Clichy,92024,0.12,13
14122,Colonel Monteil - Brune,OUI,19,18,1,1,0,OUI,OUI,2025-03-13 12:57:14+00:00,"48.82650293311, 2.3092747998272",Paris,75056,0.05263157894736842,13
19109,Tanger - Place du Maroc,OUI,19,19,0,0,0,OUI,OUI,2025-03-13 12:55:53+00:00,"48.8862524447104, 2.3689296841621403",Paris,75056,0.0,13
17047,Courcelles - Pierre Demours,OUI,26,7,19,9,10,OUI,OUI,2025-03-13 13:01:21+00:00,"48.883769733273496, 2.29858466343129",Paris,75056,0.7307692307692307,13
32014,Place du Cornillon - Stade de France,OUI,33,2,31,20,11,OUI,OUI,2025-03-13 13:01:56+00:00,"48.92540695835961, 2.3644426837563515",Saint-Denis,93066,0.9393939393939394,13
6016,Danton - Serpente,OUI,21,1,20,19,1,OUI,OUI,2025-03-13 12:58:39+00:00,"48.852297362582, 2.3414132371545",Paris,75056,0.9523809523809523,13
18032,Porte de Clignancourt.,OUI,55,53,2,0,2,OUI,OUI,2025-03-13 12:58:55+00:00,"48.897488, 2.343996",Paris,75056,0.03636363636363636,13
41204,République - Danton,OUI,19,18,1,0,1,OUI,OUI,2025-03-13 12:52:56+00:00,"48.85249172181667, 2.462034523487091",Fontenay-sous-Bois,94033,0.05263157894736842,13
17124,Porte de Saint-Ouen - Henri Huchard,OUI,26,7,19,16,3,OUI,OUI,2025-03-13 12:54:48+00:00,"48.898708366365064, 2.3295360803604126",Paris,75056,0.7307692307692307,13
19009,Cité des Sciences et de l'Industrie,OUI,27,18,9,4,5,OUI,OUI,2025-03-13 12:59:34+00:00,"48.89659571178903, 2.384599149227142",Paris,75056,0.3333333333333333,13
17027,Place du Maréchal Juin - Péreire,OUI,44,21,23,19,4,OUI,OUI,2025-03-13 13:01:03+00:00,"48.885263, 2.298286",Paris,75056,0.5227272727272727,13
18109,Pajol - Riquet,OUI,46,40,6,3,3,OUI,OUI,2025-03-13 13:00:38+00:00,"48.88960028134536, 2.3628534749150276",Paris,75056,0.13043478260869565,13
51003,Hôtel de Ville d'Argenteuil,OUI,29,12,17,11,6,OUI,OUI,2025-03-13 12:54:45+00:00,"48.946504, 2.2496396",Argenteuil,95018,0.5862068965517241,13
19038,Lassus - Delouvain,OUI,19,19,0,0,0,OUI,OUI,2025-03-13 12:59:09+00:00,"48.8755044846, 2.3890327325519",Paris,75056,0.0,13
2009,Filles Saint-Thomas - Place de la Bourse,OUI,58,3,55,23,32,OUI,OUI,2025-03-13 13:01:50+00:00,"48.868899890853, 2.3397543845203",Paris,75056,0.9482758620689655,13
21703,Square du Carrefour de l'Insurrection,OUI,20,19,1,0,1,OUI,OUI,2025-03-13 12:59:46+00:00,"48.820864559770676, 2.291113436222077",Vanves,92075,0.05,13
44102,Verdun - Adrien Damalix,OUI,26,16,10,7,3,OUI,OUI,2025-03-13 13:00:44+00:00,"48.8222334178559, 2.4215328320860863",Saint-Maurice,94069,0.38461538461538464,13
20118,Orteaux - Mouraud,OUI,24,21,3,0,3,OUI,OUI,2025-03-13 12:59:36+00:00,"48.85558642847872, 2.408762907764669",Paris,75056,0.125,13
19039,Edouard Pailleron - Simon Bolivar,OUI,23,23,0,0,0,OUI,OUI,2025-03-13 12:59:12+00:00,"48.87979886049996, 2.374839261174202",Paris,75056,0.0,13
16021,François Ponsard - La Muette,OUI,23,21,2,0,2,OUI,OUI,2025-03-13 12:57:09+00:00,"48.8583666, 2.2744515",Paris,75056,0.08695652173913043,13
16032,Eglise d'Auteuil,OUI,20,16,4,3,1,OUI,OUI,2025-03-13 12:57:57+00:00,"48.84749841771691, 2.26848387135299",Paris,75056,0.2,13
9031,Provence - Chaussée d'Antin,OUI,25,7,18,10,8,OUI,OUI,2025-03-13 12:59:17+00:00,"48.87428447542072, 2.332976511564311",Paris,75056,0.72,13
21003,Jean Jaurès - Jean Baptiste Clément,OUI,39,26,13,6,7,OUI,OUI,2025-03-13 13:01:56+00:00,"48.84576261454011, 2.2369650006294255",Boulogne-Billancourt,92012,0.3333333333333333,13
14002,Edgar Quinet - Raspail,OUI,44,36,8,0,8,OUI,OUI,2025-03-13 12:59:43+00:00,"48.83940266673835, 2.32971478253603",Paris,75056,0.18181818181818182,13
18025,Mairie du 18ème,OUI,40,36,4,0,4,OUI,OUI,2025-03-13 13:01:53+00:00,"48.892939296937605, 2.3445510864257812",Paris,75056,0.1,13
15035,Place Etienne Pernet,OUI,43,18,25,25,0,OUI,OUI,2025-03-13 13:01:08+00:00,"48.84243457133779, 2.2921819612383847",Paris,75056,0.5813953488372093,13
17122,Bridaine - Lamandé,OUI,28,25,3,1,2,OUI,OUI,2025-03-13 13:00:38+00:00,"48.8862074, 2.3206239",Paris,75056,0.10714285714285714,13
18049,Porte d'Aubervilliers,OUI,53,46,7,5,2,OUI,OUI,2025-03-13 13:00:27+00:00,"48.89859661942376, 2.3689722642302513",Paris,75056,0.1320754716981132,13
16123,Mahatma Gandhi,OUI,24,4,20,14,6,OUI,OUI,2025-03-13 13:01:29+00:00,"48.876356, 2.264205",Paris,75056,0.8333333333333334,13
10020,Chabrol - d'Hauteville,OUI,9,4,5,3,2,OUI,OUI,2025-03-13 13:00:43+00:00,"48.877018388033, 2.3513179644942",Paris,75056,0.5555555555555556,13
31007,Paris - Désiré Préaux,OUI,44,34,10,3,7,OUI,OUI,2025-03-13 12:59:33+00:00,"48.85742876694898, 2.4323049187660217",Montreuil,93048,0.22727272727272727,13
18113,Lepic - Armée d'Orient,OUI,24,22,2,0,2,OUI,OUI,2025-03-13 12:54:19+00:00,"48.887536403814, 2.3343077301979",Paris,75056,0.08333333333333333,13
15108,Lourmel - Marie Skobtsov,OUI,21,13,8,6,2,OUI,OUI,2025-03-13 13:01:55+00:00,"48.844974, 2.287283",Paris,75056,0.38095238095238093,13
19040,Belleville - Télégraphe,OUI,40,37,3,0,3,OUI,OUI,2025-03-13 12:58:20+00:00,"48.8756045, 2.3995549",Paris,75056,0.075,13
11041,Square Saint-Ambroise,OUI,39,4,35,30,5,OUI,OUI,2025-03-13 13:01:07+00:00,"48.860934, 2.375841",Paris,75056,0.8974358974358975,13
17046,Mac-Mahon - Brey,OUI,24,18,6,3,3,OUI,OUI,2025-03-13 12:59:51+00:00,"48.877532084130166, 2.294512536052928",Paris,75056,0.25,13
31703,Sadi Carnot - François Mitterrand,OUI,26,24,2,1,1,OUI,OUI,2025-03-13 12:56:23+00:00,"48.87532687671517, 2.4241617321968083",Bagnolet,93006,0.07692307692307693,13
17121,Square des Epinettes,OUI,20,19,1,0,1,OUI,OUI,2025-03-13 12:58:44+00:00,"48.89383909781389, 2.325953990221024",Paris,75056,0.05,13
35003,Gabrielle Josserand - Edouard Vaillant,OUI,24,23,1,0,1,OUI,OUI,2025-03-13 13:00:01+00:00,"48.90271566255436, 2.3933270573616032",Pantin,93055,0.041666666666666664,13
18029,Emile Blemont - Poteau,OUI,39,38,1,0,1,OUI,OUI,2025-03-13 13:01:35+00:00,"48.8943782, 2.3415122",Paris,75056,0.02564102564102564,13
15031,Théâtre - Lourmel,OUI,52,8,44,39,5,OUI,OUI,2025-03-13 12:59:47+00:00,"48.8482070397636, 2.2898658737540245",Paris,75056,0.8461538461538461,13
35017,Toffier Decaux - Cartier Bresson,OUI,17,14,3,2,1,OUI,OUI,2025-03-13 12:57:36+00:00,"48.90165072551549, 2.4017545580863957",Pantin,93055,0.17647058823529413,13
21014,Hameau Fleuri - Marché,OUI,21,0,21,8,13,OUI,OUI,2025-03-13 13:01:06+00:00,"48.831448892608314, 2.2412404417991643",Boulogne-Billancourt,92012,1.0,13
9117,Bellefond - Maubeuge,OUI,28,25,3,0,3,OUI,OUI,2025-03-13 13:01:46+00:00,"48.878255397645, 2.3452642187476",Paris,75056,0.10714285714285714,13
47005,Ecole Vétérinaire,OUI,35,17,18,14,4,OUI,OUI,2025-03-13 13:01:28+00:00,"48.81488859822486, 2.4224362157778994",Maisons-Alfort,94046,0.5142857142857142,13
20023,Pelleport - Belgrand,OUI,14,12,2,1,1,OUI,OUI,2025-03-13 12:58:32+00:00,"48.86500081847653, 2.403980836377493",Paris,75056,0.14285714285714285,13
19127,Aubervilliers - Curial,OUI,23,22,1,0,1,OUI,OUI,2025-03-13 13:00:06+00:00,"48.89088305227546, 2.3688579350709915",Paris,75056,0.043478260869565216,13
5121,Square René Viviani - Montebello,OUI,33,1,32,30,2,OUI,OUI,2025-03-13 13:01:30+00:00,"48.851904891406, 2.3478421568871",Paris,75056,0.9696969696969697,13
16015,Bassano -  Iéna,OUI,15,4,11,2,9,OUI,OUI,2025-03-13 12:57:23+00:00,"48.868144510482075, 2.296149600985935",Paris,75056,0.7333333333333333,13
11006,Ledru-Rollin - Place du Père Chaillet,OUI,37,16,21,17,4,OUI,OUI,2025-03-13 13:00:22+00:00,"48.856433706943704, 2.379020587761426",Paris,75056,0.5675675675675675,13
15070,Balard - Montagne de la Fage,OUI,35,5,30,26,4,OUI,OUI,2025-03-13 13:01:57+00:00,"48.83850740333351, 2.2782871127128606",Paris,75056,0.8571428571428571,13
14112,Méchain - Faubourg Saint-Jacques,OUI,15,11,4,1,3,OUI,OUI,2025-03-13 13:01:55+00:00,"48.83586772099485, 2.33798034198275",Paris,75056,0.26666666666666666,13
1120,Lavandieres Sainte Opportune - Rivoli,OUI,23,3,20,17,3,OUI,OUI,2025-03-13 13:00:30+00:00,"48.859279702476, 2.3466217517853",Paris,75056,0.8695652173913043,13
47004,Stade Auguste Delaune,OUI,21,2,19,18,1,OUI,OUI,2025-03-13 13:01:37+00:00,"48.80896378683884, 2.4345204234123234",Maisons-Alfort,94046,0.9047619047619048,13
21001,Transvaal - Charles de Gaulle,OUI,27,16,11,7,4,OUI,OUI,2025-03-13 12:58:15+00:00,"48.848280403628806, 2.2373420120857195",Boulogne-Billancourt,92012,0.4074074074074074,13
9026,Jean-Baptiste Pigalle - La Bruyere,OUI,17,12,5,0,5,OUI,OUI,2025-03-13 13:00:50+00:00,"48.87939826447722, 2.333709173337285",Paris,75056,0.29411764705882354,13
18033,Belliard - Damrémont,OUI,34,32,2,1,1,OUI,OUI,2025-03-13 12:54:19+00:00,"48.89669238777841, 2.338023450388167",Paris,75056,0.058823529411764705,13
11010,Boulets - Faubourg Saint-Antoine,OUI,42,42,0,0,0,OUI,OUI,2025-03-13 13:00:17+00:00,"48.849259262115, 2.3917546141943",Paris,75056,0.0,13
16122,Route de la Muette - Porte de Neuilly,OUI,49,42,7,2,5,OUI,OUI,2025-03-13 13:01:04+00:00,"48.8798926, 2.2587671",Paris,75056,0.14285714285714285,13
15002,Maine - Antoine Bourdelle,OUI,17,14,3,1,2,OUI,OUI,2025-03-13 13:00:36+00:00,"48.84308531746595, 2.320263946784738",Paris,75056,0.17647058823529413,13
21310,Kléber - Gouverneur Général Eboué,OUI,22,1,21,14,7,OUI,OUI,2025-03-13 12:57:41+00:00,"48.826885843069796, 2.2723413258790965",Issy-les-Moulineaux,92040,0.9545454545454546,13
23007,Président Wilson - Jean Jaures,OUI,25,21,4,3,1,OUI,OUI,2025-03-13 13:00:17+00:00,"48.89034054052266, 2.2920683026313786",Levallois-Perret,92044,0.16,13
32015,Gare RER de Saint-Denis,OUI,36,26,10,9,1,OUI,OUI,2025-03-13 13:00:36+00:00,"48.93554324248177, 2.3471488058567047",Saint-Denis,93066,0.2777777777777778,13
20016,Pyrénées - Maraîchers,OUI,32,32,0,0,0,OUI,OUI,2025-03-13 12:57:01+00:00,"48.85714001395299, 2.4043509364128113",Paris,75056,0.0,13
16043,Place de Passy,OUI,12,11,1,1,0,OUI,OUI,2025-03-13 13:00:54+00:00,"48.85780291711202, 2.277500546942199",Paris,75056,0.08333333333333333,13
10010,Place Jacques Bonsergent,OUI,33,7,26,19,7,OUI,OUI,2025-03-13 13:01:00+00:00,"48.870948218595, 2.3612049221992",Paris,75056,0.7878787878787878,13
20116,Haies - Réunion,OUI,20,19,1,1,0,OUI,OUI,2025-03-13 12:55:03+00:00,"48.85386896766491, 2.402426162238911",Paris,75056,0.05,13
16027,Mozart - Jasmin,OUI,62,56,6,2,4,OUI,OUI,2025-03-13 12:55:41+00:00,"48.85286124871689, 2.268483570651513",Paris,75056,0.0967741935483871,13
9017,Lallier - Trudaine,OUI,28,22,6,2,4,OUI,OUI,2025-03-13 13:00:18+00:00,"48.88109246617963, 2.3408224806189537",Paris,75056,0.21428571428571427,13
6107,Place Alphonse Deville,OUI,22,2,20,12,8,OUI,OUI,2025-03-13 13:01:25+00:00,"48.850188262662, 2.3275961726904",Paris,75056,0.9090909090909091,13
18008,Square Léon,OUI,33,31,2,1,1,OUI,OUI,2025-03-13 12:58:23+00:00,"48.88667396788626, 2.353205569088459",Paris,75056,0.06060606060606061,13
16029,Maison de Radio - France,OUI,41,0,41,38,3,OUI,OUI,2025-03-13 13:01:47+00:00,"48.85132886434057, 2.277785539627075",Paris,75056,1.0,13
7008,Villersexel - Saint-Germain,OUI,16,5,11,7,4,OUI,OUI,2025-03-13 12:58:15+00:00,"48.858297001218, 2.3237934708595",Paris,75056,0.6875,13
8019,Naples - Rome,OUI,25,23,2,1,1,OUI,OUI,2025-03-13 12:58:07+00:00,"48.879960700846226, 2.321358695626259",Paris,75056,0.08,13
14030,Pernety - Raymond Losserand,OUI,32,28,4,1,3,OUI,OUI,2025-03-13 12:55:42+00:00,"48.834254627953, 2.317609339387",Paris,75056,0.125,13
16112,Chernoviz - Raynouard,OUI,36,34,2,0,2,OUI,OUI,2025-03-13 13:00:27+00:00,"48.8569864146289, 2.282173218142987",Paris,75056,0.05555555555555555,13
20201,Eugène Reisz - Davout,OUI,20,17,3,1,2,OUI,OUI,2025-03-13 12:54:33+00:00,"48.85631874632638, 2.410396970808506",Paris,75056,0.15,13
42703,Fontainebleau - Edmond Michelet,OUI,45,43,2,1,1,OUI,OUI,2025-03-13 13:01:25+00:00,"48.80956436844049, 2.3626908659935",Le Kremlin-Bicêtre,94043,0.044444444444444446,13
13046,Eugène Oudiné - Dessous Des Berges,OUI,44,18,26,16,10,OUI,OUI,2025-03-13 13:01:40+00:00,"48.8256423, 2.3750226",Paris,75056,0.5909090909090909,13
22102,Mont Valérien - Michel Salles,OUI,24,8,16,11,5,OUI,OUI,2025-03-13 12:58:55+00:00,"48.8561915, 2.2152966",Saint-Cloud,92064,0.6666666666666666,13
15003,Gare Montparnasse - Vaugirard,OUI,66,57,9,1,8,OUI,OUI,2025-03-13 12:58:20+00:00,"48.8418071798797, 2.31951002690117",Paris,75056,0.13636363636363635,13
4110,Neuve Saint-Pierre - Beautreillis,OUI,19,9,10,4,6,OUI,OUI,2025-03-13 13:01:01+00:00,"48.85355351439652, 2.3639122769236565",Paris,75056,0.5263157894736842,13
6032,Sabot - Rennes,OUI,26,2,24,19,5,OUI,OUI,2025-03-13 12:58:22+00:00,"48.852575112948415, 2.331552766263485",Paris,75056,0.9230769230769231,13
17022,Pereire - Place de Wagram,OUI,45,42,3,1,2,OUI,OUI,2025-03-13 13:00:01+00:00,"48.887070607581215, 2.304111124531457",Paris,75056,0.06666666666666667,13
10036,Aqueduc - Villette,OUI,24,20,4,1,3,OUI,OUI,2025-03-13 13:00:58+00:00,"48.883886063895, 2.367198803315",Paris,75056,0.16666666666666666,13
7020,Champ de Mars - Cler,OUI,39,17,22,21,1,OUI,OUI,2025-03-13 13:01:20+00:00,"48.856691550115315, 2.306646779179573",Paris,75056,0.5641025641025641,13
6017,Sénat - Condé,OUI,32,2,30,21,9,OUI,OUI,2025-03-13 13:01:57+00:00,"48.84954227788459, 2.337939441204071",Paris,75056,0.9375,13
23304,Mairie de Sceaux,OUI,33,31,2,1,1,OUI,OUI,2025-03-13 13:00:52+00:00,"48.778916905132, 2.2887361764861",Sceaux,92071,0.06060606060606061,13
12161,Diderot - Reuilly,OUI,44,10,34,33,1,OUI,OUI,2025-03-13 12:59:43+00:00,"48.847208456061, 2.3861273378134",Paris,75056,0.7727272727272727,13
13103,Hôpital Pitié Salpêtrière,OUI,48,40,8,5,3,OUI,OUI,2025-03-13 12:57:36+00:00,"48.8377016, 2.3604946",Paris,75056,0.16666666666666666,13
9101,Cadet - La Fayette,OUI,18,6,12,9,3,OUI,OUI,2025-03-13 13:01:37+00:00,"48.875601632672, 2.3435704037547",Paris,75056,0.6666666666666666,13
15107,Palais des Sports,OUI,20,3,17,15,2,OUI,OUI,2025-03-13 13:01:46+00:00,"48.833468517426, 2.2858720645308",Paris,75056,0.85,13
18017,Caulaincourt - Place Constantin Pecqueur,OUI,42,39,3,0,3,OUI,OUI,2025-03-13 12:59:49+00:00,"48.889677905028, 2.3381787144261",Paris,75056,0.07142857142857142,13
1117,Pont Neuf - Rivoli,OUI,24,2,22,14,8,OUI,OUI,2025-03-13 12:59:07+00:00,"48.860089892617, 2.344057559967",Paris,75056,0.9166666666666666,13
19041,Belleville - Pyrénées,OUI,38,36,2,1,1,OUI,OUI,2025-03-13 12:58:30+00:00,"48.8741908, 2.3860039",Paris,75056,0.05263157894736842,13
31704,Jeanne Hornet - Girardot,OUI,28,26,2,0,2,OUI,OUI,2025-03-13 12:55:36+00:00,"48.873802681432146, 2.427820265293122",Bagnolet,93006,0.07142857142857142,13
11043,Place Pasdeloup,OUI,20,1,19,19,0,OUI,OUI,2025-03-13 12:58:23+00:00,"48.862654215631, 2.3670325062844",Paris,75056,0.95,13
32603,Calmette,OUI,31,29,2,1,1,OUI,OUI,2025-03-13 13:01:42+00:00,"48.88104925098552, 2.424993216991425",Les Lilas,93045,0.06451612903225806,13
23903,Stade Gaston Bouillant,OUI,29,23,6,3,3,OUI,OUI,2025-03-13 13:00:20+00:00,"48.939958667023, 2.3279571813836",Villeneuve-la-Garenne,92078,0.20689655172413793,13
17201,Porte Maillot - Perreire,OUI,50,33,17,7,10,OUI,OUI,2025-03-13 12:58:57+00:00,"48.878021154637, 2.2842371277102",Paris,75056,0.34,13
13010,Place d'Italie - Vincent Auriol,OUI,39,29,10,1,9,OUI,OUI,2025-03-13 13:00:06+00:00,"48.831481874467, 2.3567550292319",Paris,75056,0.2564102564102564,13
15059,Parc André Citroën,OUI,64,10,54,52,2,OUI,OUI,2025-03-13 13:01:48+00:00,"48.840639944296655, 2.2780618071556096",Paris,75056,0.84375,13
21311,Parvis Corentin Celton,OUI,51,5,46,38,8,OUI,OUI,2025-03-13 13:01:25+00:00,"48.82747252522725, 2.2784319519996648",Issy-les-Moulineaux,92040,0.9019607843137255,13
4013,Vieille du Temple - Francs Bourgeois,OUI,28,1,27,22,5,OUI,OUI,2025-03-13 13:00:34+00:00,"48.858256413365815, 2.35821794718504",Paris,75056,0.9642857142857143,13
23403,Chateau,OUI,21,18,3,2,1,OUI,OUI,2025-03-13 13:00:23+00:00,"48.774661399959, 2.3135878035462",Bourg-la-Reine,92014,0.14285714285714285,13
31023,Place François Mitterand,OUI,34,34,0,0,0,OUI,OUI,2025-03-13 12:53:29+00:00,"48.86492782016328, 2.442958317697048",Montreuil,93048,0.0,13
45001,Hôtel de Ville de Champigny sur Marne,OUI,21,2,19,9,10,OUI,OUI,2025-03-13 13:01:41+00:00,"48.813810628405, 2.5096759200096",Champigny-sur-Marne,94017,0.9047619047619048,13
20019,Place du Maquis du Vercors,OUI,30,29,1,0,1,OUI,OUI,2025-03-13 12:53:11+00:00,"48.877321579493575, 2.4083782732486725",Paris,75056,0.03333333333333333,13
9118,Faubourg Poissonniere - Delta,OUI,36,33,3,1,2,OUI,OUI,2025-03-13 12:59:58+00:00,"48.882555807626765, 2.3497482016682625",Paris,75056,0.08333333333333333,13
7101,Raspail - Chomel,OUI,49,9,40,29,11,OUI,OUI,2025-03-13 13:01:27+00:00,"48.852233164303, 2.3266580700874",Paris,75056,0.8163265306122449,13
21024,Billancourt - Général Leclerc,OUI,22,12,10,6,4,OUI,OUI,2025-03-13 13:00:59+00:00,"48.8322649, 2.2380413",Boulogne-Billancourt,92012,0.45454545454545453,13
13041,Porte d'Ivry,OUI,50,35,15,7,8,OUI,OUI,2025-03-13 13:00:34+00:00,"48.821768747596, 2.3688706755638",Paris,75056,0.3,13
10163,Gare du Nord - Demarquay,OUI,28,25,3,0,3,OUI,OUI,2025-03-13 13:01:31+00:00,"48.881154, 2.358411",Paris,75056,0.10714285714285714,13
14006,Saint-Jacques - Tombe Issoire,OUI,20,18,2,0,2,OUI,OUI,2025-03-13 13:00:18+00:00,"48.833206330538864, 2.3369108140468597",Paris,75056,0.1,13
2001,Greneta - Sebastopol,OUI,32,0,32,26,6,OUI,OUI,2025-03-13 13:00:42+00:00,"48.865242333228, 2.3516669869423",Paris,75056,1.0,13
31013,Centenaire - Sorins,OUI,42,39,3,0,3,OUI,OUI,2025-03-13 13:00:03+00:00,"48.85853523359734, 2.4273508787155156",Montreuil,93048,0.07142857142857142,13
19023,Manin - Simon Bolivar,OUI,24,23,1,0,1,OUI,OUI,2025-03-13 12:54:59+00:00,"48.876499654127, 2.3794073625991",Paris,75056,0.041666666666666664,13
32018,Franciade - Gabriel Péri,OUI,26,13,13,10,3,OUI,OUI,2025-03-13 13:00:58+00:00,"48.93261499331498, 2.355954498052597",Saint-Denis,93066,0.5,13
18137,Poissonniers - Nord,OUI,28,24,4,2,2,OUI,OUI,2025-03-13 13:01:01+00:00,"48.892511213520656, 2.3522228747606277",Paris,75056,0.14285714285714285,13
20202,Dupont de l'Eure - Gambetta,OUI,29,28,1,0,1,OUI,OUI,2025-03-13 12:57:20+00:00,"48.8679385, 2.4003649",Paris,75056,0.034482758620689655,13
8056,Beaujon - Wagram,OUI,28,25,3,1,2,OUI,OUI,2025-03-13 13:01:20+00:00,"48.875352455985, 2.2964416444302",Paris,75056,0.10714285714285714,13
18019,Square Raymond Souplex,OUI,51,51,0,0,0,OUI,OUI,2025-03-13 13:00:06+00:00,"48.89183721478911, 2.335426103165901",Paris,75056,0.0,13
17116,Reims - Porte d'Asnières,OUI,26,18,8,6,2,OUI,OUI,2025-03-13 12:56:37+00:00,"48.891834448210986, 2.300144659954865",Paris,75056,0.3076923076923077,13
41206,Place des Larris,OUI,34,28,6,1,5,OUI,OUI,2025-03-13 12:58:15+00:00,"48.8568363, 2.4780236",Fontenay-sous-Bois,94033,0.17647058823529413,13
18138,Station Paris Basketball - Ney - Charles Hermite,OUI,20,11,9,7,2,OUI,OUI,2025-03-13 13:00:14+00:00,"48.898748039775, 2.3645754531026",Paris,75056,0.45,13
11019,Charonne - Philippe-Auguste,OUI,30,20,10,5,5,OUI,OUI,2025-03-13 13:01:53+00:00,"48.855603162026, 2.39054639062",Paris,75056,0.3333333333333333,13
7016,Surcouf - Université,OUI,56,11,45,39,6,OUI,OUI,2025-03-13 13:01:29+00:00,"48.861273016278, 2.3094535509142",Paris,75056,0.8035714285714286,13
23008,Hôtel de Ville de Levallois Perret,OUI,26,12,14,11,3,OUI,OUI,2025-03-13 12:59:11+00:00,"48.89314451997415, 2.2888818383216862",Levallois-Perret,92044,0.5384615384615384,13
4011,Hôtel de Ville - Pont-Marie,OUI,33,3,30,27,3,OUI,OUI,2025-03-13 13:01:26+00:00,"48.853899645527, 2.3569472506642",Paris,75056,0.9090909090909091,13
8015,Roquépine - Malesherbes,OUI,50,4,46,23,23,OUI,OUI,2025-03-13 13:01:39+00:00,"48.87345073390807, 2.320404499769211",Paris,75056,0.92,13
12041,Bois de Vincennes.,OUI,58,44,14,4,10,OUI,OUI,2025-03-13 13:01:22+00:00,"48.8338064, 2.4132221",Saint-Mandé,94067,0.2413793103448276,13
21108,Mairie de Clichy,OUI,44,40,4,3,1,OUI,OUI,2025-03-13 13:01:34+00:00,"48.903653634661, 2.3059353232384",Clichy,92024,0.09090909090909091,13
12108,Bercy.,OUI,63,5,58,46,12,OUI,OUI,2025-03-13 13:01:36+00:00,"48.839966914994, 2.3788625746965",Paris,75056,0.9206349206349206,13
47002,Les Juilliottes,OUI,21,8,13,11,2,OUI,OUI,2025-03-13 12:52:30+00:00,"48.8043072, 2.4437362",Maisons-Alfort,94046,0.6190476190476191,13
7013,Duroc - Place de Breteuil,OUI,46,19,27,23,4,OUI,OUI,2025-03-13 13:00:03+00:00,"48.847460641142, 2.3126140236855",Paris,75056,0.5869565217391305,13
33005,République - Henri Barbusse,OUI,31,12,19,12,7,OUI,OUI,2025-03-13 13:01:24+00:00,"48.90661553626751, 2.389432489871979",Aubervilliers,93001,0.6129032258064516,13
21114,Gustave Eiffel - Parc des Impressionnistes,OUI,29,28,1,0,1,OUI,OUI,2025-03-13 12:56:03+00:00,"48.90390619651018, 2.2946908324956894",Clichy,92024,0.034482758620689655,13
5019,Poissy - Saint-Germain,OUI,24,4,20,18,2,OUI,OUI,2025-03-13 13:00:42+00:00,"48.84969649427, 2.3529685288668",Paris,75056,0.8333333333333334,13
17016,Brochant - Square des Batignolles,OUI,31,26,5,1,4,OUI,OUI,2025-03-13 12:58:27+00:00,"48.88818698581028, 2.316861143151153",Paris,75056,0.16129032258064516,13
1016,Thérèse - Opéra,OUI,24,1,23,17,6,OUI,OUI,2025-03-13 12:59:52+00:00,"48.866483514509, 2.3344334212238",Paris,75056,0.9583333333333334,13
17033,Carnot - Général Lanrezac,OUI,29,28,1,0,1,OUI,OUI,2025-03-13 12:53:09+00:00,"48.875443870736, 2.2938242935036",Paris,75056,0.034482758620689655,13
11003,Keller - La Roquette,OUI,34,24,10,8,2,OUI,OUI,2025-03-13 12:59:10+00:00,"48.8555508, 2.3752778",Paris,75056,0.29411764705882354,13
10164,Claude Vellefaux - Sambre et Meuse,OUI,32,30,2,1,1,OUI,OUI,2025-03-13 12:54:45+00:00,"48.875022, 2.370478",Paris,75056,0.0625,13
11034,Parmentier - Fontaine au Roi,OUI,44,40,4,0,4,OUI,OUI,2025-03-13 12:58:20+00:00,"48.86787670551736, 2.372705978671471",Paris,75056,0.09090909090909091,13
11107,Faidherbe - Dahomey,OUI,41,17,24,23,1,OUI,OUI,2025-03-13 13:00:11+00:00,"48.851358329771806, 2.383823134795429",Paris,75056,0.5853658536585366,13
9012,Rougemont - Poissonnière,OUI,30,3,27,15,12,OUI,OUI,2025-03-13 13:01:44+00:00,"48.871611569354755, 2.345873080193996",Paris,75056,0.9,13
20103,Le Vau - Maurice Bertaux,OUI,23,23,0,0,0,OUI,OUI,2025-03-13 12:54:01+00:00,"48.86803439043193, 2.411030612453627",Paris,75056,0.0,13
15020,Mairie du 15ème,OUI,31,24,7,6,1,OUI,OUI,2025-03-13 13:01:29+00:00,"48.8417762, 2.2986539",Paris,75056,0.22580645161290322,13
4109,Mornay - Sully,OUI,13,3,10,4,6,OUI,OUI,2025-03-13 12:59:38+00:00,"48.84970399548416, 2.364460788667202",Paris,75056,0.7692307692307693,13
13113,Vistule - Choisy,OUI,33,19,14,5,9,OUI,OUI,2025-03-13 13:00:52+00:00,"48.82365543660611, 2.3615723848342896",Paris,75056,0.42424242424242425,13
3101,Porte Saint-Martin,OUI,31,2,29,21,8,OUI,OUI,2025-03-13 13:01:57+00:00,"48.86860172112996, 2.35570102930069",Paris,75056,0.9354838709677419,13
19031,Manin - Crimée,OUI,21,20,1,0,1,OUI,OUI,2025-03-13 12:53:49+00:00,"48.8831217743719, 2.3863670602440834",Paris,75056,0.047619047619047616,13
15058,Place du Moulin de Javel,OUI,54,7,47,41,6,OUI,OUI,2025-03-13 13:00:59+00:00,"48.84021670922, 2.2716060653329",Paris,75056,0.8703703703703703,13
13114,Nationale - Marcel Duchamp,OUI,23,14,9,6,3,OUI,OUI,2025-03-13 12:53:55+00:00,"48.82463749337136, 2.3678014799952507",Paris,75056,0.391304347826087,13
2101,Bachaumont - Montmartre,OUI,33,10,23,22,1,OUI,OUI,2025-03-13 12:58:29+00:00,"48.86617395079137, 2.3449775576591496",Paris,75056,0.696969696969697,13
15061,Square Desnouettes,OUI,21,5,16,13,3,OUI,OUI,2025-03-13 12:59:01+00:00,"48.83476837934194, 2.284142297394666",Paris,75056,0.7619047619047619,13
22017,Charles de Gaulle - Louis Philippe,OUI,26,15,11,7,4,OUI,OUI,2025-03-13 13:01:20+00:00,"48.881742142181, 2.2710045335353",Neuilly-sur-Seine,92051,0.4230769230769231,13
20017,Saint-Blaise - Mouraud,OUI,27,24,3,1,2,OUI,OUI,2025-03-13 13:00:52+00:00,"48.85696177597818, 2.40869477391243",Paris,75056,0.1111111111111111,13
17104,Jardin Marguerite Long,OUI,21,14,7,2,5,OUI,OUI,2025-03-13 12:54:46+00:00,"48.8816985773914, 2.2836575657129288",Paris,75056,0.3333333333333333,13
6014,Pont de Lodi - Dauphine,OUI,21,2,19,9,10,OUI,OUI,2025-03-13 13:00:54+00:00,"48.855296898603285, 2.339947307565249",Paris,75056,0.9047619047619048,13
21004,Jean Jaurès - Reine,OUI,31,7,24,21,3,OUI,OUI,2025-03-13 13:01:09+00:00,"48.84009622558849, 2.239872515201569",Boulogne-Billancourt,92012,0.7741935483870968,13
14116,Romain Rolland,OUI,25,23,2,1,1,OUI,OUI,2025-03-13 12:58:44+00:00,"48.820215229662765, 2.3234144234418346",Montrouge,92049,0.08,13
13022,Butte aux Cailles - Esperance,OUI,30,27,3,1,2,OUI,OUI,2025-03-13 12:58:34+00:00,"48.82758774190948, 2.3492151126265526",Paris,75056,0.1,13
31018,Gambetta - Michelet,OUI,30,26,4,1,3,OUI,OUI,2025-03-13 13:01:23+00:00,"48.85273792380526, 2.429966032505036",Montreuil,93048,0.13333333333333333,13
13019,Fernand Braudel - Vincent Auriol,OUI,36,5,31,20,11,OUI,OUI,2025-03-13 13:01:36+00:00,"48.83637852318147, 2.3723404482007027",Paris,75056,0.8611111111111112,13
2110,Jeûneurs - Mulhouse,OUI,27,5,22,11,11,OUI,OUI,2025-03-13 13:00:19+00:00,"48.868997, 2.346925",Paris,75056,0.8148148148148148,13
11044,Square du Bataclan,OUI,17,2,15,14,1,OUI,OUI,2025-03-13 12:59:17+00:00,"48.8633762, 2.3711327",Paris,75056,0.8823529411764706,13
7026,Place de Finlande,OUI,24,2,22,18,4,OUI,OUI,2025-03-13 12:53:26+00:00,"48.862408335967, 2.3113624379039",Paris,75056,0.9166666666666666,13
21952,Place Tony de Graaff,OUI,42,22,20,17,3,OUI,OUI,2025-03-13 13:01:32+00:00,"48.8181645, 2.2458109",Meudon,92048,0.47619047619047616,13
14007,Ferrus - Saint-Jacques,OUI,33,25,8,6,2,OUI,OUI,2025-03-13 13:01:04+00:00,"48.8313878, 2.3408563",Paris,75056,0.24242424242424243,13
8029,Place du Canada,OUI,56,5,51,25,26,OUI,OUI,2025-03-13 13:01:44+00:00,"48.865346269363, 2.3101937879648",Paris,75056,0.9107142857142857,13
9113,Bleue - Trévise,OUI,27,8,19,8,11,OUI,OUI,2025-03-13 12:59:24+00:00,"48.87578906564573, 2.347289621829987",Paris,75056,0.7037037037037037,13
16031,Vignes - Boulainvilliers,OUI,19,11,8,3,5,OUI,OUI,2025-03-13 12:55:53+00:00,"48.856399483950504, 2.275240458548069",Paris,75056,0.42105263157894735,13
2014,Daunou - Louis le Grand,OUI,30,1,29,8,21,OUI,OUI,2025-03-13 13:00:34+00:00,"48.869113, 2.332515",Paris,75056,0.9666666666666667,13
12153,Terroirs de France - Lheureux,OUI,55,14,41,20,21,OUI,OUI,2025-03-13 13:01:32+00:00,"48.83212027074841, 2.388618104159832",Paris,75056,0.7454545454545455,13
8105,François 1er - Lincoln,OUI,29,5,24,2,22,OUI,OUI,2025-03-13 13:01:42+00:00,"48.869517979344, 2.3024262188416",Paris,75056,0.8275862068965517,13
17005,Brochant - Clichy,OUI,52,52,0,0,0,OUI,OUI,2025-03-13 13:01:56+00:00,"48.89032998912038, 2.319730559929781",Paris,75056,0.0,13
11048,Place Mireille Havet,OUI,42,13,29,23,6,OUI,OUI,2025-03-13 13:01:03+00:00,"48.850533, 2.383756",Paris,75056,0.6904761904761905,13
14127,Odessa - Départ,OUI,39,25,14,7,7,OUI,OUI,2025-03-13 13:01:44+00:00,"48.842885590081, 2.3244281485677",Paris,75056,0.358974358974359,13
8049,Georges V - François 1er,OUI,20,12,8,3,5,OUI,OUI,2025-03-13 13:01:39+00:00,"48.87034, 2.30082",Paris,75056,0.4,13
4010,Saint-Antoine Sévigné,OUI,25,9,16,10,6,OUI,OUI,2025-03-13 13:01:54+00:00,"48.8550222, 2.3612322",Paris,75056,0.64,13
12154,Square Georges Melies,OUI,38,23,15,6,9,OUI,OUI,2025-03-13 13:00:29+00:00,"48.84070239213081, 2.409667745232582",Paris,75056,0.39473684210526316,13
18035,René Binet - Porte de Montmartre,OUI,36,29,7,2,5,OUI,OUI,2025-03-13 13:01:04+00:00,"48.89905109950848, 2.3365534096956253",Paris,75056,0.19444444444444445,13
19021,Mairie du 19ème,OUI,24,22,2,0,2,OUI,OUI,2025-03-13 13:01:54+00:00,"48.88256264247959, 2.3812624812126164",Paris,75056,0.08333333333333333,13
13110,Moulin de la Pointe,OUI,20,19,1,1,0,OUI,OUI,2025-03-13 12:58:25+00:00,"48.82092946051445, 2.3563179373741145",Paris,75056,0.05,13
19030,Melun - Jean Jaurès,OUI,27,26,1,0,1,OUI,OUI,2025-03-13 12:59:07+00:00,"48.8837796723475, 2.376477420330048",Paris,75056,0.037037037037037035,13
15009,Suffren - Pérignon,OUI,45,12,33,30,3,OUI,OUI,2025-03-13 12:59:58+00:00,"48.84717561492764, 2.307052147596786",Paris,75056,0.7333333333333333,13
22002,Argenson - Château,OUI,24,0,24,14,10,OUI,OUI,2025-03-13 13:00:15+00:00,"48.888559314669514, 2.2642001509666447",Neuilly-sur-Seine,92051,1.0,13
20117,Saint-Fargeau - Mortier,OUI,31,31,0,0,0,OUI,OUI,2025-03-13 12:52:56+00:00,"48.87266656122256, 2.407912909984589",Paris,75056,0.0,13
35008,Place de l'Eglise - Pantin,OUI,28,28,0,0,0,OUI,OUI,2025-03-13 13:00:42+00:00,"48.892809461520265, 2.4124351143836975",Pantin,93055,0.0,13
14125,Dareau - Broussais,OUI,21,19,2,0,2,OUI,OUI,2025-03-13 12:58:39+00:00,"48.8307758, 2.3361804",Paris,75056,0.09523809523809523,13
20045,Louis Ganne - Davout,OUI,30,30,0,0,0,OUI,OUI,2025-03-13 12:58:10+00:00,"48.86338720692607, 2.409725748002529",Paris,75056,0.0,13
31017,Jean Moulin - Paul Doumer,OUI,17,15,2,0,2,OUI,OUI,2025-03-13 13:01:55+00:00,"48.8622179854695, 2.45533436536789",Montreuil,93048,0.11764705882352941,13
5030,Sorbonne - Ecoles,OUI,47,3,44,12,32,OUI,OUI,2025-03-13 13:01:50+00:00,"48.849686566191, 2.3434996604919",Paris,75056,0.9361702127659575,13
18114,Véron - Lepic,OUI,23,22,1,0,1,OUI,OUI,2025-03-13 13:00:19+00:00,"48.88526123395252, 2.334559857845307",Paris,75056,0.043478260869565216,13
16041,Versailles - Claude Terrasse,OUI,45,17,28,24,4,OUI,OUI,2025-03-13 13:01:53+00:00,"48.840219338074, 2.263834191153",Paris,75056,0.6222222222222222,13
44103,Pont De Charenton,OUI,18,5,13,12,1,OUI,OUI,2025-03-13 13:00:27+00:00,"48.8179685, 2.4199531",Saint-Maurice,94069,0.7222222222222222,13
9015,Lamartine - Faubourg Montmartre,OUI,30,8,22,11,11,OUI,OUI,2025-03-13 13:01:17+00:00,"48.876613982891, 2.3397656902671",Paris,75056,0.7333333333333333,13
22403,Pierre Brossolette - Adolphe Pinard,OUI,23,19,4,2,2,OUI,OUI,2025-03-13 13:00:08+00:00,"48.821772279548, 2.3131558299065",Malakoff,92046,0.17391304347826086,13
11110,Roquette - Folie Regnault,OUI,49,47,2,1,1,OUI,OUI,2025-03-13 12:59:24+00:00,"48.859246959155485, 2.386553623578705",Paris,75056,0.04081632653061224,13
42011,Quai Marcel Boyer - Victor Hugo,OUI,29,8,21,20,1,OUI,OUI,2025-03-13 12:59:21+00:00,"48.822556366667, 2.3920395970345",Ivry-sur-Seine,94041,0.7241379310344828,13
21017,Place Marcel Sembat,OUI,55,0,55,46,9,OUI,OUI,2025-03-13 13:00:58+00:00,"48.83328865030686, 2.2441747784614567",Boulogne-Billancourt,92012,1.0,13
9013,Mairie du 9ème,OUI,24,9,15,13,2,OUI,OUI,2025-03-13 12:58:52+00:00,"48.873267137583, 2.3407534480528",Paris,75056,0.625,13
14016,René Coty - Parc Montsouris,OUI,54,53,1,0,1,OUI,OUI,2025-03-13 12:55:15+00:00,"48.82479134498032, 2.336124926805496",Paris,75056,0.018518518518518517,13
21951,Place Centrale,OUI,22,21,1,1,0,OUI,OUI,2025-03-13 12:53:04+00:00,"48.78740167690531, 2.2278830409049992",Meudon,92048,0.045454545454545456,13
12033,François Truffaut - Saint Emilion,OUI,66,13,53,45,8,OUI,OUI,2025-03-13 13:01:48+00:00,"48.83372354344807, 2.386601903271428",Paris,75056,0.803030303030303,13
14128,Gergovie - Vercingétorix,OUI,29,25,4,1,3,OUI,OUI,2025-03-13 13:01:51+00:00,"48.83453413883994, 2.313154547426182",Paris,75056,0.13793103448275862,13
12120,Lac Daumesnil - Saint-Maurice,OUI,49,37,12,9,3,OUI,OUI,2025-03-13 12:55:32+00:00,"48.82774555743318, 2.4183654785156246",Paris,75056,0.24489795918367346,13
10039,Sambre et Meuse - Villette,OUI,24,16,8,4,4,OUI,OUI,2025-03-13 13:00:52+00:00,"48.874405666217, 2.3738072379951",Paris,75056,0.3333333333333333,13
22012,Madeleine Michelis - Roule,OUI,23,16,7,5,2,OUI,OUI,2025-03-13 12:59:52+00:00,"48.88260431301364, 2.2773634269833565",Neuilly-sur-Seine,92051,0.30434782608695654,13
19036,Hôpital Robert Debré,OUI,33,31,2,0,2,OUI,OUI,2025-03-13 12:57:41+00:00,"48.88005222200894, 2.4008650346327003",Paris,75056,0.06060606060606061,13
18142,Jessaint - Marx Dormoy,OUI,30,29,1,0,1,OUI,OUI,2025-03-13 12:56:21+00:00,"48.88484543106364, 2.358930408954621",Paris,75056,0.03333333333333333,13
31026,Demi-Lune - Aristide Briand,OUI,20,19,1,0,1,OUI,OUI,2025-03-13 12:59:57+00:00,"48.87626381919953, 2.4562818557024",Montreuil,93048,0.05,13
23105,Sèvres Rive Gauche,OUI,33,20,13,13,0,OUI,OUI,2025-03-13 12:54:36+00:00,"48.821443218278, 2.2150785306885",Sèvres,92072,0.3939393939393939,13
17001,Guy Môquet - Saint-Ouen,OUI,44,41,3,0,3,OUI,OUI,2025-03-13 13:01:35+00:00,"48.892777719023975, 2.3270335793495183",Paris,75056,0.06818181818181818,13
23005,Gare de Clichy-Levallois,OUI,26,5,21,20,1,OUI,OUI,2025-03-13 13:01:50+00:00,"48.89679827481989, 2.2984680533409123",Levallois-Perret,92044,0.8076923076923077,13
12129,Bois de Vincennes - Porte Jaune,OUI,35,30,5,2,3,OUI,OUI,2025-03-13 13:01:45+00:00,"48.838751246689455, 2.4605489149689674",Paris,75056,0.14285714285714285,13
21120,Docteur Calmette - Martre,OUI,30,20,10,10,0,OUI,OUI,2025-03-13 12:59:37+00:00,"48.898969358483, 2.3086513252383",Clichy,92024,0.3333333333333333,13
31707,Edouard Vaillant - Galliéni,OUI,48,47,1,0,1,OUI,OUI,2025-03-13 13:01:47+00:00,"48.858462881661, 2.4147954583168",Bagnolet,93006,0.020833333333333332,13
48009,République - Auguste Perret,OUI,30,29,1,1,0,OUI,OUI,2025-03-13 12:56:43+00:00,"48.78695280952244, 2.3518594354391094",Villejuif,94076,0.03333333333333333,13
13020,Paul Klee - Place Augusta Holmes,OUI,43,12,31,8,23,OUI,OUI,2025-03-13 12:59:55+00:00,"48.838946417408025, 2.3704235663952966",Paris,75056,0.7209302325581395,13
21009,Le Corbusier - Jean Jaurès,OUI,45,16,29,20,9,OUI,OUI,2025-03-13 13:01:56+00:00,"48.83780830557548, 2.2408381104469304",Boulogne-Billancourt,92012,0.6444444444444445,13
19124,Alexander Fleming - Belvédère,OUI,31,31,0,0,0,OUI,OUI,2025-03-13 12:53:51+00:00,"48.88179064200294, 2.4030599377642674",Paris,75056,0.0,13
13047,Boutroux - Porte de Vitry,OUI,49,29,20,19,1,OUI,OUI,2025-03-13 12:59:06+00:00,"48.822632, 2.377738",Paris,75056,0.40816326530612246,13
14113,Santé - Arago,OUI,36,31,5,2,3,OUI,OUI,2025-03-13 13:00:16+00:00,"48.83507657562064, 2.3415737262044938",Paris,75056,0.1388888888888889,13
4107,Beaumarchais - Pas de la Mule,OUI,17,6,11,7,4,OUI,OUI,2025-03-13 13:01:49+00:00,"48.855580507049, 2.3684333673431",Paris,75056,0.6470588235294118,13
32021,Place du Front Populaire - George Sand,OUI,64,44,20,17,3,OUI,OUI,2025-03-13 13:01:00+00:00,"48.90680713698062, 2.364541214992642",Saint-Denis,93066,0.3125,13
20047,Cours de Vincennes - Davout,OUI,48,41,7,3,4,OUI,OUI,2025-03-13 13:01:38+00:00,"48.847238029966, 2.4107042336225",Paris,75056,0.14583333333333334,13
20203,Evariste Galois,OUI,20,20,0,0,0,OUI,OUI,2025-03-13 12:52:27+00:00,"48.873341356228, 2.4133544409574",Paris,75056,0.0,13
42004,Westermeyer - Paul Vaillant-Couturier,OUI,27,13,14,11,3,OUI,OUI,2025-03-13 13:01:35+00:00,"48.819116181578764, 2.3966637253761296",Ivry-sur-Seine,94041,0.5185185185185185,13
20004,Commandant l'Herminier - Gallieni,OUI,17,16,1,1,0,OUI,OUI,2025-03-13 12:55:35+00:00,"48.847040552603, 2.4160453677177",Paris,75056,0.058823529411764705,13
92005,Gare de Nanterre Ville,OUI,42,14,28,21,7,OUI,OUI,2025-03-13 13:00:58+00:00,"48.8950295, 2.1957932",Nanterre,92050,0.6666666666666666,13
12150,Bastille - Quai de la Rapée,OUI,27,1,26,22,4,OUI,OUI,2025-03-13 13:01:37+00:00,"48.84682410855, 2.3669364675879",Paris,75056,0.9629629629629629,13
22103,Senard - Charles Blum,OUI,24,7,17,6,11,OUI,OUI,2025-03-13 12:59:23+00:00,"48.857315824799, 2.221091687679291",Saint-Cloud,92064,0.7083333333333334,13
12125,Pyramide - Parc Floral,OUI,50,47,3,2,1,OUI,OUI,2025-03-13 13:00:26+00:00,"48.837442, 2.440452",Paris,75056,0.06,13
19113,Pré Saint-Gervais - Lilas,OUI,27,26,1,0,1,OUI,OUI,2025-03-13 12:57:40+00:00,"48.877870626988, 2.3959073424339",Paris,75056,0.037037037037037035,13
15131,Charles Lecocq - Lecourbe,OUI,28,23,5,4,1,OUI,OUI,2025-03-13 12:57:35+00:00,"48.84044, 2.294867",Paris,75056,0.17857142857142858,13
31101,Jules Guesde - Laennec,OUI,19,14,5,0,5,OUI,OUI,2025-03-13 12:56:06+00:00,"48.87628983900398, 2.5006942078471184",Rosny-sous-Bois,93064,0.2631578947368421,13
15125,Parc Suzanne Lenglen,OUI,51,1,50,44,6,OUI,OUI,2025-03-13 13:01:28+00:00,"48.833250690537874, 2.2765403240919113",Paris,75056,0.9803921568627451,13
35004,Place du Président Salvador Allende,OUI,58,52,6,2,4,OUI,OUI,2025-03-13 13:01:05+00:00,"48.897307310356055, 2.40079153681279",Pantin,93055,0.10344827586206896,13
17029,Pierre Demours - Laugier,OUI,36,27,9,8,1,OUI,OUI,2025-03-13 12:57:10+00:00,"48.8813072, 2.294846",Paris,75056,0.25,13
8011,Clapeyron - Moscou,OUI,15,14,1,0,1,OUI,OUI,2025-03-13 13:01:10+00:00,"48.88078819514121, 2.324815057218075",Paris,75056,0.06666666666666667,13
10004,Metz - Faubourg Saint-Denis,OUI,44,16,28,26,2,OUI,OUI,2025-03-13 13:01:56+00:00,"48.870893, 2.353521",Paris,75056,0.6363636363636364,13
7010,Constantine - Université,OUI,59,5,54,41,13,OUI,OUI,2025-03-13 13:01:02+00:00,"48.860680473738, 2.3148481955842",Paris,75056,0.9152542372881356,13
21118,Neuilly - Petit,OUI,14,7,7,4,3,OUI,OUI,2025-03-13 12:59:13+00:00,"48.898965361341254, 2.29627937078476",Clichy,92024,0.5,13
35015,Averroès - Aimé Césaire,OUI,18,15,3,3,0,OUI,OUI,2025-03-13 13:01:46+00:00,"48.91405323432864, 2.412636950612068",Pantin,93055,0.16666666666666666,13
21203,Place Jules Ferry,OUI,28,26,2,1,1,OUI,OUI,2025-03-13 12:56:53+00:00,"48.812107928414775, 2.325837314128876",Montrouge,92049,0.07142857142857142,13
15019,Paul Barruel - Vaugirard,OUI,36,31,5,2,3,OUI,OUI,2025-03-13 13:01:31+00:00,"48.84014918546239, 2.3044332861900334",Paris,75056,0.1388888888888889,13
5034,Censier - Santeuil,OUI,66,16,50,42,8,OUI,OUI,2025-03-13 13:01:42+00:00,"48.840658921385234, 2.3537524044513702",Paris,75056,0.7575757575757576,13
7024,Rapp - Place du Général Gouraud,OUI,29,23,6,5,1,OUI,OUI,2025-03-13 12:58:43+00:00,"48.858102885107, 2.3004072904587",Paris,75056,0.20689655172413793,13
10017,Gare de l'Est - Fidélité,OUI,11,7,4,2,2,OUI,OUI,2025-03-13 12:58:42+00:00,"48.874575, 2.356796",Paris,75056,0.36363636363636365,13
11031,Jacquard - Ternaux,OUI,39,28,11,11,0,OUI,OUI,2025-03-13 12:59:59+00:00,"48.8646605, 2.373162",Paris,75056,0.28205128205128205,13
22013,Mairie de Neuilly sur Seine,OUI,30,25,5,4,1,OUI,OUI,2025-03-13 13:00:25+00:00,"48.88494728765838, 2.2677031159400944",Neuilly-sur-Seine,92051,0.16666666666666666,13
13515,Auguste Blanqui - Glacière,OUI,59,52,7,5,2,OUI,OUI,2025-03-13 12:58:48+00:00,"48.831151602964, 2.343822196126",Paris,75056,0.11864406779661017,13
16009,Saint-Didier - Raymond Poincaré,OUI,17,12,5,0,5,OUI,OUI,2025-03-13 12:53:15+00:00,"48.86642312020962, 2.285863497192411",Paris,75056,0.29411764705882354,13
9016,Choron - Martyrs,OUI,17,6,11,5,6,OUI,OUI,2025-03-13 12:57:27+00:00,"48.877851443503, 2.3396701365709",Paris,75056,0.6470588235294118,13
21029,Cours de l'Ile Seguin - Parc Billancourt,OUI,28,7,21,14,7,OUI,OUI,2025-03-13 13:00:22+00:00,"48.82714055843935, 2.234234511852265",Boulogne-Billancourt,92012,0.75,13
10152,Gare du Nord - Place de Valenciennes,OUI,23,20,3,2,1,OUI,OUI,2025-03-13 13:01:55+00:00,"48.879089, 2.354235",Paris,75056,0.13043478260869565,13
16014,Eylau - Trocadéro,OUI,22,11,11,1,10,OUI,OUI,2025-03-13 13:00:24+00:00,"48.863354122371, 2.2864209115505",Paris,75056,0.5,13
10037,Quai de Valmy,OUI,26,22,4,3,1,OUI,OUI,2025-03-13 13:01:44+00:00,"48.88126951579429, 2.368186041712761",Paris,75056,0.15384615384615385,13
21115,Chancé Milly - Cimetière Communal Sud,OUI,32,17,15,13,2,OUI,OUI,2025-03-13 12:59:36+00:00,"48.89687189382465, 2.303922325372696",Clichy,92024,0.46875,13
9036,Athènes - Clichy,OUI,18,8,10,5,5,OUI,OUI,2025-03-13 13:00:33+00:00,"48.878113787876, 2.32956021945824",Paris,75056,0.5555555555555556,13
21708,Marcel Yol - Jullien,OUI,28,20,8,6,2,OUI,OUI,2025-03-13 13:01:40+00:00,"48.82537611802588, 2.287235018058929",Vanves,92075,0.2857142857142857,13
13117,Stade Georges Carpentier,OUI,39,29,10,7,3,OUI,OUI,2025-03-13 13:00:57+00:00,"48.820482438381, 2.3668321967125",Paris,75056,0.2564102564102564,13
13048,Wurtz - Tolbiac,OUI,28,28,0,0,0,NON,NON,2025-03-13 12:52:17+00:00,"48.82631195621, 2.344585955143",Paris,75056,0.0,13
13027,Mazagran - Pierre de Coubertin,OUI,15,12,3,1,2,OUI,OUI,2025-03-13 13:00:47+00:00,"48.816218640260445, 2.344226874411106",Paris,75056,0.2,13
41210,Hôtel de ville de Fontenay-sous-Bois,OUI,19,17,2,0,2,OUI,OUI,2025-03-13 12:53:27+00:00,"48.84949749106274, 2.4750164151191716",Fontenay-sous-Bois,94033,0.10526315789473684,13
11103,Pelée - Alphonse Baudin,OUI,35,20,15,8,7,OUI,OUI,2025-03-13 13:01:28+00:00,"48.8600265, 2.3710541",Paris,75056,0.42857142857142855,13
42304,Marc Sangnier - Division Leclerc,OUI,21,8,13,11,2,OUI,OUI,2025-03-13 13:01:32+00:00,"48.78599652305309, 2.329955510795116",Cachan,94016,0.6190476190476191,13
20039,Belleville - Couronnes,OUI,48,41,7,1,6,OUI,OUI,2025-03-13 12:58:27+00:00,"48.868831082877, 2.3809862136841",Paris,75056,0.14583333333333334,13
11109,Pierre Levée - Fontaine Timbaud,OUI,21,16,5,0,5,OUI,OUI,2025-03-13 13:00:18+00:00,"48.86632723374305, 2.3711163550615306",Paris,75056,0.23809523809523808,13
21316,Cimetière d'Issy-les-Moulineaux,OUI,23,20,3,0,3,OUI,OUI,2025-03-13 12:58:36+00:00,"48.817699773925, 2.2609312087297",Issy-les-Moulineaux,92040,0.13043478260869565,13
15052,Convention - Vaugirard,OUI,44,40,4,2,2,OUI,OUI,2025-03-13 13:01:51+00:00,"48.83767682233156, 2.295586926020252",Paris,75056,0.09090909090909091,13
19025,Botzaris - Crimée,OUI,20,19,1,0,1,OUI,OUI,2025-03-13 12:59:44+00:00,"48.87959698690176, 2.3887913337477067",Paris,75056,0.05,13
44002,Paul Vaillant-Couturier - Gare RER,OUI,25,0,25,20,5,OUI,OUI,2025-03-13 13:01:06+00:00,"48.80108159069614, 2.402097210288048",Vitry-sur-Seine,94081,1.0,13
10153,Gare du Nord - Denain,OUI,20,17,3,0,3,OUI,OUI,2025-03-13 13:01:08+00:00,"48.879595787608, 2.3544725775719",Paris,75056,0.15,13
15123,Commerce - Letellier,OUI,44,31,13,9,4,OUI,OUI,2025-03-13 12:59:20+00:00,"48.84797660373612, 2.2966245196598805",Paris,75056,0.29545454545454547,13
16003,André Maurois - Joseph et Marie Hackin,OUI,27,10,17,12,5,OUI,OUI,2025-03-13 13:01:57+00:00,"48.8778983, 2.2789591",Paris,75056,0.6296296296296297,13
21030,Fessart - Château,OUI,20,3,17,15,2,OUI,OUI,2025-03-13 13:01:43+00:00,"48.84245, 2.23989",Boulogne-Billancourt,92012,0.85,13
15072,Place Fernand Forest,OUI,28,4,24,20,4,OUI,OUI,2025-03-13 13:00:01+00:00,"48.849269143836, 2.281863167882",Paris,75056,0.8571428571428571,13
21031,Cimetière de Boulogne-Billancourt,OUI,40,10,30,25,5,OUI,OUI,2025-03-13 13:01:33+00:00,"48.830764, 2.252024",Boulogne-Billancourt,92012,0.75,13
12006,Gare de Lyon - Van Gogh,OUI,41,4,37,26,11,OUI,OUI,2025-03-13 12:59:12+00:00,"48.843839785643, 2.3704450240357",Paris,75056,0.9024390243902439,13
17039,Place Saint-Ferdinand,OUI,38,26,12,2,10,OUI,OUI,2025-03-13 12:56:01+00:00,"48.87815529789739, 2.288518047864942",Paris,75056,0.3157894736842105,13
16007,Longchamp - Place d'Iéna,OUI,25,6,19,5,14,OUI,OUI,2025-03-13 13:00:45+00:00,"48.864917233434, 2.2926748171449",Paris,75056,0.76,13
22604,Hôtel de Ville de Fontenay-aux-Roses,OUI,32,31,1,0,1,OUI,OUI,2025-03-13 12:52:19+00:00,"48.790844603480856, 2.2871455930319455",Fontenay-aux-Roses,92032,0.03125,13
10110,Louis Blanc - Jemmapes,OUI,31,23,8,0,8,OUI,OUI,2025-03-13 13:01:20+00:00,"48.879330755297, 2.3684485629201",Paris,75056,0.25806451612903225,13
20009,Docteurs Déjérine - Pte de Montreuil,OUI,19,16,3,1,2,OUI,OUI,2025-03-13 12:58:15+00:00,"48.85398448133697, 2.41208288897222",Paris,75056,0.15789473684210525,13
21702,Gare SNCF Vanves-Malakoff,OUI,49,43,6,3,3,OUI,OUI,2025-03-13 13:01:39+00:00,"48.819002163836444, 2.292150005103606",Vanves,92075,0.12244897959183673,13
21955,Vaugirard - Verrerie,OUI,24,4,20,17,3,OUI,OUI,2025-03-13 12:58:45+00:00,"48.820881336842, 2.2367222622987",Meudon,92048,0.8333333333333334,13
31021,Résistance - Hoche,OUI,28,27,1,0,1,OUI,OUI,2025-03-13 12:54:37+00:00,"48.864273423741956, 2.435784414410591",Montreuil,93048,0.03571428571428571,13
10018,Square Alban Satragne,OUI,29,27,2,1,1,OUI,OUI,2025-03-13 13:01:31+00:00,"48.875388227727, 2.3559567333359",Paris,75056,0.06896551724137931,13
16115,Raffet - Montmorency,OUI,40,34,6,1,5,OUI,OUI,2025-03-13 13:01:52+00:00,"48.85258670812, 2.2629252456151954",Paris,75056,0.15,13
32301,Mairie de Romainville,OUI,17,17,0,0,0,OUI,OUI,2025-03-13 13:01:08+00:00,"48.885109, 2.435679",Romainville,93063,0.0,13
13039,Ivry - Simone Weil,OUI,18,11,7,5,2,OUI,OUI,2025-03-13 12:59:28+00:00,"48.823283932030755, 2.3659095168113713",Paris,75056,0.3888888888888889,13
5014,Jean Calvin - Tournefort,OUI,28,19,9,8,1,OUI,OUI,2025-03-13 13:01:48+00:00,"48.84158856925782, 2.348489575088024",Paris,75056,0.32142857142857145,13
16024,Ranelagh - Maison de la Radio,OUI,20,6,14,13,1,OUI,OUI,2025-03-13 13:00:01+00:00,"48.85293603169479, 2.280449643731117",Paris,75056,0.7,13
23902,Gallieni - Lycée Charles Petitet,OUI,44,21,23,17,6,OUI,OUI,2025-03-13 13:00:24+00:00,"48.927640283627, 2.3308986340524",Villeneuve-la-Garenne,92078,0.5227272727272727,13
15043,Brancion - Lefebvre,OUI,9,8,1,0,1,OUI,OUI,2025-03-13 12:57:25+00:00,"48.82900222785569, 2.301431038163409",Paris,75056,0.1111111111111111,13
42701,Charles Gide - Fort de Bicêtre,OUI,29,17,12,2,10,OUI,OUI,2025-03-13 13:01:41+00:00,"48.8071937956922, 2.353984415531159",Le Kremlin-Bicêtre,94043,0.41379310344827586,13
42305,Vanne - Saussaies,OUI,20,19,1,0,1,OUI,OUI,2025-03-13 12:52:05+00:00,"48.786404, 2.338848",Cachan,94016,0.05,13
20122,Vitruve - Davout,OUI,23,19,4,1,3,OUI,OUI,2025-03-13 13:01:21+00:00,"48.86053161154489, 2.4091592812626543",Paris,75056,0.17391304347826086,13
11032,Jean-Pierre Timbaud - Vaucouleurs,OUI,45,36,9,3,6,OUI,OUI,2025-03-13 13:00:56+00:00,"48.867937, 2.377885",Paris,75056,0.2,13
16020,Place de la Porte de Passy,OUI,34,33,1,1,0,OUI,OUI,2025-03-13 12:59:21+00:00,"48.857341095470794, 2.2644165538827115",Paris,75056,0.029411764705882353,13
16101,Malakoff - Place de la Porte Maillot,OUI,26,8,18,5,13,OUI,OUI,2025-03-13 12:55:01+00:00,"48.876733496638, 2.2834577411413",Paris,75056,0.6923076923076923,13
14101,Gare Montparnasse - Edgar Quinet,OUI,33,29,4,0,4,OUI,OUI,2025-03-13 13:01:41+00:00,"48.841487851079, 2.3233232282801",Paris,75056,0.12121212121212122,13
8001,Petit Palais,OUI,42,5,37,22,15,OUI,OUI,2025-03-13 13:01:54+00:00,"48.8667692, 2.3157655",Paris,75056,0.8809523809523809,13
8020,Batignolles - Beudant,OUI,43,38,5,0,5,OUI,OUI,2025-03-13 12:56:46+00:00,"48.88216401466375, 2.319852970540523",Paris,75056,0.11627906976744186,13
13121,Bruneseau - Quai d'Ivry,OUI,46,2,44,44,0,OUI,OUI,2025-03-13 13:01:36+00:00,"48.824945637583, 2.3885661363602",Ivry-sur-Seine,94041,0.9565217391304348,13
17015,Place de Lévis,OUI,48,46,2,0,2,OUI,OUI,2025-03-13 12:58:45+00:00,"48.883546851533254, 2.3131933808326726",Paris,75056,0.041666666666666664,13
21307,Victor Cresson - Telles de la Poterie,OUI,29,14,15,10,5,OUI,OUI,2025-03-13 13:01:38+00:00,"48.822698842979, 2.2686498274964",Issy-les-Moulineaux,92040,0.5172413793103449,13
42003,Place de l'Insurrection d'Août 1944,OUI,30,7,23,23,0,OUI,OUI,2025-03-13 13:00:09+00:00,"48.81477852751594, 2.398074567317963",Ivry-sur-Seine,94041,0.7666666666666667,13
10012,Vinaigriers - Magenta,OUI,24,13,11,8,3,OUI,OUI,2025-03-13 13:01:22+00:00,"48.8731167, 2.3593052",Paris,75056,0.4583333333333333,13
4001,Arcole - Notre-Dame,OUI,27,10,17,7,10,OUI,OUI,2025-03-13 13:01:56+00:00,"48.853883541328, 2.3493797332048",Paris,75056,0.6296296296296297,13
21028,Pierre Lefaucheux - Traversière,OUI,34,8,26,16,10,OUI,OUI,2025-03-13 13:01:21+00:00,"48.82435208303827, 2.2417913004755974",Boulogne-Billancourt,92012,0.7647058823529411,13
12043,Daumesnil - Hébrard,OUI,39,21,18,15,3,OUI,OUI,2025-03-13 13:01:40+00:00,"48.8429, 2.38474",Paris,75056,0.46153846153846156,13
4003,Quai aux Fleurs - Pont Saint-Louis,OUI,21,7,14,13,1,OUI,OUI,2025-03-13 12:59:13+00:00,"48.852915956209, 2.3521957173944",Paris,75056,0.6666666666666666,13
20108,Jardin de l'Hospice Debrousse,OUI,23,21,2,0,2,OUI,OUI,2025-03-13 12:58:09+00:00,"48.861451061938, 2.40568600595",Paris,75056,0.08695652173913043,13
14131,Jourdan - Monticelli,OUI,30,27,3,1,2,OUI,OUI,2025-03-13 13:00:38+00:00,"48.822032, 2.329095",Paris,75056,0.1,13
21219,Amaury Duval - Gabriel Péri,OUI,36,34,2,0,2,OUI,OUI,2025-03-13 12:58:12+00:00,"48.81718759671675, 2.323841750621796",Montrouge,92049,0.05555555555555555,13
17023,Porte d'Asnières,OUI,33,26,7,5,2,OUI,OUI,2025-03-13 13:01:14+00:00,"48.89035817610495, 2.3036286234855656",Paris,75056,0.21212121212121213,13
13011,Hôpital - Campo-Formio,OUI,11,4,7,2,5,OUI,OUI,2025-03-13 13:01:44+00:00,"48.835405, 2.358218",Paris,75056,0.6363636363636364,13
10105,Mazagran - Bonne Nouvelle,OUI,25,11,14,10,4,OUI,OUI,2025-03-13 12:59:22+00:00,"48.870047123655, 2.3511248454452",Paris,75056,0.56,13
31025,Paul Signac - Aristide Briand,OUI,33,30,3,0,3,OUI,OUI,2025-03-13 12:58:00+00:00,"48.86950262156371, 2.4502260982990265",Montreuil,93048,0.09090909090909091,13
42501,Raspail - Albert Schweitzer,OUI,27,8,19,18,1,OUI,OUI,2025-03-13 13:01:26+00:00,"48.81031545, 2.34395871",Gentilly,94037,0.7037037037037037,13
8549,George V - Christophe Colomb,OUI,22,1,21,6,15,OUI,OUI,2025-03-13 13:01:39+00:00,"48.87046, 2.30104",Paris,75056,0.9545454545454546,13
13109,Brillat-Savarin - Küss,OUI,21,16,5,4,1,OUI,OUI,2025-03-13 12:57:45+00:00,"48.822203, 2.350422",Paris,75056,0.23809523809523808,13
20007,Buzenval - Avron,OUI,49,49,0,0,0,OUI,OUI,2025-03-13 13:00:27+00:00,"48.851617204999, 2.4015135973077",Paris,75056,0.0,13
42209,Place de l'Europe - Quai de Bercy,OUI,15,3,12,11,1,OUI,OUI,2025-03-13 13:00:45+00:00,"48.82529858840266, 2.3945679143071175",Charenton-le-Pont,94018,0.8,13
13033,Porte d'Italie,OUI,13,11,2,0,2,OUI,OUI,2025-03-13 13:01:53+00:00,"48.817161987718954, 2.360236309468746",Paris,75056,0.15384615384615385,13
43001,Paris - Laitières,OUI,22,11,11,5,6,OUI,OUI,2025-03-13 13:01:03+00:00,"48.84630274151258, 2.4207553267478947",Vincennes,94080,0.5,13
13126,Place Nationale - Château-des-Rentiers,OUI,18,13,5,3,2,OUI,OUI,2025-03-13 12:58:59+00:00,"48.829268, 2.365212",Paris,75056,0.2777777777777778,13
22206,Louis Pasteur - Albert Petit,OUI,30,28,2,0,2,OUI,OUI,2025-03-13 13:00:54+00:00,"48.796261, 2.317289",Bagneux,92007,0.06666666666666667,13
15023,La Motte-Picquet - Grenelle,OUI,34,7,27,23,4,OUI,OUI,2025-03-13 12:56:57+00:00,"48.84858321339195, 2.299347817897797",Paris,75056,0.7941176470588235,13
15030,Emeriau - Beaugrenelle,OUI,72,11,61,52,9,OUI,OUI,2025-03-13 13:01:30+00:00,"48.84791249714942, 2.2843059897422795",Paris,75056,0.8472222222222222,13
22501,Théâtre de La Garenne,OUI,20,13,7,1,6,OUI,OUI,2025-03-13 12:58:06+00:00,"48.905658361454, 2.2345951981176",La Garenne-Colombes,92035,0.35,13
9114,Faubourg Poissonnière - Dunkerque,OUI,30,25,5,3,2,OUI,OUI,2025-03-13 13:00:58+00:00,"48.880883445404436, 2.349934279918671",Paris,75056,0.16666666666666666,13
40009,Lycée Saint Exupéry - Juliette Savar,OUI,29,19,10,8,2,OUI,OUI,2025-03-13 13:00:16+00:00,"48.783021513972, 2.4637357216879",Créteil,94028,0.3448275862068966,13
16011,Victor Hugo - La Pompe,OUI,40,28,12,1,11,OUI,OUI,2025-03-13 13:00:53+00:00,"48.86795222470859, 2.28146318346262",Paris,75056,0.3,13
23003,Président Wilson - Baudin,OUI,28,9,19,17,2,OUI,OUI,2025-03-13 13:01:01+00:00,"48.89826887103676, 2.2849336266517644",Levallois-Perret,92044,0.6785714285714286,13
47001,Place de la Gare,OUI,45,3,42,39,3,OUI,OUI,2025-03-13 13:01:01+00:00,"48.80253358011283, 2.4275037646293645",Maisons-Alfort,94046,0.9333333333333333,13
19108,Gaston Tessier - Rosa Parks RER,OUI,37,34,3,1,2,OUI,OUI,2025-03-13 12:58:39+00:00,"48.8963765, 2.3743692",Paris,75056,0.08108108108108109,13
10165,Gare de l'Est - Place du 11 Novembre 1918,OUI,39,36,3,0,3,OUI,OUI,2025-03-13 13:00:28+00:00,"48.876327, 2.3585464",Paris,75056,0.07692307692307693,13
44007,Camille Groult - Guy Môquet,OUI,21,6,15,10,5,OUI,OUI,2025-03-13 12:59:03+00:00,"48.787482746521306, 2.3976725712418556",Vitry-sur-Seine,94081,0.7142857142857143,13
13128,Quai de la Gare - Pont de Bercy,OUI,29,5,24,22,2,OUI,OUI,2025-03-13 12:57:55+00:00,"48.83730787972, 2.3740861260598",Paris,75056,0.8275862068965517,13
4002,Marché aux fleurs,OUI,20,4,16,9,7,OUI,OUI,2025-03-13 13:01:47+00:00,"48.855258115391, 2.3473754525185",Paris,75056,0.8,13
16002,Pergolèse - Malakoff,OUI,37,34,3,1,2,OUI,OUI,2025-03-13 12:59:20+00:00,"48.87521088779225, 2.2842781618237495",Paris,75056,0.08108108108108109,13
17003,Jacques Kellner - Saint-Ouen,OUI,43,41,2,0,2,OUI,OUI,2025-03-13 12:59:08+00:00,"48.895809485802886, 2.327897409164145",Paris,75056,0.046511627906976744,13
18007,Goutte d'or - Barbès,OUI,20,19,1,0,1,OUI,OUI,2025-03-13 12:58:49+00:00,"48.885124323627, 2.3496962338686",Paris,75056,0.05,13
6008,Assas - Luxembourg,OUI,32,0,32,8,24,OUI,OUI,2025-03-13 13:01:16+00:00,"48.843734468779, 2.3334283818759",Paris,75056,1.0,13
19128,Quai de l'Oise - Aisne,OUI,28,26,2,1,1,OUI,OUI,2025-03-13 13:00:24+00:00,"48.8906231, 2.3833701",Paris,75056,0.07142857142857142,13
21204,Estienne d'Orves - Henri Ginoux,OUI,31,29,2,1,1,OUI,OUI,2025-03-13 12:57:17+00:00,"48.815388220397274, 2.320886790760933",Montrouge,92049,0.06451612903225806,13
15005,Place Jacques et Thérèse Tréfouël,OUI,42,24,18,9,9,OUI,OUI,2025-03-13 13:01:11+00:00,"48.842726498317, 2.3125657439232",Paris,75056,0.42857142857142855,13
11021,Charonne - Pierre Bayle,OUI,23,22,1,0,1,OUI,OUI,2025-03-13 13:00:46+00:00,"48.858445054262, 2.3903981223891",Paris,75056,0.043478260869565216,13
18006,Square Louise Michel,OUI,35,34,1,0,1,OUI,OUI,2025-03-13 13:01:02+00:00,"48.884687354509, 2.3441386967897",Paris,75056,0.02857142857142857,13
21217,Louis Rolland - République,OUI,26,25,1,0,1,OUI,OUI,2025-03-13 13:01:19+00:00,"48.81710889740748, 2.3193106434955717",Montrouge,92049,0.038461538461538464,13
13044,Place Jeanne d'Arc,OUI,35,34,1,0,1,OUI,OUI,2025-03-13 12:56:59+00:00,"48.829575, 2.369126",Paris,75056,0.02857142857142857,13
12007,Gare de Lyon - Chalon,OUI,45,16,29,17,12,OUI,OUI,2025-03-13 13:00:40+00:00,"48.845666194202, 2.3741452395916",Paris,75056,0.6444444444444445,13
17108,Bessières - Porte de Clichy,OUI,30,15,15,11,4,OUI,OUI,2025-03-13 13:00:59+00:00,"48.89611762451474, 2.31790903955698",Paris,75056,0.5,13
25001,Colmar - Victor Hugo,OUI,31,7,24,11,13,OUI,OUI,2025-03-13 12:53:27+00:00,"48.88652251096166, 2.173960916697979",Rueil-Malmaison,92063,0.7741935483870968,13
15022,Emile Zola - Fondary,OUI,41,15,26,22,4,OUI,OUI,2025-03-13 13:01:31+00:00,"48.847051143113745, 2.2953405976295476",Paris,75056,0.6341463414634146,13
35007,Benjamin Delessert - Jean Lolive,OUI,20,19,1,0,1,OUI,OUI,2025-03-13 12:59:40+00:00,"48.89392043619345, 2.417981922626496",Pantin,93055,0.05,13
23004,Paul Vaillant-Couturier - Victor Hugo,OUI,34,8,26,25,1,OUI,OUI,2025-03-13 13:01:46+00:00,"48.89819702263572, 2.293848017974069",Levallois-Perret,92044,0.7647058823529411,13
44101,Place Mongolfier,OUI,37,15,22,13,9,OUI,OUI,2025-03-13 13:00:23+00:00,"48.815160030060376, 2.4592879414558415",Saint-Maurice,94069,0.5945945945945946,13
22408,Place du 14 Juillet,OUI,22,22,0,0,0,OUI,OUI,2025-03-13 12:52:06+00:00,"48.819266959525, 2.3011998832226",Malakoff,92046,0.0,13
13032,Italie - Jardin Joan Miro,OUI,24,24,0,0,0,OUI,OUI,2025-03-13 13:00:29+00:00,"48.81990914045756, 2.3592948541045193",Paris,75056,0.0,13
5012,Estrapade - Ulm,OUI,16,0,16,3,13,OUI,OUI,2025-03-13 13:01:56+00:00,"48.84512772828, 2.3454568170362",Paris,75056,1.0,13
15064,Javel - André Citroën,OUI,44,2,42,38,4,OUI,OUI,2025-03-13 13:01:57+00:00,"48.846276485475, 2.2786368057132",Paris,75056,0.9545454545454546,13
7017,La Motte-Picquet - La Tour Maubourg,OUI,40,18,22,15,7,OUI,OUI,2025-03-13 13:00:19+00:00,"48.856926701847, 2.3096215831203",Paris,75056,0.55,13
14010,Jean Moulin - Place Victor et Hélène Basch,OUI,38,35,3,0,3,OUI,OUI,2025-03-13 13:00:29+00:00,"48.82764910241, 2.3261967301369",Paris,75056,0.07894736842105263,13
15311,Quai du Président Roosevelt - Pont Aval,OUI,30,2,28,20,8,OUI,OUI,2025-03-13 12:59:56+00:00,"48.8343883676388, 2.2656820714473724",Paris,75056,0.9333333333333333,13
22303,Lucien Lanternier - Le Luth,OUI,25,10,15,12,3,OUI,OUI,2025-03-13 13:00:25+00:00,"48.93159430558871, 2.2889783978462224",Gennevilliers,92036,0.6,13
35006,Delizy - Louis Nadot,OUI,21,17,4,4,0,OUI,OUI,2025-03-13 12:55:20+00:00,"48.896212845581346, 2.4094578623771667",Pantin,93055,0.19047619047619047,13
92001,Mairie de quartier du Plateau - Mont-Valérien,OUI,20,14,6,4,2,OUI,OUI,2025-03-13 12:57:25+00:00,"48.8799933, 2.2072437",Nanterre,92050,0.3,13
41205,Maréchal Joffre - Verdun,OUI,20,19,1,0,1,OUI,OUI,2025-03-13 13:01:41+00:00,"48.85385, 2.470307",Fontenay-sous-Bois,94033,0.05,13
43010,La Jarry - Place Diderot,OUI,25,24,1,0,1,OUI,OUI,2025-03-13 12:55:29+00:00,"48.849726940367326, 2.452013790607453",Vincennes,94080,0.04,13
9004,Gérando - Rochechouart,OUI,21,20,1,0,1,OUI,OUI,2025-03-13 12:53:34+00:00,"48.88294340845, 2.3464846238494",Paris,75056,0.047619047619047616,13
17107,Berthier - Place Stuart Merril,OUI,35,20,15,13,2,OUI,OUI,2025-03-13 13:00:17+00:00,"48.885927922355044, 2.2933450341224675",Paris,75056,0.42857142857142855,13
51002,Placette Grégoire Collas,OUI,25,14,11,4,7,OUI,OUI,2025-03-13 13:01:57+00:00,"48.94342014002797, 2.2487476095557213",Argenteuil,95018,0.44,13
15057,Lucien Bossoutrot - Général Martial Vallin,OUI,38,6,32,21,11,OUI,OUI,2025-03-13 13:01:17+00:00,"48.836956046311, 2.2741072252393",Paris,75056,0.8421052631578947,13
32601,Porte des Lilas - Faidherbe,OUI,39,38,1,1,0,OUI,OUI,2025-03-13 12:54:28+00:00,"48.87861855668978, 2.4120327830314636",Les Lilas,93045,0.02564102564102564,13
15004,Vaugirard - Pasteur,OUI,21,18,3,0,3,OUI,OUI,2025-03-13 12:59:07+00:00,"48.84040868803496, 2.3154367133975033",Paris,75056,0.14285714285714285,13
12026,Place Ginette Hamelin,OUI,50,20,30,25,5,OUI,OUI,2025-03-13 13:01:50+00:00,"48.837853, 2.382064",Paris,75056,0.6,13
23010,Voltaire - Anatole France,OUI,26,5,21,13,8,OUI,OUI,2025-03-13 12:59:36+00:00,"48.891999360256904, 2.284262739121914",Levallois-Perret,92044,0.8076923076923077,13
10162,Alexandre Parodi - Quai de Valmy,OUI,24,22,2,0,2,OUI,OUI,2025-03-13 13:00:54+00:00,"48.879359419425, 2.3665961623192",Paris,75056,0.08333333333333333,13
6027,Blaise-Desgoffe - Vaugirard,OUI,32,21,11,7,4,OUI,OUI,2025-03-13 12:58:54+00:00,"48.846128877747, 2.3242672160268",Paris,75056,0.34375,13
6012,Saint-Germain - Ciseaux,OUI,18,7,11,8,3,OUI,OUI,2025-03-13 12:59:59+00:00,"48.853305277595, 2.3344654618827",Paris,75056,0.6111111111111112,13
21401,Mairie de Clamart,OUI,31,27,4,0,4,OUI,OUI,2025-03-13 13:01:04+00:00,"48.800612, 2.262151",Clamart,92023,0.12903225806451613,13
9102,Londres - Place d'Estienne d'Orves,OUI,24,0,24,12,12,OUI,OUI,2025-03-13 12:58:39+00:00,"48.876693805756986, 2.3305362090468407",Paris,75056,1.0,13
9027,Douai - Pierre Fontaine,OUI,23,17,6,3,3,OUI,OUI,2025-03-13 13:00:16+00:00,"48.88229101148092, 2.33324121683836",Paris,75056,0.2608695652173913,13
8116,Champs-Elysees - Bassano,OUI,25,25,0,0,0,NON,NON,2021-02-21 19:09:18+00:00,"48.871811807816, 2.300238981843",Paris,75056,0.0,19
18030,Joseph Dijon - Ornano,OUI,36,33,3,1,2,OUI,OUI,2025-03-13 13:01:15+00:00,"48.89374453351521, 2.3476678133010864",Paris,75056,0.08333333333333333,13
4020,Place Edmond Michelet,OUI,23,13,10,8,2,OUI,OUI,2025-03-13 13:01:49+00:00,"48.860134890542, 2.3500636965036",Paris,75056,0.43478260869565216,13
92006,Place Nelson Mandela,OUI,30,19,11,2,9,OUI,OUI,2025-03-13 12:59:21+00:00,"48.897874318180556, 2.2182820737361912",Nanterre,92050,0.36666666666666664,13
8037,Monceau - Malesherbes,OUI,37,31,6,3,3,OUI,OUI,2025-03-13 13:01:54+00:00,"48.8795079, 2.3145456",Paris,75056,0.16216216216216217,13
12038,Picpus - Louis Braille,OUI,43,42,1,1,0,OUI,OUI,2025-03-13 13:01:25+00:00,"48.839988788912, 2.4005256685521",Paris,75056,0.023255813953488372,13
11017,Charonne - Bureau,OUI,44,40,4,2,2,OUI,OUI,2025-03-13 12:59:27+00:00,"48.854176, 2.396093",Paris,75056,0.09090909090909091,13
12005,Crozatier - Faubourg Saint-Antoine,OUI,39,11,28,24,4,OUI,OUI,2025-03-13 13:01:15+00:00,"48.850440013405, 2.378901366211",Paris,75056,0.717948717948718,13
21306,Place Lafayette,OUI,61,9,52,47,5,OUI,OUI,2025-03-13 13:01:27+00:00,"48.829654975522, 2.2638675570488",Issy-les-Moulineaux,92040,0.8524590163934426,13
12155,Rottembourg - Général Michel Bizot,OUI,42,36,6,5,1,OUI,OUI,2025-03-13 12:59:15+00:00,"48.83787825992554, 2.4044052511453633",Paris,75056,0.14285714285714285,13
1021,Halles - Bourdonnais,OUI,18,6,12,9,3,OUI,OUI,2025-03-13 12:59:12+00:00,"48.860448992575, 2.3460162431002",Paris,75056,0.6666666666666666,13
12035,Madagascar - Meuniers,OUI,31,27,4,1,3,OUI,OUI,2025-03-13 13:01:11+00:00,"48.83460464474706, 2.3970650508999825",Paris,75056,0.12903225806451613,13
33015,Charles Tillon - Cimetière Communal,OUI,26,1,25,6,19,OUI,OUI,2025-03-13 13:00:33+00:00,"48.91844023641836, 2.3935630917549138",Aubervilliers,93001,0.9615384615384616,13
10021,Marché Saint-Quentin,OUI,14,11,3,2,1,OUI,OUI,2025-03-13 13:01:24+00:00,"48.877356057652, 2.3545114456374",Paris,75056,0.21428571428571427,13
22015,Île de la Jatte,OUI,23,5,18,4,14,OUI,OUI,2025-03-13 13:01:33+00:00,"48.894036161302104, 2.2666339203715324",Neuilly-sur-Seine,92051,0.782608695652174,13
5115,Buffon - Jardin des Plantes,OUI,29,5,24,17,7,OUI,OUI,2025-03-13 12:59:37+00:00,"48.842668466104875, 2.3618587106466293",Paris,75056,0.8275862068965517,13
12018,Saint-Mandé - Fabre d'Eglantine,OUI,33,22,11,7,4,OUI,OUI,2025-03-13 13:00:32+00:00,"48.8453579, 2.3965022",Paris,75056,0.3333333333333333,13
44011,Lebrun - Colonel Fabien,OUI,27,26,1,0,1,OUI,OUI,2025-03-13 13:01:57+00:00,"48.78266870733145, 2.381317801773548",Vitry-sur-Seine,94081,0.037037037037037035,13
44016,Balzac - Olympes de Gouges,OUI,28,11,17,8,9,OUI,OUI,2025-03-13 12:59:16+00:00,"48.77850332486751, 2.4006786569952965",Vitry-sur-Seine,94081,0.6071428571428571,13
21707,Square Etienne Jarousse,OUI,22,22,0,0,0,OUI,OUI,2025-03-13 13:00:37+00:00,"48.82485182597129, 2.2925933450460434",Vanves,92075,0.0,13
44005,Place Saint-Just,OUI,22,10,12,6,6,OUI,OUI,2025-03-13 13:01:47+00:00,"48.790379518724265, 2.3895226791501045",Vitry-sur-Seine,94081,0.5454545454545454,13
15129,Hôpital Necker,OUI,37,18,19,14,5,OUI,OUI,2025-03-13 12:58:21+00:00,"48.846043490118454, 2.313245013356209",Paris,75056,0.5135135135135135,13
17119,Toqueville - Cardinet,OUI,31,24,7,6,1,OUI,OUI,2025-03-13 13:00:58+00:00,"48.88490187110713, 2.3109393194317818",Paris,75056,0.22580645161290322,13
15039,Abbé Groult - Convention,OUI,12,11,1,0,1,OUI,OUI,2025-03-13 13:01:19+00:00,"48.83596927866069, 2.302064039509349",Paris,75056,0.08333333333333333,13
15011,Cambronne - Villa Croix Nivert,OUI,60,44,16,14,2,OUI,OUI,2025-03-13 13:00:39+00:00,"48.845847561366, 2.3017574474216",Paris,75056,0.26666666666666666,13
6022,Marché Saint-Germain,OUI,19,2,17,11,6,OUI,OUI,2025-03-13 12:59:55+00:00,"48.85165625855281, 2.335500307381153",Paris,75056,0.8947368421052632,13
33016,Fort d'Aubervilliers,OUI,20,8,12,10,2,OUI,OUI,2025-03-13 12:59:58+00:00,"48.91502382370325, 2.4035281687974925",Aubervilliers,93001,0.6,13
21402,Place Aimé Césaire,OUI,27,23,4,0,4,OUI,OUI,2025-03-13 12:53:14+00:00,"48.783194713067815, 2.2429127991199493",Clamart,92023,0.14814814814814814,13
13009,Auguste Blanqui - Corvisart,OUI,26,21,5,0,5,OUI,OUI,2025-03-13 12:56:25+00:00,"48.8300989, 2.3502726",Paris,75056,0.19230769230769232,13
41403,Gare RER - Malleret-Joinville,OUI,20,8,12,10,2,OUI,OUI,2025-03-13 13:00:14+00:00,"48.802936, 2.42531",Alfortville,94002,0.6,13
27005,Gare du Stade,OUI,18,13,5,2,3,OUI,OUI,2025-03-13 12:55:27+00:00,"48.9312676, 2.2603778",Colombes,92025,0.2777777777777778,13
13018,Bruant - Vincent Auriol,OUI,25,5,20,12,8,OUI,OUI,2025-03-13 13:01:47+00:00,"48.834848452929, 2.3668264996271",Paris,75056,0.8,13
15071,Suffren - Champ de Mars,OUI,23,12,11,10,1,OUI,OUI,2025-03-13 13:00:12+00:00,"48.8547194, 2.2952168",Paris,75056,0.4782608695652174,13
21303,Jean Monnet - Iles,OUI,32,3,29,26,3,OUI,OUI,2025-03-13 13:01:47+00:00,"48.823393984057304, 2.2497073194874866",Issy-les-Moulineaux,92040,0.90625,13
9024,Taitbout - La Fayette,OUI,51,6,45,25,20,OUI,OUI,2025-03-13 13:01:41+00:00,"48.8733298892, 2.3352625966072",Paris,75056,0.8823529411764706,13
9007,Condorcet - Turgot,OUI,19,18,1,0,1,OUI,OUI,2025-03-13 13:01:56+00:00,"48.87985155789093, 2.345232367515564",Paris,75056,0.05263157894736842,13
8201,Arsène Houssaye - Friedland,OUI,29,21,8,2,6,OUI,OUI,2025-03-13 13:01:36+00:00,"48.874510616163, 2.2994716674148",Paris,75056,0.27586206896551724,13
17024,Villiers - Batignolles,OUI,23,16,7,4,3,OUI,OUI,2025-03-13 13:00:19+00:00,"48.88125253846116, 2.31653843075037",Paris,75056,0.30434782608695654,13
17111,Lemercier - Cardinet,OUI,24,20,4,0,4,OUI,OUI,2025-03-13 12:54:31+00:00,"48.890097168851746, 2.317377626895905",Paris,75056,0.16666666666666666,13
15127,Place Charles Michels,OUI,35,8,27,19,8,OUI,OUI,2025-03-13 13:01:09+00:00,"48.846401, 2.28502",Paris,75056,0.7714285714285715,13
21319,Esplanade du Foncet - Camille Desmoulins,OUI,27,0,27,20,7,OUI,OUI,2025-03-13 13:01:29+00:00,"48.827090233494964, 2.2606857866048813",Issy-les-Moulineaux,92040,1.0,13
14032,Mairie du 14ème,OUI,32,29,3,1,2,OUI,OUI,2025-03-13 12:58:23+00:00,"48.83254578123, 2.3254923149943",Paris,75056,0.09375,13
9006,Dunkerque - Trudaine,OUI,16,15,1,1,0,OUI,OUI,2025-03-13 12:58:26+00:00,"48.88215166773376, 2.3463253676891327",Paris,75056,0.0625,13
14011,Place des Droits de l'Enfant,OUI,39,39,0,0,0,OUI,OUI,2025-03-13 12:59:30+00:00,"48.8274804, 2.3319217",Paris,75056,0.0,13
5024,Place Monge,OUI,21,17,4,2,2,OUI,OUI,2025-03-13 13:00:28+00:00,"48.842761803051, 2.3524079471827",Paris,75056,0.19047619047619047,13
6002,Saint-Benoît - Jacob,OUI,22,4,18,14,4,OUI,OUI,2025-03-13 13:00:03+00:00,"48.85545136013941, 2.3334722220897675",Paris,75056,0.8181818181818182,13
31005,Square Denise Buisson,OUI,45,44,1,0,1,OUI,OUI,2025-03-13 13:00:00+00:00,"48.8562322730982, 2.426436245441437",Montreuil,93048,0.022222222222222223,13
20044,Davout - Volga,OUI,27,24,3,1,2,OUI,OUI,2025-03-13 12:57:57+00:00,"48.852919679957296, 2.410522909779111",Paris,75056,0.1111111111111111,13
21314,Chemin de Bretagne,OUI,28,2,26,19,7,OUI,OUI,2025-03-13 13:01:49+00:00,"48.824753068884, 2.2588385956052",Issy-les-Moulineaux,92040,0.9285714285714286,13
33012,Landy - Heurtault,OUI,29,29,0,0,0,OUI,OUI,2025-03-13 12:58:50+00:00,"48.915096534520316, 2.375951372087002",Aubervilliers,93001,0.0,13
13516,Glacière - Soeur Catherine Marie,OUI,40,32,8,4,4,OUI,OUI,2025-03-13 12:55:51+00:00,"48.829522989420596, 2.343570403754711",Paris,75056,0.2,13
10033,Gare du Nord - Saint-Vincent de Paul,OUI,24,23,1,0,1,OUI,OUI,2025-03-13 12:52:40+00:00,"48.880955741648, 2.3524305148385",Paris,75056,0.041666666666666664,13
9011,Geoffroy - Marie,OUI,18,2,16,10,6,OUI,OUI,2025-03-13 13:01:16+00:00,"48.873781940593325, 2.344513876337893",Paris,75056,0.8888888888888888,13
12028,Vivaldi - Antoine-Julien Hénard,OUI,27,25,2,1,1,OUI,OUI,2025-03-13 12:58:48+00:00,"48.841923663276546, 2.389728979467376",Paris,75056,0.07407407407407407,13
20022,Porte de Bagnolet,OUI,33,33,0,0,0,OUI,OUI,2025-03-13 13:00:22+00:00,"48.864707139122984, 2.408344637349607",Paris,75056,0.0,13
9034,Godot de Mauroy - Madeleine,OUI,21,3,18,4,14,OUI,OUI,2025-03-13 13:01:11+00:00,"48.869789, 2.326347",Paris,75056,0.8571428571428571,13
12036,Reuilly - Place Felix Eboue,OUI,41,40,1,0,1,OUI,OUI,2025-03-13 12:57:37+00:00,"48.84030274499962, 2.394630398715453",Paris,75056,0.024390243902439025,13
41211,Louis Xavier de Ricard - Ancienne Mairie,OUI,34,32,2,2,0,OUI,OUI,2025-03-13 12:58:54+00:00,"48.84629899065091, 2.472420372068882",Fontenay-sous-Bois,94033,0.058823529411764705,13
14026,Plantes - Moulin Vert,OUI,45,43,2,0,2,OUI,OUI,2025-03-13 12:59:29+00:00,"48.83005755305626, 2.3232302069664006",Paris,75056,0.044444444444444446,13
2108,Vivienne - Montmartre,OUI,37,3,34,16,18,OUI,OUI,2025-03-13 13:01:53+00:00,"48.871347597383, 2.3414588347077",Paris,75056,0.918918918918919,13
10008,Cité Riverin - Château d'Eau,OUI,17,2,15,11,4,OUI,OUI,2025-03-13 13:01:48+00:00,"48.870702423554306, 2.358739863900845",Paris,75056,0.8823529411764706,13
12101,Charenton - Prague,OUI,28,7,21,15,6,OUI,OUI,2025-03-13 13:01:37+00:00,"48.848175129981, 2.3763584494312",Paris,75056,0.75,13
16036,Porte Molitor,OUI,59,5,54,36,18,OUI,OUI,2025-03-13 13:00:51+00:00,"48.84524763511433, 2.2569015249609947",Paris,75056,0.9152542372881356,13
4019,Cloître Saint-Merri - Renard,OUI,29,3,26,20,6,OUI,OUI,2025-03-13 13:01:13+00:00,"48.858835448898, 2.3518279194832",Paris,75056,0.896551724137931,13
42505,Charles Frérot - Albert Guilpin,OUI,29,26,3,1,2,OUI,OUI,2025-03-13 13:00:11+00:00,"48.8155839183714, 2.3505029082298283",Gentilly,94037,0.10344827586206896,13
5001,Harpe - Saint-Germain,OUI,43,21,22,17,5,OUI,OUI,2025-03-13 13:00:03+00:00,"48.851518815017, 2.3436703160405",Paris,75056,0.5116279069767442,13
8117,Place de la Madeleine - Royale,OUI,41,3,38,26,12,OUI,OUI,2025-03-13 13:01:09+00:00,"48.869228052648, 2.324421107769",Paris,75056,0.926829268292683,13
51001,Gare d'Argenteuil,OUI,37,19,18,4,14,OUI,OUI,2025-03-13 12:58:03+00:00,"48.947022436806705, 2.256898172199726",Argenteuil,95018,0.4864864864864865,13
10032,Claude Vellefaux - Hôpital Saint-Louis,OUI,31,29,2,2,0,OUI,OUI,2025-03-13 13:01:17+00:00,"48.872859139003, 2.3700717069851",Paris,75056,0.06451612903225806,13
8027,Mairie du 8ème,OUI,14,0,14,7,7,OUI,OUI,2025-03-13 13:01:37+00:00,"48.877932, 2.318264",Paris,75056,1.0,13
12015,Place de la Nation - Picpus,OUI,35,32,3,2,1,OUI,OUI,2025-03-13 13:00:36+00:00,"48.846821681548, 2.4001130461693",Paris,75056,0.08571428571428572,13
21315,Jules Guesdes - Général de Gaulle,OUI,24,24,0,0,0,OUI,OUI,2025-03-13 12:59:06+00:00,"48.81930581291959, 2.278934195637703",Issy-les-Moulineaux,92040,0.0,13
48004,Maxime Gorki - Louis Aragon,OUI,20,16,4,2,2,OUI,OUI,2025-03-13 13:01:55+00:00,"48.78909814728443, 2.368387877941132",Villejuif,94076,0.2,13
23102,Hôtel de Ville de Sèvres,OUI,31,15,16,13,3,OUI,OUI,2025-03-13 13:01:40+00:00,"48.824363561289, 2.2131047397852",Sèvres,92072,0.5161290322580645,13
16042,Murat - Porte de Saint-Cloud,OUI,38,3,35,31,4,OUI,OUI,2025-03-13 12:58:56+00:00,"48.83750862621299, 2.2577651962637906",Paris,75056,0.9210526315789473,13
15036,Croix Nivert - Square Saint-Lambert,OUI,47,47,0,0,0,NON,NON,2025-03-03 09:03:43+00:00,"48.843051521591, 2.2952004522085",Paris,75056,0.0,9
15001,Gare Montparnasse - Arrivée,OUI,42,26,16,8,8,OUI,OUI,2025-03-13 13:01:32+00:00,"48.843827994315, 2.3225811123848",Paris,75056,0.38095238095238093,13
15006,Cherche-Midi - Hôpital Necker,OUI,34,22,12,9,3,OUI,OUI,2025-03-13 13:01:13+00:00,"48.84461063309956, 2.317914068698883",Paris,75056,0.35294117647058826,13
15008,Sèvres - Lecourbe,OUI,60,34,26,24,2,OUI,OUI,2025-03-13 13:01:50+00:00,"48.8447677, 2.3110086",Paris,75056,0.43333333333333335,13
33014,Parc Eli Lotar,OUI,19,16,3,2,1,OUI,OUI,2025-03-13 13:00:04+00:00,"48.91844993053703, 2.3727085813879967",Aubervilliers,93001,0.15789473684210525,13
22201,Henri Ravera - Gabriel Péri,OUI,28,28,0,0,0,OUI,OUI,2025-03-13 12:57:38+00:00,"48.79722273833844, 2.302115857601166",Bagneux,92007,0.0,13
13052,Leredde - Tolbiac,OUI,43,13,30,13,17,OUI,OUI,2025-03-13 12:58:59+00:00,"48.82887629664, 2.3744382709265",Paris,75056,0.6976744186046512,13
11112,Jules Vallès - Charonne,OUI,23,16,7,5,2,OUI,OUI,2025-03-13 12:53:17+00:00,"48.854284379935, 2.3847674578428",Paris,75056,0.30434782608695654,13
20105,Benoît Frachon - République,OUI,28,25,3,1,2,OUI,OUI,2025-03-13 13:01:56+00:00,"48.85230729014318, 2.415605485439301",Paris,75056,0.10714285714285714,13
5007,Ecoles - Carmes,OUI,34,0,34,18,16,OUI,OUI,2025-03-13 13:00:44+00:00,"48.848904447989405, 2.3473486304283147",Paris,75056,1.0,13
33103,Jean Jaurès - Jules Jacquemin,OUI,22,21,1,1,0,OUI,OUI,2025-03-13 13:01:31+00:00,"48.88433053604843, 2.4082902455152104",Le Pré-Saint-Gervais,93061,0.045454545454545456,13
18202,Diane Arbus,OUI,37,36,1,1,0,OUI,OUI,2025-03-13 12:57:43+00:00,"48.898800717199, 2.3524022474885",Paris,75056,0.02702702702702703,13
41401,Marne - Charles de Gaulle,OUI,25,16,9,8,1,OUI,OUI,2025-03-13 13:00:26+00:00,"48.815071719544434, 2.4121668934822087",Alfortville,94002,0.36,13
1007,Turbigo - Française,OUI,16,7,9,7,2,OUI,OUI,2025-03-13 13:01:32+00:00,"48.86358858111446, 2.3477794602513313",Paris,75056,0.5625,13
14031,Didot - Place de Moro-Giafferi,OUI,20,18,2,1,1,OUI,OUI,2025-03-13 13:00:07+00:00,"48.8337, 2.3215",Paris,75056,0.1,13
47003,Charentonneau - Maisons Alfort,OUI,20,15,5,5,0,OUI,OUI,2025-03-13 13:01:18+00:00,"48.809932980484355, 2.443288456496946",Maisons-Alfort,94046,0.25,13
16019,Porte de la Muette,OUI,34,13,21,4,17,OUI,OUI,2025-03-13 13:00:11+00:00,"48.86302317841182, 2.2687188170157406",Paris,75056,0.6176470588235294,13
16013,Mairie du 16ème,OUI,35,34,1,0,1,OUI,OUI,2025-03-13 12:58:20+00:00,"48.863936848471994, 2.2765953093767166",Paris,75056,0.02857142857142857,13
2013,Favart - Italiens,OUI,17,1,16,3,13,OUI,OUI,2025-03-13 13:01:47+00:00,"48.871446353921, 2.3382901058508",Paris,75056,0.9411764705882353,13
18034,Leibniz - Jean Dollfus,OUI,32,32,0,0,0,OUI,OUI,2025-03-13 12:57:30+00:00,"48.896328348515986, 2.333390423834684",Paris,75056,0.0,13
3102,Bourg l'Abbé - Saint-Martin,OUI,36,3,33,19,14,OUI,OUI,2025-03-13 13:00:45+00:00,"48.86393331949257, 2.352406270802021",Paris,75056,0.9166666666666666,13
14135,Jourdan - Cité Universitaire,OUI,39,30,9,5,4,OUI,OUI,2025-03-13 13:01:29+00:00,"48.819897343156676, 2.3397007964124366",Paris,75056,0.23076923076923078,13
10019,Paradis - Hauteville,OUI,31,5,26,20,6,OUI,OUI,2025-03-13 12:59:21+00:00,"48.874999954666755, 2.3522757401923404",Paris,75056,0.8387096774193549,13
18140,Porte de Clignancourt - Ney,OUI,38,27,11,2,9,OUI,OUI,2025-03-13 13:01:56+00:00,"48.899641123987095, 2.344321422278881",Paris,75056,0.2894736842105263,13
11033,Bréguet - Sabin,OUI,29,3,26,22,4,OUI,OUI,2025-03-13 13:01:51+00:00,"48.856931678257, 2.3706749462105",Paris,75056,0.896551724137931,13
41203,Stalingrad - Rigollots,OUI,50,46,4,0,4,OUI,OUI,2025-03-13 12:58:19+00:00,"48.84997403844251, 2.45557576417923",Fontenay-sous-Bois,94033,0.08,13
10034,Louis Blanc - La Chapelle,OUI,21,19,2,0,2,OUI,OUI,2025-03-13 13:00:41+00:00,"48.884008964514, 2.3599335551262",Paris,75056,0.09523809523809523,13
18039,Jardins d'Eole,OUI,19,17,2,0,2,OUI,OUI,2025-03-13 12:51:10+00:00,"48.8869703, 2.3668488",Paris,75056,0.10526315789473684,13
16102,Pergolèse - Marbeau,OUI,26,22,4,0,4,OUI,OUI,2025-03-13 12:54:22+00:00,"48.873568706869, 2.2815125225299",Paris,75056,0.15384615384615385,13
4021,Centre Georges Pompidou,OUI,24,2,22,14,8,OUI,OUI,2025-03-13 13:00:29+00:00,"48.861419, 2.352581",Paris,75056,0.9166666666666666,13
16012,Flandrin - Longchamp,OUI,40,1,39,14,25,OUI,OUI,2025-03-13 13:01:06+00:00,"48.86877849178477, 2.274354539176829",Paris,75056,0.975,13
20034,Sorbier - Ménilmontant,OUI,24,24,0,0,0,OUI,OUI,2025-03-13 13:00:43+00:00,"48.868542395661, 2.3897721245885",Paris,75056,0.0,13
14001,Edgar Quinet - Gaité,OUI,27,19,8,0,8,OUI,OUI,2025-03-13 12:59:48+00:00,"48.841160928966, 2.324595451355",Paris,75056,0.2962962962962963,13
19201,Petit - Georges Thill,OUI,23,21,2,1,1,OUI,OUI,2025-03-13 12:56:51+00:00,"48.88603131999171, 2.3895753175020222",Paris,75056,0.08695652173913043,13
26004,Gare RER les Grésillons,OUI,22,15,7,7,0,OUI,OUI,2025-03-13 12:58:40+00:00,"48.919898633572764, 2.31458459136273",Asnières-sur-Seine,92004,0.3181818181818182,13
10009,Mairie du 10ème,OUI,18,2,16,11,5,OUI,OUI,2025-03-13 13:01:16+00:00,"48.872089449907, 2.3575825989246",Paris,75056,0.8888888888888888,13
18139,Poissonniers - Championnet,OUI,28,27,1,0,1,OUI,OUI,2025-03-13 13:01:17+00:00,"48.89543299733937, 2.3530178144574165",Paris,75056,0.03571428571428571,13
22301,Chausson - Gabriel Péri,OUI,20,12,8,8,0,OUI,OUI,2025-03-13 13:01:40+00:00,"48.921891003481115, 2.2952306270599365",Gennevilliers,92036,0.4,13
1006,Grande Truanderie - Saint-Denis,OUI,27,15,12,11,1,OUI,OUI,2025-03-13 13:00:02+00:00,"48.8626302, 2.3498075",Paris,75056,0.4444444444444444,13
41405,Place de l'Europe - Alfortville,OUI,24,6,18,18,0,OUI,OUI,2025-03-13 12:58:18+00:00,"48.78913702405837, 2.4284800887107854",Alfortville,94002,0.75,13
19110,Square Claude Bernard,OUI,29,14,15,9,6,OUI,OUI,2025-03-13 13:01:41+00:00,"48.89876016219984, 2.375325746834278",Paris,75056,0.5172413793103449,13
20006,Pyrénées - Plaine,OUI,12,12,0,0,0,OUI,OUI,2025-03-13 12:58:26+00:00,"48.85026702458, 2.4062821269035",Paris,75056,0.0,13
16105,Crevaux - Bugeaud,OUI,31,30,1,0,1,OUI,OUI,2025-03-13 12:55:30+00:00,"48.87080942867, 2.2811490076919",Paris,75056,0.03225806451612903,13
10011,Bourse du Travail,OUI,15,6,9,7,2,OUI,OUI,2025-03-13 13:01:35+00:00,"48.868976638826, 2.3623438552022",Paris,75056,0.6,13
4006,Bourdon - Pont Morland,OUI,49,17,32,25,7,OUI,OUI,2025-03-13 13:01:39+00:00,"48.8478103, 2.3659356",Paris,75056,0.6530612244897959,13
21953,Gare de Bellevue,OUI,20,17,3,0,3,OUI,OUI,2025-03-13 12:57:24+00:00,"48.8192404685572, 2.2295309230685234",Meudon,92048,0.15,13
3008,Perle - Vieille du Temple,OUI,35,2,33,26,7,OUI,OUI,2025-03-13 13:00:52+00:00,"48.8601346, 2.3611206",Paris,75056,0.9428571428571428,13
21506,Maurice Payret-Dortail,OUI,22,21,1,0,1,OUI,OUI,2025-03-13 12:52:18+00:00,"48.87811957063342, 2.2233625128865246",Suresnes,92073,0.045454545454545456,13
6010,Chevreuse - Montparnasse,OUI,15,13,2,0,2,OUI,OUI,2025-03-13 13:01:42+00:00,"48.841739161231, 2.3315522167367",Paris,75056,0.13333333333333333,13
14103,Maine - Liancourt,OUI,25,24,1,0,1,OUI,OUI,2025-03-13 13:00:22+00:00,"48.835064363954, 2.323731449974",Paris,75056,0.04,13
5015,Epée de Bois - Mouffetard,OUI,62,50,12,8,4,OUI,OUI,2025-03-13 12:56:39+00:00,"48.841508690388835, 2.350066713988781",Paris,75056,0.1935483870967742,13
9037,Parme - Clichy,OUI,23,20,3,2,1,OUI,OUI,2025-03-13 12:55:23+00:00,"48.881266424227, 2.3281970934506",Paris,75056,0.13043478260869565,13
45002,Roger Salengro - Général de Gaulle,OUI,27,16,11,3,8,OUI,OUI,2025-03-13 12:58:48+00:00,"48.820029010376956, 2.4846760556101803",Champigny-sur-Marne,94017,0.4074074074074074,13
7021,Bosquet - Saint-Dominique,OUI,28,14,14,11,3,OUI,OUI,2025-03-13 12:53:57+00:00,"48.858651709526, 2.3037165802346",Paris,75056,0.5,13
15128,Cadix - Hameau,OUI,36,29,7,5,2,OUI,OUI,2025-03-13 12:56:19+00:00,"48.8340107632249, 2.289516180753708",Paris,75056,0.19444444444444445,13
2015,Louis le Grand - Italiens,OUI,33,0,33,18,15,OUI,OUI,2025-03-13 13:01:53+00:00,"48.870508937204, 2.3340544619393",Paris,75056,1.0,13
44014,Camille Risch - Paul Armangot,OUI,25,15,10,5,5,OUI,OUI,2025-03-13 13:00:55+00:00,"48.774703, 2.373685",Vitry-sur-Seine,94081,0.4,13
20029,Frères Flavien - Porte des Lilas,OUI,23,23,0,0,0,OUI,OUI,2025-03-13 12:55:52+00:00,"48.8780992764359, 2.41104629853209",Paris,75056,0.0,13
12037,Reuilly - Daumesnil,OUI,36,33,3,0,3,OUI,OUI,2025-03-13 13:01:36+00:00,"48.8395385, 2.3972516",Paris,75056,0.08333333333333333,13
2003,Saint-Denis - Réaumur,OUI,31,7,24,12,12,OUI,OUI,2025-03-13 13:01:42+00:00,"48.8661116315789, 2.3507790675507594",Paris,75056,0.7741935483870968,13
18004,Place des Abbesses,OUI,12,11,1,0,1,OUI,OUI,2025-03-13 13:01:57+00:00,"48.884542726149725, 2.3386867716908455",Paris,75056,0.08333333333333333,13
13017,Nationale - Vincent Auriol,OUI,33,28,5,1,4,OUI,OUI,2025-03-13 13:01:49+00:00,"48.83252708397293, 2.362354410392119",Paris,75056,0.15151515151515152,13
7012,Cité Vaneau,OUI,23,4,19,10,9,OUI,OUI,2025-03-13 13:01:07+00:00,"48.8542210666207, 2.319614924490452",Paris,75056,0.8260869565217391,13
15111,Olivier de Serres - Leriche,OUI,24,21,3,1,2,OUI,OUI,2025-03-13 13:00:25+00:00,"48.83460221715206, 2.2957482933998112",Paris,75056,0.125,13
20001,Place de la Nation - Charonne,OUI,35,35,0,0,0,OUI,OUI,2025-03-13 12:55:39+00:00,"48.848364667777, 2.3997623859813",Paris,75056,0.0,13
2021,Cléry - Montmartre,OUI,58,37,21,12,9,OUI,OUI,2025-03-13 13:01:32+00:00,"48.867458, 2.3445211",Paris,75056,0.3620689655172414,13
20008,Pyrénées - Avron,OUI,31,31,0,0,0,OUI,OUI,2025-03-13 12:58:12+00:00,"48.853246898211985, 2.405871044529538",Paris,75056,0.0,13
24006,Adolphe Lalyre - Armand Silvestre,OUI,38,36,2,1,1,OUI,OUI,2025-03-13 13:01:57+00:00,"48.90406266961591, 2.273416221141815",Courbevoie,92026,0.05263157894736842,13
12019,Gare de Reuilly - Picpus,OUI,27,21,6,4,2,OUI,OUI,2025-03-13 13:01:06+00:00,"48.84267354116789, 2.3972943797707558",Paris,75056,0.2222222222222222,13
14132,Bézout - Général Leclerc,OUI,28,26,2,1,1,OUI,OUI,2025-03-13 13:01:48+00:00,"48.82884804502439, 2.3285973072052",Paris,75056,0.07142857142857142,13
20104,Louis Lumière.,OUI,22,21,1,0,1,OUI,OUI,2025-03-13 12:57:23+00:00,"48.86216198070008, 2.41112578185621",Paris,75056,0.045454545454545456,13
4014,Blancs-Manteaux - Archives,OUI,28,1,27,23,4,OUI,OUI,2025-03-13 12:59:42+00:00,"48.85941800703, 2.3559471219778",Paris,75056,0.9642857142857143,13
8110,Gare Saint-Lazare - Stockholm,OUI,30,19,11,5,6,OUI,OUI,2025-03-13 13:01:33+00:00,"48.877127316667654, 2.322417162358761",Paris,75056,0.36666666666666664,13
23702,Hôtel de Ville de Chaville,OUI,20,19,1,0,1,OUI,OUI,2025-03-13 12:57:55+00:00,"48.80887149094033, 2.188134044408798",Chaville,92022,0.05,13
20024,Gambetta - Père Lachaise,OUI,27,25,2,0,2,OUI,OUI,2025-03-13 13:00:50+00:00,"48.864295696165875, 2.398228667282044",Paris,75056,0.07407407407407407,13
14022,Didot - Mariniers,OUI,35,35,0,0,0,OUI,OUI,2025-03-13 12:56:30+00:00,"48.82650543613106, 2.313136198271666",Paris,75056,0.0,13
3010,Beaubourg - Michel-le-Comte,OUI,15,0,15,10,5,OUI,OUI,2025-03-13 12:57:49+00:00,"48.862534941806, 2.3543103039265",Paris,75056,1.0,13
2002,Etienne Marcel - Montorgueil,OUI,25,2,23,17,6,OUI,OUI,2025-03-13 13:01:17+00:00,"48.86450567259199, 2.3461959511041637",Paris,75056,0.92,13
12156,Niger - Soult,OUI,23,19,4,1,3,OUI,OUI,2025-03-13 13:00:24+00:00,"48.84369906369085, 2.410361237220498",Paris,75056,0.17391304347826086,13
19012,Lally-Tollendal - Armand Carrel,OUI,27,25,2,0,2,OUI,OUI,2025-03-13 13:01:41+00:00,"48.88270066221072, 2.374717555940151",Paris,75056,0.07407407407407407,13
9009,Square Montholon,OUI,19,8,11,1,10,OUI,OUI,2025-03-13 12:57:49+00:00,"48.876620377545024, 2.3457641154527664",Paris,75056,0.5789473684210527,13
22306,Place du 17 Octobre,OUI,16,10,6,3,3,OUI,OUI,2025-03-13 12:57:24+00:00,"48.91962690034779, 2.2978286134199792",Gennevilliers,92036,0.375,13
6104,Herschel - Observatoire,OUI,36,12,24,3,21,OUI,OUI,2025-03-13 13:01:25+00:00,"48.84342376221923, 2.3376645147800446",Paris,75056,0.6666666666666666,13
14023,Adolphe Pinard - Victor Hugo,OUI,51,49,2,1,1,OUI,OUI,2025-03-13 12:56:58+00:00,"48.8236825874564, 2.3077843710780144",Malakoff,92046,0.0392156862745098,13
21309,Mairie d'Issy,OUI,39,26,13,8,5,OUI,OUI,2025-03-13 13:01:37+00:00,"48.823767792468, 2.2723111510277",Issy-les-Moulineaux,92040,0.3333333333333333,13
22502,Kléber - National,OUI,20,14,6,4,2,OUI,OUI,2025-03-13 12:58:33+00:00,"48.906333898712234, 2.2393910586833954",La Garenne-Colombes,92035,0.3,13
13005,Cordelières - Arago,OUI,45,16,29,28,1,OUI,OUI,2025-03-13 13:00:53+00:00,"48.83548071896613, 2.348572461702221",Paris,75056,0.6444444444444445,13
4015,Mairie du 4ème,OUI,41,2,39,30,9,OUI,OUI,2025-03-13 13:01:31+00:00,"48.855949910497, 2.3563823103905",Paris,75056,0.9512195121951219,13
19002,Centquatre,OUI,38,33,5,0,5,NON,NON,2025-03-13 13:00:51+00:00,"48.889333538455, 2.3707854375243",Paris,75056,0.13157894736842105,13
3003,Fille du Calvaire - Turenne,OUI,26,3,23,21,2,OUI,OUI,2025-03-13 12:57:42+00:00,"48.86210505412563, 2.3649600148200993",Paris,75056,0.8846153846153846,13
17019,Phalsbourg - Villiers,OUI,18,7,11,4,7,OUI,OUI,2025-03-13 12:53:54+00:00,"48.88242307900951, 2.3090453445911407",Paris,75056,0.6111111111111112,13
19111,Cesaria Evora - Rosa Parks,OUI,35,31,4,4,0,OUI,OUI,2025-03-13 13:00:50+00:00,"48.89717672825043, 2.3745173960924144",Paris,75056,0.11428571428571428,13
19010,Emile Reynaud - Porte de la Villette,OUI,22,22,0,0,0,OUI,OUI,2025-03-13 13:00:58+00:00,"48.90098953630053, 2.3887022584676743",Paris,75056,0.0,13
21110,Parc Roger Salengro,OUI,30,7,23,20,3,OUI,OUI,2025-03-13 13:01:28+00:00,"48.905303858642, 2.31055945158",Clichy,92024,0.7666666666666667,13
15132,Bargue -  Dutot,OUI,20,17,3,2,1,OUI,OUI,2025-03-13 12:58:17+00:00,"48.837884, 2.308876",Paris,75056,0.15,13
8036,Lisbonne - Monceau,OUI,46,3,43,17,26,OUI,OUI,2025-03-13 13:01:56+00:00,"48.877455676814, 2.3096942214195",Paris,75056,0.9347826086956522,13
8028,Arsène Houssaye - Champs-Elysées,OUI,28,11,17,0,17,OUI,OUI,2025-03-13 12:59:46+00:00,"48.873409276267, 2.2977904602885",Paris,75056,0.6071428571428571,13
48005,Eugène Varlin - Place de la Paix,OUI,23,20,3,1,2,OUI,OUI,2025-03-13 12:53:48+00:00,"48.792862, 2.363093",Villejuif,94076,0.13043478260869565,13
14137,Maurice d'Ocagne - General Maudhuy,OUI,29,24,5,2,3,OUI,OUI,2025-03-13 12:57:55+00:00,"48.82414282524159, 2.3158789426088333",Paris,75056,0.1724137931034483,13
41208,Alouettes - Maréchal de Lattre de Tassigny,OUI,21,10,11,2,9,OUI,OUI,2025-03-13 13:01:03+00:00,"48.85511009293948, 2.4930700287222862",Fontenay-sous-Bois,94033,0.5238095238095238,13
14019,Sarrette - Général Leclerc,OUI,22,21,1,0,1,OUI,OUI,2025-03-13 12:59:33+00:00,"48.825030852925, 2.3264128693982",Paris,75056,0.045454545454545456,13
42704,Mairie du Kremlin-Bicêtre,OUI,25,25,0,0,0,OUI,OUI,2025-03-13 12:57:11+00:00,"48.81191981537702, 2.3570189997553825",Le Kremlin-Bicêtre,94043,0.0,13
3011,Turbigo - Réaumur,OUI,31,5,26,25,1,OUI,OUI,2025-03-13 12:59:59+00:00,"48.865574047531, 2.3564198613167",Paris,75056,0.8387096774193549,13
21706,Jean Bleuzen - Square du 11 Novembre,OUI,45,41,4,4,0,OUI,OUI,2025-03-13 13:00:16+00:00,"48.8232579, 2.2965213",Vanves,92075,0.08888888888888889,13
31709,Place de la Fraternité,OUI,22,20,2,1,1,OUI,OUI,2025-03-13 12:56:16+00:00,"48.85716405838368, 2.422847449779511",Montreuil,93048,0.09090909090909091,13
1014,Rivoli - Musée du Louvre,OUI,20,0,20,10,10,OUI,OUI,2025-03-13 13:01:00+00:00,"48.86364636851945, 2.33409583568573",Paris,75056,1.0,13
10027,Dunkerque - Alsace,OUI,20,17,3,1,2,OUI,OUI,2025-03-13 13:00:58+00:00,"48.879355, 2.358379",Paris,75056,0.15,13
4017,Place de l'Hôtel de Ville,OUI,13,2,11,11,0,OUI,OUI,2025-03-13 13:00:54+00:00,"48.8573314, 2.351458",Paris,75056,0.8461538461538461,13
10006,Petites Ecuries - Faubourg Saint-Denis,OUI,27,21,6,5,1,OUI,OUI,2025-03-13 13:01:52+00:00,"48.87287120589831, 2.3542150855064397",Paris,75056,0.2222222222222222,13
12163,Hippodrome Paris-Vincennes,OUI,42,40,2,1,1,OUI,OUI,2025-03-13 12:54:42+00:00,"48.82048387758518, 2.446271181106568",Paris,75056,0.047619047619047616,13
22401,Charles de Gaulle - Plateau de Vanves,OUI,32,29,3,1,2,OUI,OUI,2025-03-13 13:00:55+00:00,"48.82233088973263, 2.298571803412886",Malakoff,92046,0.09375,13
3002,Saint-Gilles - Turenne,OUI,15,5,10,5,5,OUI,OUI,2025-03-13 13:01:40+00:00,"48.858158956779, 2.3647149920992",Paris,75056,0.6666666666666666,13
12002,Lacuée - Lyon,OUI,15,0,15,11,4,OUI,OUI,2025-03-13 13:01:27+00:00,"48.849268481958, 2.3704585433006",Paris,75056,1.0,13
1012,Jean-Jacques Rousseau - Deux Ecus,OUI,21,1,20,12,8,OUI,OUI,2025-03-13 12:59:31+00:00,"48.86297805972131, 2.3414635285735126",Paris,75056,0.9523809523809523,13
4103,Archives - Rivoli,OUI,19,1,18,12,6,OUI,OUI,2025-03-13 13:01:50+00:00,"48.857346707443, 2.3539767041802",Paris,75056,0.9473684210526315,13
2004,Square Pierre Lazareff,OUI,17,9,8,4,4,OUI,OUI,2025-03-13 12:59:44+00:00,"48.867141720746, 2.3483933508396",Paris,75056,0.47058823529411764,13
3001,Beaumarchais - Saint-Gilles,OUI,44,29,15,10,5,OUI,OUI,2025-03-13 12:56:09+00:00,"48.8580378, 2.3679352",Paris,75056,0.3409090909090909,13
4018,Saint-Bon - Rivoli,OUI,14,0,14,10,4,OUI,OUI,2025-03-13 13:01:35+00:00,"48.857999643315, 2.3502172809763",Paris,75056,1.0,13
21026,Sèvres - Général Leclerc,OUI,29,6,23,17,6,OUI,OUI,2025-03-13 13:01:32+00:00,"48.830121559055, 2.2314262390137",Boulogne-Billancourt,92012,0.7931034482758621,13
16044,Porte de Saint Cloud - Parc des Princes,OUI,31,18,13,9,4,OUI,OUI,2025-03-13 13:00:17+00:00,"48.838662757066, 2.2525164484978",Paris,75056,0.41935483870967744,13
19129,Solitaires - Place des Fêtes,OUI,29,29,0,0,0,NON,NON,2025-02-23 09:26:05+00:00,"48.876601, 2.391769",Paris,75056,0.0,9
4007,Place de la Bastille - Bourdon,OUI,33,9,24,11,13,OUI,OUI,2025-03-13 13:01:18+00:00,"48.852364355271, 2.3681089282036",Paris,75056,0.7272727272727273,13
32013,Saint-Denis - Université,OUI,19,3,16,6,10,OUI,OUI,2025-03-13 12:58:33+00:00,"48.94563430946964, 2.3638297989964485",Saint-Denis,93066,0.8421052631578947,13
4009,Village Saint-Paul,OUI,27,2,25,20,5,OUI,OUI,2025-03-13 13:00:30+00:00,"48.852639866625, 2.3607301712036",Paris,75056,0.9259259259259259,13
22503,Joffre - Aigle,OUI,19,13,6,4,2,OUI,OUI,2025-03-13 12:59:49+00:00,"48.904033, 2.245096",La Garenne-Colombes,92035,0.3157894736842105,13
10041,Gare du Nord - La Chapelle,OUI,18,18,0,0,0,OUI,OUI,2025-03-13 13:01:13+00:00,"48.884178287286, 2.3561057075858",Paris,75056,0.0,13
1102,Française - Etienne Marcel,OUI,35,22,13,11,2,OUI,OUI,2025-03-13 13:00:06+00:00,"48.864053304653766, 2.347587011754513",Paris,75056,0.37142857142857144,13
33020,Waldeck Rochet - Germaine Tillon,OUI,30,5,25,16,9,OUI,OUI,2025-03-13 13:00:23+00:00,"48.91105960199651, 2.3676301538944244",Aubervilliers,93001,0.8333333333333334,13
12020,Cours de Vincennes - Soult,OUI,44,39,5,2,3,OUI,OUI,2025-03-13 13:01:38+00:00,"48.846918761569, 2.4105220288038",Paris,75056,0.11363636363636363,13
32019,Place du 8 mai 1945.,OUI,28,19,9,5,4,OUI,OUI,2025-03-13 12:57:53+00:00,"48.938882272105, 2.3566243797541",Saint-Denis,93066,0.32142857142857145,13
3009,Temple - Haudriettes,OUI,19,4,15,12,3,OUI,OUI,2025-03-13 12:59:45+00:00,"48.861636880212, 2.3566960206458",Paris,75056,0.7894736842105263,13
9039,Chaussée d'Antin - Haussmann,OUI,23,3,20,13,7,OUI,OUI,2025-03-13 13:00:49+00:00,"48.87243, 2.33359",Paris,75056,0.8695652173913043,13
2005,Montmartre - Etienne Marcel,OUI,16,4,12,10,2,OUI,OUI,2025-03-13 12:58:33+00:00,"48.86502194581, 2.3450684401448",Paris,75056,0.75,13
22506,Gare des Vallées,OUI,18,12,6,3,3,OUI,OUI,2025-03-13 12:57:35+00:00,"48.913179, 2.257726",La Garenne-Colombes,92035,0.3333333333333333,13
3012,Square Emile - Chautemps,OUI,24,2,22,17,5,OUI,OUI,2025-03-13 13:01:55+00:00,"48.867433724231, 2.3536357283592",Paris,75056,0.9166666666666666,13
1018,Alger - Rivoli,OUI,14,1,13,8,5,OUI,OUI,2025-03-13 12:55:32+00:00,"48.864773553495, 2.3294493936128",Paris,75056,0.9285714285714286,13
31001,Lagny - Auguste Blanqui,OUI,26,10,16,14,2,OUI,OUI,2025-03-13 13:00:01+00:00,"48.84922568052601, 2.4218603968620305",Montreuil,93048,0.6153846153846154,13
1026,Place du Lieutenant Henri Karcher,OUI,29,0,29,23,6,OUI,OUI,2025-03-13 13:01:46+00:00,"48.863490871724466, 2.3400671035051346",Paris,75056,1.0,13
21507,Gardenat-Lapostol - Velettes,OUI,20,13,7,1,6,OUI,OUI,2025-03-13 13:00:02+00:00,"48.87387, 2.224185",Suresnes,92073,0.35,13
18015,Custine - Ramey,OUI,40,40,0,0,0,OUI,OUI,2025-03-13 13:00:13+00:00,"48.888735896947, 2.3469526693225",Paris,75056,0.0,13
3006,Mairie du 3ème,OUI,23,5,18,15,3,OUI,OUI,2025-03-13 13:00:02+00:00,"48.86446178139141, 2.361762821674347",Paris,75056,0.782608695652174,13
17106,Berthier - Porte de Clichy,OUI,24,13,11,7,4,OUI,OUI,2025-03-13 12:59:05+00:00,"48.894222687781, 2.3125872006816",Paris,75056,0.4583333333333333,13
32024,Port - Confluence,OUI,23,18,5,3,2,OUI,OUI,2025-03-13 12:53:37+00:00,"48.936093926526, 2.3436167797955",Saint-Denis,93066,0.21739130434782608,13
9111,Victoire - Laffitte,OUI,19,1,18,17,1,OUI,OUI,2025-03-13 12:59:58+00:00,"48.87514373494672, 2.338118505144376",Paris,75056,0.9473684210526315,13
1017,Saint-Honoré - 29 juillet,OUI,18,6,12,10,2,OUI,OUI,2025-03-13 13:01:00+00:00,"48.86557114282421, 2.330567417577153",Paris,75056,0.6666666666666666,13
5122,Saint-Michel - Luxembourg,OUI,28,7,21,3,18,OUI,OUI,2025-03-13 13:01:56+00:00,"48.84501507626, 2.3394941166043",Paris,75056,0.75,13
15040,Saint-Amand - Labrouste,OUI,34,31,3,0,3,OUI,OUI,2025-03-13 13:01:33+00:00,"48.834097274832295, 2.3087677359581",Paris,75056,0.08823529411764706,13
13125,Gare d'Austerlitz - Pont Charles de Gaulle,OUI,55,9,46,26,20,OUI,OUI,2025-03-13 13:01:34+00:00,"48.842319830109, 2.3670300096273",Paris,75056,0.8363636363636363,13
23107,Gare de Sèvres - Ville d'Avray,OUI,22,20,2,1,1,OUI,OUI,2025-03-13 12:55:22+00:00,"48.826262366227, 2.2001516849313",Sèvres,92072,0.09090909090909091,13
6031,Pierre Sarrazin - Saint-Michel,OUI,31,0,31,24,7,OUI,OUI,2025-03-13 13:01:55+00:00,"48.850908146398, 2.342130728066",Paris,75056,1.0,13
6201,Saint Pères - Saint Germain,OUI,22,10,12,6,6,OUI,OUI,2025-03-13 12:46:33+00:00,"48.853729675265, 2.3300181032703",Paris,75056,0.5454545454545454,13
14133,Froidevaux - Boulard,OUI,35,34,1,0,1,OUI,OUI,2025-03-13 12:55:32+00:00,"48.835147319625, 2.3294411972165",Paris,75056,0.02857142857142857,13
22601,Marx Dormoy - Château Sainte-Barbe,OUI,20,18,2,0,2,OUI,OUI,2025-03-13 12:55:03+00:00,"48.791782341055324, 2.297856844961643",Fontenay-aux-Roses,92032,0.1,13
4012,Tiron - Rivoli,OUI,27,1,26,18,8,OUI,OUI,2025-03-13 12:58:28+00:00,"48.855692253233, 2.3579058051109",Paris,75056,0.9629629629629629,13
42018,Amédée Huon - Fort d'Ivry,OUI,31,27,4,1,3,OUI,OUI,2025-03-13 13:01:57+00:00,"48.805131376899986, 2.388489693403244",Ivry-sur-Seine,94041,0.12903225806451613,13
21215,Verdier - Jean Jaurès,OUI,32,30,2,1,1,OUI,OUI,2025-03-13 12:59:18+00:00,"48.81614048711214, 2.3123561963438988",Montrouge,92049,0.0625,13
12164,Stade Pershing,OUI,26,26,0,0,0,NON,NON,2025-02-26 05:58:32+00:00,"48.829107826857, 2.4583535268903",Paris,75056,0.0,6
26006,Bas - Gabriel Péri,OUI,30,10,20,16,4,OUI,OUI,2025-03-13 13:01:32+00:00,"48.91585580539625, 2.2948095202445984",Asnières-sur-Seine,92004,0.6666666666666666,13
1023,Saint-Honoré - Musée du Louvre,OUI,21,0,21,10,11,OUI,OUI,2025-03-13 13:01:18+00:00,"48.863443132848, 2.3348781846405",Paris,75056,1.0,13
42211,Séminaire de Conflans - Liberté,OUI,24,8,16,9,7,OUI,OUI,2025-03-13 12:59:53+00:00,"48.823194, 2.404179",Charenton-le-Pont,94018,0.6666666666666666,13
48008,Guy Môquet - Parvis Georges Marchais,OUI,30,30,0,0,0,OUI,OUI,2025-03-13 13:01:32+00:00,"48.79518840095975, 2.35943466424942",Villejuif,94076,0.0,13
42026,Barbès - Monique Maunoury,OUI,40,39,1,1,0,OUI,OUI,2025-03-13 13:01:54+00:00,"48.81552718820216, 2.3687169334905405",Ivry-sur-Seine,94041,0.025,13
19202,Marseillaise - Grenade,OUI,43,38,5,1,4,OUI,OUI,2025-03-13 13:01:56+00:00,"48.889371092747, 2.3979396821544",Paris,75056,0.11627906976744186,13
2012,Choiseul - Quatre Septembre,OUI,44,6,38,16,22,OUI,OUI,2025-03-13 13:01:23+00:00,"48.8699355331869, 2.3359975218772893",Paris,75056,0.8636363636363636,13
14201,Decrès - Alésia,OUI,30,27,3,1,2,OUI,OUI,2025-03-13 12:57:45+00:00,"48.832200060759, 2.3139070151575",Paris,75056,0.1,13
21509,Gardenat Lapostol - Franklin Roosevelt,OUI,24,21,3,0,3,OUI,OUI,2025-03-13 12:56:55+00:00,"48.871839, 2.222505",Suresnes,92073,0.125,13
5003,Le Goff - Gay-Lussac,OUI,34,9,25,9,16,OUI,OUI,2025-03-13 13:00:07+00:00,"48.846102400979, 2.3412207886577",Paris,75056,0.7352941176470589,13
13054,Pau Casals - Neuve Tolbiac,OUI,53,5,48,20,28,OUI,OUI,2025-03-13 13:01:52+00:00,"48.8311602, 2.3774395",Paris,75056,0.9056603773584906,13
3007,Archives - Pastourelle,OUI,26,2,24,16,8,OUI,OUI,2025-03-13 13:00:52+00:00,"48.8623615, 2.3595041",Paris,75056,0.9230769230769231,13
19130,Place Paul Delouvrier,OUI,26,25,1,0,1,OUI,OUI,2025-03-13 12:56:43+00:00,"48.89197621431365, 2.3851288855075836",Paris,75056,0.038461538461538464,13
31020,Résistance - Parmentier,OUI,32,31,1,1,0,OUI,OUI,2025-03-13 12:56:58+00:00,"48.85965138131299, 2.436705082654953",Montreuil,93048,0.03125,13
35012,Candale - Mehul,OUI,25,23,2,0,2,OUI,OUI,2025-03-13 12:59:30+00:00,"48.8893935006175, 2.414379715919495",Pantin,93055,0.08,13
28005,Jean Jaurès - Paul Lafargue,OUI,25,3,22,5,17,OUI,OUI,2025-03-13 12:59:42+00:00,"48.884933177666, 2.2484488785267",Puteaux,92062,0.88,13
21505,Édouard Vaillant - Place Jean Jaurès,OUI,20,18,2,1,1,OUI,OUI,2025-03-13 12:56:22+00:00,"48.86265537999924, 2.2089037319128613",Suresnes,92073,0.1,13
12166,Parc Floral du Bel Air,OUI,24,10,14,9,5,OUI,OUI,2025-03-13 13:01:42+00:00,"48.839285711865735, 2.438560165464878",Paris,75056,0.5833333333333334,13
2016,Aboukir - Alexandrie,OUI,21,9,12,11,1,OUI,OUI,2025-03-13 13:01:56+00:00,"48.86868344444473, 2.3502043269474897",Paris,75056,0.5714285714285714,13
22603,Place de la Division Leclerc,OUI,33,33,0,0,0,OUI,OUI,2025-03-13 13:00:25+00:00,"48.793824988636516, 2.2731140430551027",Fontenay-aux-Roses,92032,0.0,13
44001,Quai Jules Guesde - Saint-Simon,OUI,30,1,29,26,3,OUI,OUI,2025-03-13 13:00:56+00:00,"48.80391487219, 2.4089661620274",Vitry-sur-Seine,94081,0.9666666666666667,13
12113,Cardinal Lavigerie,OUI,46,8,38,29,9,OUI,OUI,2025-03-13 13:01:36+00:00,"48.832934193699835, 2.402636749399156",Paris,75056,0.8260869565217391,13
5004,Saint-Jacques - Val de Grâce,OUI,19,1,18,0,18,OUI,OUI,2025-03-13 13:00:04+00:00,"48.8417514, 2.3413893",Paris,75056,0.9473684210526315,13
21119,Belfort - Victor Hugo,OUI,21,4,17,12,5,OUI,OUI,2025-03-13 13:01:01+00:00,"48.9018492, 2.3172724",Clichy,92024,0.8095238095238095,13
4101,Bastille - Beaumarchais,OUI,20,4,16,12,4,OUI,OUI,2025-03-13 13:00:24+00:00,"48.853833463852, 2.3685702681541",Paris,75056,0.8,13
16010,Belles Feuilles - Place de Mexico,OUI,22,16,6,3,3,OUI,OUI,2025-03-13 13:01:54+00:00,"48.865804746474, 2.2829206287861",Paris,75056,0.2727272727272727,13
1025,Oratoire - Rivoli,OUI,17,2,15,9,6,OUI,OUI,2025-03-13 12:58:44+00:00,"48.861342760889, 2.3400047421455",Paris,75056,0.8823529411764706,13
23042,André Theuriet - Blagis,OUI,30,15,15,9,6,OUI,OUI,2025-03-13 12:57:22+00:00,"48.77977325745441, 2.3130525648593903",Bourg-la-Reine,92014,0.5,13
2008,Mairie du 2ème,OUI,28,1,27,16,11,OUI,OUI,2025-03-13 12:56:47+00:00,"48.8672190355135, 2.3404625437747044",Paris,75056,0.9642857142857143,13
32020,Jules Guesdes - Carnot,OUI,14,13,1,0,1,OUI,OUI,2025-03-13 12:55:19+00:00,"48.93828169931872, 2.3508992046117783",Saint-Denis,93066,0.07142857142857142,13
23101,Grande Rue - Europe,OUI,25,18,7,5,2,OUI,OUI,2025-03-13 13:01:19+00:00,"48.8218104687602, 2.205879874527455",Sèvres,92072,0.28,13
27006,Victor Hugo - Gare,OUI,19,15,4,3,1,OUI,OUI,2025-03-13 12:55:22+00:00,"48.923133952658, 2.2600970417261",Colombes,92025,0.21052631578947367,13
1116,Ventadour - Opéra,OUI,25,2,23,12,11,OUI,OUI,2025-03-13 12:59:52+00:00,"48.866810653323, 2.3343884482519",Paris,75056,0.92,13
2006,Place des Victoires,OUI,23,0,23,15,8,OUI,OUI,2025-03-13 13:01:13+00:00,"48.8660354, 2.3420333",Paris,75056,1.0,13
6026,Saint-Placide - Cherche Midi,OUI,66,41,25,14,11,OUI,OUI,2025-03-13 13:01:08+00:00,"48.8490535919234, 2.325317971408367",Paris,75056,0.3787878787878788,13
44004,Place de l'Eglise - Vitry-sur-Seine,OUI,28,5,23,22,1,OUI,OUI,2025-03-13 13:01:00+00:00,"48.791922819921815, 2.395057752728462",Vitry-sur-Seine,94081,0.8214285714285714,13
27001,Square Victor Basch,OUI,19,6,13,11,2,OUI,OUI,2025-03-13 12:59:29+00:00,"48.914304862261, 2.2289156913757",Colombes,92025,0.6842105263157895,13
1024,Coquillière - Louvre,OUI,17,0,17,4,13,OUI,OUI,2025-03-13 13:00:41+00:00,"48.863795909662, 2.3425736278296",Paris,75056,1.0,13
17021,Jouffroy d'Abbans - Villiers,OUI,30,20,10,8,2,OUI,OUI,2025-03-13 12:51:30+00:00,"48.884215547037, 2.3056533560157",Paris,75056,0.3333333333333333,13
19046,Porte de Pantin.,OUI,33,32,1,0,1,OUI,OUI,2025-03-13 13:00:33+00:00,"48.889199725577, 2.3950181901455",Paris,75056,0.030303030303030304,13
2020,Danielle Casanova - Opéra,OUI,20,1,19,10,9,OUI,OUI,2025-03-13 13:01:25+00:00,"48.867643242297, 2.3333894088864",Paris,75056,0.95,13
35005,Quai de l'Aisne - Général Leclerc,OUI,26,23,3,1,2,OUI,OUI,2025-03-13 13:00:52+00:00,"48.895713, 2.400571",Pantin,93055,0.11538461538461539,13
10201,Magenta - Chabrol,OUI,23,20,3,0,3,OUI,OUI,2025-03-13 13:01:16+00:00,"48.876495350882, 2.3560990020633",Paris,75056,0.13043478260869565,13
18112,Arthur Ranc - Hôpital Bichat,OUI,23,14,9,6,3,OUI,OUI,2025-03-13 13:01:03+00:00,"48.8978712500682, 2.333521842956543",Paris,75056,0.391304347826087,13
6029,Vaugirard - Monsieur le Prince,OUI,24,1,23,10,13,OUI,OUI,2025-03-13 13:01:55+00:00,"48.848951441614, 2.3411329463124",Paris,75056,0.9583333333333334,13
16139,Suresnes - Muette à Neuilly,OUI,26,22,4,3,1,OUI,OUI,2025-03-13 12:56:31+00:00,"48.868570404348, 2.266000919044",Paris,75056,0.15384615384615385,13
23301,Les Blagis,OUI,24,12,12,10,2,OUI,OUI,2025-03-13 13:01:17+00:00,"48.785205, 2.302526",Sceaux,92071,0.5,13
6007,Bréa - Raspail,OUI,23,8,15,2,13,OUI,OUI,2025-03-13 12:57:32+00:00,"48.842738478258, 2.3297942217634",Paris,75056,0.6521739130434783,13
48012,Stalingrad - Henri Luisette,OUI,26,25,1,0,1,OUI,OUI,2025-03-13 13:00:24+00:00,"48.78363092456589, 2.366935946761926",Villejuif,94076,0.038461538461538464,13
42028,Verdun - Carnot,OUI,28,28,0,0,0,OUI,OUI,2025-03-13 12:59:31+00:00,"48.808439376064946, 2.373795211315155",Ivry-sur-Seine,94041,0.0,13
23303,Gare de Robinson,OUI,29,28,1,0,1,OUI,OUI,2025-03-13 12:54:21+00:00,"48.7799259211605, 2.281828634440899",Sceaux,92071,0.034482758620689655,13
16201,Porte Dauphine,OUI,60,38,22,4,18,OUI,OUI,2025-03-13 13:00:28+00:00,"48.871139344351, 2.2749781616017",Paris,75056,0.36666666666666664,13
20010,Sorbier - Gasnier-Guy,OUI,34,33,1,1,0,OUI,OUI,2025-03-13 13:00:46+00:00,"48.865217631011, 2.3936596512794",Paris,75056,0.029411764705882353,13
42019,Lampes,OUI,43,8,35,35,0,OUI,OUI,2025-03-13 13:01:55+00:00,"48.81152481985875, 2.4017931148409843",Ivry-sur-Seine,94041,0.813953488372093,13
42022,Gare RER - Maurice Grandcoing,OUI,37,4,33,31,2,OUI,OUI,2025-03-13 13:00:43+00:00,"48.813881, 2.392429",Ivry-sur-Seine,94041,0.8918918918918919,13
26012,Jardin Modèle - Pierre Boudou,OUI,15,12,3,2,1,OUI,OUI,2025-03-13 13:00:29+00:00,"48.914866710946, 2.3057010525935",Asnières-sur-Seine,92004,0.2,13
1015,Place André Malraux,OUI,16,3,13,7,6,OUI,OUI,2025-03-13 13:00:17+00:00,"48.863925158727, 2.3356226831675",Paris,75056,0.8125,13
20048,Bagnolet - Place Saint-Blaise,OUI,27,21,6,2,4,OUI,OUI,2025-03-13 13:01:03+00:00,"48.85973, 2.40334",Paris,75056,0.2222222222222222,13
1008,Les Halles - Saint-Eustache,OUI,32,3,29,12,17,OUI,OUI,2025-03-13 13:00:41+00:00,"48.86362695901683, 2.342623919248581",Paris,75056,0.90625,13
10166,Strasbourg - Saint-Denis,OUI,16,8,8,5,3,OUI,OUI,2025-03-13 13:01:52+00:00,"48.869601642433, 2.3542908579111",Paris,75056,0.5,13
9019,Victor Massé - Jean-Baptiste Pigalle,OUI,18,15,3,0,3,OUI,OUI,2025-03-13 12:58:46+00:00,"48.8811043724, 2.3366955667734",Paris,75056,0.16666666666666666,13
45004,République - Louis Loucheur,OUI,37,4,33,5,28,OUI,OUI,2025-03-13 13:00:38+00:00,"48.823549261189, 2.5101865455508",Champigny-sur-Marne,94017,0.8918918918918919,13
2102,Saint-Marc - Feydeau,OUI,36,3,33,15,18,OUI,OUI,2025-03-13 13:01:40+00:00,"48.870326843044, 2.3418715826353",Paris,75056,0.9166666666666666,13
13049,Vincent Auriol - Louise Weiss,OUI,22,6,16,10,6,OUI,OUI,2025-03-13 13:01:48+00:00,"48.834001935501, 2.3703888058662",Paris,75056,0.7272727272727273,13
17202,Mariotte - Batignolles,OUI,18,13,5,0,5,OUI,OUI,2025-03-13 13:00:32+00:00,"48.884571659595, 2.321469503475",Paris,75056,0.2777777777777778,13
12016,Saint-Mande - Picpus,OUI,33,31,2,1,1,OUI,OUI,2025-03-13 13:01:52+00:00,"48.845127728278, 2.4015686296482",Paris,75056,0.06060606060606061,13
12202,Charenton - Wattignies,OUI,40,37,3,2,1,OUI,OUI,2025-03-13 13:01:02+00:00,"48.836919119234, 2.3916775206425",Paris,75056,0.075,13
42210,Victor Hugo - Paul Eluard,OUI,31,1,30,25,5,OUI,OUI,2025-03-13 12:57:04+00:00,"48.819602554907, 2.4114319673051",Charenton-le-Pont,94018,0.967741935483871,13
23206,Béranger - Félix Faure,OUI,26,26,0,0,0,OUI,OUI,2025-03-13 12:44:24+00:00,"48.80404828621485, 2.2848263373723436",Châtillon,92020,0.0,13
34013,Blanqui - Docteur Bauer,OUI,20,7,13,9,4,OUI,OUI,2025-03-13 12:57:33+00:00,"48.907735489085, 2.3407192814591",Saint-Ouen-sur-Seine,93070,0.65,13
8040,Pierre Charron - Champs-Elysées,OUI,30,3,27,9,18,OUI,OUI,2025-03-13 13:01:44+00:00,"48.870103359864, 2.3043501377106",Paris,75056,0.9,13
44008,Youri Gagarine - Commune de Paris,OUI,32,16,16,10,6,OUI,OUI,2025-03-13 12:58:06+00:00,"48.782427463041, 2.3939734697342",Vitry-sur-Seine,94081,0.5,13
42030,Stéphanie Bouvard - Gambetta,OUI,30,21,9,8,1,OUI,OUI,2025-03-13 13:00:19+00:00,"48.814548138856, 2.4024386957288",Ivry-sur-Seine,94041,0.3,13
23104,Quai de Sèvres - Manufacture Nationale,OUI,27,12,15,6,9,OUI,OUI,2025-03-13 13:00:52+00:00,"48.828688, 2.22499",Sèvres,92072,0.5555555555555556,13
21011,Silly - Louis Blériot,OUI,23,3,20,6,14,OUI,OUI,2025-03-13 12:59:11+00:00,"48.83219045374266, 2.2340199351310734",Boulogne-Billancourt,92012,0.8695652173913043,13
24101,Place Charles de Gaulle,OUI,24,21,3,0,3,OUI,OUI,2025-03-13 13:00:00+00:00,"48.826073335699, 2.1894485725692",Ville-d'Avray,92077,0.125,13
20140,Paganini - Davout,OUI,21,20,1,1,0,OUI,OUI,2025-03-13 12:55:46+00:00,"48.85135, 2.412021",Paris,75056,0.047619047619047616,13
34011,Clef des Champs - Albert Dhalenne,OUI,25,8,17,11,6,OUI,OUI,2025-03-13 12:58:45+00:00,"48.914938, 2.330665",Saint-Ouen-sur-Seine,93070,0.68,13
15018,Dutot - Place Alleray,OUI,56,52,4,1,3,OUI,OUI,2025-03-13 13:01:38+00:00,"48.836826091766, 2.3071701095578",Paris,75056,0.07142857142857142,13
21329,Gare - Aristide Briand,OUI,28,9,19,17,2,OUI,OUI,2025-03-13 12:59:00+00:00,"48.821410564722, 2.2555950104387",Issy-les-Moulineaux,92040,0.6785714285714286,13
23202,Henri Barbusse - Gabriel Péri,OUI,17,15,2,0,2,OUI,OUI,2025-03-13 13:01:49+00:00,"48.801773795836, 2.2874166362216",Châtillon,92020,0.11764705882352941,13
21704,Place du Maréchal de Lattre de Tassigny,OUI,27,25,2,1,1,OUI,OUI,2025-03-13 13:00:34+00:00,"48.821707715257055, 2.2853431485432423",Vanves,92075,0.07407407407407407,13
6015,André Mazet - Saint-André des Arts,OUI,55,0,55,49,6,OUI,OUI,2025-03-13 13:00:51+00:00,"48.85375581057431, 2.3390958085656166",Paris,75056,1.0,13
19121,Belleville -  Pré Saint-Gervais,OUI,21,20,1,0,1,OUI,OUI,2025-03-13 12:58:04+00:00,"48.875565910073, 2.3930460959673",Paris,75056,0.047619047619047616,13
32605,Mairie,OUI,19,19,0,0,0,OUI,OUI,2025-03-13 12:56:35+00:00,"48.87914304162, 2.4163350908311",Les Lilas,93045,0.0,13
25007,Bons Raisins - Voltaire,OUI,24,23,1,1,0,OUI,OUI,2025-03-13 13:00:49+00:00,"48.87282451461399, 2.1947155570850896",Rueil-Malmaison,92063,0.041666666666666664,13
8202,Londres - Europe,OUI,27,18,9,2,7,OUI,OUI,2025-03-13 13:01:36+00:00,"48.878618556803, 2.3248164693922",Paris,75056,0.3333333333333333,13
19114,Manin - Secrétan,OUI,20,18,2,0,2,OUI,OUI,2025-03-13 13:01:51+00:00,"48.8791665, 2.3787959",Paris,75056,0.1,13
32011,Stade de France - Francis de Pressensé,OUI,43,2,41,5,36,OUI,OUI,2025-03-13 13:01:47+00:00,"48.919141953558, 2.3620655760169",Saint-Denis,93066,0.9534883720930233,13
12123,Château de Vincennes,OUI,49,42,7,4,3,OUI,OUI,2025-03-13 13:00:23+00:00,"48.84423193255657, 2.439209537709179",Paris,75056,0.14285714285714285,13
17020,Jouffroy d'Abbans - Malesherbes,OUI,26,9,17,1,16,OUI,OUI,2025-03-13 13:01:46+00:00,"48.8850134, 2.3070717",Paris,75056,0.6538461538461539,13
23041,Général Leclerc - Bièvre,OUI,24,18,6,3,3,OUI,OUI,2025-03-13 13:01:05+00:00,"48.782414428747316, 2.3166695237159733",Bourg-la-Reine,92014,0.25,13
10202,Bichat - Grange aux Belles,OUI,29,27,2,2,0,OUI,OUI,2025-03-13 13:00:29+00:00,"48.873688, 2.365015",Paris,75056,0.06896551724137931,13
24005,Edith Cavell - Volta,OUI,32,27,5,1,4,OUI,OUI,2025-03-13 13:01:52+00:00,"48.901616564286975, 2.269354350864887",Courbevoie,92026,0.15625,13
8018,Saint-Augustin,OUI,29,3,26,12,14,OUI,OUI,2025-03-13 12:56:59+00:00,"48.8762009747008, 2.319786250591278",Paris,75056,0.896551724137931,13
48006,Maxime Gorki - Paul Vaillant-Couturier,OUI,19,18,1,0,1,OUI,OUI,2025-03-13 13:01:16+00:00,"48.79673508795443, 2.3683342337608337",Villejuif,94076,0.05263157894736842,13
15012,Cambronne - Mademoiselle,OUI,66,64,2,2,0,OUI,OUI,2025-03-13 13:01:54+00:00,"48.843277330035214, 2.30230766886348",Paris,75056,0.030303030303030304,13
20142,Mûriers - Père Lachaise,OUI,19,15,4,2,2,OUI,OUI,2025-03-13 12:55:57+00:00,"48.864130509668044, 2.39164982067019",Paris,75056,0.21052631578947367,13
21022,Dôme - République,OUI,24,1,23,17,6,OUI,OUI,2025-03-13 12:58:33+00:00,"48.832681, 2.250257",Boulogne-Billancourt,92012,0.9583333333333334,13
48001,Chastenet de Géry - Marcel Paul,OUI,25,22,3,0,3,OUI,OUI,2025-03-13 12:59:33+00:00,"48.800123, 2.3567359",Villejuif,94076,0.12,13
15041,Franquet - Labrouste,OUI,37,37,0,0,0,OUI,OUI,2025-03-13 12:59:09+00:00,"48.83287705011431, 2.306762784719467",Paris,75056,0.0,13
51008,Martyrs de Châteaubriant - Jean Grandel,OUI,38,27,11,1,10,OUI,OUI,2025-03-13 12:57:44+00:00,"48.951432, 2.211214",Argenteuil,95018,0.2894736842105263,13
10003,Hauteville - Bonne Nouvelle,OUI,17,6,11,9,2,OUI,OUI,2025-03-13 12:58:09+00:00,"48.87077436024, 2.3496496368327",Paris,75056,0.6470588235294118,13
18135,Ney - Porte de Montmartre,OUI,23,19,4,2,2,OUI,OUI,2025-03-13 13:00:18+00:00,"48.897918, 2.3364872",Paris,75056,0.17391304347826086,13
41103,Place de la vache noire,OUI,23,21,2,0,2,OUI,OUI,2025-03-13 13:01:09+00:00,"48.81040517059777, 2.327060401439667",Arcueil,94003,0.08695652173913043,13
13015,Chevaleret - Louise Weiss,OUI,35,14,21,12,9,OUI,OUI,2025-03-13 13:00:34+00:00,"48.832586513351, 2.37121138812",Paris,75056,0.6,13
41602,Place Charles Digeon,OUI,31,30,1,0,1,OUI,OUI,2025-03-13 13:00:59+00:00,"48.84354203133597, 2.418427169322968",Saint-Mandé,94067,0.03225806451612903,13
21002,Place Denfert-Rochereau,OUI,19,10,9,3,6,OUI,OUI,2025-03-13 12:58:16+00:00,"48.843252536286684, 2.245987951755524",Boulogne-Billancourt,92012,0.47368421052631576,13
13028,Gouthière - Poterne des Peupliers,OUI,32,29,3,1,2,OUI,OUI,2025-03-13 12:58:53+00:00,"48.820507, 2.351342",Paris,75056,0.09375,13
13024,Bobillot - Tolbiac,OUI,33,30,3,0,3,OUI,OUI,2025-03-13 13:01:37+00:00,"48.8255961335041, 2.350204177200794",Paris,75056,0.09090909090909091,13
15069,Félix Faure - Convention,OUI,44,28,16,12,4,OUI,OUI,2025-03-13 13:01:50+00:00,"48.841249336041, 2.2883866008495",Paris,75056,0.36363636363636365,13
24004,Paix - Verdun,OUI,33,23,10,5,5,OUI,OUI,2025-03-13 12:58:26+00:00,"48.900504, 2.261173",Courbevoie,92026,0.30303030303030304,13
20012,Buzenval - Vignoles,OUI,17,17,0,0,0,OUI,OUI,2025-03-13 13:00:22+00:00,"48.853858171688, 2.4000040814281",Paris,75056,0.0,13
31104,Mairie de Rosny-sous-Bois,OUI,26,12,14,10,4,OUI,OUI,2025-03-13 12:59:44+00:00,"48.871256519012, 2.4865807592869",Rosny-sous-Bois,93064,0.5384615384615384,13
48002,LCL Campus - Place Oscar Niemeyer,OUI,37,36,1,0,1,OUI,OUI,2025-03-13 12:59:23+00:00,"48.805342480621576, 2.363983690738678",Villejuif,94076,0.02702702702702703,13
42024,Danielle Casanova - Ledru-Rollin,OUI,28,8,20,20,0,OUI,OUI,2025-03-13 12:55:52+00:00,"48.815783497876815, 2.383259721100331",Ivry-sur-Seine,94041,0.7142857142857143,13
41605,Général De Gaulle - Vivien,OUI,21,18,3,0,3,OUI,OUI,2025-03-13 12:59:07+00:00,"48.83607420090204, 2.4189166724681854",Saint-Mandé,94067,0.14285714285714285,13
5027,Gobelins - Port-Royal,OUI,36,7,29,27,2,OUI,OUI,2025-03-13 13:01:36+00:00,"48.837135900263, 2.3515201359987",Paris,75056,0.8055555555555556,13
35013,Guillaume Tell - Parc Henri Barbusse,OUI,20,19,1,0,1,OUI,OUI,2025-03-13 12:56:43+00:00,"48.88958925894009, 2.4198862910270695",Pantin,93055,0.05,13
15203,Porte de Versailles,OUI,27,13,14,5,9,OUI,OUI,2025-03-13 13:01:53+00:00,"48.832324016657, 2.2875617349045",Paris,75056,0.5185185185185185,13
12102,Bercy - Traversiére,OUI,30,1,29,25,4,OUI,OUI,2025-03-13 13:00:58+00:00,"48.846192642574, 2.3703800886869",Paris,75056,0.9666666666666667,13
13116,Place du Docteur Yersin,OUI,50,46,4,1,3,OUI,OUI,2025-03-13 13:01:29+00:00,"48.82010494991975, 2.3725583776831627",Paris,75056,0.08,13
15024,Suffren - La Motte-Piquet,OUI,23,11,12,8,4,OUI,OUI,2025-03-13 13:00:01+00:00,"48.850881230919, 2.3012199997902",Paris,75056,0.5217391304347826,13
11111,Léon Frot - Charonne,OUI,18,9,9,4,5,OUI,OUI,2025-03-13 13:00:23+00:00,"48.854963800335234, 2.387217085372007",Paris,75056,0.5,13
12119,Dom-Pérignon - Gravelle,OUI,45,27,18,16,2,OUI,OUI,2025-03-13 13:01:28+00:00,"48.825481574435, 2.409880310297",Paris,75056,0.4,13
18016,Francoeur - Caulaincourt,OUI,33,31,2,1,1,OUI,OUI,2025-03-13 12:57:23+00:00,"48.8899944409612, 2.342529706656933",Paris,75056,0.06060606060606061,13
13006,Duméril - Jeanne d'Arc,OUI,40,30,10,8,2,OUI,OUI,2025-03-13 13:01:45+00:00,"48.838151608087, 2.3571084495564",Paris,75056,0.25,13
19117,Euryale Dehaynin - Loire,OUI,29,26,3,0,3,OUI,OUI,2025-03-13 12:58:44+00:00,"48.886248917304805, 2.3774591088294987",Paris,75056,0.10344827586206896,13
43007,Hôtel de Ville de Vincennes,OUI,26,14,12,6,6,OUI,OUI,2025-03-13 13:00:18+00:00,"48.84827609706963, 2.4398955702781677",Vincennes,94080,0.46153846153846156,13
15053,Lecourbe - Convention,OUI,44,34,10,7,3,OUI,OUI,2025-03-13 13:01:24+00:00,"48.83923319241899, 2.2915197908878326",Paris,75056,0.22727272727272727,13
15050,Dominique Pado - Croix Nivert,OUI,22,18,4,2,2,OUI,OUI,2025-03-13 12:56:47+00:00,"48.83648798164934, 2.2897250577807426",Paris,75056,0.18181818181818182,13
20003,Pyrénées - Cours de Vincennes,OUI,19,15,4,1,3,OUI,OUI,2025-03-13 12:59:54+00:00,"48.847796779935, 2.4061721563339",Paris,75056,0.21052631578947367,13
16025,Jean de la Fontaine - Boulainvilliers,OUI,66,3,63,45,18,OUI,OUI,2025-03-13 13:01:28+00:00,"48.85264791461651, 2.2758664190769196",Paris,75056,0.9545454545454546,13
11022,Roquette - Auguste Laurent,OUI,16,4,12,5,7,OUI,OUI,2025-03-13 13:00:56+00:00,"48.858001906023354, 2.381797702650783",Paris,75056,0.75,13
13036,Olympiades,OUI,36,29,7,5,2,OUI,OUI,2025-03-13 13:01:49+00:00,"48.826764665199, 2.3650860786438",Paris,75056,0.19444444444444445,13
14004,Port Royal - Hôpital Cochin,OUI,22,16,6,2,4,OUI,OUI,2025-03-13 12:58:46+00:00,"48.838608030238, 2.3406994164846",Paris,75056,0.2727272727272727,13
43004,Montreuil - République,OUI,22,14,8,5,3,OUI,OUI,2025-03-13 13:01:08+00:00,"48.85026349463687, 2.4345204234123234",Vincennes,94080,0.36363636363636365,13
14027,Gergovie - Alésia,OUI,54,50,4,1,3,OUI,OUI,2025-03-13 13:00:04+00:00,"48.83088717455243, 2.318882101207347",Paris,75056,0.07407407407407407,13
17117,Pereire - Saussure,OUI,31,29,2,1,1,OUI,OUI,2025-03-13 12:57:22+00:00,"48.888229075478, 2.3101296275854",Paris,75056,0.06451612903225806,13
42303,Place Eustache Deschamps,OUI,20,14,6,5,1,OUI,OUI,2025-03-13 12:57:03+00:00,"48.793855, 2.336637",Cachan,94016,0.3,13
16017,Siam - La Pompe,OUI,16,13,3,0,3,OUI,OUI,2025-03-13 12:53:29+00:00,"48.861720329027264, 2.275346568555312",Paris,75056,0.1875,13
30003,Moscou - Edouard Vaillant,OUI,29,20,9,4,5,OUI,OUI,2025-03-13 13:00:12+00:00,"48.90755810177, 2.4689837335263",Bobigny,93008,0.3103448275862069,13
20013,Alexandre Dumas - Place de la Réunion,OUI,45,44,1,0,1,OUI,OUI,2025-03-13 12:57:35+00:00,"48.85533710742046, 2.3997703687646292",Paris,75056,0.022222222222222223,13
20020,Pyrénées - Charles Renouvier,OUI,29,27,2,0,2,OUI,OUI,2025-03-13 12:58:08+00:00,"48.86095933229224, 2.400421852042113",Paris,75056,0.06896551724137931,13
15045,Porte de la Plaine,OUI,35,35,0,0,0,OUI,OUI,2025-03-13 12:59:42+00:00,"48.82805169605981, 2.2924277186393742",Paris,75056,0.0,13
12008,Hector Malot - Daumesnil,OUI,52,0,52,48,4,OUI,OUI,2025-03-13 13:01:02+00:00,"48.84693552991762, 2.3770876228809357",Paris,75056,1.0,13
15027,Duhamel - André Gide,OUI,20,19,1,0,1,OUI,OUI,2025-03-13 12:54:18+00:00,"48.8365662244334, 2.312707121097412",Paris,75056,0.05,13
13120,Pierre Joseph Desault,OUI,18,8,10,9,1,OUI,OUI,2025-03-13 13:01:32+00:00,"48.82110230800372, 2.378775402903557",Paris,75056,0.5555555555555556,13
22701,Général Leclerc - République,OUI,28,10,18,16,2,OUI,OUI,2025-03-13 12:59:46+00:00,"48.915885074177, 2.2682306702811",Bois-Colombes,92009,0.6428571428571429,13
14009,Tombe Issoire - René Coty,OUI,35,33,2,1,1,OUI,OUI,2025-03-13 12:58:11+00:00,"48.830512876709, 2.3343613743782",Paris,75056,0.05714285714285714,13
22404,Pierre Brossolette - 12 Février 1934,OUI,23,18,5,4,1,OUI,OUI,2025-03-13 13:01:18+00:00,"48.8176962416867, 2.3076123744249344",Malakoff,92046,0.21739130434782608,13
18021,Marcadet - Ramey,OUI,21,20,1,0,1,OUI,OUI,2025-03-13 12:59:58+00:00,"48.890875, 2.3449019",Paris,75056,0.047619047619047616,13
20032,Square des Amandiers,OUI,26,26,0,0,0,OUI,OUI,2025-03-13 12:53:20+00:00,"48.86615630668046, 2.3891324177384377",Paris,75056,0.0,13
16116,George Sand - Jean de La Fontaine,OUI,28,22,6,3,3,OUI,OUI,2025-03-13 12:55:17+00:00,"48.84986918764119, 2.268257387525699",Paris,75056,0.21428571428571427,13
30004,Jean Jaurès - Place de la Libération,OUI,28,6,22,10,12,OUI,OUI,2025-03-13 12:56:12+00:00,"48.90617751921, 2.4391458057475",Bobigny,93008,0.7857142857142857,13
5033,Saint-Séverin - Saint-Michel,OUI,30,3,27,20,7,OUI,OUI,2025-03-13 13:00:49+00:00,"48.852731305488, 2.3440927639604",Paris,75056,0.9,13
14035,Maine - Jean Zay,OUI,47,40,7,2,5,OUI,OUI,2025-03-13 12:58:38+00:00,"48.837925263898, 2.3225428909063",Paris,75056,0.14893617021276595,13
25004,Marcel Pourtout - Édouard Manet,OUI,24,6,18,17,1,OUI,OUI,2025-03-13 12:59:28+00:00,"48.87555620763429, 2.1655967831611638",Rueil-Malmaison,92063,0.75,13
20110,Gambetta - Tourelles,OUI,20,19,1,0,1,OUI,OUI,2025-03-13 12:53:39+00:00,"48.875337902264, 2.4059921130538",Paris,75056,0.05,13
12022,Sahel - Général Michel Bizot,OUI,30,28,2,0,2,OUI,OUI,2025-03-13 13:01:07+00:00,"48.840872964793355, 2.4044444784522057",Paris,75056,0.06666666666666667,13
14005,René Coty - Place Denfert-Rochereau,OUI,36,31,5,0,5,OUI,OUI,2025-03-13 12:59:08+00:00,"48.833056477316, 2.3329411447048",Paris,75056,0.1388888888888889,13
21023,Ancienne Mairie - André Morizet,OUI,25,12,13,7,6,OUI,OUI,2025-03-13 12:59:59+00:00,"48.838311, 2.234077",Boulogne-Billancourt,92012,0.52,13
8007,Rome - Provence,OUI,29,6,23,20,3,OUI,OUI,2025-03-13 13:01:18+00:00,"48.874230055580306, 2.325570111724113",Paris,75056,0.7931034482758621,13
31105,Lavoisier - Missak Manouchian,OUI,13,10,3,1,2,OUI,OUI,2025-03-13 12:57:58+00:00,"48.86286468896063, 2.495676465332508",Rosny-sous-Bois,93064,0.23076923076923078,13
17006,Guy Môquet - Compoint,OUI,35,34,1,0,1,OUI,OUI,2025-03-13 12:57:22+00:00,"48.89213559044868, 2.32321947813034",Paris,75056,0.02857142857142857,13
42205,Place Aristide Briand,OUI,35,25,10,8,2,OUI,OUI,2025-03-13 13:00:12+00:00,"48.82189236575831, 2.413003742694855",Charenton-le-Pont,94018,0.2857142857142857,13
18101,Championnet.,OUI,20,16,4,1,3,OUI,OUI,2025-03-13 13:01:45+00:00,"48.8953643, 2.3498166",Paris,75056,0.2,13
17110,Legendre - Nollet,OUI,29,26,3,0,3,OUI,OUI,2025-03-13 13:01:44+00:00,"48.887742186754224, 2.320293079881375",Paris,75056,0.10344827586206896,13
6028,Quatre Vents - Carrefour de l'Odéon,OUI,37,1,36,21,15,OUI,OUI,2025-03-13 12:59:44+00:00,"48.851751374458864, 2.338161695134053",Paris,75056,0.972972972972973,13
31701,Mairie de Bagnolet,OUI,28,26,2,1,1,OUI,OUI,2025-03-13 13:00:57+00:00,"48.868421318555, 2.4179587885737",Bagnolet,93006,0.07142857142857142,13
21207,Verdier - République,OUI,29,25,4,1,3,OUI,OUI,2025-03-13 13:01:17+00:00,"48.815403766277, 2.31739372015",Montrouge,92049,0.13793103448275862,13
20014,Charonne - Alexandre Dumas,OUI,34,30,4,2,2,OUI,OUI,2025-03-13 12:50:56+00:00,"48.856077415056, 2.3948693275452",Paris,75056,0.11764705882352941,13
11016,Philippe-Auguste,OUI,48,45,3,1,2,OUI,OUI,2025-03-13 13:01:35+00:00,"48.851853488265, 2.3932945355773",Paris,75056,0.0625,13
8046,Marceau - Président Wilson,OUI,29,4,25,17,8,OUI,OUI,2025-03-13 13:00:38+00:00,"48.8652359, 2.3002513",Paris,75056,0.8620689655172413,13
15120,Colonel Pierre Avia,OUI,28,15,13,10,3,OUI,OUI,2025-03-13 12:59:54+00:00,"48.8296843300915, 2.275342586850291",Paris,75056,0.4642857142857143,13
21218,Gabriel Péri - Place de la Libération,OUI,17,16,1,1,0,OUI,OUI,2025-03-13 12:53:43+00:00,"48.819828421929, 2.3117361743705",Montrouge,92049,0.058823529411764705,13
24007,Jean-Baptiste Charcot - Sainte-Geneviève,OUI,21,19,2,1,1,OUI,OUI,2025-03-13 13:01:34+00:00,"48.90310883721567, 2.278892956674099",Courbevoie,92026,0.09523809523809523,13
20005,Reynaldo Hahn - Lagny,OUI,19,18,1,1,0,OUI,OUI,2025-03-13 12:57:13+00:00,"48.849266043601794, 2.412330328844772",Paris,75056,0.05263157894736842,13
11029,Ménilmontant - Oberkampf,OUI,39,30,9,1,8,OUI,OUI,2025-03-13 13:01:34+00:00,"48.866617658681, 2.3830134404158",Paris,75056,0.23076923076923078,13
12122,Bois de Vincennes - Polygone,OUI,51,49,2,0,2,OUI,OUI,2025-03-13 12:59:56+00:00,"48.83544491617421, 2.431421081436563",Paris,75056,0.0392156862745098,13
13055,M.- A. Lagroua Weill-Hallé -  F. Dolto,OUI,59,6,53,27,26,OUI,OUI,2025-03-13 13:01:14+00:00,"48.828595283857425, 2.380220606266108",Paris,75056,0.8983050847457628,13
16033,Marché d'Auteuil,OUI,31,1,30,27,3,OUI,OUI,2025-03-13 13:00:53+00:00,"48.84842761367387, 2.265253821160005",Paris,75056,0.967741935483871,13
22014,Victor Hugo - Bineau,OUI,24,17,7,5,2,OUI,OUI,2025-03-13 13:00:32+00:00,"48.88758225888669, 2.2783890366554265",Neuilly-sur-Seine,92051,0.2916666666666667,13
21205,Arthur Auger - Jean Jaurès,OUI,23,19,4,2,2,OUI,OUI,2025-03-13 12:57:54+00:00,"48.813736445585235, 2.3069277405738835",Montrouge,92049,0.17391304347826086,13
21027,Fief - République,OUI,25,1,24,21,3,OUI,OUI,2025-03-13 13:01:50+00:00,"48.83170888166024, 2.255771979689598",Boulogne-Billancourt,92012,0.96,13
16023,Passy - Place du Costa Rica,OUI,29,26,3,0,3,OUI,OUI,2025-03-13 13:01:45+00:00,"48.8584893, 2.2839655",Paris,75056,0.10344827586206896,13
15044,Dantzig - Lefebvre,OUI,33,32,1,1,0,OUI,OUI,2025-03-13 13:00:01+00:00,"48.83013921586756, 2.295934036374092",Paris,75056,0.030303030303030304,13
6004,Regard - Rennes,OUI,46,31,15,10,5,OUI,OUI,2025-03-13 13:01:40+00:00,"48.847385404956, 2.3268555477262",Paris,75056,0.32608695652173914,13
6005,Montparnasse -  Square Ozanam,OUI,49,26,23,12,11,OUI,OUI,2025-03-13 13:00:40+00:00,"48.843310567822, 2.3265242949128",Paris,75056,0.46938775510204084,13
15114,Pasteur - Cotentin,OUI,9,8,1,0,1,OUI,OUI,2025-03-13 13:01:17+00:00,"48.8389284, 2.316356",Paris,75056,0.1111111111111111,13
20011,Pyrénées - Dagorno,OUI,20,19,1,1,0,OUI,OUI,2025-03-13 13:01:26+00:00,"48.855425770695085, 2.4051643162965775",Paris,75056,0.05,13
19014,Lorraine - Jean Jaurès,OUI,18,13,5,2,3,OUI,OUI,2025-03-13 12:59:00+00:00,"48.8863865, 2.3825772",Paris,75056,0.2777777777777778,13
20106,Mairie du 20ème,OUI,27,25,2,0,2,OUI,OUI,2025-03-13 13:00:36+00:00,"48.865302324275, 2.3990669846535",Paris,75056,0.07407407407407407,13
15014,Volontaires - Vaugirard,OUI,33,33,0,0,0,OUI,OUI,2025-03-13 12:59:56+00:00,"48.84132050184004, 2.30808901725357",Paris,75056,0.0,13
21007,Rond-Point Rhin et Danube,OUI,53,41,12,6,6,OUI,OUI,2025-03-13 13:01:53+00:00,"48.840452820991764, 2.2280225157737736",Boulogne-Billancourt,92012,0.22641509433962265,13
11028,Guillaume Bertrand - République,OUI,38,24,14,4,10,OUI,OUI,2025-03-13 13:00:33+00:00,"48.863825174341, 2.380906377155",Paris,75056,0.3684210526315789,13
19007,Flandre - Ourcq,OUI,29,20,9,4,5,OUI,OUI,2025-03-13 13:01:24+00:00,"48.89260159189023, 2.3790915682911873",Paris,75056,0.3103448275862069,13
25002,Hôtel de Ville de Rueil-Malmaison,OUI,19,3,16,11,5,OUI,OUI,2025-03-13 13:01:51+00:00,"48.878194, 2.181724",Rueil-Malmaison,92063,0.8421052631578947,13
11018,Saint-Maur - République,OUI,36,33,3,2,1,OUI,OUI,2025-03-13 13:01:57+00:00,"48.864185861455, 2.3783174157143",Paris,75056,0.08333333333333333,13
15113,Arsonval - Falguière,OUI,24,20,4,1,3,OUI,OUI,2025-03-13 13:01:54+00:00,"48.84040040365445, 2.313117867297474",Paris,75056,0.16666666666666666,13
22007,Commandant Charcot - Bretteville,OUI,31,16,15,11,4,OUI,OUI,2025-03-13 13:01:52+00:00,"48.87530570765423, 2.2558460757136345",Neuilly-sur-Seine,92051,0.4838709677419355,13
16022,Jean Bologne - Passy,OUI,19,17,2,1,1,OUI,OUI,2025-03-13 12:58:27+00:00,"48.857566889784465, 2.280027395306772",Paris,75056,0.10526315789473684,13
13037,Ivry - Baudricourt,OUI,20,18,2,1,1,OUI,OUI,2025-03-13 12:56:33+00:00,"48.824695995415006, 2.363106073577468",Paris,75056,0.1,13
19001,Crimée - Ourcq,OUI,56,51,5,1,4,OUI,OUI,2025-03-13 12:57:47+00:00,"48.894104140316, 2.3729460884673",Paris,75056,0.08928571428571429,13
12017,Saint-Mandé - Docteur Arnold Netter,OUI,36,31,5,3,2,OUI,OUI,2025-03-13 13:01:41+00:00,"48.84462585769668, 2.404946386814118",Paris,75056,0.1388888888888889,13
14025,Jacquier - Didot,OUI,30,30,0,0,0,OUI,OUI,2025-03-13 12:52:27+00:00,"48.82953336292279, 2.318179272115231",Paris,75056,0.0,13
13023,Bobillot - Moulin des Prés,OUI,28,24,4,1,3,OUI,OUI,2025-03-13 12:59:06+00:00,"48.828657346203, 2.353020646317",Paris,75056,0.14285714285714285,13
6009,Guynemer - Jardin du Luxembourg,OUI,34,15,19,11,8,OUI,OUI,2025-03-13 13:01:32+00:00,"48.8466127, 2.3325478",Paris,75056,0.5588235294117647,13
12040,Porte de Charenton,OUI,66,56,10,5,5,OUI,OUI,2025-03-13 12:57:39+00:00,"48.831240105856, 2.3989107459784",Paris,75056,0.15151515151515152,13
42027,Verdun - Pierre et Marie Curie,OUI,26,24,2,0,2,OUI,OUI,2025-03-13 13:00:44+00:00,"48.812822398263286, 2.3707106709480286",Ivry-sur-Seine,94041,0.07692307692307693,13
6020,Place Saint-André des Arts,OUI,33,1,32,22,10,OUI,OUI,2025-03-13 13:01:23+00:00,"48.852886173881, 2.3426544293761",Paris,75056,0.9696969696969697,13
13008,Place d'Italie - Soeur Rosalie,OUI,51,47,4,0,4,OUI,OUI,2025-03-13 13:01:27+00:00,"48.831908520394, 2.3546943448098",Paris,75056,0.0784313725490196,13
21016,Point du Jour - Jean Jaurès,OUI,39,27,12,12,0,OUI,OUI,2025-03-13 13:00:05+00:00,"48.828753141436465, 2.245911467014621",Boulogne-Billancourt,92012,0.3076923076923077,13
21511,Marcel Monge - Marcel Dassault,OUI,46,9,37,31,6,OUI,OUI,2025-03-13 13:01:21+00:00,"48.86096384533371, 2.2246733296048142",Suresnes,92073,0.8043478260869565,13
5105,Geoffroy-Saint-Hilaire - Saint-Marcel,OUI,17,13,4,2,2,OUI,OUI,2025-03-13 13:01:45+00:00,"48.83907826424974, 2.356877340669728",Paris,75056,0.23529411764705882,13
21033,Sèvres - Maréchal Juin,OUI,18,8,10,10,0,OUI,OUI,2025-03-13 13:00:44+00:00,"48.8324305, 2.2292812",Boulogne-Billancourt,92012,0.5555555555555556,13
19123,Metz - Marne,OUI,29,24,5,2,3,OUI,OUI,2025-03-13 12:56:09+00:00,"48.891163, 2.3865705",Paris,75056,0.1724137931034483,13
8003,Galilée - Vernet,OUI,47,29,18,3,15,OUI,OUI,2025-03-13 13:01:44+00:00,"48.871715878697, 2.2985444962978",Paris,75056,0.3829787234042553,13
21107,Bertrand Sincholle - Henri Barbusse,OUI,18,12,6,3,3,OUI,OUI,2025-03-13 12:59:59+00:00,"48.89925982394349, 2.3042294383049016",Clichy,92024,0.3333333333333333,13
24010,Charles de Gaulle - Rue de l'Alma,OUI,27,4,23,6,17,OUI,OUI,2025-03-13 13:00:33+00:00,"48.896620592993, 2.252313240191",Courbevoie,92026,0.8518518518518519,13
12039,Général Michel Bizot - Claude Decaen,OUI,37,32,5,2,3,OUI,OUI,2025-03-13 12:54:28+00:00,"48.83481262982544, 2.400927788127704",Paris,75056,0.13513513513513514,13
25009,Place des Arts - Jean Mermoz,OUI,20,6,14,13,1,OUI,OUI,2025-03-13 13:00:56+00:00,"48.880391139734, 2.1832160452221",Rueil-Malmaison,92063,0.7,13
5031,Lacépède - Linné,OUI,49,11,38,28,10,OUI,OUI,2025-03-13 13:00:47+00:00,"48.8437035476636, 2.354651279747486",Paris,75056,0.7755102040816326,13
41101,Paul Doumer - Stalingrad,OUI,24,19,5,5,0,OUI,OUI,2025-03-13 12:59:36+00:00,"48.806518992199, 2.3368880152702",Arcueil,94003,0.20833333333333334,13
16104,Paul Valery - Victor Hugo,OUI,34,23,11,2,9,OUI,OUI,2025-03-13 12:59:41+00:00,"48.87137406080164, 2.2887128591537476",Paris,75056,0.3235294117647059,13
20030,Ménilmontant - Père Lachaise,OUI,40,33,7,0,7,OUI,OUI,2025-03-13 13:01:56+00:00,"48.863287291502, 2.3869940266013",Paris,75056,0.175,13
20033,Etienne Dolet - Place Maurice Chevalier,OUI,47,44,3,1,2,OUI,OUI,2025-03-13 12:54:02+00:00,"48.86798303359366, 2.3851405311143026",Paris,75056,0.06382978723404255,13
20035,Pyrénées - Ménilmontant,OUI,24,23,1,0,1,OUI,OUI,2025-03-13 13:01:27+00:00,"48.8693268535238, 2.395084574818611",Paris,75056,0.041666666666666664,13
30005,Convention - Campus de Bobigny,OUI,28,20,8,1,7,OUI,OUI,2025-03-13 12:57:55+00:00,"48.914920058264, 2.4172238067445",Bobigny,93008,0.2857142857142857,13
23106,Pavé des Gardes - Charles Vaillant,OUI,20,13,7,7,0,OUI,OUI,2025-03-13 12:57:43+00:00,"48.81168551728, 2.2111820107205",Sèvres,92072,0.35,13
21508,Georges Pompidou - Verdun,OUI,24,5,19,12,7,OUI,OUI,2025-03-13 12:58:24+00:00,"48.875481, 2.232443",Suresnes,92073,0.7916666666666666,13
17050,Batignolles - Abel Truchet,OUI,26,24,2,0,2,OUI,OUI,2025-03-13 12:56:18+00:00,"48.883103904582, 2.3238347490884",Paris,75056,0.07692307692307693,13
19045,Macdonald - Césaria Evora,OUI,66,45,21,9,12,OUI,OUI,2025-03-13 12:58:53+00:00,"48.89883, 2.37933",Paris,75056,0.3181818181818182,13
13013,Saint-Marcel - Hôpital,OUI,20,3,17,8,9,OUI,OUI,2025-03-13 13:00:36+00:00,"48.839504424583, 2.3609894170229",Paris,75056,0.85,13
9029,Saint-Lazare - Place d'Estienne d'Orves,OUI,39,2,37,22,15,OUI,OUI,2025-03-13 12:59:36+00:00,"48.8768345, 2.3329067",Paris,75056,0.9487179487179487,13
8044,Alfred de Vigny - Place du Général Brocard,OUI,32,22,10,2,8,OUI,OUI,2025-03-13 13:01:08+00:00,"48.87836138361425, 2.305254448220567",Paris,75056,0.3125,13
48011,Epi d'Or - Chevilly,OUI,20,18,2,0,2,OUI,OUI,2025-03-13 12:53:56+00:00,"48.781109786782, 2.3549050362061",Villejuif,94076,0.1,13
1201,Perrault - Place du Louvre,OUI,27,4,23,12,11,OUI,OUI,2025-03-13 13:01:52+00:00,"48.860273568996, 2.3412468419093",Paris,75056,0.8518518518518519,13
21510,Fontaine du Tertre - Calvaire,OUI,23,22,1,0,1,OUI,OUI,2025-03-13 12:53:57+00:00,"48.8702539, 2.2187778",Suresnes,92073,0.043478260869565216,13
7007,Musée d'Orsay,OUI,63,8,55,41,14,OUI,OUI,2025-03-13 13:01:40+00:00,"48.859726157909, 2.3258604481816",Paris,75056,0.873015873015873,13
51007,Résistance - Romain Rolland,OUI,28,26,2,0,2,OUI,OUI,2025-03-13 12:58:27+00:00,"48.950873482371, 2.2310190077797",Argenteuil,95018,0.07142857142857142,13
22209,Verdun - Henri Barbusse,OUI,23,21,2,1,1,OUI,OUI,2025-03-13 12:59:02+00:00,"48.802056061754, 2.3159965061736",Bagneux,92007,0.08695652173913043,13
17036,Place Tristan Bernard,OUI,28,25,3,1,2,OUI,OUI,2025-03-13 13:00:20+00:00,"48.8794936, 2.2915423",Paris,75056,0.10714285714285714,13
45005,Stalingrad - Général de Gaulle,OUI,26,12,14,4,10,OUI,OUI,2025-03-13 12:59:38+00:00,"48.823450589614, 2.4965062363218",Champigny-sur-Marne,94017,0.5384615384615384,13
11040,Temple - Jean-Pierre Timbaud,OUI,32,7,25,20,5,OUI,OUI,2025-03-13 13:01:18+00:00,"48.86446597201, 2.3660597205162",Paris,75056,0.78125,13
18045,Pierre Ginier - Clichy,OUI,16,14,2,0,2,OUI,OUI,2025-03-13 13:00:12+00:00,"48.8867667, 2.326228",Paris,75056,0.125,13
11038,Temple - Charlot,OUI,41,4,37,32,5,OUI,OUI,2025-03-13 13:00:23+00:00,"48.865709343796, 2.3652737250724",Paris,75056,0.9024390243902439,13
14110,Abbé Carton - Plantes,OUI,25,25,0,0,0,OUI,OUI,2025-03-13 13:00:27+00:00,"48.827673823166, 2.3209181427956",Paris,75056,0.0,13
21112,Claude Debussy - Marc Bloch,OUI,52,40,12,9,3,OUI,OUI,2025-03-13 13:00:32+00:00,"48.910388180512, 2.3117771744728",Clichy,92024,0.23076923076923078,13
10025,Jemmapes - Ecluses Saint-Martin,OUI,13,10,3,1,2,OUI,OUI,2025-03-13 12:58:52+00:00,"48.87748519186726, 2.3660067468881607",Paris,75056,0.23076923076923078,13
22703,Place Jean Mermoz,OUI,30,22,8,3,5,OUI,OUI,2025-03-13 13:01:05+00:00,"48.9220937, 2.2718348",Bois-Colombes,92009,0.26666666666666666,13
32305,Saint-Germain - Verdun,OUI,29,29,0,0,0,OUI,OUI,2025-03-13 12:57:47+00:00,"48.882877330093, 2.4331868384644",Romainville,93063,0.0,13
26010,Louis Armand - Bernard Palissy,OUI,17,7,10,8,2,OUI,OUI,2025-03-13 12:56:10+00:00,"48.916974, 2.313384",Asnières-sur-Seine,92004,0.5882352941176471,13
22507,Châteaudun - Place de la Liberté,OUI,25,22,3,2,1,OUI,OUI,2025-03-13 12:54:16+00:00,"48.90970830301211, 2.2454486480600626",La Garenne-Colombes,92035,0.12,13
16140,Hippodrome de Longchamp,OUI,24,4,20,15,5,OUI,OUI,2025-03-13 13:00:19+00:00,"48.86413226532, 2.239905372262",Paris,75056,0.8333333333333334,13
22602,Place Henri Dunant - Gare RER,OUI,30,29,1,0,1,OUI,OUI,2025-03-13 12:57:52+00:00,"48.788093281931, 2.2909234046643",Fontenay-aux-Roses,92032,0.03333333333333333,13
3201,Payenne - Square George Caïn,OUI,22,2,20,17,3,OUI,OUI,2025-03-13 13:00:29+00:00,"48.8578329, 2.3622643",Paris,75056,0.9090909090909091,13
12106,Gare de Lyon - Roland Barthes,OUI,68,7,61,59,2,OUI,OUI,2025-03-13 13:00:39+00:00,"48.84395729494058, 2.3790882155299187",Paris,75056,0.8970588235294118,13
15032,Félix Faure - Lourmel,OUI,55,35,20,19,1,OUI,OUI,2025-03-13 13:01:24+00:00,"48.83868901709515, 2.2818081825971603",Paris,75056,0.36363636363636365,13
23205,Parc des Pierrettes,OUI,22,21,1,0,1,OUI,OUI,2025-03-13 12:58:33+00:00,"48.7973062, 2.2909969",Châtillon,92020,0.045454545454545456,13
20037,Gambetta - Saint Fargeau,OUI,24,23,1,0,1,OUI,OUI,2025-03-13 12:56:57+00:00,"48.871244610447015, 2.4039056897163396",Paris,75056,0.041666666666666664,13
25010,Maréchal Leclerc de Hauteclocque - Marché Buzenval,OUI,30,26,4,4,0,OUI,OUI,2025-03-13 12:54:38+00:00,"48.858446, 2.192077",Rueil-Malmaison,92063,0.13333333333333333,13
22302,Gare RER - Général de Gaulle,OUI,38,17,21,14,7,OUI,OUI,2025-03-13 13:00:00+00:00,"48.933548439566, 2.3064726536317",Gennevilliers,92036,0.5526315789473685,13
12165,Champs de Manoeuvre - Cartoucherie,OUI,32,7,25,13,12,OUI,OUI,2025-03-13 13:00:09+00:00,"48.835261, 2.447974",Paris,75056,0.78125,13
13053,Chevaleret - Tolbiac,OUI,21,7,14,11,3,OUI,OUI,2025-03-13 12:59:24+00:00,"48.82941, 2.375934",Paris,75056,0.6666666666666666,13
12001,Bastille - Biscornet,OUI,59,0,59,46,13,OUI,OUI,2025-03-13 13:01:11+00:00,"48.851355779579, 2.369220033288",Paris,75056,1.0,13
41212,Nungesser - Santé,OUI,22,20,2,0,2,OUI,OUI,2025-03-13 12:54:11+00:00,"48.852335, 2.448967",Fontenay-sous-Bois,94033,0.09090909090909091,13
22018,Charles de Gaulle - Les Sablons,OUI,35,15,20,10,10,OUI,OUI,2025-03-13 13:00:17+00:00,"48.880987514929, 2.2715748726513",Neuilly-sur-Seine,92051,0.5714285714285714,13
34009,Dora Maar - Nadia Guendouz,OUI,28,3,25,22,3,OUI,OUI,2025-03-13 13:01:09+00:00,"48.905452421305, 2.3220406472683",Saint-Ouen-sur-Seine,93070,0.8928571428571429,13
9035,Gare Saint-Lazare - Place de Budapest,OUI,43,18,25,15,10,OUI,OUI,2025-03-13 12:58:40+00:00,"48.877753, 2.327339",Paris,75056,0.5813953488372093,13
41304,Port - Maurice Chevalier,OUI,30,4,26,23,3,OUI,OUI,2025-03-13 13:00:16+00:00,"48.832474421632, 2.490257616467",Nogent-sur-Marne,94052,0.8666666666666667,13
17126,Hélène et François Missoffe - Emile Borel,OUI,28,11,17,16,1,OUI,OUI,2025-03-13 12:58:36+00:00,"48.89990653843488, 2.321543991674844",Paris,75056,0.6071428571428571,13
10151,Gare du Nord - Faubourg Saint-Denis,OUI,28,17,11,2,9,OUI,OUI,2025-03-13 13:01:51+00:00,"48.879612765504, 2.3568402975798",Paris,75056,0.39285714285714285,13
34005,Adrien Lesesne - Docteur Bauer,OUI,29,24,5,1,4,OUI,OUI,2025-03-13 12:58:54+00:00,"48.90263867304635, 2.348248063431511",Saint-Ouen-sur-Seine,93070,0.1724137931034483,13
8031,Jean Mermoz - Champs-Elysées,OUI,44,6,38,14,24,OUI,OUI,2025-03-13 13:01:25+00:00,"48.869689856852, 2.3107324540615",Paris,75056,0.8636363636363636,13
34008,Garibaldi - Gabriel Péri,OUI,28,18,10,4,6,OUI,OUI,2025-03-13 13:00:17+00:00,"48.905741911394, 2.3316044208059",Saint-Ouen-sur-Seine,93070,0.35714285714285715,13
26011,Ménil - Argenteuil,OUI,18,11,7,3,4,OUI,OUI,2025-03-13 12:56:37+00:00,"48.925901818305, 2.2741496502338",Asnières-sur-Seine,92004,0.3888888888888889,13
31301,Gare RER,OUI,25,16,9,0,9,OUI,OUI,2025-03-13 12:59:52+00:00,"48.896280181078, 2.4581568985227",Noisy-le-Sec,93053,0.36,13
22208,Stalingrad - Barbara,OUI,19,16,3,0,3,OUI,OUI,2025-03-13 12:57:42+00:00,"48.809223658808, 2.3175904558822",Bagneux,92007,0.15789473684210525,13
31303,Simone Signoret - Paris,OUI,26,18,8,4,4,OUI,OUI,2025-03-13 12:57:40+00:00,"48.903600624712865, 2.465406596265139",Noisy-le-Sec,93053,0.3076923076923077,13
35021,Cartier Bresson - Denis Papin,OUI,31,28,3,0,3,OUI,OUI,2025-03-13 12:59:38+00:00,"48.902616, 2.397814",Pantin,93055,0.0967741935483871,13
5107,Pontoise - La Tournelle,OUI,22,2,20,15,5,OUI,OUI,2025-03-13 13:01:57+00:00,"48.850458009188, 2.3524542754922",Paris,75056,0.9090909090909091,13
18018,Carpeaux - Place Jacques Froment,OUI,17,17,0,0,0,OUI,OUI,2025-03-13 13:01:28+00:00,"48.8906542, 2.3309428",Paris,75056,0.0,13
10026,Gare de l'Est - Chateau Landon,OUI,54,48,6,2,4,OUI,OUI,2025-03-13 13:01:22+00:00,"48.879305, 2.362424",Paris,75056,0.1111111111111111,13
22305,Jean Jaurès - Place du Dr Roux,OUI,34,26,8,7,1,OUI,OUI,2025-03-13 12:57:26+00:00,"48.927567032796, 2.2947337017374",Gennevilliers,92036,0.23529411764705882,13
17010,Jonquière - Docteur Paul Brousse,OUI,37,34,3,3,0,OUI,OUI,2025-03-13 13:01:21+00:00,"48.894799816683985, 2.318705212173216",Paris,75056,0.08108108108108109,13
21954,Val-Fleury,OUI,23,16,7,3,4,OUI,OUI,2025-03-13 12:58:20+00:00,"48.807671407991, 2.2407217696309",Meudon,92048,0.30434782608695654,13
18026,Ruisseau - Ordener,OUI,33,33,0,0,0,OUI,OUI,2025-03-13 12:56:13+00:00,"48.89299462568024, 2.340144887566567",Paris,75056,0.0,13
11201,Faubourg St-Antoine - Place de la Nation,OUI,15,11,4,2,2,OUI,OUI,2025-03-13 12:55:13+00:00,"48.8487726, 2.393606",Paris,75056,0.26666666666666666,13
18024,Clignancourt - Ordener,OUI,35,33,2,1,1,OUI,OUI,2025-03-13 12:57:08+00:00,"48.891457726153774, 2.348636478060487",Paris,75056,0.05714285714285714,13
32023,Guy Môquet - Jean Moulin,OUI,27,6,21,11,10,OUI,OUI,2025-03-13 12:58:14+00:00,"48.940931521020836, 2.363948999931771",Saint-Denis,93066,0.7777777777777778,13
16006,Lauriston - Copernic,OUI,19,15,4,0,4,OUI,OUI,2025-03-13 13:01:25+00:00,"48.86926, 2.289918",Paris,75056,0.21052631578947367,13
23201,Avenir,OUI,41,35,6,5,1,OUI,OUI,2025-03-13 12:58:34+00:00,"48.8103438, 2.3003776",Châtillon,92020,0.14634146341463414,13
8008,Joseph Sansboeuf - Saint Lazare,OUI,31,17,14,6,8,OUI,OUI,2025-03-13 13:01:13+00:00,"48.875315630653, 2.3229019716382",Paris,75056,0.45161290322580644,13
21320,Président Roosevelt - Rouget de Lisle,OUI,40,0,40,24,16,OUI,OUI,2025-03-13 12:57:01+00:00,"48.83047518749, 2.2616135525345",Issy-les-Moulineaux,92040,1.0,13
31201,Suzanne Masson,OUI,33,9,24,13,11,OUI,OUI,2025-03-13 13:01:12+00:00,"48.923306888013, 2.3847292397611",La Courneuve,93027,0.7272727272727273,13
11001,Richard Lenoir - Place de la Bastille,OUI,46,6,40,28,12,OUI,OUI,2025-03-13 13:00:28+00:00,"48.8538327, 2.3697222",Paris,75056,0.8695652173913043,13
15013,Volontaires - Lecourbe,OUI,29,24,5,4,1,OUI,OUI,2025-03-13 13:01:48+00:00,"48.84351378799, 2.3065522313118",Paris,75056,0.1724137931034483,13
21327,Jean Bouin - Gouverneur Général Eboué,OUI,31,8,23,23,0,OUI,OUI,2025-03-13 12:59:30+00:00,"48.824792734266, 2.2651904328524",Issy-les-Moulineaux,92040,0.7419354838709677,13
23203,Division Leclerc - Kléber,OUI,25,19,6,2,4,OUI,OUI,2025-03-13 13:00:27+00:00,"48.798666226364, 2.2833752789972",Châtillon,92020,0.24,13
15062,Convention - Lourmel,OUI,35,19,16,15,1,OUI,OUI,2025-03-13 12:59:17+00:00,"48.842055041656, 2.2859910875559",Paris,75056,0.45714285714285713,13
17127,Porte de Clichy - Place des Nations Unies,OUI,37,1,36,33,3,OUI,OUI,2025-03-13 13:00:46+00:00,"48.896737263309504, 2.310542999196392",Paris,75056,0.972972972972973,13
13202,Place Farhat Hached,OUI,28,3,25,10,15,OUI,OUI,2025-03-13 13:01:16+00:00,"48.825487045602, 2.3816306985827",Paris,75056,0.8928571428571429,13
26008,Henri Barbusse - Bourguignons,OUI,32,26,6,3,3,OUI,OUI,2025-03-13 12:53:18+00:00,"48.91301722799713, 2.2734212270774417",Asnières-sur-Seine,92004,0.1875,13
8038,François 1er - Montaigne,OUI,51,13,38,24,14,OUI,OUI,2025-03-13 13:00:12+00:00,"48.866887649978, 2.3066755757207",Paris,75056,0.7450980392156863,13
26009,Marceau Delorme - Pierre Brossolette,OUI,26,19,7,1,6,OUI,OUI,2025-03-13 12:56:35+00:00,"48.91206062860357, 2.295897423568745",Asnières-sur-Seine,92004,0.2692307692307692,13
21501,Pont de Suresnes,OUI,15,11,4,2,2,OUI,OUI,2025-03-13 12:59:20+00:00,"48.867415092322, 2.2258946679617",Suresnes,92073,0.26666666666666666,13
34012,Bateliers - Quai de Seine,OUI,21,13,8,4,4,OUI,OUI,2025-03-13 12:56:14+00:00,"48.915817585516, 2.3239533298594",Saint-Ouen-sur-Seine,93070,0.38095238095238093,13
19204,Rampal - Belleville,OUI,19,19,0,0,0,OUI,OUI,2025-03-13 13:00:33+00:00,"48.873114661405, 2.3798409114805",Paris,75056,0.0,13
23204,Roland Garros - Jean Bouin,OUI,28,27,1,0,1,OUI,OUI,2025-03-13 12:57:40+00:00,"48.809460857173, 2.2853198638301",Châtillon,92020,0.03571428571428571,13
18042,Place Pigalle,OUI,20,15,5,1,4,OUI,OUI,2025-03-13 13:01:38+00:00,"48.8827555, 2.3361566",Paris,75056,0.25,13
21514,Place de la Paix - Abbé Saint-Pierre,OUI,24,21,3,2,1,OUI,OUI,2025-03-13 12:58:05+00:00,"48.86462724459225, 2.2047570338469806",Suresnes,92073,0.125,13
11037,Faubourg Du Temple - Republique,OUI,38,9,29,28,1,OUI,OUI,2025-03-13 13:01:42+00:00,"48.867872484749, 2.3648982158072",Paris,75056,0.7631578947368421,13
18023,Ordener - Poissonniers,OUI,35,35,0,0,0,OUI,OUI,2025-03-13 12:57:20+00:00,"48.891213890844654, 2.351288666219873",Paris,75056,0.0,13
18041,Rochechouart - Martyrs,OUI,17,16,1,0,1,OUI,OUI,2025-03-13 12:58:29+00:00,"48.882193779572, 2.3405495658517",Paris,75056,0.058823529411764705,13
19018,Cité de la Musique,OUI,52,32,20,11,9,OUI,OUI,2025-03-13 13:00:09+00:00,"48.888796556487, 2.3925811931922",Paris,75056,0.38461538461538464,13
11014,Place de la Nation - Taillebourg,OUI,46,43,3,2,1,OUI,OUI,2025-03-13 13:00:09+00:00,"48.8488408, 2.3973043",Paris,75056,0.06521739130434782,13
13205,Choisy - Pointe d'Ivry,OUI,24,20,4,3,1,OUI,OUI,2025-03-13 13:00:30+00:00,"48.822154170359, 2.3633708034878",Paris,75056,0.16666666666666666,13
35002,Jean Jaurès - Presles,OUI,31,27,4,2,2,OUI,OUI,2025-03-13 13:01:19+00:00,"48.907134414988, 2.3960057280531",Pantin,93055,0.12903225806451613,13
31202,Gabriel Péri - Jules Ferry,OUI,27,8,19,16,3,OUI,OUI,2025-03-13 13:01:19+00:00,"48.926182814311, 2.3912295762525",La Courneuve,93027,0.7037037037037037,13
11020,Belfort - Voltaire,OUI,39,36,3,1,2,OUI,OUI,2025-03-13 12:58:07+00:00,"48.8563358, 2.3829901",Paris,75056,0.07692307692307693,13
7201,Place De Fontenoy - Saxe,OUI,18,1,17,11,6,OUI,OUI,2025-03-13 13:01:26+00:00,"48.850270554523, 2.3069813815839",Paris,75056,0.9444444444444444,13
8039,Colisée - Champs-Elysées,OUI,15,1,14,3,11,OUI,OUI,2025-03-13 12:55:11+00:00,"48.870475399387, 2.3076190799475",Paris,75056,0.9333333333333333,13
18044,Clichy - Douai,OUI,32,30,2,1,1,OUI,OUI,2025-03-13 13:01:15+00:00,"48.883687771522, 2.328063700029",Paris,75056,0.0625,13
13204,Tolbiac - Boussingault,OUI,41,37,4,2,2,OUI,OUI,2025-03-13 12:57:48+00:00,"48.826177754027, 2.3420378552202",Paris,75056,0.0975609756097561,13
16103,Traktir - Foch,OUI,20,4,16,4,12,OUI,OUI,2025-03-13 13:01:00+00:00,"48.872755334614, 2.2915497802487",Paris,75056,0.8,13
13035,Choisy - Tolbiac,OUI,20,18,2,0,2,OUI,OUI,2025-03-13 12:53:32+00:00,"48.82591155587, 2.3602393269539",Paris,75056,0.1,13
21213,Vanne - Général de Gaulle,OUI,24,21,3,1,2,OUI,OUI,2025-03-13 13:00:48+00:00,"48.815007, 2.328318",Montrouge,92049,0.125,13
10114,Granges aux Belles - Hôpital Saint-Louis,OUI,59,56,3,1,2,OUI,OUI,2025-03-13 13:00:57+00:00,"48.874794994841, 2.366669436985",Paris,75056,0.05084745762711865,13
3004,Place de la République - Temple,OUI,17,3,14,9,5,OUI,OUI,2025-03-13 13:00:26+00:00,"48.867211201859, 2.3635464370545",Paris,75056,0.8235294117647058,13
18134,Ney - Porte de Clignancourt,OUI,24,23,1,1,0,OUI,OUI,2025-03-13 12:55:31+00:00,"48.8978867, 2.3458001",Paris,75056,0.041666666666666664,13
11046,Place de la République - Voltaire,OUI,16,2,14,13,1,OUI,OUI,2025-03-13 13:00:55+00:00,"48.866830968942, 2.3654810339212",Paris,75056,0.875,13
13203,Square de Choisy - Eastman,OUI,23,13,10,1,9,OUI,OUI,2025-03-13 12:57:30+00:00,"48.828543456283, 2.3583075090494",Paris,75056,0.43478260869565216,13
11009,Boulets - Voltaire,OUI,24,19,5,1,4,OUI,OUI,2025-03-13 12:59:53+00:00,"48.85218705621, 2.3890301585197",Paris,75056,0.20833333333333334,13
47007,Liberté - Vert-de-Maisons,OUI,20,3,17,15,2,OUI,OUI,2025-03-13 12:53:43+00:00,"48.790147809608, 2.4328628182411",Maisons-Alfort,94046,0.85,13
35001,Jean Jaurès - Ouvrières Pivéreuses,OUI,21,20,1,0,1,OUI,OUI,2025-03-13 12:59:50+00:00,"48.910423437526, 2.3995766043663",Pantin,93055,0.047619047619047616,13
13051,Halle Freyssinet - Parvis Alan Turing,OUI,23,6,17,8,9,OUI,OUI,2025-03-13 13:01:48+00:00,"48.832846814471, 2.3711421713233",Paris,75056,0.7391304347826086,13
11011,Richard Lenoir - Voltaire,OUI,25,16,9,7,2,OUI,OUI,2025-03-13 13:01:52+00:00,"48.86164273878, 2.3727491497993",Paris,75056,0.36,13
5201,Saint-Jacques - Soufflot,OUI,16,2,14,1,13,OUI,OUI,2025-03-13 12:58:10+00:00,"48.846280383395, 2.3430785379567",Paris,75056,0.875,13
11012,Montreuil - Voltaire,OUI,32,31,1,0,1,OUI,OUI,2025-03-13 12:56:17+00:00,"48.850507011842, 2.3930755582745",Paris,75056,0.03125,13
11102,Alexandre Dumas - Voltaire,OUI,58,53,5,2,3,OUI,OUI,2025-03-13 13:01:44+00:00,"48.852888670365, 2.3891476408096",Paris,75056,0.08620689655172414,13
15105,Fédération - Suffren,OUI,24,18,6,5,1,OUI,OUI,2025-03-13 13:01:27+00:00,"48.852828153442, 2.2978776320815",Paris,75056,0.25,13
12157,Fabre d'Eglantine - Place de la Nation,OUI,66,58,8,0,8,OUI,OUI,2025-03-13 13:01:37+00:00,"48.8471116, 2.3956204",Paris,75056,0.12121212121212122,13
7023,Bourdonnais - Tour Eiffel,OUI,56,6,50,38,12,OUI,OUI,2025-03-13 13:01:49+00:00,"48.860897797941, 2.295599598447",Paris,75056,0.8928571428571429,13
15060,Place de la Montagne du Goulet,OUI,20,7,13,12,1,OUI,OUI,2025-03-13 13:00:50+00:00,"48.8443415, 2.2773844",Paris,75056,0.65,13
9025,Taitbout - Châteaudun,OUI,53,2,51,45,6,OUI,OUI,2025-03-13 13:00:42+00:00,"48.876383969379, 2.3353566779335",Paris,75056,0.9622641509433962,13
7111,Ecole Militaire - Place Joffre,OUI,25,15,10,8,2,OUI,OUI,2025-03-13 13:00:01+00:00,"48.852060203583, 2.3017993569374",Paris,75056,0.4,13
7025,Octave Gréard - Tour Eiffel,OUI,32,5,27,15,12,OUI,OUI,2025-03-13 13:01:39+00:00,"48.856502977696, 2.2931787543289",Paris,75056,0.84375,13
18205,Mauroy - Cheminots,OUI,30,22,8,3,5,OUI,OUI,2025-03-13 12:57:48+00:00,"48.897715198403, 2.357895075822",Paris,75056,0.26666666666666666,13
4108,Quai de Béthune - Pont de la Tournelle,OUI,25,11,14,11,3,OUI,OUI,2025-03-13 13:01:05+00:00,"48.85097433194, 2.3563072085381",Paris,75056,0.56,13
8057,Hoche - Tilsitt,OUI,31,22,9,2,7,OUI,OUI,2025-03-13 13:01:08+00:00,"48.874836457837, 2.2971323132515",Paris,75056,0.2903225806451613,13
12105,Bercy - Villot,OUI,36,12,24,20,4,OUI,OUI,2025-03-13 13:01:56+00:00,"48.841795009027, 2.3767850184816",Paris,75056,0.6666666666666666,13
7109,Place Joffre - Frédéric le Play,OUI,37,19,18,11,7,OUI,OUI,2025-03-13 13:00:25+00:00,"48.853754486938, 2.3044242337346",Paris,75056,0.4864864864864865,13
40010,Haut du Mont-Mesly,OUI,21,17,4,3,1,OUI,OUI,2025-03-13 12:55:15+00:00,"48.780191921646, 2.4685737495183",Créteil,94028,0.19047619047619047,13
40007,Préfecture de Créteil,OUI,27,7,20,14,6,OUI,OUI,2025-03-13 13:01:16+00:00,"48.783680285918, 2.4544713672215",Créteil,94028,0.7407407407407407,13
40012,Stade de la Habette,OUI,16,14,2,0,2,OUI,OUI,2025-03-13 12:56:23+00:00,"48.774397033806, 2.4668785263921",Créteil,94028,0.125,13
12107,Diderot - Pierre Bourdan,OUI,21,5,16,8,8,OUI,OUI,2025-03-13 13:00:16+00:00,"48.847648620797, 2.3902582749724",Paris,75056,0.7619047619047619,13
40013,Hôtel de Ville de Créteil,OUI,36,16,20,14,6,OUI,OUI,2025-03-13 12:59:56+00:00,"48.77699496201, 2.4552552404284",Créteil,94028,0.5555555555555556,13
23011,Bineau - Louise Michel,OUI,26,10,16,5,11,OUI,OUI,2025-03-13 12:55:20+00:00,"48.88666162207, 2.2843274474144",Levallois-Perret,92044,0.6153846153846154,13
40014,Créteil Pointe du Lac,OUI,28,2,26,9,17,OUI,OUI,2025-03-13 13:00:09+00:00,"48.769807356177, 2.4623027310281",Créteil,94028,0.9285714285714286,13
40008,Créteil Pompadour,OUI,44,15,29,11,18,OUI,OUI,2025-03-13 12:58:51+00:00,"48.773011623355, 2.435166164893",Créteil,94028,0.6590909090909091,13
16005,Raymond Poincaré - Place Victor Hugo,OUI,22,14,8,1,7,OUI,OUI,2025-03-13 12:58:28+00:00,"48.87030612437, 2.2850745414202",Paris,75056,0.36363636363636365,13
14021,Place de la Porte de Châtillon,OUI,59,58,1,1,0,OUI,OUI,2025-03-13 12:59:17+00:00,"48.8242469, 2.3186306",Paris,75056,0.01694915254237288,13
12201,Dugommier,OUI,53,45,8,4,4,OUI,OUI,2025-03-13 12:54:41+00:00,"48.838811048815, 2.3896577954292",Paris,75056,0.1509433962264151,13
13106,Bobillot - Paulin Mery,OUI,21,17,4,0,4,OUI,OUI,2025-03-13 13:00:42+00:00,"48.829899841747, 2.3543356766749",Paris,75056,0.19047619047619047,13
26005,Hôtel de Ville d'Asnières sur Seine,OUI,25,20,5,2,3,OUI,OUI,2025-03-13 12:55:49+00:00,"48.90999330025577, 2.288238108158112",Asnières-sur-Seine,92004,0.2,13
40015,Iles de Loisirs de Créteil,OUI,24,5,19,10,9,OUI,OUI,2025-03-13 13:01:04+00:00,"48.780258200618, 2.4455094301232",Créteil,94028,0.7916666666666666,13
40003,Centre Hospitalier Intercommunal de Créteil,OUI,17,17,0,0,0,OUI,OUI,2025-03-13 13:00:13+00:00,"48.797078298909, 2.463801423807",Créteil,94028,0.0,13
23801,Place de la Gare,OUI,20,17,3,1,2,OUI,OUI,2025-03-13 12:54:55+00:00,"48.838513582184, 2.1866139007512",Garches,92033,0.15,13
10031,Louis Blanc - Aqueduc,OUI,36,32,4,3,1,OUI,OUI,2025-03-13 13:01:36+00:00,"48.882030182599, 2.363561578095",Paris,75056,0.1111111111111111,13
40004,Créteil Village,OUI,25,4,21,7,14,OUI,OUI,2025-03-13 13:01:28+00:00,"48.79122395576, 2.4642198533952",Créteil,94028,0.84,13
32004,Wilson - Landy,OUI,38,12,26,17,9,OUI,OUI,2025-03-13 13:01:22+00:00,"48.91516726221354, 2.357633225619793",Saint-Denis,93066,0.6842105263157895,13
23703,Gare de Chaville Rive Gauche,OUI,18,16,2,1,1,OUI,OUI,2025-03-13 12:57:44+00:00,"48.805160304345, 2.188277207315",Chaville,92022,0.1111111111111111,13
10013,Alibert - Jemmapes,OUI,57,44,13,6,7,OUI,OUI,2025-03-13 12:57:10+00:00,"48.871044051984, 2.3661044619878",Paris,75056,0.22807017543859648,13
1022,Danielle Casanova - Place Vendôme,OUI,37,0,37,22,15,OUI,OUI,2025-03-13 12:59:40+00:00,"48.868266498223, 2.3304839059711",Paris,75056,1.0,13
51005,Yves Farges - Route d'Enghien,OUI,33,16,17,6,11,OUI,OUI,2025-03-13 12:59:05+00:00,"48.95756799268, 2.2834496977978",Argenteuil,95018,0.5151515151515151,13
41301,Bois de Vincennes - Gare,OUI,50,47,3,2,1,OUI,OUI,2025-03-13 12:59:10+00:00,"48.836022242887, 2.470833995083",Nogent-sur-Marne,94052,0.06,13
34014,Michelet - Dr Bauer,OUI,29,25,4,0,4,OUI,OUI,2025-03-13 12:58:56+00:00,"48.906125424194, 2.3440374449846",Saint-Ouen-sur-Seine,93070,0.13793103448275862,13
20137,Borrégo - Gambetta,OUI,25,24,1,0,1,OUI,OUI,2025-03-13 12:57:39+00:00,"48.87330497045532, 2.4014145880937576",Paris,75056,0.04,13
27004,Gare de la Garenne-Colombes,OUI,27,18,9,7,2,OUI,OUI,2025-03-13 13:00:34+00:00,"48.909752, 2.239145",Colombes,92025,0.3333333333333333,13
35014,Charles de Gaulle - Jean Lolive,OUI,26,24,2,2,0,OUI,OUI,2025-03-13 12:58:22+00:00,"48.8932644350857, 2.4126765131950383",Pantin,93055,0.07692307692307693,13
17123,Mstislav Rostropovitch - Berthier,OUI,18,14,4,1,3,OUI,OUI,2025-03-13 12:57:58+00:00,"48.892120821173975, 2.309234105050564",Paris,75056,0.2222222222222222,13
31708,Noisy le Sec - Jean-Baptiste Clément,OUI,19,18,1,0,1,OUI,OUI,2025-03-13 12:52:00+00:00,"48.874515389637, 2.4152836203575",Bagnolet,93006,0.05263157894736842,13
6001,Institut de France,OUI,17,2,15,9,6,OUI,OUI,2025-03-13 13:00:15+00:00,"48.857615678565, 2.3358313530377",Paris,75056,0.8823529411764706,13
1003,Saint-Denis - Rivoli,OUI,42,8,34,22,12,OUI,OUI,2025-03-13 13:01:55+00:00,"48.859059340842, 2.3476943001151",Paris,75056,0.8095238095238095,13
17038,Grande Armée - Brunel,OUI,60,26,34,12,22,OUI,OUI,2025-03-13 13:01:12+00:00,"48.876116, 2.288124",Paris,75056,0.5666666666666667,13
15103,Cauchy - Cévennes,OUI,50,5,45,41,4,OUI,OUI,2025-03-13 13:01:28+00:00,"48.843372571022, 2.2751328349113",Paris,75056,0.9,13
8052,Balzac - Champs Elysées,OUI,30,14,16,8,8,OUI,OUI,2025-03-13 13:00:49+00:00,"48.872699639621, 2.3001953959465",Paris,75056,0.5333333333333333,13
15026,Bir Hakeim,OUI,32,9,23,13,10,OUI,OUI,2025-03-13 13:00:57+00:00,"48.853844054334, 2.289705348222",Paris,75056,0.71875,13
4104,Sebastopol - Rambuteau,OUI,15,1,14,11,3,OUI,OUI,2025-03-13 13:01:41+00:00,"48.86181809267, 2.3501381278038",Paris,75056,0.9333333333333333,13
19203,Pailleron - Bouret,OUI,27,24,3,2,1,OUI,OUI,2025-03-13 13:01:48+00:00,"48.880516995482, 2.3763902374411",Paris,75056,0.1111111111111111,13
32001,Proudhon - Président Wilson,OUI,29,11,18,11,7,OUI,OUI,2025-03-13 13:01:43+00:00,"48.906442763495, 2.3584905266762",Saint-Denis,93066,0.6206896551724138,13
18043,Clichy - Place Blanche,OUI,18,15,3,2,1,OUI,OUI,2025-03-13 13:00:58+00:00,"48.883601088297, 2.3332237824798",Paris,75056,0.16666666666666666,13
33019,Madeleine Vionnet,OUI,45,5,40,14,26,OUI,OUI,2025-03-13 13:01:19+00:00,"48.902519074064, 2.3740895837545",Aubervilliers,93001,0.8888888888888888,13
32012,Carrefour Pleyel,OUI,65,25,40,15,25,OUI,OUI,2025-03-13 13:01:47+00:00,"48.92034156960326, 2.3438543826341625",Saint-Denis,93066,0.6153846153846154,13
21021,Enfants du Paradis - Peupliers,OUI,60,1,59,30,29,OUI,OUI,2025-03-13 13:01:43+00:00,"48.833122686454, 2.2571459412575",Boulogne-Billancourt,92012,0.9833333333333333,13
21404,Jean Jaurès - Gare de Clamart,OUI,20,19,1,0,1,OUI,OUI,2025-03-13 12:56:26+00:00,"48.81321981219, 2.2716768079163",Clamart,92023,0.05,13
12127,Tremblay - Lac des Minimes,OUI,52,5,47,19,28,OUI,OUI,2025-03-13 13:00:48+00:00,"48.834131261494, 2.4547516554594",Paris,75056,0.9038461538461539,13
1002,Victoria - Place du Chatelet,OUI,19,2,17,8,9,OUI,OUI,2025-03-13 13:01:41+00:00,"48.857992591527, 2.3469167947769",Paris,75056,0.8947368421052632,13
15056,Place Balard,OUI,28,6,22,18,4,OUI,OUI,2025-03-13 13:01:23+00:00,"48.836395736424, 2.2784192115068",Paris,75056,0.7857142857142857,13
12010,Daumesnil - Picpus,OUI,20,7,13,11,2,OUI,OUI,2025-03-13 12:59:45+00:00,"48.8374688, 2.401765",Paris,75056,0.65,13
8004,Malesherbes - Place de la Madeleine,OUI,78,3,75,29,46,OUI,OUI,2025-03-13 13:01:07+00:00,"48.870406028483, 2.323243509808",Paris,75056,0.9615384615384616,13
13123,BNF - Bibliothèque Nationale de France,OUI,43,2,41,28,13,OUI,OUI,2025-03-13 13:01:42+00:00,"48.8350268238, 2.3760157451034",Paris,75056,0.9534883720930233,13
40002,Bleuets - Bordières,OUI,21,17,4,2,2,OUI,OUI,2025-03-13 12:52:06+00:00,"48.802117531472, 2.4543687905029",Créteil,94028,0.19047619047619047,13
8002,Gare Saint-Lazare - Cour du Havre,OUI,42,18,24,5,19,OUI,OUI,2025-03-13 13:01:00+00:00,"48.875674400851, 2.3265598341823",Paris,75056,0.5714285714285714,13
21302,Aristide Briand - Place de la Résistance,OUI,38,3,35,34,1,OUI,OUI,2025-03-13 12:58:29+00:00,"48.82124248401006, 2.2511002421379094",Issy-les-Moulineaux,92040,0.9210526315789473,13
9104,Caumartin - Provence,OUI,22,6,16,13,3,OUI,OUI,2025-03-13 13:01:00+00:00,"48.874422773426545, 2.3284685611724854",Paris,75056,0.7272727272727273,13
16107,Benjamin Godard - Victor Hugo,OUI,32,30,2,1,1,OUI,OUI,2025-03-13 14:01:17+00:00,"48.865983, 2.275725",Paris,75056,0.0625,14
40001,Hôpital Mondor,OUI,28,9,19,10,9,OUI,OUI,2025-03-13 14:00:10+00:00,"48.798922410229, 2.4537451531298",Créteil,94028,0.6785714285714286,14
9020,Toudouze - Clauzel,OUI,21,15,6,5,1,OUI,OUI,2025-03-13 13:58:17+00:00,"48.87929591733507, 2.3373600840568547",Paris,75056,0.2857142857142857,14
44015,Rouget de L'isle - Watteau,OUI,20,10,10,0,10,OUI,OUI,2025-03-13 13:58:32+00:00,"48.778192750803, 2.3963020229163",Vitry-sur-Seine,94081,0.5,14
8026,Messine - Place Du Pérou,OUI,12,3,9,4,5,OUI,OUI,2025-03-13 13:59:45+00:00,"48.875448033960744, 2.315508019010038",Paris,75056,0.75,14
14111,Cassini - Denfert-Rochereau,OUI,23,20,3,0,3,OUI,OUI,2025-03-13 14:01:51+00:00,"48.837525839067, 2.3360354080796",Paris,75056,0.13043478260869565,14
7002,Vaneau - Sèvres,OUI,35,11,24,19,5,OUI,OUI,2025-03-13 14:01:50+00:00,"48.848563233059, 2.3204218259346",Paris,75056,0.6857142857142857,14
14014,Jourdan - Stade Charléty,OUI,58,45,13,3,10,OUI,OUI,2025-03-13 14:01:21+00:00,"48.819428333369, 2.3433353751898",Paris,75056,0.22413793103448276,14
5110,Lacépède - Monge,OUI,22,16,6,3,3,OUI,OUI,2025-03-13 13:59:05+00:00,"48.84389286531899, 2.3519663885235786",Paris,75056,0.2727272727272727,14
32017,Basilique,OUI,20,10,10,4,6,OUI,OUI,2025-03-13 14:00:34+00:00,"48.93626891059109, 2.3588666820200914",Saint-Denis,93066,0.5,14
42016,Pierre et Marie Curie - Maurice Thorez,OUI,26,18,8,4,4,OUI,OUI,2025-03-13 13:58:46+00:00,"48.81580226360801, 2.376804985105991",Ivry-sur-Seine,94041,0.3076923076923077,14
11104,Charonne - Robert et Sonia Delaunay,OUI,20,18,2,0,2,OUI,OUI,2025-03-13 13:59:16+00:00,"48.855907555969, 2.3925706744194",Paris,75056,0.1,14
25006,Place Nelson Mandela,OUI,22,22,0,0,0,OUI,OUI,2025-03-13 14:01:14+00:00,"48.862453313908, 2.1961666225454",Rueil-Malmaison,92063,0.0,14
13007,Le Brun - Gobelins,OUI,48,34,14,13,1,OUI,OUI,2025-03-13 14:00:42+00:00,"48.835092787824, 2.3534681351338",Paris,75056,0.2916666666666667,14
32304,Charcot - Benfleet,OUI,28,27,1,0,1,NON,NON,2025-03-13 13:53:58+00:00,"48.878370277021, 2.440523876268",Romainville,93063,0.03571428571428571,14
6003,Saint-Sulpice,OUI,21,2,19,11,8,OUI,OUI,2025-03-13 14:01:34+00:00,"48.85165383178419, 2.3308077827095985",Paris,75056,0.9047619047619048,14
7003,Square Boucicaut,OUI,58,20,38,26,12,OUI,OUI,2025-03-13 14:00:40+00:00,"48.851296433665276, 2.325061820447445",Paris,75056,0.6551724137931034,14
6108,Saint-Romain - Cherche-Midi,OUI,16,11,5,4,1,OUI,OUI,2025-03-13 14:01:42+00:00,"48.84708159081946, 2.321374788880348",Paris,75056,0.3125,14
5016,Thouin - Cardinal Lemoine,OUI,16,2,14,0,14,OUI,OUI,2025-03-13 13:59:22+00:00,"48.84504716661511, 2.3494647851273465",Paris,75056,0.875,14
33006,André Karman - République,OUI,30,29,1,0,1,OUI,OUI,2025-03-13 13:57:29+00:00,"48.91039875761846, 2.3851355910301213",Aubervilliers,93001,0.03333333333333333,14
11025,Froment - Bréguet,OUI,43,27,16,13,3,OUI,OUI,2025-03-13 13:52:18+00:00,"48.8570414504784, 2.37289470306807",Paris,75056,0.37209302325581395,14
40011,Bas du Mont-Mesly,OUI,26,18,8,5,3,OUI,OUI,2025-03-13 14:01:57+00:00,"48.779035118572, 2.4609763908985",Créteil,94028,0.3076923076923077,14
15047,Morillons - Dantzig,OUI,51,50,1,0,1,OUI,OUI,2025-03-13 13:55:01+00:00,"48.83310149953933, 2.299380004405976",Paris,75056,0.0196078431372549,14
21010,Silly - Galliéni,OUI,25,12,13,6,7,OUI,OUI,2025-03-13 14:00:42+00:00,"48.835583838706, 2.2325500845909",Boulogne-Billancourt,92012,0.52,14
17026,Jouffroy d'Abbans - Wagram,OUI,39,19,20,11,9,OUI,OUI,2025-03-13 13:58:51+00:00,"48.881973298352, 2.301132157445",Paris,75056,0.5128205128205128,14
30002,Jean Rostand - Paul Vaillant Couturier,OUI,39,25,14,8,6,OUI,OUI,2025-03-13 14:01:46+00:00,"48.908168131015, 2.4530601033354",Bobigny,93008,0.358974358974359,14
6021,Beaux-Arts - Bonaparte,OUI,20,1,19,13,6,OUI,OUI,2025-03-13 14:01:50+00:00,"48.856451985396, 2.3348518833518",Paris,75056,0.95,14
17041,Guersant - Gouvion-Saint-Cyr,OUI,33,24,9,5,4,OUI,OUI,2025-03-13 13:58:22+00:00,"48.88287775178599, 2.287667370814871",Paris,75056,0.2727272727272727,14
12109,Mairie du 12ème,OUI,30,24,6,5,1,OUI,OUI,2025-03-13 13:57:02+00:00,"48.840855311763, 2.3875549435616",Paris,75056,0.2,14
15202,Bracion - Périphérique,OUI,30,26,4,0,4,OUI,OUI,2025-03-13 13:55:37+00:00,"48.826103771275, 2.3004549373748",Paris,75056,0.13333333333333333,14
8050,Boétie - Ponthieu,OUI,43,3,40,15,25,OUI,OUI,2025-03-13 14:01:38+00:00,"48.871417284355, 2.3076787590981",Paris,75056,0.9302325581395349,14
13101,Croulebarde - Corvisart,OUI,33,21,12,7,5,OUI,OUI,2025-03-13 14:00:42+00:00,"48.830981659316855, 2.3481646925210953",Paris,75056,0.36363636363636365,14
14108,Le Brix et Mesmin - Jourdan,OUI,20,16,4,1,3,OUI,OUI,2025-03-13 14:01:18+00:00,"48.82234096593411, 2.327861653302471",Paris,75056,0.2,14
2022,Saint-Fiacre - Poissonière,OUI,33,3,30,13,17,OUI,OUI,2025-03-13 14:01:20+00:00,"48.870828911558, 2.3459213599563",Paris,75056,0.9090909090909091,14
31024,Romainville - Vaillant-Couturier,OUI,36,32,4,0,4,OUI,OUI,2025-03-13 14:00:40+00:00,"48.86785, 2.446748",Montreuil,93048,0.1111111111111111,14
17044,Porte de Saint-Ouen - Bessières,OUI,42,34,8,6,2,OUI,OUI,2025-03-13 14:01:31+00:00,"48.89792240854517, 2.32851451022192",Paris,75056,0.19047619047619047,14
19033,Cambrai - Benjamin Constant,OUI,39,36,3,2,1,OUI,OUI,2025-03-13 14:01:04+00:00,"48.89594736851349, 2.381133802246315",Paris,75056,0.07692307692307693,14
20143,Ramponeau - Belleville,OUI,44,41,3,1,2,OUI,OUI,2025-03-13 14:00:03+00:00,"48.871031137596, 2.379056852114",Paris,75056,0.06818181818181818,14
17025,Chazelles - Courcelles,OUI,32,24,8,3,5,OUI,OUI,2025-03-13 14:01:52+00:00,"48.879406604954, 2.3034455627202988",Paris,75056,0.25,14
16138,Saint-Cloud - Hippodrome,OUI,30,19,11,4,7,OUI,OUI,2025-03-13 14:00:44+00:00,"48.85772148887421, 2.2549109905958176",Paris,75056,0.36666666666666664,14
21326,Moulin de Pierre - Abbé Grégoire,OUI,20,14,6,0,6,OUI,OUI,2025-03-13 13:57:52+00:00,"48.822036188382, 2.2754641655975",Issy-les-Moulineaux,92040,0.3,14
21216,Louis Lejeune - Barbès,OUI,24,22,2,0,2,OUI,OUI,2025-03-13 13:54:10+00:00,"48.81807418981508, 2.3267009854316716",Montrouge,92049,0.08333333333333333,14
43002,Lagny - Victor Basch,OUI,24,23,1,1,0,OUI,OUI,2025-03-13 14:00:43+00:00,"48.84884147189881, 2.426325418925233",Vincennes,94080,0.041666666666666664,14
15068,Général Martial Valin - Pont du Garigliano,OUI,14,6,8,3,5,OUI,OUI,2025-03-13 14:01:52+00:00,"48.83823094269141, 2.270506024360657",Paris,75056,0.5714285714285714,14
19027,Serrurier,OUI,18,15,3,0,3,OUI,OUI,2025-03-13 13:59:46+00:00,"48.880493403246, 2.398064173758",Paris,75056,0.16666666666666666,14
22207,Rond-point du Dr Albert Schweitzer,OUI,22,17,5,2,3,OUI,OUI,2025-03-13 14:00:46+00:00,"48.78980918988166, 2.3143940046429634",Bagneux,92007,0.22727272727272727,14
31028,Raspail Barbès,OUI,28,27,1,1,0,OUI,OUI,2025-03-13 14:01:33+00:00,"48.8529945, 2.4247387",Montreuil,93048,0.03571428571428571,14
92002,Théâtre des Amandiers - Palais des sports,OUI,23,7,16,8,8,OUI,OUI,2025-03-13 13:57:55+00:00,"48.892648526839, 2.2136941552162",Nanterre,92050,0.6956521739130435,14
17048,De Toqueville - Terrasse,OUI,30,26,4,1,3,OUI,OUI,2025-03-13 14:01:30+00:00,"48.882428, 2.314002",Paris,75056,0.13333333333333333,14
16118,Michel-Ange - Parent de Rosan,OUI,23,20,3,0,3,OUI,OUI,2025-03-13 14:01:05+00:00,"48.840579923690115, 2.2584119439125065",Paris,75056,0.13043478260869565,14
44017,Jules Guesde - Pont du Port à l'Anglais,OUI,26,1,25,25,0,OUI,OUI,2025-03-13 14:01:00+00:00,"48.79628807093802, 2.417212128639221",Vitry-sur-Seine,94081,0.9615384615384616,14
2017,Caire - Dussoubs,OUI,39,11,28,27,1,OUI,OUI,2025-03-13 14:01:43+00:00,"48.86785342111862, 2.349364310503006",Paris,75056,0.717948717948718,14
8103,Artois - Berri,OUI,22,3,19,11,8,OUI,OUI,2025-03-13 13:59:41+00:00,"48.87393521240818, 2.3064258322119713",Paris,75056,0.8636363636363636,14
9008,Tour d'Auvergne - Rodier,OUI,16,15,1,0,1,OUI,OUI,2025-03-13 13:52:47+00:00,"48.879161, 2.343698",Paris,75056,0.0625,14
15112,Vigée-Lebrun - Anselme Payen,OUI,23,22,1,0,1,OUI,OUI,2025-03-13 14:01:11+00:00,"48.838683941628375, 2.3110422492027287",Paris,75056,0.043478260869565216,14
8048,Marceau - Chaillot,OUI,21,7,14,2,12,OUI,OUI,2025-03-13 14:00:08+00:00,"48.868834023334, 2.2986030816809",Paris,75056,0.6666666666666666,14
13030,Italie - Tolbiac,OUI,21,17,4,0,4,OUI,OUI,2025-03-13 13:54:34+00:00,"48.82557229464416, 2.3576171323657036",Paris,75056,0.19047619047619047,14
14013,Liard - Amiral Mouchez,OUI,26,24,2,1,1,OUI,OUI,2025-03-13 14:00:32+00:00,"48.8214169, 2.342167",Paris,75056,0.07692307692307693,14
18111,Félix Ziem - Armand Gauthier,OUI,23,22,1,0,1,OUI,OUI,2025-03-13 14:00:29+00:00,"48.88949630486821, 2.333393658804396",Paris,75056,0.043478260869565216,14
13118,Regnault - Patay,OUI,63,12,51,45,6,OUI,OUI,2025-03-13 14:01:54+00:00,"48.82435782216384, 2.377065159380436",Paris,75056,0.8095238095238095,14
48003,Youri Gagarine - Karl Marx,OUI,22,19,3,1,2,OUI,OUI,2025-03-13 13:57:33+00:00,"48.78448485079149, 2.35908430069685",Villejuif,94076,0.13636363636363635,14
9002,Abbeville - Faubourg Poissonnière,OUI,14,12,2,1,1,OUI,OUI,2025-03-13 14:00:18+00:00,"48.879223, 2.349147",Paris,75056,0.14285714285714285,14
43009,Place Jean-Spire-Lemaître,OUI,47,46,1,0,1,OUI,OUI,2025-03-13 13:55:00+00:00,"48.8468428626593, 2.452062070369721",Vincennes,94080,0.02127659574468085,14
16110,Octave Feuillet - Albéric Magnard,OUI,21,8,13,1,12,OUI,OUI,2025-03-13 13:59:06+00:00,"48.86106902949534, 2.2730283066630363",Paris,75056,0.6190476190476191,14
10161,Gare de l'Est - Faubourg-Saint-Martin,OUI,32,28,4,0,4,OUI,OUI,2025-03-13 14:01:13+00:00,"48.875642647477, 2.3594588041306",Paris,75056,0.125,14
9001,Bellefond - Poissonnière,OUI,15,14,1,1,0,OUI,OUI,2025-03-13 14:02:01+00:00,"48.87759897050706, 2.348463758826256",Paris,75056,0.06666666666666667,14
41303,Gare de Nogent-le-Perreux,OUI,31,18,13,10,3,OUI,OUI,2025-03-13 13:56:00+00:00,"48.83842553348809, 2.493693307042122",Nogent-sur-Marne,94052,0.41935483870967744,14
17032,Jean Oestreicher - Porte de Champerret,OUI,21,1,20,10,10,OUI,OUI,2025-03-13 14:01:13+00:00,"48.88655580065981, 2.288640439510346",Paris,75056,0.9523809523809523,14
12031,Gabriel Lamé,OUI,34,30,4,3,1,OUI,OUI,2025-03-13 13:59:16+00:00,"48.8351212784276, 2.385534569621086",Paris,75056,0.11764705882352941,14
8016,Square Louis XVI,OUI,29,1,28,19,9,OUI,OUI,2025-03-13 14:00:57+00:00,"48.87320440102894, 2.323658830743138",Paris,75056,0.9655172413793104,14
1001,Quai de l'Horloge - Pont Neuf,OUI,16,4,12,8,4,OUI,OUI,2025-03-13 13:57:57+00:00,"48.857058739111, 2.3417982839439",Paris,75056,0.75,14
10115,Granges aux Belles,OUI,27,24,3,1,2,OUI,OUI,2025-03-13 14:01:48+00:00,"48.8761373390584, 2.3680844979417",Paris,75056,0.1111111111111111,14
5022,Boulangers - Cardinal Lemoine,OUI,18,1,17,12,5,OUI,OUI,2025-03-13 13:59:55+00:00,"48.8462904, 2.3521495",Paris,75056,0.9444444444444444,14
10029,Dunkerque - Rocroy,OUI,24,24,0,0,0,OUI,OUI,2025-03-13 13:59:36+00:00,"48.880726, 2.351464",Paris,75056,0.0,14
21328,Verger - Colonel Guichard,OUI,29,27,2,0,2,OUI,OUI,2025-03-13 13:54:57+00:00,"48.816376985087, 2.2670380088932",Issy-les-Moulineaux,92040,0.06896551724137931,14
13104,Gare d'Austerlitz - Quai Saint-Bernard,OUI,26,1,25,15,10,OUI,OUI,2025-03-13 13:59:59+00:00,"48.84369030864, 2.3657163977623",Paris,75056,0.9615384615384616,14
17040,Pereire - Ternes,OUI,48,39,9,4,5,OUI,OUI,2025-03-13 14:01:05+00:00,"48.87973954830735, 2.288012132048607",Paris,75056,0.1875,14
9038,Douai - Bruxelles,OUI,26,20,6,0,6,OUI,OUI,2025-03-13 13:58:15+00:00,"48.88320784122797, 2.3308449949028507",Paris,75056,0.23076923076923078,14
8009,Gare Saint-Lazare - Isly,OUI,24,18,6,3,3,OUI,OUI,2025-03-13 14:01:46+00:00,"48.874777677621296, 2.326515804784655",Paris,75056,0.25,14
31103,Gare Rosny-Bois-Perrier,OUI,32,10,22,0,22,OUI,OUI,2025-03-13 14:00:08+00:00,"48.88115023337061, 2.480436824262142",Rosny-sous-Bois,93064,0.6875,14
17008,Porte Pouchet-Bessières,OUI,23,14,9,7,2,OUI,OUI,2025-03-13 13:59:36+00:00,"48.8978765, 2.3230632",Paris,75056,0.391304347826087,14
7018,Ségur - d'Estrées,OUI,19,2,17,6,11,OUI,OUI,2025-03-13 14:01:27+00:00,"48.851419978983, 2.3097044974566",Paris,75056,0.8947368421052632,14
8053,Place Georges Guillaumin,OUI,27,17,10,6,4,OUI,OUI,2025-03-13 13:56:37+00:00,"48.874750203957, 2.301771435326",Paris,75056,0.37037037037037035,14
18203,Lamarck - Saint-Ouen,OUI,40,40,0,0,0,NON,NON,2025-03-13 13:59:01+00:00,"48.891334555236, 2.3272445342326",Paris,75056,0.0,14
19105,Ambroise Rendu - Porte Brunet,OUI,17,15,2,1,1,OUI,OUI,2025-03-13 13:58:50+00:00,"48.883667, 2.395733",Paris,75056,0.11764705882352941,14
5005,Gay Lussac - Saint-Jacques,OUI,24,7,17,4,13,OUI,OUI,2025-03-13 13:59:12+00:00,"48.844730256132, 2.3419239448664",Paris,75056,0.7083333333333334,14
17004,Legendre - Clichy,OUI,38,34,4,3,1,OUI,OUI,2025-03-13 14:01:54+00:00,"48.88896161855884, 2.322528975094376",Paris,75056,0.10526315789473684,14
21323,Charlot - Stade Gabriel Voisin,OUI,31,1,30,28,2,OUI,OUI,2025-03-13 13:57:49+00:00,"48.827228120536, 2.268122527474",Issy-les-Moulineaux,92040,0.967741935483871,14
19003,Quai de la Seine,OUI,24,19,5,1,4,OUI,OUI,2025-03-13 14:01:42+00:00,"48.884492238407525, 2.3703941702842717",Paris,75056,0.20833333333333334,14
9014,Faubourg Montmartre - La Fayette,OUI,33,10,23,16,7,OUI,OUI,2025-03-13 14:01:12+00:00,"48.875254549053, 2.3408536612988",Paris,75056,0.696969696969697,14
5020,Institut du Monde Arabe - Saint-Germain,OUI,37,3,34,29,5,OUI,OUI,2025-03-13 14:01:38+00:00,"48.849063299501, 2.3558086529374",Paris,75056,0.918918918918919,14
9106,Boudreau - Auber,OUI,27,9,18,6,12,OUI,OUI,2025-03-13 13:57:56+00:00,"48.87219, 2.329423",Paris,75056,0.6666666666666666,14
92007,Pesaro - Préfecture,OUI,21,14,7,2,5,OUI,OUI,2025-03-13 13:53:50+00:00,"48.89577046284005, 2.223908342421055",Nanterre,92050,0.3333333333333333,14
31706,Château - République,OUI,24,22,2,0,2,OUI,OUI,2025-03-13 13:52:52+00:00,"48.862923800596, 2.4155035614967",Bagnolet,93006,0.08333333333333333,14
16026,Ranelagh - Mozart,OUI,7,3,4,2,2,OUI,OUI,2025-03-13 14:01:38+00:00,"48.8554439, 2.2704418",Paris,75056,0.5714285714285714,14
22409,Henri Barbusse - Stalingrad,OUI,16,14,2,0,2,OUI,OUI,2025-03-13 14:02:00+00:00,"48.814183748660554, 2.2872862592339516",Malakoff,92046,0.125,14
9028,Moncey - Blanche,OUI,17,15,2,0,2,OUI,OUI,2025-03-13 14:01:33+00:00,"48.88006587474148, 2.3310810327529907",Paris,75056,0.11764705882352941,14
19015,Thionville - Ourcq,OUI,23,19,4,4,0,OUI,OUI,2025-03-13 13:58:29+00:00,"48.88917613743794, 2.3833653330802917",Paris,75056,0.17391304347826086,14
17043,Belidor - Gouvion-Saint-Cyr,OUI,38,26,12,11,1,OUI,OUI,2025-03-13 13:55:06+00:00,"48.88022154052015, 2.2854680567979813",Paris,75056,0.3157894736842105,14
9022,Rossini - Laffitte,OUI,33,4,29,18,11,OUI,OUI,2025-03-13 14:00:54+00:00,"48.87334627510507, 2.337980867701675",Paris,75056,0.8787878787878788,14
19026,Place de Rhin et Danube,OUI,14,14,0,0,0,OUI,OUI,2025-03-13 13:55:17+00:00,"48.88192765861766, 2.392586767673493",Paris,75056,0.0,14
26003,Argenteuil - Voltaire,OUI,16,7,9,3,6,OUI,OUI,2025-03-13 13:59:14+00:00,"48.91864865955558, 2.2814112156629562",Asnières-sur-Seine,92004,0.5625,14
11023,Saint-Maur - Roquette,OUI,46,36,10,6,4,OUI,OUI,2025-03-13 14:01:17+00:00,"48.858688774062955, 2.383553994571467",Paris,75056,0.21739130434782608,14
12151,Gare de Lyon - Place Louis Armand,OUI,58,2,56,45,11,OUI,OUI,2025-03-13 14:00:00+00:00,"48.845515089794, 2.3726498446286",Paris,75056,0.9655172413793104,14
45003,11 Novembre 1918 - 8 Mai 1945,OUI,36,13,23,14,9,OUI,OUI,2025-03-13 13:57:14+00:00,"48.80889533774377, 2.5382421165704727",Champigny-sur-Marne,94017,0.6388888888888888,14
10107,Gare du Nord - Hôpital Lariboisière,OUI,49,47,2,1,1,OUI,OUI,2025-03-13 14:00:32+00:00,"48.881949, 2.352339",Paris,75056,0.04081632653061224,14
12111,Claude Decaen - Cannebière,OUI,27,26,1,1,0,OUI,OUI,2025-03-13 14:01:52+00:00,"48.83761417037952, 2.397253782195704",Paris,75056,0.037037037037037035,14
26002,Redoute - Les Courtilles,OUI,37,16,21,17,4,OUI,OUI,2025-03-13 14:01:49+00:00,"48.929867194519, 2.2836696356535",Asnières-sur-Seine,92004,0.5675675675675675,14
19043,Delphine Seyrig - Général Leclerc,OUI,51,45,6,3,3,OUI,OUI,2025-03-13 13:58:32+00:00,"48.893923963057865, 2.39790290594101",Pantin,93055,0.11764705882352941,14
16039,Exelmans - Versailles,OUI,48,17,31,24,7,OUI,OUI,2025-03-13 14:01:54+00:00,"48.84097491091973, 2.264390252530575",Paris,75056,0.6458333333333334,14
5032,Panthéon - Valette,OUI,39,15,24,0,24,OUI,OUI,2025-03-13 14:00:39+00:00,"48.847020571652, 2.3464982619671",Paris,75056,0.6153846153846154,14
11002,Roquette - Thiéré,OUI,21,3,18,15,3,OUI,OUI,2025-03-13 14:00:34+00:00,"48.85507930579506, 2.3733686318721463",Paris,75056,0.8571428571428571,14
15067,Desaix - Edgar Faure,OUI,11,3,8,5,3,OUI,OUI,2025-03-13 14:00:00+00:00,"48.852804604940296, 2.293077029857222",Paris,75056,0.7272727272727273,14
8034,Berri - Haussmann,OUI,34,2,32,16,16,OUI,OUI,2025-03-13 14:00:00+00:00,"48.874746047357135, 2.3082953318953514",Paris,75056,0.9411764705882353,14
11027,Saint-Ambroise - Parmentier,OUI,35,27,8,7,1,OUI,OUI,2025-03-13 13:59:42+00:00,"48.862147844548, 2.3772348091006",Paris,75056,0.22857142857142856,14
11047,Amelot - Saint-Sébastien,OUI,29,6,23,16,7,OUI,OUI,2025-03-13 14:01:17+00:00,"48.861142162761, 2.3677996181077",Paris,75056,0.7931034482758621,14
31022,Mairie de Montreuil,OUI,51,48,3,2,1,OUI,OUI,2025-03-13 14:00:26+00:00,"48.86131452758348, 2.440614402294159",Montreuil,93048,0.058823529411764705,14
18107,Chartres - La Charbonnière,OUI,34,33,1,1,0,OUI,OUI,2025-03-13 13:59:28+00:00,"48.8847601, 2.3534657",Paris,75056,0.029411764705882353,14
31009,Place Du Général De Gaulle,OUI,25,23,2,0,2,OUI,OUI,2025-03-13 14:01:32+00:00,"48.8687591, 2.4329931",Montreuil,93048,0.08,14
20042,Pyrénées - Emmery,OUI,39,35,4,0,4,OUI,OUI,2025-03-13 13:58:06+00:00,"48.872010281270974, 2.392039597034455",Paris,75056,0.10256410256410256,14
14020,Cimetière de Montrouge,OUI,58,58,0,0,0,OUI,OUI,2025-03-13 13:55:19+00:00,"48.821466904768, 2.3215785772007",Paris,75056,0.0,14
17030,Pereire - Rennequin,OUI,22,17,5,2,3,OUI,OUI,2025-03-13 13:59:33+00:00,"48.88364782887555, 2.2952447086572647",Paris,75056,0.22727272727272727,14
33017,Anatole France - President Roosevelt,OUI,25,19,6,3,3,OUI,OUI,2025-03-13 14:00:03+00:00,"48.9155156, 2.3814103",Aubervilliers,93001,0.24,14
6006,Notre-Dame-des-Champs - Stanislas,OUI,19,5,14,9,5,OUI,OUI,2025-03-13 14:01:25+00:00,"48.84479928858768, 2.329337755887181",Paris,75056,0.7368421052631579,14
33102,Gabriel Péri - Francisco Ferrer,OUI,18,17,1,0,1,OUI,OUI,2025-03-13 13:55:14+00:00,"48.88633710236977, 2.407338917255402",Le Pré-Saint-Gervais,93061,0.05555555555555555,14
12128,Pyramide - Ecole du Breuil,OUI,33,33,0,0,0,OUI,OUI,2025-03-13 13:55:26+00:00,"48.82237977153955, 2.4586871266365056",Paris,75056,0.0,14
21212,Marne - Germain Dardan,OUI,21,17,4,3,1,OUI,OUI,2025-03-13 13:55:00+00:00,"48.81217465201, 2.3035024699104",Montrouge,92049,0.19047619047619047,14
8010,Liège - Moscou,OUI,15,7,8,2,6,OUI,OUI,2025-03-13 13:59:38+00:00,"48.8795431, 2.3264628",Paris,75056,0.5333333333333333,14
44006,Concorde - Stalingrad,OUI,35,27,8,2,6,OUI,OUI,2025-03-13 13:58:42+00:00,"48.7985844, 2.3821302",Vitry-sur-Seine,94081,0.22857142857142856,14
46002,Rouget de Lisle,OUI,35,6,29,16,13,OUI,OUI,2025-03-13 13:57:23+00:00,"48.764615483395254, 2.4071189761161804",Choisy-le-Roi,94022,0.8285714285714286,14
11113,Richard Lenoir - Republique,OUI,57,25,32,30,2,OUI,OUI,2025-03-13 14:01:33+00:00,"48.8667175, 2.3692541",Paris,75056,0.5614035087719298,14
10016,Récollets - Square Villemin,OUI,16,15,1,0,1,OUI,OUI,2025-03-13 13:57:01+00:00,"48.875034655883944, 2.359801238597928",Paris,75056,0.0625,14
15104,Hôpital Européen Georges Pompidou,OUI,64,10,54,51,3,OUI,OUI,2025-03-13 14:00:40+00:00,"48.837695319163, 2.2753742337227",Paris,75056,0.84375,14
41302,Charles de Gaulle - Beauté,OUI,48,48,0,0,0,OUI,OUI,2025-03-13 14:01:43+00:00,"48.83649602312711, 2.479562651149885",Nogent-sur-Marne,94052,0.0,14
43008,Fontenay - Libération,OUI,25,20,5,3,2,OUI,OUI,2025-03-13 14:01:29+00:00,"48.847803063647, 2.4451419711113",Vincennes,94080,0.2,14
15042,Henry Farman,OUI,16,2,14,11,3,OUI,OUI,2025-03-13 13:57:33+00:00,"48.83372430280548, 2.2713854536414146",Paris,75056,0.875,14
5018,Mutualité,OUI,37,1,36,30,6,OUI,OUI,2025-03-13 14:00:19+00:00,"48.848225572724, 2.3502873256803",Paris,75056,0.972972972972973,14
18011,Pajol - Place Herbert,OUI,39,37,2,0,2,OUI,OUI,2025-03-13 14:01:45+00:00,"48.8927825, 2.3635598",Paris,75056,0.05128205128205128,14
19101,Square Simon Bolivar,OUI,23,20,3,1,2,OUI,OUI,2025-03-13 13:57:36+00:00,"48.875089888322, 2.3826304078102",Paris,75056,0.13043478260869565,14
42706,Roger Salengro - Fontainebleau,OUI,25,17,8,5,3,OUI,OUI,2025-03-13 14:00:41+00:00,"48.814548697325, 2.3611663654447",Le Kremlin-Bicêtre,94043,0.32,14
14138,Porte de Vanves,OUI,30,27,3,2,1,OUI,OUI,2025-03-13 13:56:22+00:00,"48.828012849445, 2.3056878894567",Paris,75056,0.1,14
19120,Carducci - Place Hannah Arendt,OUI,27,24,3,0,3,OUI,OUI,2025-03-13 13:52:23+00:00,"48.877436681515796, 2.3860743641853337",Paris,75056,0.1111111111111111,14
46003,Conservatoire de Musique,OUI,24,2,22,19,3,OUI,OUI,2025-03-13 14:01:59+00:00,"48.77093586667601, 2.4034014344215398",Choisy-le-Roi,94022,0.9166666666666666,14
18003,Cimetière de Montmartre,OUI,43,42,1,0,1,OUI,OUI,2025-03-13 13:55:50+00:00,"48.886472466142, 2.3328901827335",Paris,75056,0.023255813953488372,14
41209,Cimetière de Fontenay-sous-Bois,OUI,15,13,2,0,2,OUI,OUI,2025-03-13 14:00:40+00:00,"48.84706173362218, 2.4787822365760808",Fontenay-sous-Bois,94033,0.13333333333333333,14
14003,Schoelcher - Raspail,OUI,47,43,4,1,3,OUI,OUI,2025-03-13 14:00:53+00:00,"48.83681733526843, 2.3312794080411474",Paris,75056,0.0851063829787234,14
21312,Lucie Aubrac - Fort,OUI,30,29,1,0,1,OUI,OUI,2025-03-13 13:54:47+00:00,"48.818144834008976, 2.271184623241425",Issy-les-Moulineaux,92040,0.03333333333333333,14
19103,Manin - Carrières d'Amérique,OUI,17,16,1,0,1,OUI,OUI,2025-03-13 13:59:53+00:00,"48.88467214209463, 2.3919698596000676",Paris,75056,0.058823529411764705,14
14008,Mouton Duvernet - Général Leclerc,OUI,26,22,4,1,3,OUI,OUI,2025-03-13 13:57:15+00:00,"48.831632518293, 2.3293121159077",Paris,75056,0.15384615384615385,14
12114,Victor Hugo - Jeanne Jugan,OUI,28,25,3,2,1,OUI,OUI,2025-03-13 13:56:24+00:00,"48.843949064031825, 2.415081394834419",Paris,75056,0.10714285714285714,14
18028,Championnet - Vauvenargues,OUI,31,30,1,0,1,OUI,OUI,2025-03-13 14:01:36+00:00,"48.89401874744574, 2.3319872841238976",Paris,75056,0.03225806451612903,14
13001,Port-Royal - Hôpital du Val-de-Grâce,OUI,17,8,9,3,6,OUI,OUI,2025-03-13 14:01:38+00:00,"48.837668272811, 2.3448138346607",Paris,75056,0.5294117647058824,14
8017,Rocher - Laborde,OUI,64,50,14,10,4,OUI,OUI,2025-03-13 14:01:22+00:00,"48.87590240712654, 2.322616316378116",Paris,75056,0.21875,14
15054,Lecourbe - Jean Maridor,OUI,18,10,8,6,2,OUI,OUI,2025-03-13 13:57:31+00:00,"48.83796366147599, 2.2877392172813416",Paris,75056,0.4444444444444444,14
5124,Erasme - Ulm,OUI,22,9,13,1,12,OUI,OUI,2025-03-13 14:01:10+00:00,"48.84264375274712, 2.3445946723222733",Paris,75056,0.5909090909090909,14
15106,Grenelle - Violet,OUI,34,16,18,17,1,OUI,OUI,2025-03-13 13:57:13+00:00,"48.84993035512154, 2.294612042605877",Paris,75056,0.5294117647058824,14
18046,Etienne Jodelle - Saint Ouen,OUI,32,31,1,1,0,OUI,OUI,2025-03-13 13:54:41+00:00,"48.88794016394694, 2.326124420314341",Paris,75056,0.03125,14
14106,Marc Sangnier - Porte de Vanves,OUI,20,18,2,0,2,OUI,OUI,2025-03-13 13:53:12+00:00,"48.825218683556734, 2.3107116669416428",Paris,75056,0.1,14
22406,Guy Môquet - Etienne Dolet,OUI,22,21,1,0,1,OUI,OUI,2025-03-13 14:01:52+00:00,"48.81527009991819, 2.298078276995073",Malakoff,92046,0.045454545454545456,14
2111,Chabanais - Petits Champs,OUI,29,0,29,20,9,OUI,OUI,2025-03-13 13:58:46+00:00,"48.86703740186721, 2.336716018617153",Paris,75056,1.0,14
31102,Boissière - Etienne Dolet,OUI,20,18,2,1,1,OUI,OUI,2025-03-13 13:58:34+00:00,"48.876111, 2.4677312",Montreuil,93048,0.1,14
14012,Sibelle - Alésia,OUI,37,37,0,0,0,OUI,OUI,2025-03-13 13:55:46+00:00,"48.826701758539215, 2.3384983465075493",Paris,75056,0.0,14
18022,Marcadet - Barbès,OUI,34,32,2,0,2,OUI,OUI,2025-03-13 14:01:59+00:00,"48.890451120965, 2.3490573929687",Paris,75056,0.058823529411764705,14
21005,Hôtel de Ville de Boulogne Billancourt,OUI,26,5,21,6,15,OUI,OUI,2025-03-13 13:55:55+00:00,"48.83495885166784, 2.2416803240776066",Boulogne-Billancourt,92012,0.8076923076923077,14
8054,Bertie Albrecht - Hoche,OUI,32,15,17,9,8,OUI,OUI,2025-03-13 13:59:19+00:00,"48.87614039826388, 2.301303138307601",Paris,75056,0.53125,14
10042,Enghien - Faubourg Poissonnière,OUI,31,18,13,13,0,OUI,OUI,2025-03-13 13:58:35+00:00,"48.872420063053, 2.3483952362828",Paris,75056,0.41935483870967744,14
15109,Cevennes - Bergers,OUI,28,18,10,8,2,OUI,OUI,2025-03-13 14:01:35+00:00,"48.84240765130395, 2.281037718057633",Paris,75056,0.35714285714285715,14
42014,Place Marcel Cachin,OUI,32,10,22,21,1,OUI,OUI,2025-03-13 13:59:18+00:00,"48.81411442356866, 2.39090770483017",Ivry-sur-Seine,94041,0.6875,14
21209,Molière - République,OUI,30,26,4,0,4,OUI,OUI,2025-03-13 13:59:42+00:00,"48.81111581390707, 2.3145738624448158",Montrouge,92049,0.13333333333333333,14
8045,Place de la Reine Astrid,OUI,57,17,40,27,13,OUI,OUI,2025-03-13 13:58:16+00:00,"48.864920982538, 2.3025491823859",Paris,75056,0.7017543859649122,14
35010,Hoche - Jean Lolive,OUI,20,17,3,0,3,OUI,OUI,2025-03-13 13:57:46+00:00,"48.89110239200789, 2.402843534946442",Pantin,93055,0.15,14
14124,David Weill - Parc Montsouris,OUI,22,19,3,0,3,OUI,OUI,2025-03-13 13:58:15+00:00,"48.821092374256104, 2.333725690841675",Paris,75056,0.13636363636363635,14
17203,Place de la Porte de Champeret,OUI,28,10,18,14,4,OUI,OUI,2025-03-13 14:00:36+00:00,"48.886062068226, 2.2917001576821",Paris,75056,0.6428571428571429,14
15110,Place Robert Guillemard,OUI,22,0,22,17,5,OUI,OUI,2025-03-13 13:59:06+00:00,"48.836191728066666, 2.2811267160086417",Paris,75056,1.0,14
4016,Lobau - Hôtel de Ville,OUI,59,3,56,47,9,OUI,OUI,2025-03-13 14:01:58+00:00,"48.8562118, 2.3532536",Paris,75056,0.9491525423728814,14
21006,Marcelin Berthelot,OUI,27,18,9,4,5,OUI,OUI,2025-03-13 13:55:23+00:00,"48.8415473058801, 2.233161628246308",Boulogne-Billancourt,92012,0.3333333333333333,14
15133,Saint Lambert - Blomet,OUI,26,24,2,0,2,OUI,OUI,2025-03-13 14:01:59+00:00,"48.83659148147257, 2.2930556908249855",Paris,75056,0.07692307692307693,14
20131,Repos - Cimetière du Père Lachaise,OUI,33,33,0,0,0,OUI,OUI,2025-03-13 13:55:48+00:00,"48.859358523593, 2.3896131366845",Paris,75056,0.0,14
6025,Assas - Rennes,OUI,31,12,19,10,9,OUI,OUI,2025-03-13 14:00:51+00:00,"48.8492084999386, 2.32851454623001",Paris,75056,0.6129032258064516,14
44013,Edouard Tremblay - Julian Grimaux,OUI,30,30,0,0,0,OUI,OUI,2025-03-13 13:55:40+00:00,"48.781383825117, 2.3723508417606",Vitry-sur-Seine,94081,0.0,14
44003,Gabriel Péri - Danielle Casanova,OUI,20,8,12,9,3,OUI,OUI,2025-03-13 14:00:06+00:00,"48.790114, 2.4025777",Vitry-sur-Seine,94081,0.6,14
21015,Nationale - Place Jules Guesde,OUI,23,9,14,10,4,OUI,OUI,2025-03-13 14:01:40+00:00,"48.82753962462998, 2.2416052222251897",Boulogne-Billancourt,92012,0.6086956521739131,14
22203,Tertres - Fontaine,OUI,27,26,1,0,1,OUI,OUI,2025-03-13 14:01:55+00:00,"48.787553654715644, 2.306235730648041",Bagneux,92007,0.037037037037037035,14
15034,Lakanal - Commerce,OUI,48,21,27,26,1,OUI,OUI,2025-03-13 13:59:48+00:00,"48.84442462786544, 2.294059172272682",Paris,75056,0.5625,14
41202,Gare Rer de Fontenay sous Bois,OUI,60,54,6,2,4,OUI,OUI,2025-03-13 13:59:51+00:00,"48.8436279, 2.4630465",Fontenay-sous-Bois,94033,0.1,14
5028,Censier - Jardin des Plantes,OUI,28,7,21,17,4,OUI,OUI,2025-03-13 14:00:37+00:00,"48.84107178161383, 2.355475388467312",Paris,75056,0.75,14
42021,Raspail - Manufacture des Oeillets,OUI,31,8,23,21,2,OUI,OUI,2025-03-13 13:59:59+00:00,"48.8094458, 2.3903009",Ivry-sur-Seine,94041,0.7419354838709677,14
48010,Karl Marx,OUI,16,6,10,2,8,OUI,OUI,2025-03-13 13:55:31+00:00,"48.784527937293184, 2.3646667979455587",Villejuif,94076,0.625,14
1119,Cossonnerie - Sébastopol,OUI,23,3,20,12,8,OUI,OUI,2025-03-13 13:59:19+00:00,"48.86132665908402, 2.349419631063938",Paris,75056,0.8695652173913043,14
35020,Marcelle - Thalie,OUI,20,20,0,0,0,OUI,OUI,2025-03-13 14:00:44+00:00,"48.8835462, 2.4137883",Pantin,93055,0.0,14
25003,Henri Ste-Claire Déville - Paul Héroult,OUI,21,7,14,6,8,OUI,OUI,2025-03-13 14:01:54+00:00,"48.892663, 2.172411",Rueil-Malmaison,92063,0.6666666666666666,14
1020,Cambon - Rivoli,OUI,35,7,28,15,13,OUI,OUI,2025-03-13 14:00:54+00:00,"48.866143390992, 2.3251800647137",Paris,75056,0.8,14
22402,Jean Jaurès - Salvador Allende,OUI,42,40,2,0,2,OUI,OUI,2025-03-13 14:01:51+00:00,"48.821475594736775, 2.3026576638221745",Malakoff,92046,0.047619047619047616,14
20115,Louis Lumière - Porte de Bagnolet,OUI,20,20,0,0,0,OUI,OUI,2025-03-13 13:55:20+00:00,"48.86431136000005, 2.4105210229754443",Paris,75056,0.0,14
11030,Oberkampf - République,OUI,20,14,6,3,3,OUI,OUI,2025-03-13 14:00:25+00:00,"48.86531608707, 2.37611478491",Paris,75056,0.3,14
31003,Paris - Emile Zola,OUI,29,28,1,0,1,OUI,OUI,2025-03-13 13:59:22+00:00,"48.854898095789295, 2.4186685681343083",Montreuil,93048,0.034482758620689655,14
11039,Richard Lenoir - Jean-Pierre Timbaud,OUI,35,19,16,15,1,OUI,OUI,2025-03-13 13:58:25+00:00,"48.865804276686, 2.3693370749669",Paris,75056,0.45714285714285713,14
9116,Victoire - Chaussée d'Antin,OUI,24,2,22,8,14,OUI,OUI,2025-03-13 14:00:37+00:00,"48.875065791004396, 2.3316738009452824",Paris,75056,0.9166666666666666,14
17013,Legendre - Dulong,OUI,23,21,2,0,2,OUI,OUI,2025-03-13 13:58:30+00:00,"48.885325169402904, 2.316423766314984",Paris,75056,0.08695652173913043,14
11026,Chemin Vert - Saint-Maur,OUI,44,36,8,1,7,OUI,OUI,2025-03-13 14:01:57+00:00,"48.86112461407359, 2.381299026310444",Paris,75056,0.18181818181818182,14
19024,Botzaris - Parc des Buttes Chaumont,OUI,20,19,1,0,1,OUI,OUI,2025-03-13 13:55:20+00:00,"48.877951, 2.381464",Paris,75056,0.05,14
32604,Square du Théâtre du Garde-Chasse,OUI,50,50,0,0,0,OUI,OUI,2025-03-13 14:00:53+00:00,"48.881287375060616, 2.420119643211365",Les Lilas,93045,0.0,14
23006,Jules Guesde - Alsace,OUI,24,10,14,9,5,OUI,OUI,2025-03-13 14:00:03+00:00,"48.890566275506, 2.2950777411461",Levallois-Perret,92044,0.5833333333333334,14
41601,Général De Gaulle - Alouette,OUI,25,17,8,5,3,OUI,OUI,2025-03-13 14:01:05+00:00,"48.839109, 2.4175664",Saint-Mandé,94067,0.32,14
15021,Joseph Liouville - Croix Nivert,OUI,62,32,30,27,3,OUI,OUI,2025-03-13 13:59:15+00:00,"48.844835471244416, 2.297508493065834",Paris,75056,0.4838709677419355,14
18009,Jean-François Lépine - Stephenson,OUI,20,17,3,1,2,OUI,OUI,2025-03-13 13:55:34+00:00,"48.88611466796807, 2.356855627529275",Paris,75056,0.15,14
17105,Place Madeleine Daniélou,OUI,42,19,23,19,4,OUI,OUI,2025-03-13 14:01:37+00:00,"48.883498, 2.282015",Paris,75056,0.5476190476190477,14
11105,Parmentier - République,OUI,22,16,6,2,4,OUI,OUI,2025-03-13 14:01:37+00:00,"48.8644954, 2.3750124",Paris,75056,0.2727272727272727,14
9010,Rochechouart lamartine,OUI,24,12,12,1,11,OUI,OUI,2025-03-13 14:00:01+00:00,"48.876719895109, 2.344393021854",Paris,75056,0.5,14
21701,Larmeroux - Baudelaire,OUI,28,22,6,1,5,OUI,OUI,2025-03-13 13:59:00+00:00,"48.816939911292, 2.2809894804846",Vanves,92075,0.21428571428571427,14
16108,Sablons - Georges Mandel,OUI,38,35,3,2,1,OUI,OUI,2025-03-13 13:56:39+00:00,"48.863875, 2.28189",Paris,75056,0.07894736842105263,14
11024,Mairie du 11ème,OUI,50,44,6,0,6,OUI,OUI,2025-03-13 14:01:41+00:00,"48.858925, 2.3789759",Paris,75056,0.12,14
17125,Marie-Georges Picquart - Pereire,OUI,31,27,4,3,1,OUI,OUI,2025-03-13 14:00:37+00:00,"48.88863669349711, 2.3111706599593163",Paris,75056,0.12903225806451613,14
43005,Gare RER de Vincennes,OUI,47,27,20,10,10,OUI,OUI,2025-03-13 14:01:48+00:00,"48.847563015126106, 2.433383166790009",Vincennes,94080,0.425531914893617,14
21008,Victor Hugo - Galliéni,OUI,33,16,17,16,1,OUI,OUI,2025-03-13 13:59:49+00:00,"48.838020154411, 2.2460845112801",Boulogne-Billancourt,92012,0.5151515151515151,14
16136,Théophile Gautier - François Millet,OUI,27,4,23,17,6,OUI,OUI,2025-03-13 14:01:42+00:00,"48.85034821320644, 2.273029983043671",Paris,75056,0.8518518518518519,14
20134,Lieutenant Chauré - Etienne Marey,OUI,19,17,2,0,2,OUI,OUI,2025-03-13 13:52:22+00:00,"48.86746195408435, 2.405970990657807",Paris,75056,0.10526315789473684,14
19032,Villette - Belleville,OUI,39,29,10,4,6,OUI,OUI,2025-03-13 14:01:28+00:00,"48.8726877314, 2.376461327076",Paris,75056,0.2564102564102564,14
22016,Charles de Gaulle - Sablonville,OUI,26,17,9,5,4,OUI,OUI,2025-03-13 13:59:37+00:00,"48.87991924860035, 2.2763770446181297",Neuilly-sur-Seine,92051,0.34615384615384615,14
19022,Marché Secrétan,OUI,25,23,2,1,1,OUI,OUI,2025-03-13 14:01:53+00:00,"48.88125496379482, 2.373463287949562",Paris,75056,0.08,14
14136,Auguste Cain - Jean Moulin,OUI,40,39,1,1,0,OUI,OUI,2025-03-13 13:59:37+00:00,"48.82577028927573, 2.3210415244102482",Paris,75056,0.025,14
16008,Galilée - Kléber,OUI,30,12,18,1,17,OUI,OUI,2025-03-13 14:01:58+00:00,"48.867411865714, 2.2907813801148",Paris,75056,0.6,14
32302,Chemin Vert - Fraternité,OUI,20,18,2,0,2,OUI,OUI,2025-03-13 14:00:18+00:00,"48.877141208359035, 2.4461565166711807",Romainville,93063,0.1,14
22003,Beffroy,OUI,26,4,22,6,16,OUI,OUI,2025-03-13 13:56:01+00:00,"48.886591074488, 2.2613945603371",Neuilly-sur-Seine,92051,0.8461538461538461,14
10014,Marseille - Beaurepaire,OUI,46,0,46,35,11,OUI,OUI,2025-03-13 14:00:22+00:00,"48.871624306962985, 2.3639265082738348",Paris,75056,1.0,14
13050,Quai Panhard et Levassor,OUI,57,3,54,32,22,OUI,OUI,2025-03-13 14:01:56+00:00,"48.828374828097, 2.3842737458056",Paris,75056,0.9473684210526315,14
11035,Parmentier - Abel Rabaud,OUI,49,44,5,4,1,OUI,OUI,2025-03-13 13:59:15+00:00,"48.86921273836114, 2.371688821240712",Paris,75056,0.10204081632653061,14
24001,Arche - Léonard de Vinci,OUI,27,20,7,4,3,OUI,OUI,2025-03-13 13:55:18+00:00,"48.89790972494496, 2.2383723043644914",Courbevoie,92026,0.25925925925925924,14
46001,Place Paul Eluard,OUI,19,4,15,9,6,OUI,OUI,2025-03-13 13:59:19+00:00,"48.7672039733195, 2.4144977331161503",Choisy-le-Roi,94022,0.7894736842105263,14
42010,Mairie d'Ivry-sur-Seine,OUI,51,22,29,26,3,OUI,OUI,2025-03-13 14:01:57+00:00,"48.81057120969284, 2.3842826485633855",Ivry-sur-Seine,94041,0.5686274509803921,14
17028,Reims - Raymond Pitet,OUI,36,14,22,18,4,OUI,OUI,2025-03-13 14:01:08+00:00,"48.8888, 2.296319",Paris,75056,0.6111111111111112,14
15046,Parc Georges Brassens - Brancion,OUI,28,28,0,0,0,OUI,OUI,2025-03-13 13:56:20+00:00,"48.83227829269761, 2.3022570088505745",Paris,75056,0.0,14
21301,Saint-Vincent - Verdun,OUI,33,11,22,15,7,OUI,OUI,2025-03-13 13:58:19+00:00,"48.819211549234495, 2.254007756710053",Issy-les-Moulineaux,92040,0.6666666666666666,14
16040,Exelmans - Michel-Ange,OUI,31,15,16,13,3,OUI,OUI,2025-03-13 14:01:23+00:00,"48.84309486651855, 2.2597770800669053",Paris,75056,0.5161290322580645,14
32003,Wilson - Métallurgie,OUI,28,11,17,10,7,OUI,OUI,2025-03-13 14:01:43+00:00,"48.909423010092326, 2.3584435880184174",Saint-Denis,93066,0.6071428571428571,14
22006,Pierret - Madrid,OUI,27,3,24,17,7,OUI,OUI,2025-03-13 14:01:30+00:00,"48.882976576876565, 2.260125767248034",Neuilly-sur-Seine,92051,0.8888888888888888,14
11042,Grand Prieuré - Crussol,OUI,46,22,24,22,2,OUI,OUI,2025-03-13 14:00:17+00:00,"48.864660627935, 2.3692265531829",Paris,75056,0.5217391304347826,14
42302,Aristide Briand - Gare de Bagneux,OUI,20,18,2,0,2,OUI,OUI,2025-03-13 13:59:17+00:00,"48.79387269664978, 2.321148812770844",Cachan,94016,0.1,14
8025,Miromesnil - La Boétie,OUI,32,13,19,13,6,OUI,OUI,2025-03-13 14:01:47+00:00,"48.873722412917, 2.3158480972052",Paris,75056,0.59375,14
19029,Seine - Flandre,OUI,18,16,2,0,2,OUI,OUI,2025-03-13 14:02:00+00:00,"48.886785741479684, 2.3746193200349808",Paris,75056,0.1111111111111111,14
7102,Mairie du 7ème,OUI,48,4,44,29,15,OUI,OUI,2025-03-13 14:01:38+00:00,"48.8577967, 2.3192664",Paris,75056,0.9166666666666666,14
9032,Mathurins - Auber,OUI,35,9,26,22,4,OUI,OUI,2025-03-13 14:01:57+00:00,"48.872988840744, 2.3294984212276",Paris,75056,0.7428571428571429,14
13002,Arago - Glacière,OUI,26,18,8,3,5,OUI,OUI,2025-03-13 14:01:23+00:00,"48.83486054775774, 2.3445770524322067",Paris,75056,0.3076923076923077,14
19016,Hautpoul - Jean Jaurès,OUI,30,29,1,0,1,OUI,OUI,2025-03-13 14:01:34+00:00,"48.886393679436, 2.3865414544355",Paris,75056,0.03333333333333333,14
20121,Boyer - Ménilmontant,OUI,19,16,3,0,3,OUI,OUI,2025-03-13 14:00:19+00:00,"48.868895162679, 2.3919824145635",Paris,75056,0.15789473684210525,14
21104,Madame de Sanzillon - Mozart,OUI,22,5,17,13,4,OUI,OUI,2025-03-13 14:01:31+00:00,"48.90379820774301, 2.3187401890754704",Clichy,92024,0.7727272727272727,14
19013,Laumière - Petit,OUI,32,30,2,0,2,OUI,OUI,2025-03-13 13:55:45+00:00,"48.88467368538326, 2.380039058625698",Paris,75056,0.0625,14
32026,Leroy des Barres - Médiathèque,OUI,27,1,26,10,16,OUI,OUI,2025-03-13 14:01:30+00:00,"48.928253687082, 2.3681719727966",Saint-Denis,93066,0.9629629629629629,14
42504,Gare RER de Gentilly,OUI,30,28,2,2,0,OUI,OUI,2025-03-13 13:58:25+00:00,"48.814280450380224, 2.3410347104072575",Gentilly,94037,0.06666666666666667,14
9005,Square d'Anvers,OUI,32,32,0,0,0,OUI,OUI,2025-03-13 13:59:26+00:00,"48.882633484311, 2.3448844062122",Paris,75056,0.0,14
26013,Quai du docteur Dervaux,OUI,26,17,9,8,1,OUI,OUI,2025-03-13 13:59:17+00:00,"48.910482, 2.297998",Asnières-sur-Seine,92004,0.34615384615384615,14
1013,Place du Palais Royal,OUI,65,3,62,39,23,OUI,OUI,2025-03-13 14:00:45+00:00,"48.862382970647, 2.3384822532535",Paris,75056,0.9538461538461539,14
20111,Villiers de l'Isle Adam - Pyrénées,OUI,20,20,0,0,0,OUI,OUI,2025-03-13 13:53:59+00:00,"48.867362, 2.396222",Paris,75056,0.0,14
20043,Charonne - Avron,OUI,25,24,1,0,1,OUI,OUI,2025-03-13 13:45:41+00:00,"48.851602665222, 2.3984030470379",Paris,75056,0.04,14
42301,Gare Arcueil - Cachan,OUI,25,20,5,1,4,OUI,OUI,2025-03-13 13:58:55+00:00,"48.799824, 2.328171",Arcueil,94003,0.2,14
32016,Place de la Porte de Paris,OUI,33,24,9,4,5,OUI,OUI,2025-03-13 14:01:39+00:00,"48.93009363207303, 2.3564037680625916",Saint-Denis,93066,0.2727272727272727,14
42015,Place Jean Ferrat,OUI,23,18,5,2,3,OUI,OUI,2025-03-13 14:00:54+00:00,"48.8184945213025, 2.3744174838066106",Ivry-sur-Seine,94041,0.21739130434782608,14
15201,Place Amédée Gordini - Lefebvre,OUI,37,33,4,1,3,OUI,OUI,2025-03-13 13:56:59+00:00,"48.83061737745, 2.2920634208276",Paris,75056,0.10810810810810811,14
19008,Flandre - Alphonse Karr,OUI,26,24,2,1,1,OUI,OUI,2025-03-13 13:58:52+00:00,"48.89465, 2.381868",Paris,75056,0.07692307692307693,14
31010,Stalingrad - Désiré Chevalier,OUI,42,40,2,0,2,OUI,OUI,2025-03-13 13:56:50+00:00,"48.85670169739857, 2.445072233676911",Montreuil,93048,0.047619047619047616,14
92008,Hôtel de Ville de Nanterre,OUI,35,13,22,11,11,OUI,OUI,2025-03-13 14:01:39+00:00,"48.892371898250424, 2.205548956990242",Nanterre,92050,0.6285714285714286,14
11004,Charonne - Faubourg Saint-Antoine,OUI,32,12,20,15,5,OUI,OUI,2025-03-13 14:00:40+00:00,"48.852191909696, 2.3740932717919",Paris,75056,0.625,14
41402,Victor Hugo - Ecoles,OUI,22,11,11,8,3,OUI,OUI,2025-03-13 14:01:03+00:00,"48.80476007936134, 2.4180373930262093",Alfortville,94002,0.5,14
18201,Tristan Tzara -  Tchaïkovski,OUI,33,30,3,2,1,OUI,OUI,2025-03-13 13:58:08+00:00,"48.89490221746837, 2.3648490384221077",Paris,75056,0.09090909090909091,14
51004,Général Delambre - Prebuard,OUI,28,16,12,3,9,OUI,OUI,2025-03-13 13:56:44+00:00,"48.93870344444, 2.2234171606307",Argenteuil,95018,0.42857142857142855,14
18012,Stephenson - Doudeauville,OUI,35,28,7,2,5,OUI,OUI,2025-03-13 14:01:58+00:00,"48.888537048944826, 2.3561610281467438",Paris,75056,0.2,14
12009,Charenton - Diderot,OUI,18,10,8,2,6,OUI,OUI,2025-03-13 14:01:42+00:00,"48.846171461187, 2.3793068155646",Paris,75056,0.4444444444444444,14
14036,Boulard - Daguerre,OUI,43,41,2,0,2,OUI,OUI,2025-03-13 14:00:53+00:00,"48.83446472680611, 2.3293386027216907",Paris,75056,0.046511627906976744,14
19125,Place de l'Édit de Nantes,OUI,27,27,0,0,0,OUI,OUI,2025-03-13 13:56:48+00:00,"48.88879, 2.3785",Paris,75056,0.0,14
19205,Simon Bolivar - Henri Turot,OUI,23,22,1,1,0,OUI,OUI,2025-03-13 14:00:00+00:00,"48.877475489801, 2.3739709492211",Paris,75056,0.043478260869565216,14
5123,Saint-Germain - Thenard,OUI,29,2,27,12,15,OUI,OUI,2025-03-13 13:59:41+00:00,"48.850571, 2.3471015",Paris,75056,0.9310344827586207,14
11036,Jules Ferry - Faubourg du Temple Paris,OUI,56,24,32,27,5,OUI,OUI,2025-03-13 14:00:28+00:00,"48.868397, 2.3678933",Paris,75056,0.5714285714285714,14
9021,Saint Georges - d'Aumale,OUI,23,15,8,4,4,OUI,OUI,2025-03-13 14:01:32+00:00,"48.87778639599673, 2.337429821491241",Paris,75056,0.34782608695652173,14
43003,Hôpital Bégin,OUI,26,26,0,0,0,NON,NON,2025-03-13 13:59:51+00:00,"48.84571672113, 2.4272462725639",Vincennes,94080,0.0,14
23009,Anatole France - Louise Michel,OUI,47,42,5,1,4,OUI,OUI,2025-03-13 14:00:24+00:00,"48.88873214926474, 2.2881576418876652",Levallois-Perret,92044,0.10638297872340426,14
42029,Stalingrad - Germaine Tailleferre,OUI,28,25,3,0,3,OUI,OUI,2025-03-13 13:52:22+00:00,"48.80257200481316, 2.3786691203713417",Ivry-sur-Seine,94041,0.10714285714285714,14
12027,Montgallet - Charenton,OUI,15,2,13,12,1,OUI,OUI,2025-03-13 14:02:00+00:00,"48.842647778701, 2.3861649278137",Paris,75056,0.8666666666666667,14
8035,Bienfaisance - Place de Narvik,OUI,34,9,25,16,9,OUI,OUI,2025-03-13 14:01:56+00:00,"48.87660163459077, 2.3129771277308464",Paris,75056,0.7352941176470589,14
21313,Guynemer - Séverine,OUI,24,3,21,17,4,OUI,OUI,2025-03-13 14:00:23+00:00,"48.83091743371036, 2.2790706530213356",Issy-les-Moulineaux,92040,0.875,14
17102,Alfred Roll - Berthier,OUI,28,19,9,4,5,OUI,OUI,2025-03-13 13:54:58+00:00,"48.887808570529, 2.3000952981763",Paris,75056,0.32142857142857145,14
28001,Richard Wallace - Place du 8 Mai 1945,OUI,29,7,22,13,9,OUI,OUI,2025-03-13 14:01:48+00:00,"48.87866794788021, 2.2420343756675725",Puteaux,92062,0.7586206896551724,14
11007,Jean Macé - Faidherbe,OUI,57,52,5,0,5,OUI,OUI,2025-03-13 14:00:44+00:00,"48.85337548426, 2.3828620836139",Paris,75056,0.08771929824561403,14
26007,Square Gilbert Thomain,OUI,19,10,9,4,5,OUI,OUI,2025-03-13 13:59:59+00:00,"48.90717373809284, 2.2695400938391685",Asnières-sur-Seine,92004,0.47368421052631576,14
15025,Dupleix - du Guesclin,OUI,45,21,24,21,3,OUI,OUI,2025-03-13 14:00:03+00:00,"48.85147910413369, 2.296709530055523",Paris,75056,0.5333333333333333,14
16111,Faustin Hélie - Desbordes-Valmore,OUI,27,23,4,0,4,OUI,OUI,2025-03-13 13:57:30+00:00,"48.859403, 2.276522",Paris,75056,0.14814814814814814,14
18110,Departement - Pajol,OUI,16,14,2,1,1,OUI,OUI,2025-03-13 13:48:16+00:00,"48.886674849730184, 2.3613611608743668",Paris,75056,0.125,14
35018,Ancien Canal - Hélène Brion,OUI,23,22,1,1,0,OUI,OUI,2025-03-13 13:58:13+00:00,"48.89484799296163, 2.4188338592648506",Pantin,93055,0.043478260869565216,14
17011,Fragonard - Porte de Clichy,OUI,55,30,25,23,2,OUI,OUI,2025-03-13 13:59:58+00:00,"48.894155633419, 2.3143893107772",Paris,75056,0.45454545454545453,14
19005,Flandre - Riquet,OUI,20,17,3,1,2,OUI,OUI,2025-03-13 13:58:59+00:00,"48.888013281448, 2.3737595955229",Paris,75056,0.15,14
33018,Edouard Poisson - Victor Hugo,OUI,27,22,5,2,3,OUI,OUI,2025-03-13 13:54:44+00:00,"48.91118557052621, 2.379864752692811",Aubervilliers,93001,0.18518518518518517,14
10113,Parmentier - Hôpital Saint-Louis,OUI,41,36,5,3,2,OUI,OUI,2025-03-13 14:01:56+00:00,"48.871379874257, 2.3698963836667",Paris,75056,0.12195121951219512,14
11115,Montreuil - Gonnet,OUI,24,19,5,2,3,OUI,OUI,2025-03-13 13:55:54+00:00,"48.850500564921, 2.3890856287864",Paris,75056,0.20833333333333334,14
41606,Pasteur - Gambetta,OUI,19,9,10,7,3,OUI,OUI,2025-03-13 14:00:25+00:00,"48.84572797384512, 2.4236011505126953",Saint-Mandé,94067,0.5263157894736842,14
5021,Jussieu - Fossés Saint-Bernard,OUI,38,5,33,30,3,OUI,OUI,2025-03-13 14:01:54+00:00,"48.847185510023, 2.3534858599305",Paris,75056,0.868421052631579,14
17045,Place des Ternes.,OUI,44,44,0,0,0,OUI,OUI,2025-03-13 13:59:08+00:00,"48.878438631226516, 2.297727763652802",Paris,75056,0.0,14
16121,Jardin d'Acclimatation,OUI,30,23,7,5,2,OUI,OUI,2025-03-13 13:57:34+00:00,"48.878772242510465, 2.270772233605385",Paris,75056,0.23333333333333334,14
43402,Place de Verdun,OUI,40,20,20,19,1,OUI,OUI,2025-03-13 14:00:27+00:00,"48.8202823, 2.473775",Joinville-le-Pont,94042,0.5,14
15010,Square Cambronne,OUI,59,0,59,56,3,OUI,OUI,2025-03-13 14:00:57+00:00,"48.84756654526, 2.3025691509247",Paris,75056,1.0,14
12013,Montgallet - Reuilly,OUI,14,12,2,0,2,OUI,OUI,2025-03-13 14:01:35+00:00,"48.844291, 2.3896481",Paris,75056,0.14285714285714285,14
41102,Gare de Laplace,OUI,43,42,1,1,0,OUI,OUI,2025-03-13 13:56:40+00:00,"48.80893199114179, 2.3349460959434514",Arcueil,94003,0.023255813953488372,14
21305,Place Jacques Madaule,OUI,23,2,21,19,2,OUI,OUI,2025-03-13 14:01:46+00:00,"48.823933787309, 2.2606918215752",Issy-les-Moulineaux,92040,0.9130434782608695,14
18141,Clignancourt - Sofia,OUI,19,17,2,0,2,OUI,OUI,2025-03-13 14:01:56+00:00,"48.88511992309783, 2.34719488842051",Paris,75056,0.10526315789473684,14
7015,Varenne,OUI,44,17,27,21,6,OUI,OUI,2025-03-13 14:01:11+00:00,"48.857202661803, 2.3152771219611",Paris,75056,0.6136363636363636,14
16124,Route de Sèvres - Porte de Bagatelle,OUI,66,4,62,52,10,OUI,OUI,2025-03-13 14:00:08+00:00,"48.87525984132485, 2.249415814876557",Paris,75056,0.9393939393939394,14
33003,Bordier - Félix Faure,OUI,45,37,8,5,3,OUI,OUI,2025-03-13 13:58:44+00:00,"48.90390751882016, 2.3830059170722966",Aubervilliers,93001,0.17777777777777778,14
6013,Jacques Callot - Mazarine,OUI,27,4,23,20,3,OUI,OUI,2025-03-13 13:57:32+00:00,"48.855280175332, 2.3375743255019",Paris,75056,0.8518518518518519,14
25005,18 juin 1940 - Buzenval,OUI,25,18,7,4,3,OUI,OUI,2025-03-13 13:55:02+00:00,"48.868807, 2.185428",Rueil-Malmaison,92063,0.28,14
12115,Porte de Vincennes,OUI,32,26,6,3,3,OUI,OUI,2025-03-13 14:00:55+00:00,"48.846454, 2.415514",Paris,75056,0.1875,14
19115,Porte de la Villette,OUI,26,25,1,1,0,OUI,OUI,2025-03-13 13:56:38+00:00,"48.89835196548483, 2.386150136590004",Paris,75056,0.038461538461538464,14
8033,Commandant Rivière,OUI,38,2,36,22,14,OUI,OUI,2025-03-13 14:01:36+00:00,"48.872933, 2.309796",Paris,75056,0.9473684210526315,14
14034,Ouest - Château,OUI,23,23,0,0,0,OUI,OUI,2025-03-13 14:00:25+00:00,"48.83617286014242, 2.319392143923804",Paris,75056,0.0,14
23001,Paul Vaillant Couturier - Chaptal,OUI,36,7,29,19,10,OUI,OUI,2025-03-13 14:01:51+00:00,"48.893479576183, 2.2775253653526",Levallois-Perret,92044,0.8055555555555556,14
32010,Place aux Étoiles,OUI,37,9,28,4,24,OUI,OUI,2025-03-13 14:00:54+00:00,"48.91835629408464, 2.3523425683379173",Saint-Denis,93066,0.7567567567567568,14
17037,Bayen - Pereire,OUI,21,16,5,5,0,OUI,OUI,2025-03-13 14:01:31+00:00,"48.881804409079656, 2.2921088710427284",Paris,75056,0.23809523809523808,14
16018,Flandrin - Henri Martin,OUI,17,16,1,0,1,OUI,OUI,2025-03-13 14:02:00+00:00,"48.8643275, 2.2724174",Paris,75056,0.058823529411764705,14
33009,Félix Faure - Sadi Carnot,OUI,33,27,6,3,3,OUI,OUI,2025-03-13 13:58:29+00:00,"48.90812110228388, 2.378623187541962",Aubervilliers,93001,0.18181818181818182,14
15033,Place Violet,OUI,28,20,8,4,4,OUI,OUI,2025-03-13 14:00:57+00:00,"48.84487893836502, 2.2905756533145905",Paris,75056,0.2857142857142857,14
5106,Cujas - Saint-Michel,OUI,19,0,19,1,18,OUI,OUI,2025-03-13 13:59:44+00:00,"48.848191348584, 2.341831654854",Paris,75056,1.0,14
25008,Place du 8 Mai 1945,OUI,18,14,4,4,0,OUI,OUI,2025-03-13 14:01:21+00:00,"48.871552174017, 2.2025031970585",Rueil-Malmaison,92063,0.2222222222222222,14
22505,Mairie de La Garenne Colombes,OUI,22,16,6,5,1,OUI,OUI,2025-03-13 13:54:14+00:00,"48.90663823468682, 2.24679596722126",La Garenne-Colombes,92035,0.2727272727272727,14
33001,Victor Hugo - Magasins Généraux,OUI,34,23,11,4,7,OUI,OUI,2025-03-13 14:01:01+00:00,"48.903281401126755, 2.368072383105755",Aubervilliers,93001,0.3235294117647059,14
13045,Jean Colly - Tolbiac,OUI,35,28,7,1,6,OUI,OUI,2025-03-13 14:00:08+00:00,"48.827817291597846, 2.3705490678548813",Paris,75056,0.2,14
15122,Place Charles Vallin,OUI,26,23,3,1,2,OUI,OUI,2025-03-13 14:00:39+00:00,"48.835523812041, 2.3025986552238",Paris,75056,0.11538461538461539,14
12034,Pirogues de Bercy - Libourne,OUI,48,26,22,8,14,OUI,OUI,2025-03-13 13:59:59+00:00,"48.832308, 2.38637",Paris,75056,0.4583333333333333,14
92003,Chanzy - Sud-Est,OUI,25,25,0,0,0,OUI,OUI,2025-03-13 14:00:34+00:00,"48.888912037698766, 2.195632159709931",Nanterre,92050,0.0,14
19044,Grands Moulins de Pantin,OUI,50,43,7,4,3,OUI,OUI,2025-03-13 13:58:41+00:00,"48.89738369720229, 2.3959985375404362",Paris,75056,0.14,14
5119,Jussieu - Guy de la Brosse,OUI,38,11,27,22,5,OUI,OUI,2025-03-13 14:01:37+00:00,"48.845665, 2.355653",Paris,75056,0.7105263157894737,14
24002,Gare de Courbevoie,OUI,32,22,10,4,6,OUI,OUI,2025-03-13 13:57:17+00:00,"48.8993867, 2.2506506",Courbevoie,92026,0.3125,14
19019,Petit - Manin,OUI,22,22,0,0,0,NON,NON,2025-03-13 13:56:47+00:00,"48.886506875343, 2.3938155401308",Paris,75056,0.0,14
16034,Porte d'Auteuil,OUI,32,24,8,3,5,OUI,OUI,2025-03-13 14:01:55+00:00,"48.8479394142243, 2.2608396783471107",Paris,75056,0.25,14
27002,Parc Pierre Lagravère,OUI,30,10,20,9,11,OUI,OUI,2025-03-13 14:00:35+00:00,"48.92650488131725, 2.239069678491417",Colombes,92025,0.6666666666666666,14
41404,Carnot - Pâquerettes,OUI,23,4,19,19,0,OUI,OUI,2025-03-13 14:01:32+00:00,"48.79592939432515, 2.4261841177940373",Alfortville,94002,0.8260869565217391,14
23701,Parvis Robert Schuman - Roger Salengro,OUI,24,15,9,2,7,OUI,OUI,2025-03-13 14:00:11+00:00,"48.812657470558754, 2.1921751275658607",Chaville,92022,0.375,14
7009,Assemblée Nationale,OUI,75,4,71,32,39,OUI,OUI,2025-03-13 13:58:05+00:00,"48.861411014652, 2.3201214185208",Paris,75056,0.9466666666666667,14
12024,Gare de Bercy,OUI,35,12,23,21,2,OUI,OUI,2025-03-13 14:01:34+00:00,"48.839794573906, 2.3826066032052",Paris,75056,0.6571428571428571,14
20132,Réunion - Avron,OUI,26,24,2,1,1,OUI,OUI,2025-03-13 13:54:31+00:00,"48.852566752033766, 2.403928068708116",Paris,75056,0.07692307692307693,14
16129,Ceinture du Lac Inferieure - Saint-Cloud,OUI,41,39,2,0,2,OUI,OUI,2025-03-13 13:56:35+00:00,"48.86218070933143, 2.2617871686816216",Paris,75056,0.04878048780487805,14
42707,Place Jean-Baptiste Clément,OUI,23,21,2,0,2,OUI,OUI,2025-03-13 13:55:20+00:00,"48.81240466867336, 2.3617091774940495",Le Kremlin-Bicêtre,94043,0.08695652173913043,14
20119,Square des Saint-Simoniens,OUI,25,24,1,0,1,OUI,OUI,2025-03-13 13:58:44+00:00,"48.8701796, 2.3967273",Paris,75056,0.04,14
35009,Jean Lolive - Parc Stalingrad,OUI,22,20,2,1,1,OUI,OUI,2025-03-13 14:01:49+00:00,"48.89206174403158, 2.4091735482215886",Pantin,93055,0.09090909090909091,14
31705,Champeaux - Gallieni,OUI,47,44,3,0,3,OUI,OUI,2025-03-13 13:55:22+00:00,"48.864459134684644, 2.4161778017878532",Bagnolet,93006,0.06382978723404255,14
8055,Courcelles - Place des Ternes,OUI,29,23,6,4,2,OUI,OUI,2025-03-13 13:58:29+00:00,"48.878199928923124, 2.2992860188665043",Paris,75056,0.20689655172413793,14
23802,Raymond Poincaré - Allée de la Marche,OUI,22,14,8,7,1,OUI,OUI,2025-03-13 13:59:17+00:00,"48.838634069623, 2.1724102640451",Garches,92033,0.36363636363636365,14
21109,Guichet - Jean Jaurès,OUI,23,19,4,2,2,OUI,OUI,2025-03-13 13:57:02+00:00,"48.905169868129036, 2.3023840785026555",Clichy,92024,0.17391304347826086,14
20036,Ménilmontant - Pelleport,OUI,31,30,1,0,1,OUI,OUI,2025-03-13 14:00:16+00:00,"48.870682633845, 2.3989596023316",Paris,75056,0.03225806451612903,14
17007,Navier - Epinettes,OUI,36,30,6,4,2,OUI,OUI,2025-03-13 13:53:22+00:00,"48.89587780769155, 2.3226776719093327",Paris,75056,0.16666666666666666,14
15029,Emeriau - Place de Brazzaville,OUI,51,16,35,34,1,OUI,OUI,2025-03-13 14:01:31+00:00,"48.850785261674964, 2.2871585190296173",Paris,75056,0.6862745098039216,14
21502,Verdun - Place Henri IV,OUI,26,8,18,14,4,OUI,OUI,2025-03-13 14:01:08+00:00,"48.870797375639214, 2.2277003154158592",Suresnes,92073,0.6923076923076923,14
92004,Nanterre - Université,OUI,19,9,10,8,2,OUI,OUI,2025-03-13 13:56:10+00:00,"48.901365, 2.212693",Nanterre,92050,0.5263157894736842,14
31012,Place Carnot,OUI,23,21,2,0,2,OUI,OUI,2025-03-13 13:57:47+00:00,"48.85593932186797, 2.441531717777252",Montreuil,93048,0.08695652173913043,14
20136,Henri Chevreau - Couronnes,OUI,26,23,3,1,2,OUI,OUI,2025-03-13 13:57:40+00:00,"48.87033205312931, 2.388777695596218",Paris,75056,0.11538461538461539,14
35019,Anatole France - Jean Lolive,OUI,27,26,1,1,0,OUI,OUI,2025-03-13 14:00:45+00:00,"48.8949922, 2.4253764",Pantin,93055,0.037037037037037035,14
5026,Pascal - Claude Bernard,OUI,48,23,25,23,2,OUI,OUI,2025-03-13 13:59:18+00:00,"48.839061952159746, 2.3499782010912895",Paris,75056,0.5208333333333334,14
14104,Boyer-Barret - Raymond Losserand,OUI,22,20,2,0,2,OUI,OUI,2025-03-13 13:56:23+00:00,"48.83329880233322, 2.3173383995890617",Paris,75056,0.09090909090909091,14
5002,Sommerard - Saint-Jacques,OUI,34,4,30,25,5,OUI,OUI,2025-03-13 13:58:25+00:00,"48.850310432924466, 2.345015835298588",Paris,75056,0.8823529411764706,14
20113,Piat - Parc de Belleville,OUI,21,17,4,0,4,OUI,OUI,2025-03-13 14:00:52+00:00,"48.87195626635528, 2.384981390278095",Paris,75056,0.19047619047619047,14
15028,Grenelle - Dr Finlay,OUI,71,9,62,60,2,OUI,OUI,2025-03-13 14:01:53+00:00,"48.851315406715976, 2.2919502854347233",Paris,75056,0.8732394366197183,14
6030,Assas - Vaugirard,OUI,34,13,21,8,13,OUI,OUI,2025-03-13 14:01:24+00:00,"48.848274111398, 2.3292413726449",Paris,75056,0.6176470588235294,14
8102,Lamennais - Washington,OUI,25,2,23,11,12,OUI,OUI,2025-03-13 14:01:13+00:00,"48.87352990026496, 2.303444892168045",Paris,75056,0.92,14
12126,Gravelle - Route du Bac,OUI,49,42,7,5,2,OUI,OUI,2025-03-13 14:01:17+00:00,"48.824407, 2.418455",Paris,75056,0.14285714285714285,14
14018,Porte d'Orléans,OUI,45,42,3,0,3,OUI,OUI,2025-03-13 14:01:04+00:00,"48.8227639, 2.3249313",Paris,75056,0.06666666666666667,14
41604,Lagny - Joffre,OUI,30,12,18,13,5,OUI,OUI,2025-03-13 14:01:16+00:00,"48.84930687084088, 2.417949736118317",Saint-Mandé,94067,0.6,14
31702,Pierre et Marie Curie - Julien Grimau,OUI,18,15,3,0,3,OUI,OUI,2025-03-13 14:01:44+00:00,"48.870714014863225, 2.424097023904324",Bagnolet,93006,0.16666666666666666,14
15017,Place Falguière,OUI,23,22,1,0,1,OUI,OUI,2025-03-13 13:56:32+00:00,"48.83629973941847, 2.3104464635252953",Paris,75056,0.043478260869565216,14
7004,Raspail - Varenne,OUI,16,11,5,2,3,OUI,OUI,2025-03-13 14:00:12+00:00,"48.853147816545, 2.3263905197382",Paris,75056,0.3125,14
17018,Parc Monceau,OUI,18,6,12,9,3,OUI,OUI,2025-03-13 13:54:46+00:00,"48.881077914129, 2.3095492646098",Paris,75056,0.6666666666666666,14
21013,Pierre Grenier - Pont de Billancourt,OUI,21,19,2,2,0,OUI,OUI,2025-03-13 13:53:38+00:00,"48.8258020742942, 2.2487989068031315",Boulogne-Billancourt,92012,0.09523809523809523,14
18005,Tardieu - Chappe,OUI,16,15,1,0,1,OUI,OUI,2025-03-13 13:56:41+00:00,"48.884146759782, 2.341845408082",Paris,75056,0.0625,14
21111,Professeur René Leriche - Général Leclerc,OUI,50,36,14,13,1,OUI,OUI,2025-03-13 13:55:23+00:00,"48.90782845483013, 2.307887971401215",Clichy,92024,0.28,14
10005,Petites Ecuries - Faubourg Poissonnière,OUI,16,6,10,9,1,OUI,OUI,2025-03-13 14:01:04+00:00,"48.87397217237368, 2.348388757504776",Paris,75056,0.625,14
2010,Uzès - Montmartre,OUI,26,2,24,12,12,OUI,OUI,2025-03-13 14:01:13+00:00,"48.870790980240706, 2.3431010171771054",Paris,75056,0.9230769230769231,14
26001,Gare d'Asnières sur Seine,OUI,21,6,15,12,3,OUI,OUI,2025-03-13 14:01:46+00:00,"48.90636459217474, 2.2835066914558415",Asnières-sur-Seine,92004,0.7142857142857143,14
5116,Place Valhubert,OUI,51,0,51,45,6,OUI,OUI,2025-03-13 14:01:59+00:00,"48.844182577315, 2.3640366643667",Paris,75056,1.0,14
18020,Francoeur - Marcadet,OUI,20,20,0,0,0,OUI,OUI,2025-03-13 13:57:43+00:00,"48.89104123261663, 2.340014585442034",Paris,75056,0.0,14
7006,Quai Voltaire,OUI,31,5,26,24,2,OUI,OUI,2025-03-13 14:01:21+00:00,"48.858942986179, 2.3314182047146",Paris,75056,0.8387096774193549,14
43006,Vignerons - Minimes,OUI,29,19,10,10,0,OUI,OUI,2025-03-13 13:58:59+00:00,"48.841486, 2.430793",Vincennes,94080,0.3448275862068966,14
20040,Parc de Belleville - Julien Lacroix,OUI,26,24,2,0,2,OUI,OUI,2025-03-13 13:57:29+00:00,"48.8703459, 2.3842214",Paris,75056,0.07692307692307693,14
42503,Vladimir Ilitch Lénine - Andrée Chedid,OUI,31,29,2,0,2,OUI,OUI,2025-03-13 14:00:24+00:00,"48.813240124373, 2.3319716067039",Gentilly,94037,0.06451612903225806,14
17017,Gare de Pont-Cardinet,OUI,31,27,4,1,3,OUI,OUI,2025-03-13 14:01:23+00:00,"48.88713901475306, 2.314494143994255",Paris,75056,0.12903225806451613,14
11114,Ledru-Rollin - Charonne,OUI,32,12,20,16,4,OUI,OUI,2025-03-13 14:01:00+00:00,"48.85345855607243, 2.3772463581947094",Paris,75056,0.625,14
10023,Gare de l'Est - Verdun,OUI,13,9,4,1,3,OUI,OUI,2025-03-13 13:59:35+00:00,"48.876156054271, 2.3609149083206",Paris,75056,0.3076923076923077,14
7014,Saint-François-Xavier,OUI,42,2,40,27,13,OUI,OUI,2025-03-13 14:00:51+00:00,"48.85154484769, 2.3146149516106",Paris,75056,0.9523809523809523,14
34002,Capitaine Glarner - Gabriel Péri,OUI,24,18,6,4,2,OUI,OUI,2025-03-13 13:59:16+00:00,"48.902449900418745, 2.3304807533425724",Saint-Ouen-sur-Seine,93070,0.25,14
8012,Batignolles - Place de Clichy,OUI,46,42,4,2,2,OUI,OUI,2025-03-13 13:59:52+00:00,"48.883474535757, 2.326493114233",Paris,75056,0.08695652173913043,14
13026,Place Jean Delay,OUI,33,31,2,0,2,OUI,OUI,2025-03-13 14:01:14+00:00,"48.823316, 2.354336",Paris,75056,0.06060606060606061,14
14139,Pierre Larousse - Raymond Losserand,OUI,30,27,3,1,2,OUI,OUI,2025-03-13 13:59:57+00:00,"48.83059564231877, 2.3119183257222176",Paris,75056,0.1,14
23002,Pont de Levallois-bécon,OUI,49,17,32,19,13,OUI,OUI,2025-03-13 14:01:41+00:00,"48.8984179, 2.2791311",Levallois-Perret,92044,0.6530612244897959,14
13102,Pitié-Salpêtrière,OUI,49,17,32,17,15,OUI,OUI,2025-03-13 14:01:38+00:00,"48.83748810318667, 2.365213818848133",Paris,75056,0.6530612244897959,14
14130,Jonquoy - Didot,OUI,30,25,5,1,4,OUI,OUI,2025-03-13 13:58:12+00:00,"48.82890454823947, 2.31648076325655",Paris,75056,0.16666666666666666,14
11101,Charles Delescluze,OUI,48,22,26,26,0,OUI,OUI,2025-03-13 14:00:53+00:00,"48.85242200848887, 2.380632497370243",Paris,75056,0.5416666666666666,14
41207,Place du Général de Gaulle,OUI,28,15,13,0,13,OUI,OUI,2025-03-13 14:01:07+00:00,"48.8525288, 2.4877332",Fontenay-sous-Bois,94033,0.4642857142857143,14
15055,Vasco de Gama,OUI,54,24,30,25,5,OUI,OUI,2025-03-13 14:00:48+00:00,"48.83671783466264, 2.283664085650799",Paris,75056,0.5555555555555556,14
12011,Charenton - Place du Col Bourgoin,OUI,35,19,16,10,6,OUI,OUI,2025-03-13 14:01:24+00:00,"48.844867319554, 2.3825789350545",Paris,75056,0.45714285714285713,14
10015,Lucien Sampaix - Récollets,OUI,41,35,6,2,4,OUI,OUI,2025-03-13 14:00:01+00:00,"48.874330377560476, 2.3621229082345963",Paris,75056,0.14634146341463414,14
21308,Bara - Henri Farman,OUI,58,4,54,35,19,OUI,OUI,2025-03-13 14:00:04+00:00,"48.833218027457846, 2.2677567601203923",Issy-les-Moulineaux,92040,0.9310344827586207,14
12032,Porte Dorée,OUI,35,14,21,16,5,OUI,OUI,2025-03-13 14:01:57+00:00,"48.8354337, 2.4077132",Paris,75056,0.6,14
6103,Mézières - Rennes,OUI,53,46,7,2,5,OUI,OUI,2025-03-13 14:01:12+00:00,"48.85023459321703, 2.3303819820284843",Paris,75056,0.1320754716981132,14
19037,Belleville - Porte des Lilas,OUI,29,27,2,0,2,OUI,OUI,2025-03-13 13:55:23+00:00,"48.87660391892763, 2.404769691129476",Paris,75056,0.06896551724137931,14
6018,Michelet - Assas,OUI,16,5,11,5,6,OUI,OUI,2025-03-13 13:58:21+00:00,"48.842741502832, 2.3350211977959",Paris,75056,0.6875,14
15038,Place Adolphe Cherioux - Vaugirard,OUI,62,58,4,0,4,OUI,OUI,2025-03-13 13:59:15+00:00,"48.83959442800459, 2.3010657727718353",Paris,75056,0.06451612903225806,14
21105,Morice - Général Leclerc,OUI,25,20,5,4,1,OUI,OUI,2025-03-13 13:59:36+00:00,"48.90245471981591, 2.3128929734230046",Clichy,92024,0.2,14
21032,Sèvres-Gallieni,OUI,25,4,21,14,7,OUI,OUI,2025-03-13 14:01:26+00:00,"48.837809408957, 2.2281519323587",Boulogne-Billancourt,92012,0.84,14
18032,Porte de Clignancourt.,OUI,55,54,1,0,1,OUI,OUI,2025-03-13 13:55:31+00:00,"48.897488, 2.343996",Paris,75056,0.01818181818181818,14
20021,Indre - Prairies,OUI,38,36,2,0,2,OUI,OUI,2025-03-13 13:54:31+00:00,"48.86254398506782, 2.403290458023548",Paris,75056,0.05263157894736842,14
44012,Génie - Mozart,OUI,18,17,1,1,0,OUI,OUI,2025-03-13 13:54:07+00:00,"48.794902381218904, 2.3734183609485626",Vitry-sur-Seine,94081,0.05555555555555555,14
7005,Raspail - Bac,OUI,51,9,42,27,15,OUI,OUI,2025-03-13 14:01:58+00:00,"48.855628721101, 2.3256602883339",Paris,75056,0.8235294117647058,14
31016,Lucie Aubrac - Franklin,OUI,35,34,1,1,0,OUI,OUI,2025-03-13 13:56:54+00:00,"48.86223916006812, 2.4435862898826604",Montreuil,93048,0.02857142857142857,14
21019,Edouard Vaillant - Paul-Adolphe Souriau,OUI,26,2,24,18,6,OUI,OUI,2025-03-13 14:00:14+00:00,"48.834845858829, 2.2479459643364",Boulogne-Billancourt,92012,0.9230769230769231,14
13016,Primo Levi - Frigos,OUI,33,2,31,25,6,OUI,OUI,2025-03-13 14:01:24+00:00,"48.83094844846017, 2.37965351592796",Paris,75056,0.9393939393939394,14
19109,Tanger - Place du Maroc,OUI,19,18,1,1,0,OUI,OUI,2025-03-13 13:56:21+00:00,"48.8862524447104, 2.3689296841621403",Paris,75056,0.05263157894736842,14
19039,Edouard Pailleron - Simon Bolivar,OUI,23,23,0,0,0,OUI,OUI,2025-03-13 13:59:44+00:00,"48.87979886049996, 2.374839261174202",Paris,75056,0.0,14
31019,Vincennes - Douy-Delcupe,OUI,37,36,1,0,1,OUI,OUI,2025-03-13 13:57:07+00:00,"48.85493692155721, 2.436049282550812",Montreuil,93048,0.02702702702702703,14
9023,Laffitte - Italiens,OUI,31,0,31,18,13,OUI,OUI,2025-03-13 13:58:58+00:00,"48.871815737396, 2.3372015478451",Paris,75056,1.0,14
32014,Place du Cornillon - Stade de France,OUI,33,3,30,21,9,OUI,OUI,2025-03-13 14:02:00+00:00,"48.92540695835961, 2.3644426837563515",Saint-Denis,93066,0.9090909090909091,14
19040,Belleville - Télégraphe,OUI,40,40,0,0,0,OUI,OUI,2025-03-13 13:55:05+00:00,"48.8756045, 2.3995549",Paris,75056,0.0,14
17124,Porte de Saint-Ouen - Henri Huchard,OUI,26,9,17,15,2,OUI,OUI,2025-03-13 14:01:30+00:00,"48.898708366365064, 2.3295360803604126",Paris,75056,0.6538461538461539,14
17046,Mac-Mahon - Brey,OUI,24,16,8,5,3,OUI,OUI,2025-03-13 14:01:51+00:00,"48.877532084130166, 2.294512536052928",Paris,75056,0.3333333333333333,14
17027,Place du Maréchal Juin - Péreire,OUI,44,22,22,19,3,OUI,OUI,2025-03-13 14:01:12+00:00,"48.885263, 2.298286",Paris,75056,0.5,14
17121,Square des Epinettes,OUI,20,16,4,0,4,OUI,OUI,2025-03-13 13:59:16+00:00,"48.89383909781389, 2.325953990221024",Paris,75056,0.2,14
51003,Hôtel de Ville d'Argenteuil,OUI,29,12,17,11,6,OUI,OUI,2025-03-13 13:54:56+00:00,"48.946504, 2.2496396",Argenteuil,95018,0.5862068965517241,14
16021,François Ponsard - La Muette,OUI,23,21,2,0,2,OUI,OUI,2025-03-13 13:57:38+00:00,"48.8583666, 2.2744515",Paris,75056,0.08695652173913043,14
22101,Gare Routière de Saint Cloud,OUI,30,9,21,14,7,OUI,OUI,2025-03-13 14:01:01+00:00,"48.84288183896324, 2.222245037555695",Saint-Cloud,92064,0.7,14
9031,Provence - Chaussée d'Antin,OUI,25,4,21,12,9,OUI,OUI,2025-03-13 13:59:15+00:00,"48.87428447542072, 2.332976511564311",Paris,75056,0.84,14
13043,Dunois - Clisson,OUI,50,47,3,2,1,OUI,OUI,2025-03-13 13:57:16+00:00,"48.832294, 2.3674523",Paris,75056,0.06,14
18049,Porte d'Aubervilliers,OUI,53,44,9,6,3,OUI,OUI,2025-03-13 13:58:44+00:00,"48.89859661942376, 2.3689722642302513",Paris,75056,0.16981132075471697,14
8051,Batignolles - Rome,OUI,11,7,4,0,4,OUI,OUI,2025-03-13 13:59:38+00:00,"48.881823370566806, 2.3202589899301524",Paris,75056,0.36363636363636365,14
10020,Chabrol - d'Hauteville,OUI,11,10,1,0,1,OUI,OUI,2025-03-13 14:00:53+00:00,"48.877018388033, 2.3513179644942",Paris,75056,0.09090909090909091,14
2009,Filles Saint-Thomas - Place de la Bourse,OUI,58,4,54,22,32,OUI,OUI,2025-03-13 14:01:56+00:00,"48.868899890853, 2.3397543845203",Paris,75056,0.9310344827586207,14
18113,Lepic - Armée d'Orient,OUI,24,24,0,0,0,OUI,OUI,2025-03-13 13:54:47+00:00,"48.887536403814, 2.3343077301979",Paris,75056,0.0,14
44102,Verdun - Adrien Damalix,OUI,26,19,7,5,2,OUI,OUI,2025-03-13 13:59:38+00:00,"48.8222334178559, 2.4215328320860863",Saint-Maurice,94069,0.2692307692307692,14
9115,Milton - Manuel,OUI,21,19,2,0,2,OUI,OUI,2025-03-13 13:55:32+00:00,"48.878249, 2.341181",Paris,75056,0.09523809523809523,14
35003,Gabrielle Josserand - Edouard Vaillant,OUI,24,23,1,0,1,OUI,OUI,2025-03-13 13:57:01+00:00,"48.90271566255436, 2.3933270573616032",Pantin,93055,0.041666666666666664,14
16032,Eglise d'Auteuil,OUI,21,18,3,0,3,OUI,OUI,2025-03-13 14:00:38+00:00,"48.84749841771691, 2.26848387135299",Paris,75056,0.14285714285714285,14
15031,Théâtre - Lourmel,OUI,52,10,42,37,5,OUI,OUI,2025-03-13 13:59:57+00:00,"48.8482070397636, 2.2898658737540245",Paris,75056,0.8076923076923077,14
21003,Jean Jaurès - Jean Baptiste Clément,OUI,39,26,13,7,6,OUI,OUI,2025-03-13 13:59:46+00:00,"48.84576261454011, 2.2369650006294255",Boulogne-Billancourt,92012,0.3333333333333333,14
19127,Aubervilliers - Curial,OUI,23,19,4,1,3,OUI,OUI,2025-03-13 14:00:34+00:00,"48.89088305227546, 2.3688579350709915",Paris,75056,0.17391304347826086,14
22001,Château - Bineau,OUI,21,2,19,9,10,OUI,OUI,2025-03-13 14:01:35+00:00,"48.890404028589806, 2.270106375217438",Neuilly-sur-Seine,92051,0.9047619047619048,14
15070,Balard - Montagne de la Fage,OUI,35,4,31,28,3,OUI,OUI,2025-03-13 13:59:59+00:00,"48.83850740333351, 2.2782871127128606",Paris,75056,0.8857142857142857,14
18025,Mairie du 18ème,OUI,40,38,2,0,2,OUI,OUI,2025-03-13 14:00:30+00:00,"48.892939296937605, 2.3445510864257812",Paris,75056,0.05,14
1120,Lavandieres Sainte Opportune - Rivoli,OUI,25,2,23,18,5,OUI,OUI,2025-03-13 14:00:51+00:00,"48.859279702476, 2.3466217517853",Paris,75056,0.92,14
17122,Bridaine - Lamandé,OUI,28,23,5,1,4,OUI,OUI,2025-03-13 14:01:07+00:00,"48.8862074, 2.3206239",Paris,75056,0.17857142857142858,14
47004,Stade Auguste Delaune,OUI,21,3,18,18,0,OUI,OUI,2025-03-13 13:59:34+00:00,"48.80896378683884, 2.4345204234123234",Maisons-Alfort,94046,0.8571428571428571,14
20027,Porte de Ménilmontant,OUI,15,15,0,0,0,OUI,OUI,2025-03-13 13:59:20+00:00,"48.8691543609174, 2.40932246879487",Paris,75056,0.0,14
9026,Jean-Baptiste Pigalle - La Bruyere,OUI,17,11,6,0,6,OUI,OUI,2025-03-13 14:01:09+00:00,"48.87939826447722, 2.333709173337285",Paris,75056,0.35294117647058826,14
14122,Colonel Monteil - Brune,OUI,19,18,1,1,0,OUI,OUI,2025-03-13 13:57:41+00:00,"48.82650293311, 2.3092747998272",Paris,75056,0.05263157894736842,14
21001,Transvaal - Charles de Gaulle,OUI,27,19,8,6,2,OUI,OUI,2025-03-13 13:58:46+00:00,"48.848280403628806, 2.2373420120857195",Boulogne-Billancourt,92012,0.2962962962962963,14
16123,Mahatma Gandhi,OUI,24,2,22,14,8,OUI,OUI,2025-03-13 13:58:38+00:00,"48.876356, 2.264205",Paris,75056,0.9166666666666666,14
18033,Belliard - Damrémont,OUI,34,33,1,1,0,OUI,OUI,2025-03-13 13:54:47+00:00,"48.89669238777841, 2.338023450388167",Paris,75056,0.029411764705882353,14
31007,Paris - Désiré Préaux,OUI,44,36,8,3,5,OUI,OUI,2025-03-13 14:01:44+00:00,"48.85742876694898, 2.4323049187660217",Montreuil,93048,0.18181818181818182,14
11010,Boulets - Faubourg Saint-Antoine,OUI,42,42,0,0,0,OUI,OUI,2025-03-13 14:00:14+00:00,"48.849259262115, 2.3917546141943",Paris,75056,0.0,14
15108,Lourmel - Marie Skobtsov,OUI,22,16,6,4,2,OUI,OUI,2025-03-13 13:57:55+00:00,"48.844974, 2.287283",Paris,75056,0.2727272727272727,14
21310,Kléber - Gouverneur Général Eboué,OUI,22,0,22,16,6,OUI,OUI,2025-03-13 13:57:46+00:00,"48.826885843069796, 2.2723413258790965",Issy-les-Moulineaux,92040,1.0,14
17047,Courcelles - Pierre Demours,OUI,26,7,19,11,8,OUI,OUI,2025-03-13 14:01:30+00:00,"48.883769733273496, 2.29858466343129",Paris,75056,0.7307692307692307,14
23007,Président Wilson - Jean Jaures,OUI,25,15,10,5,5,OUI,OUI,2025-03-13 14:00:47+00:00,"48.89034054052266, 2.2920683026313786",Levallois-Perret,92044,0.4,14
6016,Danton - Serpente,OUI,21,2,19,18,1,OUI,OUI,2025-03-13 13:59:17+00:00,"48.852297362582, 2.3414132371545",Paris,75056,0.9047619047619048,14
20016,Pyrénées - Maraîchers,OUI,32,31,1,0,1,OUI,OUI,2025-03-13 13:55:49+00:00,"48.85714001395299, 2.4043509364128113",Paris,75056,0.03125,14
41204,République - Danton,OUI,19,18,1,0,1,OUI,OUI,2025-03-13 14:00:47+00:00,"48.85249172181667, 2.462034523487091",Fontenay-sous-Bois,94033,0.05263157894736842,14
20116,Haies - Réunion,OUI,20,19,1,0,1,OUI,OUI,2025-03-13 13:59:38+00:00,"48.85386896766491, 2.402426162238911",Paris,75056,0.05,14
19009,Cité des Sciences et de l'Industrie,OUI,27,16,11,4,7,OUI,OUI,2025-03-13 14:00:01+00:00,"48.89659571178903, 2.384599149227142",Paris,75056,0.4074074074074074,14
18008,Square Léon,OUI,33,31,2,0,2,OUI,OUI,2025-03-13 13:58:53+00:00,"48.88667396788626, 2.353205569088459",Paris,75056,0.06060606060606061,14
18109,Pajol - Riquet,OUI,45,42,3,0,3,OUI,OUI,2025-03-13 13:59:49+00:00,"48.88960028134536, 2.3628534749150276",Paris,75056,0.06666666666666667,14
7008,Villersexel - Saint-Germain,OUI,16,6,10,6,4,OUI,OUI,2025-03-13 13:59:34+00:00,"48.858297001218, 2.3237934708595",Paris,75056,0.625,14
19038,Lassus - Delouvain,OUI,19,17,2,1,1,OUI,OUI,2025-03-13 14:01:59+00:00,"48.8755044846, 2.3890327325519",Paris,75056,0.10526315789473684,14
16112,Chernoviz - Raynouard,OUI,36,32,4,0,4,OUI,OUI,2025-03-13 14:00:40+00:00,"48.8569864146289, 2.282173218142987",Paris,75056,0.1111111111111111,14
18029,Emile Blemont - Poteau,OUI,39,37,2,1,1,OUI,OUI,2025-03-13 14:01:49+00:00,"48.8943782, 2.3415122",Paris,75056,0.05128205128205128,14
42703,Fontainebleau - Edmond Michelet,OUI,45,43,2,1,1,OUI,OUI,2025-03-13 13:57:28+00:00,"48.80956436844049, 2.3626908659935",Le Kremlin-Bicêtre,94043,0.044444444444444446,14
21703,Square du Carrefour de l'Insurrection,OUI,20,19,1,0,1,OUI,OUI,2025-03-13 13:58:36+00:00,"48.820864559770676, 2.291113436222077",Vanves,92075,0.05,14
14030,Pernety - Raymond Losserand,OUI,32,32,0,0,0,OUI,OUI,2025-03-13 13:56:10+00:00,"48.834254627953, 2.317609339387",Paris,75056,0.0,14
35017,Toffier Decaux - Cartier Bresson,OUI,18,17,1,0,1,OUI,OUI,2025-03-13 13:57:59+00:00,"48.90165072551549, 2.4017545580863957",Pantin,93055,0.05555555555555555,14
13046,Eugène Oudiné - Dessous Des Berges,OUI,44,18,26,19,7,OUI,OUI,2025-03-13 14:01:39+00:00,"48.8256423, 2.3750226",Paris,75056,0.5909090909090909,14
20118,Orteaux - Mouraud,OUI,24,22,2,0,2,OUI,OUI,2025-03-13 14:01:40+00:00,"48.85558642847872, 2.408762907764669",Paris,75056,0.08333333333333333,14
7020,Champ de Mars - Cler,OUI,39,14,25,22,3,OUI,OUI,2025-03-13 14:01:39+00:00,"48.856691550115315, 2.306646779179573",Paris,75056,0.6410256410256411,14
9117,Bellefond - Maubeuge,OUI,28,26,2,0,2,OUI,OUI,2025-03-13 13:55:05+00:00,"48.878255397645, 2.3452642187476",Paris,75056,0.07142857142857142,14
10036,Aqueduc - Villette,OUI,24,19,5,1,4,OUI,OUI,2025-03-13 14:01:42+00:00,"48.883886063895, 2.367198803315",Paris,75056,0.20833333333333334,14
20023,Pelleport - Belgrand,OUI,14,12,2,0,2,OUI,OUI,2025-03-13 13:55:59+00:00,"48.86500081847653, 2.403980836377493",Paris,75056,0.14285714285714285,14
23304,Mairie de Sceaux,OUI,33,31,2,1,1,OUI,OUI,2025-03-13 14:01:23+00:00,"48.778916905132, 2.2887361764861",Sceaux,92071,0.06060606060606061,14
14002,Edgar Quinet - Raspail,OUI,44,37,7,0,7,OUI,OUI,2025-03-13 14:00:07+00:00,"48.83940266673835, 2.32971478253603",Paris,75056,0.1590909090909091,14
12161,Diderot - Reuilly,OUI,44,9,35,32,3,OUI,OUI,2025-03-13 13:59:52+00:00,"48.847208456061, 2.3861273378134",Paris,75056,0.7954545454545454,14
15035,Place Etienne Pernet,OUI,43,15,28,25,3,OUI,OUI,2025-03-13 14:01:16+00:00,"48.84243457133779, 2.2921819612383847",Paris,75056,0.6511627906976745,14
15107,Palais des Sports,OUI,20,0,20,17,3,OUI,OUI,2025-03-13 14:01:54+00:00,"48.833468517426, 2.2858720645308",Paris,75056,1.0,14
11041,Square Saint-Ambroise,OUI,39,0,39,31,8,OUI,OUI,2025-03-13 14:01:13+00:00,"48.860934, 2.375841",Paris,75056,1.0,14
9101,Cadet - La Fayette,OUI,18,0,18,12,6,OUI,OUI,2025-03-13 14:01:44+00:00,"48.875601632672, 2.3435704037547",Paris,75056,1.0,14
31703,Sadi Carnot - François Mitterrand,OUI,26,21,5,1,4,OUI,OUI,2025-03-13 13:58:05+00:00,"48.87532687671517, 2.4241617321968083",Bagnolet,93006,0.19230769230769232,14
19041,Belleville - Pyrénées,OUI,38,37,1,0,1,OUI,OUI,2025-03-13 13:58:49+00:00,"48.8741908, 2.3860039",Paris,75056,0.02631578947368421,14
21014,Hameau Fleuri - Marché,OUI,21,2,19,7,12,OUI,OUI,2025-03-13 14:01:14+00:00,"48.831448892608314, 2.2412404417991643",Boulogne-Billancourt,92012,0.9047619047619048,14
11043,Place Pasdeloup,OUI,20,3,17,16,1,OUI,OUI,2025-03-13 13:58:33+00:00,"48.862654215631, 2.3670325062844",Paris,75056,0.85,14
5121,Square René Viviani - Montebello,OUI,33,5,28,28,0,OUI,OUI,2025-03-13 14:01:38+00:00,"48.851904891406, 2.3478421568871",Paris,75056,0.8484848484848485,14
13010,Place d'Italie - Vincent Auriol,OUI,39,35,4,1,3,OUI,OUI,2025-03-13 14:00:49+00:00,"48.831481874467, 2.3567550292319",Paris,75056,0.10256410256410256,14
11006,Ledru-Rollin - Place du Père Chaillet,OUI,37,14,23,17,6,OUI,OUI,2025-03-13 13:59:47+00:00,"48.856433706943704, 2.379020587761426",Paris,75056,0.6216216216216216,14
15059,Parc André Citroën,OUI,64,9,55,52,3,OUI,OUI,2025-03-13 14:02:00+00:00,"48.840639944296655, 2.2780618071556096",Paris,75056,0.859375,14
47005,Ecole Vétérinaire,OUI,35,17,18,16,2,OUI,OUI,2025-03-13 14:01:37+00:00,"48.81488859822486, 2.4224362157778994",Maisons-Alfort,94046,0.5142857142857142,14
4013,Vieille du Temple - Francs Bourgeois,OUI,28,2,26,23,3,OUI,OUI,2025-03-13 14:01:04+00:00,"48.858256413365815, 2.35821794718504",Paris,75056,0.9285714285714286,14
16015,Bassano -  Iéna,OUI,15,6,9,1,8,OUI,OUI,2025-03-13 13:57:51+00:00,"48.868144510482075, 2.296149600985935",Paris,75056,0.6,14
45001,Hôtel de Ville de Champigny sur Marne,OUI,21,3,18,9,9,OUI,OUI,2025-03-13 14:01:50+00:00,"48.813810628405, 2.5096759200096",Champigny-sur-Marne,94017,0.8571428571428571,14
14112,Méchain - Faubourg Saint-Jacques,OUI,15,11,4,1,3,OUI,OUI,2025-03-13 14:01:04+00:00,"48.83586772099485, 2.33798034198275",Paris,75056,0.26666666666666666,14
31023,Place François Mitterand,OUI,34,34,0,0,0,OUI,OUI,2025-03-13 13:53:59+00:00,"48.86492782016328, 2.442958317697048",Montreuil,93048,0.0,14
16122,Route de la Muette - Porte de Neuilly,OUI,49,42,7,2,5,OUI,OUI,2025-03-13 14:01:42+00:00,"48.8798926, 2.2587671",Paris,75056,0.14285714285714285,14
10163,Gare du Nord - Demarquay,OUI,28,28,0,0,0,OUI,OUI,2025-03-13 13:59:24+00:00,"48.881154, 2.358411",Paris,75056,0.0,14
15002,Maine - Antoine Bourdelle,OUI,17,11,6,2,4,OUI,OUI,2025-03-13 14:01:06+00:00,"48.84308531746595, 2.320263946784738",Paris,75056,0.35294117647058826,14
2001,Greneta - Sebastopol,OUI,31,1,30,27,3,OUI,OUI,2025-03-13 14:00:47+00:00,"48.865242333228, 2.3516669869423",Paris,75056,0.967741935483871,14
32015,Gare RER de Saint-Denis,OUI,36,26,10,8,2,OUI,OUI,2025-03-13 14:00:44+00:00,"48.93554324248177, 2.3471488058567047",Saint-Denis,93066,0.2777777777777778,14
13041,Porte d'Ivry,OUI,50,40,10,5,5,OUI,OUI,2025-03-13 14:01:56+00:00,"48.821768747596, 2.3688706755638",Paris,75056,0.2,14
10010,Place Jacques Bonsergent,OUI,34,2,32,26,6,OUI,OUI,2025-03-13 14:01:56+00:00,"48.870948218595, 2.3612049221992",Paris,75056,0.9411764705882353,14
4011,Hôtel de Ville - Pont-Marie,OUI,33,4,29,26,3,OUI,OUI,2025-03-13 14:01:35+00:00,"48.853899645527, 2.3569472506642",Paris,75056,0.8787878787878788,14
16043,Place de Passy,OUI,12,11,1,1,0,OUI,OUI,2025-03-13 14:01:30+00:00,"48.85780291711202, 2.277500546942199",Paris,75056,0.08333333333333333,14
12041,Bois de Vincennes.,OUI,58,44,14,4,10,OUI,OUI,2025-03-13 14:01:55+00:00,"48.8338064, 2.4132221",Saint-Mandé,94067,0.2413793103448276,14
16027,Mozart - Jasmin,OUI,62,56,6,3,3,OUI,OUI,2025-03-13 13:55:49+00:00,"48.85286124871689, 2.268483570651513",Paris,75056,0.0967741935483871,14
12108,Bercy.,OUI,63,10,53,46,7,OUI,OUI,2025-03-13 14:00:49+00:00,"48.839966914994, 2.3788625746965",Paris,75056,0.8412698412698413,14
6107,Place Alphonse Deville,OUI,22,3,19,12,7,OUI,OUI,2025-03-13 14:01:36+00:00,"48.850188262662, 2.3275961726904",Paris,75056,0.8636363636363636,14
7013,Duroc - Place de Breteuil,OUI,46,19,27,25,2,OUI,OUI,2025-03-13 14:00:08+00:00,"48.847460641142, 2.3126140236855",Paris,75056,0.5869565217391305,14
16029,Maison de Radio - France,OUI,42,4,38,37,1,OUI,OUI,2025-03-13 14:01:55+00:00,"48.85132886434057, 2.277785539627075",Paris,75056,0.9047619047619048,14
21114,Gustave Eiffel - Parc des Impressionnistes,OUI,29,29,0,0,0,OUI,OUI,2025-03-13 13:59:03+00:00,"48.90390619651018, 2.2946908324956894",Clichy,92024,0.0,14
8019,Naples - Rome,OUI,25,16,9,2,7,OUI,OUI,2025-03-13 13:58:22+00:00,"48.879960700846226, 2.321358695626259",Paris,75056,0.36,14
31013,Centenaire - Sorins,OUI,42,39,3,1,2,OUI,OUI,2025-03-13 13:53:38+00:00,"48.85853523359734, 2.4273508787155156",Montreuil,93048,0.07142857142857142,14
9017,Lallier - Trudaine,OUI,27,23,4,1,3,OUI,OUI,2025-03-13 14:02:00+00:00,"48.88109246617963, 2.3408224806189537",Paris,75056,0.14814814814814814,14
32018,Franciade - Gabriel Péri,OUI,26,15,11,8,3,OUI,OUI,2025-03-13 14:01:07+00:00,"48.93261499331498, 2.355954498052597",Saint-Denis,93066,0.4230769230769231,14
20201,Eugène Reisz - Davout,OUI,20,15,5,0,5,OUI,OUI,2025-03-13 13:55:03+00:00,"48.85631874632638, 2.410396970808506",Paris,75056,0.25,14
18019,Square Raymond Souplex,OUI,51,48,3,0,3,OUI,OUI,2025-03-13 14:00:09+00:00,"48.89183721478911, 2.335426103165901",Paris,75056,0.058823529411764705,14
22102,Mont Valérien - Michel Salles,OUI,24,9,15,11,4,OUI,OUI,2025-03-13 13:59:14+00:00,"48.8561915, 2.2152966",Saint-Cloud,92064,0.625,14
15003,Gare Montparnasse - Vaugirard,OUI,66,54,12,1,11,OUI,OUI,2025-03-13 13:58:21+00:00,"48.8418071798797, 2.31951002690117",Paris,75056,0.18181818181818182,14
11034,Parmentier - Fontaine au Roi,OUI,45,40,5,3,2,OUI,OUI,2025-03-13 14:02:00+00:00,"48.86787670551736, 2.372705978671471",Paris,75056,0.1111111111111111,14
4110,Neuve Saint-Pierre - Beautreillis,OUI,20,6,14,8,6,OUI,OUI,2025-03-13 14:01:11+00:00,"48.85355351439652, 2.3639122769236565",Paris,75056,0.7,14
9012,Rougemont - Poissonnière,OUI,30,4,26,15,11,OUI,OUI,2025-03-13 14:01:50+00:00,"48.871611569354755, 2.345873080193996",Paris,75056,0.8666666666666667,14
6032,Sabot - Rennes,OUI,26,4,22,20,2,OUI,OUI,2025-03-13 14:00:12+00:00,"48.852575112948415, 2.331552766263485",Paris,75056,0.8461538461538461,14
13113,Vistule - Choisy,OUI,33,21,12,7,5,OUI,OUI,2025-03-13 13:58:48+00:00,"48.82365543660611, 2.3615723848342896",Paris,75056,0.36363636363636365,14
17022,Pereire - Place de Wagram,OUI,45,42,3,1,2,OUI,OUI,2025-03-13 14:00:12+00:00,"48.887070607581215, 2.304111124531457",Paris,75056,0.06666666666666667,14
19031,Manin - Crimée,OUI,21,21,0,0,0,OUI,OUI,2025-03-13 13:59:26+00:00,"48.8831217743719, 2.3863670602440834",Paris,75056,0.0,14
6017,Sénat - Condé,OUI,32,1,31,21,10,OUI,OUI,2025-03-13 14:01:11+00:00,"48.84954227788459, 2.337939441204071",Paris,75056,0.96875,14
13114,Nationale - Marcel Duchamp,OUI,23,17,6,4,2,OUI,OUI,2025-03-13 14:01:57+00:00,"48.82463749337136, 2.3678014799952507",Paris,75056,0.2608695652173913,14
13103,Hôpital Pitié Salpêtrière,OUI,49,42,7,4,3,OUI,OUI,2025-03-13 13:54:55+00:00,"48.8377016, 2.3604946",Paris,75056,0.14285714285714285,14
15061,Square Desnouettes,OUI,21,6,15,12,3,OUI,OUI,2025-03-13 13:59:31+00:00,"48.83476837934194, 2.284142297394666",Paris,75056,0.7142857142857143,14
18017,Caulaincourt - Place Constantin Pecqueur,OUI,42,40,2,0,2,OUI,OUI,2025-03-13 14:01:56+00:00,"48.889677905028, 2.3381787144261",Paris,75056,0.047619047619047616,14
11019,Charonne - Philippe-Auguste,OUI,30,22,8,5,3,OUI,OUI,2025-03-13 14:01:59+00:00,"48.855603162026, 2.39054639062",Paris,75056,0.26666666666666666,14
1117,Pont Neuf - Rivoli,OUI,25,1,24,16,8,OUI,OUI,2025-03-13 14:01:51+00:00,"48.860089892617, 2.344057559967",Paris,75056,0.96,14
23008,Hôtel de Ville de Levallois Perret,OUI,25,12,13,12,1,OUI,OUI,2025-03-13 13:59:20+00:00,"48.89314451997415, 2.2888818383216862",Levallois-Perret,92044,0.52,14
23903,Stade Gaston Bouillant,OUI,29,23,6,3,3,OUI,OUI,2025-03-13 14:00:20+00:00,"48.939958667023, 2.3279571813836",Villeneuve-la-Garenne,92078,0.20689655172413793,14
8015,Roquépine - Malesherbes,OUI,52,10,42,24,18,OUI,OUI,2025-03-13 14:01:44+00:00,"48.87345073390807, 2.320404499769211",Paris,75056,0.8076923076923077,14
31704,Jeanne Hornet - Girardot,OUI,28,27,1,0,1,OUI,OUI,2025-03-13 14:00:38+00:00,"48.873802681432146, 2.427820265293122",Bagnolet,93006,0.03571428571428571,14
6014,Pont de Lodi - Dauphine,OUI,21,1,20,9,11,OUI,OUI,2025-03-13 14:01:03+00:00,"48.855296898603285, 2.339947307565249",Paris,75056,0.9523809523809523,14
32603,Calmette,OUI,31,30,1,1,0,OUI,OUI,2025-03-13 14:01:51+00:00,"48.88104925098552, 2.424993216991425",Les Lilas,93045,0.03225806451612903,14
47002,Les Juilliottes,OUI,21,7,14,11,3,OUI,OUI,2025-03-13 13:54:16+00:00,"48.8043072, 2.4437362",Maisons-Alfort,94046,0.6666666666666666,14
17201,Porte Maillot - Perreire,OUI,50,34,16,6,10,OUI,OUI,2025-03-13 13:56:37+00:00,"48.878021154637, 2.2842371277102",Paris,75056,0.32,14
33005,République - Henri Barbusse,OUI,32,17,15,11,4,OUI,OUI,2025-03-13 14:01:53+00:00,"48.90661553626751, 2.389432489871979",Aubervilliers,93001,0.46875,14
21311,Parvis Corentin Celton,OUI,51,10,41,38,3,OUI,OUI,2025-03-13 14:01:54+00:00,"48.82747252522725, 2.2784319519996648",Issy-les-Moulineaux,92040,0.803921568627451,14
5019,Poissy - Saint-Germain,OUI,24,4,20,19,1,OUI,OUI,2025-03-13 13:58:34+00:00,"48.84969649427, 2.3529685288668",Paris,75056,0.8333333333333334,14
23403,Chateau,OUI,21,19,2,1,1,OUI,OUI,2025-03-13 14:00:57+00:00,"48.774661399959, 2.3135878035462",Bourg-la-Reine,92014,0.09523809523809523,14
1016,Thérèse - Opéra,OUI,24,2,22,19,3,OUI,OUI,2025-03-13 13:59:15+00:00,"48.866483514509, 2.3344334212238",Paris,75056,0.9166666666666666,14
9118,Faubourg Poissonniere - Delta,OUI,36,33,3,0,3,OUI,OUI,2025-03-13 13:58:10+00:00,"48.882555807626765, 2.3497482016682625",Paris,75056,0.08333333333333333,14
14007,Ferrus - Saint-Jacques,OUI,33,27,6,3,3,OUI,OUI,2025-03-13 14:01:09+00:00,"48.8313878, 2.3408563",Paris,75056,0.18181818181818182,14
21024,Billancourt - Général Leclerc,OUI,21,14,7,5,2,OUI,OUI,2025-03-13 14:01:01+00:00,"48.8322649, 2.2380413",Boulogne-Billancourt,92012,0.3333333333333333,14
11107,Faidherbe - Dahomey,OUI,41,17,24,22,2,OUI,OUI,2025-03-13 14:00:19+00:00,"48.851358329771806, 2.383823134795429",Paris,75056,0.5853658536585366,14
19023,Manin - Simon Bolivar,OUI,24,23,1,0,1,OUI,OUI,2025-03-13 13:55:29+00:00,"48.876499654127, 2.3794073625991",Paris,75056,0.041666666666666664,14
9113,Bleue - Trévise,OUI,27,5,22,12,10,OUI,OUI,2025-03-13 13:59:34+00:00,"48.87578906564573, 2.347289621829987",Paris,75056,0.8148148148148148,14
20019,Place du Maquis du Vercors,OUI,30,29,1,0,1,OUI,OUI,2025-03-13 13:53:40+00:00,"48.877321579493575, 2.4083782732486725",Paris,75056,0.03333333333333333,14
20103,Le Vau - Maurice Bertaux,OUI,23,23,0,0,0,OUI,OUI,2025-03-13 13:54:34+00:00,"48.86803439043193, 2.411030612453627",Paris,75056,0.0,14
18137,Poissonniers - Nord,OUI,28,26,2,1,1,OUI,OUI,2025-03-13 14:01:20+00:00,"48.892511213520656, 2.3522228747606277",Paris,75056,0.07142857142857142,14
3101,Porte Saint-Martin,OUI,31,4,27,24,3,OUI,OUI,2025-03-13 14:01:22+00:00,"48.86860172112996, 2.35570102930069",Paris,75056,0.8709677419354839,14
7101,Raspail - Chomel,OUI,49,6,43,27,16,OUI,OUI,2025-03-13 14:00:44+00:00,"48.852233164303, 2.3266580700874",Paris,75056,0.8775510204081632,14
2101,Bachaumont - Montmartre,OUI,33,8,25,24,1,OUI,OUI,2025-03-13 13:59:53+00:00,"48.86617395079137, 2.3449775576591496",Paris,75056,0.7575757575757576,14
8056,Beaujon - Wagram,OUI,28,26,2,1,1,OUI,OUI,2025-03-13 14:01:49+00:00,"48.875352455985, 2.2964416444302",Paris,75056,0.07142857142857142,14
8049,Georges V - François 1er,OUI,21,12,9,4,5,OUI,OUI,2025-03-13 14:01:50+00:00,"48.87034, 2.30082",Paris,75056,0.42857142857142855,14
17116,Reims - Porte d'Asnières,OUI,26,18,8,5,3,OUI,OUI,2025-03-13 13:52:28+00:00,"48.891834448210986, 2.300144659954865",Paris,75056,0.3076923076923077,14
19021,Mairie du 19ème,OUI,24,24,0,0,0,OUI,OUI,2025-03-13 14:00:44+00:00,"48.88256264247959, 2.3812624812126164",Paris,75056,0.0,14
18138,Station Paris Basketball - Ney - Charles Hermite,OUI,20,11,9,7,2,OUI,OUI,2025-03-13 14:01:15+00:00,"48.898748039775, 2.3645754531026",Paris,75056,0.45,14
19030,Melun - Jean Jaurès,OUI,27,26,1,1,0,OUI,OUI,2025-03-13 13:59:55+00:00,"48.8837796723475, 2.376477420330048",Paris,75056,0.037037037037037035,14
7016,Surcouf - Université,OUI,56,12,44,41,3,OUI,OUI,2025-03-13 14:01:59+00:00,"48.861273016278, 2.3094535509142",Paris,75056,0.7857142857142857,14
21004,Jean Jaurès - Reine,OUI,31,10,21,19,2,OUI,OUI,2025-03-13 14:01:42+00:00,"48.84009622558849, 2.239872515201569",Boulogne-Billancourt,92012,0.6774193548387096,14
14006,Saint-Jacques - Tombe Issoire,OUI,20,19,1,1,0,OUI,OUI,2025-03-13 14:01:00+00:00,"48.833206330538864, 2.3369108140468597",Paris,75056,0.05,14
13022,Butte aux Cailles - Esperance,OUI,30,27,3,1,2,OUI,OUI,2025-03-13 13:59:03+00:00,"48.82758774190948, 2.3492151126265526",Paris,75056,0.1,14
17016,Brochant - Square des Batignolles,OUI,31,30,1,0,1,OUI,OUI,2025-03-13 13:59:41+00:00,"48.88818698581028, 2.316861143151153",Paris,75056,0.03225806451612903,14
20045,Louis Ganne - Davout,OUI,30,30,0,0,0,OUI,OUI,2025-03-13 13:58:39+00:00,"48.86338720692607, 2.409725748002529",Paris,75056,0.0,14
20202,Dupont de l'Eure - Gambetta,OUI,29,28,1,1,0,OUI,OUI,2025-03-13 14:01:54+00:00,"48.8679385, 2.4003649",Paris,75056,0.034482758620689655,14
16041,Versailles - Claude Terrasse,OUI,44,20,24,22,2,OUI,OUI,2025-03-13 14:01:51+00:00,"48.840219338074, 2.263834191153",Paris,75056,0.5454545454545454,14
11003,Keller - La Roquette,OUI,34,27,7,5,2,OUI,OUI,2025-03-13 13:59:47+00:00,"48.8555508, 2.3752778",Paris,75056,0.20588235294117646,14
21952,Place Tony de Graaff,OUI,42,20,22,17,5,OUI,OUI,2025-03-13 14:02:00+00:00,"48.8181645, 2.2458109",Meudon,92048,0.5238095238095238,14
15020,Mairie du 15ème,OUI,31,29,2,1,1,OUI,OUI,2025-03-13 14:00:20+00:00,"48.8417762, 2.2986539",Paris,75056,0.06451612903225806,14
12153,Terroirs de France - Lheureux,OUI,55,15,40,20,20,OUI,OUI,2025-03-13 14:01:41+00:00,"48.83212027074841, 2.388618104159832",Paris,75056,0.7272727272727273,14
41206,Place des Larris,OUI,34,29,5,1,4,OUI,OUI,2025-03-13 13:58:42+00:00,"48.8568363, 2.4780236",Fontenay-sous-Bois,94033,0.14705882352941177,14
21017,Place Marcel Sembat,OUI,55,3,52,43,9,OUI,OUI,2025-03-13 14:01:07+00:00,"48.83328865030686, 2.2441747784614567",Boulogne-Billancourt,92012,0.9454545454545454,14
20017,Saint-Blaise - Mouraud,OUI,27,23,4,0,4,OUI,OUI,2025-03-13 14:01:24+00:00,"48.85696177597818, 2.40869477391243",Paris,75056,0.14814814814814814,14
14127,Odessa - Départ,OUI,39,25,14,7,7,OUI,OUI,2025-03-13 14:01:52+00:00,"48.842885590081, 2.3244281485677",Paris,75056,0.358974358974359,14
21108,Mairie de Clichy,OUI,44,38,6,5,1,OUI,OUI,2025-03-13 14:01:53+00:00,"48.903653634661, 2.3059353232384",Clichy,92024,0.13636363636363635,14
12033,François Truffaut - Saint Emilion,OUI,66,9,57,47,10,OUI,OUI,2025-03-13 14:01:13+00:00,"48.83372354344807, 2.386601903271428",Paris,75056,0.8636363636363636,14
14116,Romain Rolland,OUI,25,23,2,2,0,OUI,OUI,2025-03-13 13:59:10+00:00,"48.820215229662765, 2.3234144234418346",Montrouge,92049,0.08,14
18142,Jessaint - Marx Dormoy,OUI,30,29,1,0,1,OUI,OUI,2025-03-13 13:56:49+00:00,"48.88484543106364, 2.358930408954621",Paris,75056,0.03333333333333333,14
31018,Gambetta - Michelet,OUI,30,26,4,2,2,OUI,OUI,2025-03-13 14:01:37+00:00,"48.85273792380526, 2.429966032505036",Montreuil,93048,0.13333333333333333,14
4010,Saint-Antoine Sévigné,OUI,23,7,16,9,7,OUI,OUI,2025-03-13 14:01:59+00:00,"48.8550222, 2.3612322",Paris,75056,0.6956521739130435,14
2110,Jeûneurs - Mulhouse,OUI,27,13,14,7,7,OUI,OUI,2025-03-13 14:01:35+00:00,"48.868997, 2.346925",Paris,75056,0.5185185185185185,14
18035,René Binet - Porte de Montmartre,OUI,36,31,5,3,2,OUI,OUI,2025-03-13 13:57:02+00:00,"48.89905109950848, 2.3365534096956253",Paris,75056,0.1388888888888889,14
7026,Place de Finlande,OUI,24,4,20,17,3,OUI,OUI,2025-03-13 13:53:35+00:00,"48.862408335967, 2.3113624379039",Paris,75056,0.8333333333333334,14
13110,Moulin de la Pointe,OUI,21,19,2,0,2,OUI,OUI,2025-03-13 13:58:53+00:00,"48.82092946051445, 2.3563179373741145",Paris,75056,0.09523809523809523,14
17033,Carnot - Général Lanrezac,OUI,29,29,0,0,0,OUI,OUI,2025-03-13 13:56:50+00:00,"48.875443870736, 2.2938242935036",Paris,75056,0.0,14
23105,Sèvres Rive Gauche,OUI,33,20,13,13,0,OUI,OUI,2025-03-13 13:55:16+00:00,"48.821443218278, 2.2150785306885",Sèvres,92072,0.3939393939393939,14
10164,Claude Vellefaux - Sambre et Meuse,OUI,32,30,2,1,1,OUI,OUI,2025-03-13 13:57:57+00:00,"48.875022, 2.370478",Paris,75056,0.0625,14
15009,Suffren - Pérignon,OUI,45,11,34,29,5,OUI,OUI,2025-03-13 14:01:23+00:00,"48.84717561492764, 2.307052147596786",Paris,75056,0.7555555555555555,14
2014,Daunou - Louis le Grand,OUI,30,3,27,8,19,OUI,OUI,2025-03-13 14:00:43+00:00,"48.869113, 2.332515",Paris,75056,0.9,14
21120,Docteur Calmette - Martre,OUI,30,22,8,7,1,OUI,OUI,2025-03-13 13:58:56+00:00,"48.898969358483, 2.3086513252383",Clichy,92024,0.26666666666666666,14
4109,Mornay - Sully,OUI,13,4,9,4,5,OUI,OUI,2025-03-13 13:59:20+00:00,"48.84970399548416, 2.364460788667202",Paris,75056,0.6923076923076923,14
14125,Dareau - Broussais,OUI,21,18,3,0,3,OUI,OUI,2025-03-13 14:01:57+00:00,"48.8307758, 2.3361804",Paris,75056,0.14285714285714285,14
8105,François 1er - Lincoln,OUI,29,7,22,0,22,OUI,OUI,2025-03-13 14:01:52+00:00,"48.869517979344, 2.3024262188416",Paris,75056,0.7586206896551724,14
31017,Jean Moulin - Paul Doumer,OUI,17,13,4,0,4,OUI,OUI,2025-03-13 14:00:50+00:00,"48.8622179854695, 2.45533436536789",Montreuil,93048,0.23529411764705882,14
15058,Place du Moulin de Javel,OUI,54,7,47,40,7,OUI,OUI,2025-03-13 14:01:05+00:00,"48.84021670922, 2.2716060653329",Paris,75056,0.8703703703703703,14
13047,Boutroux - Porte de Vitry,OUI,49,27,22,20,2,OUI,OUI,2025-03-13 13:59:15+00:00,"48.822632, 2.377738",Paris,75056,0.4489795918367347,14
11048,Place Mireille Havet,OUI,41,5,36,28,8,OUI,OUI,2025-03-13 14:01:41+00:00,"48.850533, 2.383756",Paris,75056,0.8780487804878049,14
18114,Véron - Lepic,OUI,23,22,1,0,1,OUI,OUI,2025-03-13 14:00:52+00:00,"48.88526123395252, 2.334559857845307",Paris,75056,0.043478260869565216,14
12154,Square Georges Melies,OUI,38,24,14,4,10,OUI,OUI,2025-03-13 14:00:29+00:00,"48.84070239213081, 2.409667745232582",Paris,75056,0.3684210526315789,14
44103,Pont De Charenton,OUI,18,6,12,12,0,OUI,OUI,2025-03-13 13:59:24+00:00,"48.8179685, 2.4199531",Saint-Maurice,94069,0.6666666666666666,14
22017,Charles de Gaulle - Louis Philippe,OUI,26,13,13,8,5,OUI,OUI,2025-03-13 14:01:26+00:00,"48.881742142181, 2.2710045335353",Neuilly-sur-Seine,92051,0.5,14
42011,Quai Marcel Boyer - Victor Hugo,OUI,29,3,26,23,3,OUI,OUI,2025-03-13 14:00:50+00:00,"48.822556366667, 2.3920395970345",Ivry-sur-Seine,94041,0.896551724137931,14
17104,Jardin Marguerite Long,OUI,21,16,5,2,3,OUI,OUI,2025-03-13 13:59:18+00:00,"48.8816985773914, 2.2836575657129288",Paris,75056,0.23809523809523808,14
14128,Gergovie - Vercingétorix,OUI,29,27,2,0,2,OUI,OUI,2025-03-13 13:54:21+00:00,"48.83453413883994, 2.313154547426182",Paris,75056,0.06896551724137931,14
22002,Argenson - Château,OUI,24,1,23,16,7,OUI,OUI,2025-03-13 14:00:46+00:00,"48.888559314669514, 2.2642001509666447",Neuilly-sur-Seine,92051,0.9583333333333334,14
19036,Hôpital Robert Debré,OUI,33,31,2,0,2,OUI,OUI,2025-03-13 13:58:10+00:00,"48.88005222200894, 2.4008650346327003",Paris,75056,0.06060606060606061,14
35008,Place de l'Eglise - Pantin,OUI,28,27,1,1,0,OUI,OUI,2025-03-13 14:00:52+00:00,"48.892809461520265, 2.4124351143836975",Pantin,93055,0.03571428571428571,14
31026,Demi-Lune - Aristide Briand,OUI,20,19,1,0,1,OUI,OUI,2025-03-13 14:01:20+00:00,"48.87626381919953, 2.4562818557024",Montreuil,93048,0.05,14
13019,Fernand Braudel - Vincent Auriol,OUI,36,8,28,20,8,OUI,OUI,2025-03-13 14:01:10+00:00,"48.83637852318147, 2.3723404482007027",Paris,75056,0.7777777777777778,14
31707,Edouard Vaillant - Galliéni,OUI,48,45,3,1,2,OUI,OUI,2025-03-13 14:01:55+00:00,"48.858462881661, 2.4147954583168",Bagnolet,93006,0.0625,14
11044,Square du Bataclan,OUI,17,1,16,15,1,OUI,OUI,2025-03-13 13:59:26+00:00,"48.8633762, 2.3711327",Paris,75056,0.9411764705882353,14
8011,Clapeyron - Moscou,OUI,15,12,3,1,2,OUI,OUI,2025-03-13 14:01:54+00:00,"48.88078819514121, 2.324815057218075",Paris,75056,0.2,14
5030,Sorbonne - Ecoles,OUI,47,10,37,7,30,OUI,OUI,2025-03-13 14:01:59+00:00,"48.849686566191, 2.3434996604919",Paris,75056,0.7872340425531915,14
13020,Paul Klee - Place Augusta Holmes,OUI,43,13,30,7,23,OUI,OUI,2025-03-13 14:00:24+00:00,"48.838946417408025, 2.3704235663952966",Paris,75056,0.6976744186046512,14
9015,Lamartine - Faubourg Montmartre,OUI,29,13,16,11,5,OUI,OUI,2025-03-13 14:01:49+00:00,"48.876613982891, 2.3397656902671",Paris,75056,0.5517241379310345,14
19124,Alexander Fleming - Belvédère,OUI,31,30,1,0,1,OUI,OUI,2025-03-13 13:54:19+00:00,"48.88179064200294, 2.4030599377642674",Paris,75056,0.03225806451612903,14
8029,Place du Canada,OUI,56,8,48,24,24,OUI,OUI,2025-03-13 14:01:57+00:00,"48.865346269363, 2.3101937879648",Paris,75056,0.8571428571428571,14
32021,Place du Front Populaire - George Sand,OUI,64,43,21,16,5,OUI,OUI,2025-03-13 14:01:09+00:00,"48.90680713698062, 2.364541214992642",Saint-Denis,93066,0.328125,14
11110,Roquette - Folie Regnault,OUI,50,45,5,2,3,OUI,OUI,2025-03-13 14:00:04+00:00,"48.859246959155485, 2.386553623578705",Paris,75056,0.1,14
15019,Paul Barruel - Vaugirard,OUI,36,30,6,3,3,OUI,OUI,2025-03-13 14:01:59+00:00,"48.84014918546239, 2.3044332861900334",Paris,75056,0.16666666666666666,14
16031,Vignes - Boulainvilliers,OUI,19,13,6,3,3,OUI,OUI,2025-03-13 13:55:46+00:00,"48.856399483950504, 2.275240458548069",Paris,75056,0.3157894736842105,14
20203,Evariste Galois,OUI,20,20,0,0,0,OUI,OUI,2025-03-13 13:52:56+00:00,"48.873341356228, 2.4133544409574",Paris,75056,0.0,14
17005,Brochant - Clichy,OUI,52,49,3,0,3,OUI,OUI,2025-03-13 14:00:30+00:00,"48.89032998912038, 2.319730559929781",Paris,75056,0.057692307692307696,14
20004,Commandant l'Herminier - Gallieni,OUI,17,17,0,0,0,OUI,OUI,2025-03-13 13:59:31+00:00,"48.847040552603, 2.4160453677177",Paris,75056,0.0,14
14016,René Coty - Parc Montsouris,OUI,54,51,3,0,3,OUI,OUI,2025-03-13 13:52:53+00:00,"48.82479134498032, 2.336124926805496",Paris,75056,0.05555555555555555,14
11031,Jacquard - Ternaux,OUI,39,27,12,11,1,OUI,OUI,2025-03-13 14:01:19+00:00,"48.8646605, 2.373162",Paris,75056,0.3076923076923077,14
12120,Lac Daumesnil - Saint-Maurice,OUI,49,37,12,9,3,OUI,OUI,2025-03-13 13:56:35+00:00,"48.82774555743318, 2.4183654785156246",Paris,75056,0.24489795918367346,14
12125,Pyramide - Parc Floral,OUI,50,46,4,1,3,OUI,OUI,2025-03-13 14:01:29+00:00,"48.837442, 2.440452",Paris,75056,0.08,14
22012,Madeleine Michelis - Roule,OUI,23,11,12,4,8,OUI,OUI,2025-03-13 13:55:59+00:00,"48.88260431301364, 2.2773634269833565",Neuilly-sur-Seine,92051,0.5217391304347826,14
10152,Gare du Nord - Place de Valenciennes,OUI,23,19,4,3,1,OUI,OUI,2025-03-13 14:01:07+00:00,"48.879089, 2.354235",Paris,75056,0.17391304347826086,14
23005,Gare de Clichy-Levallois,OUI,25,6,19,15,4,OUI,OUI,2025-03-13 14:01:36+00:00,"48.89679827481989, 2.2984680533409123",Levallois-Perret,92044,0.76,14
10037,Quai de Valmy,OUI,26,22,4,2,2,OUI,OUI,2025-03-13 14:01:58+00:00,"48.88126951579429, 2.368186041712761",Paris,75056,0.15384615384615385,14
20117,Saint-Fargeau - Mortier,OUI,31,31,0,0,0,OUI,OUI,2025-03-13 13:55:19+00:00,"48.87266656122256, 2.407912909984589",Paris,75056,0.0,14
15125,Parc Suzanne Lenglen,OUI,51,4,47,44,3,OUI,OUI,2025-03-13 14:01:36+00:00,"48.833250690537874, 2.2765403240919113",Paris,75056,0.9215686274509803,14
48009,République - Auguste Perret,OUI,30,29,1,1,0,OUI,OUI,2025-03-13 13:57:14+00:00,"48.78695280952244, 2.3518594354391094",Villejuif,94076,0.03333333333333333,14
17029,Pierre Demours - Laugier,OUI,36,32,4,3,1,OUI,OUI,2025-03-13 13:57:59+00:00,"48.8813072, 2.294846",Paris,75056,0.1111111111111111,14
21009,Le Corbusier - Jean Jaurès,OUI,45,14,31,21,10,OUI,OUI,2025-03-13 13:58:41+00:00,"48.83780830557548, 2.2408381104469304",Boulogne-Billancourt,92012,0.6888888888888889,14
20039,Belleville - Couronnes,OUI,48,45,3,1,2,OUI,OUI,2025-03-13 13:58:34+00:00,"48.868831082877, 2.3809862136841",Paris,75056,0.0625,14
4107,Beaumarchais - Pas de la Mule,OUI,17,6,11,7,4,OUI,OUI,2025-03-13 14:01:58+00:00,"48.855580507049, 2.3684333673431",Paris,75056,0.6470588235294118,14
21203,Place Jules Ferry,OUI,28,25,3,3,0,OUI,OUI,2025-03-13 13:57:26+00:00,"48.812107928414775, 2.325837314128876",Montrouge,92049,0.10714285714285714,14
22403,Pierre Brossolette - Adolphe Pinard,OUI,23,21,2,2,0,OUI,OUI,2025-03-13 14:00:38+00:00,"48.821772279548, 2.3131558299065",Malakoff,92046,0.08695652173913043,14
5034,Censier - Santeuil,OUI,66,20,46,40,6,OUI,OUI,2025-03-13 13:59:55+00:00,"48.840658921385234, 2.3537524044513702",Paris,75056,0.696969696969697,14
20047,Cours de Vincennes - Davout,OUI,48,42,6,3,3,OUI,OUI,2025-03-13 14:01:47+00:00,"48.847238029966, 2.4107042336225",Paris,75056,0.125,14
21316,Cimetière d'Issy-les-Moulineaux,OUI,23,21,2,0,2,OUI,OUI,2025-03-13 14:01:14+00:00,"48.817699773925, 2.2609312087297",Issy-les-Moulineaux,92040,0.08695652173913043,14
9013,Mairie du 9ème,OUI,24,5,19,13,6,OUI,OUI,2025-03-13 13:57:13+00:00,"48.873267137583, 2.3407534480528",Paris,75056,0.7916666666666666,14
21029,Cours de l'Ile Seguin - Parc Billancourt,OUI,28,6,22,14,8,OUI,OUI,2025-03-13 14:00:31+00:00,"48.82714055843935, 2.234234511852265",Boulogne-Billancourt,92012,0.7857142857142857,14
42004,Westermeyer - Paul Vaillant-Couturier,OUI,27,15,12,8,4,OUI,OUI,2025-03-13 14:01:41+00:00,"48.819116181578764, 2.3966637253761296",Ivry-sur-Seine,94041,0.4444444444444444,14
15072,Place Fernand Forest,OUI,28,1,27,22,5,OUI,OUI,2025-03-13 14:00:11+00:00,"48.849269143836, 2.281863167882",Paris,75056,0.9642857142857143,14
21951,Place Centrale,OUI,22,21,1,1,0,OUI,OUI,2025-03-13 13:53:46+00:00,"48.78740167690531, 2.2278830409049992",Meudon,92048,0.045454545454545456,14
12006,Gare de Lyon - Van Gogh,OUI,41,1,40,28,12,OUI,OUI,2025-03-13 13:59:08+00:00,"48.843839785643, 2.3704450240357",Paris,75056,0.975609756097561,14
92005,Gare de Nanterre Ville,OUI,42,15,27,21,6,OUI,OUI,2025-03-13 14:01:06+00:00,"48.8950295, 2.1957932",Nanterre,92050,0.6428571428571429,14
10110,Louis Blanc - Jemmapes,OUI,31,25,6,0,6,OUI,OUI,2025-03-13 14:01:18+00:00,"48.879330755297, 2.3684485629201",Paris,75056,0.1935483870967742,14
22103,Senard - Charles Blum,OUI,24,6,18,6,12,OUI,OUI,2025-03-13 13:59:31+00:00,"48.857315824799, 2.221091687679291",Saint-Cloud,92064,0.75,14
41210,Hôtel de ville de Fontenay-sous-Bois,OUI,19,17,2,0,2,OUI,OUI,2025-03-13 13:53:56+00:00,"48.84949749106274, 2.4750164151191716",Fontenay-sous-Bois,94033,0.10526315789473684,14
19113,Pré Saint-Gervais - Lilas,OUI,27,25,2,0,2,OUI,OUI,2025-03-13 13:58:04+00:00,"48.877870626988, 2.3959073424339",Paris,75056,0.07407407407407407,14
21702,Gare SNCF Vanves-Malakoff,OUI,49,43,6,4,2,OUI,OUI,2025-03-13 14:01:42+00:00,"48.819002163836444, 2.292150005103606",Vanves,92075,0.12244897959183673,14
10039,Sambre et Meuse - Villette,OUI,24,21,3,3,0,OUI,OUI,2025-03-13 13:58:11+00:00,"48.874405666217, 2.3738072379951",Paris,75056,0.125,14
42304,Marc Sangnier - Division Leclerc,OUI,21,5,16,11,5,OUI,OUI,2025-03-13 14:01:41+00:00,"48.78599652305309, 2.329955510795116",Cachan,94016,0.7619047619047619,14
31101,Jules Guesde - Laennec,OUI,19,14,5,0,5,OUI,OUI,2025-03-13 13:56:33+00:00,"48.87628983900398, 2.5006942078471184",Rosny-sous-Bois,93064,0.2631578947368421,14
15052,Convention - Vaugirard,OUI,44,35,9,6,3,OUI,OUI,2025-03-13 14:01:59+00:00,"48.83767682233156, 2.295586926020252",Paris,75056,0.20454545454545456,14
17001,Guy Môquet - Saint-Ouen,OUI,44,41,3,0,3,OUI,OUI,2025-03-13 14:00:12+00:00,"48.892777719023975, 2.3270335793495183",Paris,75056,0.06818181818181818,14
31021,Résistance - Hoche,OUI,28,28,0,0,0,OUI,OUI,2025-03-13 13:55:04+00:00,"48.864273423741956, 2.435784414410591",Montreuil,93048,0.0,14
12129,Bois de Vincennes - Porte Jaune,OUI,35,32,3,2,1,OUI,OUI,2025-03-13 13:57:10+00:00,"48.838751246689455, 2.4605489149689674",Paris,75056,0.08571428571428572,14
15123,Commerce - Letellier,OUI,43,29,14,8,6,OUI,OUI,2025-03-13 13:59:53+00:00,"48.84797660373612, 2.2966245196598805",Paris,75056,0.32558139534883723,14
35004,Place du Président Salvador Allende,OUI,58,47,11,3,8,OUI,OUI,2025-03-13 14:00:49+00:00,"48.897307310356055, 2.40079153681279",Pantin,93055,0.1896551724137931,14
21031,Cimetière de Boulogne-Billancourt,OUI,40,10,30,26,4,OUI,OUI,2025-03-13 14:01:38+00:00,"48.830764, 2.252024",Boulogne-Billancourt,92012,0.75,14
7010,Constantine - Université,OUI,58,3,55,47,8,OUI,OUI,2025-03-13 14:01:07+00:00,"48.860680473738, 2.3148481955842",Paris,75056,0.9482758620689655,14
16024,Ranelagh - Maison de la Radio,OUI,20,6,14,14,0,OUI,OUI,2025-03-13 14:01:19+00:00,"48.85293603169479, 2.280449643731117",Paris,75056,0.7,14
14113,Santé - Arago,OUI,36,33,3,2,1,OUI,OUI,2025-03-13 14:00:26+00:00,"48.83507657562064, 2.3415737262044938",Paris,75056,0.08333333333333333,14
17039,Place Saint-Ferdinand,OUI,38,20,18,5,13,OUI,OUI,2025-03-13 13:59:28+00:00,"48.87815529789739, 2.288518047864942",Paris,75056,0.47368421052631576,14
35015,Averroès - Aimé Césaire,OUI,18,15,3,3,0,OUI,OUI,2025-03-13 13:55:13+00:00,"48.91405323432864, 2.412636950612068",Pantin,93055,0.16666666666666666,14
42305,Vanne - Saussaies,OUI,20,18,2,0,2,OUI,OUI,2025-03-13 13:52:35+00:00,"48.786404, 2.338848",Cachan,94016,0.1,14
7024,Rapp - Place du Général Gouraud,OUI,29,20,9,8,1,OUI,OUI,2025-03-13 13:59:29+00:00,"48.858102885107, 2.3004072904587",Paris,75056,0.3103448275862069,14
21955,Vaugirard - Verrerie,OUI,24,4,20,17,3,OUI,OUI,2025-03-13 13:58:54+00:00,"48.820881336842, 2.2367222622987",Meudon,92048,0.8333333333333334,14
12150,Bastille - Quai de la Rapée,OUI,27,2,25,21,4,OUI,OUI,2025-03-13 14:01:13+00:00,"48.84682410855, 2.3669364675879",Paris,75056,0.9259259259259259,14
8001,Petit Palais,OUI,45,10,35,22,13,OUI,OUI,2025-03-13 14:00:04+00:00,"48.8667692, 2.3157655",Paris,75056,0.7777777777777778,14
13515,Auguste Blanqui - Glacière,OUI,59,55,4,2,2,OUI,OUI,2025-03-13 13:59:15+00:00,"48.831151602964, 2.343822196126",Paris,75056,0.06779661016949153,14
4003,Quai aux Fleurs - Pont Saint-Louis,OUI,21,8,13,11,2,OUI,OUI,2025-03-13 13:59:20+00:00,"48.852915956209, 2.3521957173944",Paris,75056,0.6190476190476191,14
9016,Choron - Martyrs,OUI,17,4,13,4,9,OUI,OUI,2025-03-13 13:59:31+00:00,"48.877851443503, 2.3396701365709",Paris,75056,0.7647058823529411,14
21219,Amaury Duval - Gabriel Péri,OUI,36,35,1,0,1,OUI,OUI,2025-03-13 13:55:26+00:00,"48.81718759671675, 2.323841750621796",Montrouge,92049,0.027777777777777776,14
15131,Charles Lecocq - Lecourbe,OUI,28,22,6,3,3,OUI,OUI,2025-03-13 13:57:59+00:00,"48.84044, 2.294867",Paris,75056,0.21428571428571427,14
31025,Paul Signac - Aristide Briand,OUI,33,30,3,0,3,OUI,OUI,2025-03-13 14:00:29+00:00,"48.86950262156371, 2.4502260982990265",Montreuil,93048,0.09090909090909091,14
9036,Athènes - Clichy,OUI,18,8,10,5,5,OUI,OUI,2025-03-13 14:00:43+00:00,"48.878113787876, 2.32956021945824",Paris,75056,0.5555555555555556,14
5014,Jean Calvin - Tournefort,OUI,28,20,8,5,3,OUI,OUI,2025-03-13 14:01:57+00:00,"48.84158856925782, 2.348489575088024",Paris,75056,0.2857142857142857,14
13117,Stade Georges Carpentier,OUI,39,32,7,4,3,OUI,OUI,2025-03-13 13:56:51+00:00,"48.820482438381, 2.3668321967125",Paris,75056,0.1794871794871795,14
23902,Gallieni - Lycée Charles Petitet,OUI,44,20,24,17,7,OUI,OUI,2025-03-13 14:00:33+00:00,"48.927640283627, 2.3308986340524",Villeneuve-la-Garenne,92078,0.5454545454545454,14
13027,Mazagran - Pierre de Coubertin,OUI,15,10,5,2,3,OUI,OUI,2025-03-13 13:57:24+00:00,"48.816218640260445, 2.344226874411106",Paris,75056,0.3333333333333333,14
20007,Buzenval - Avron,OUI,49,44,5,1,4,OUI,OUI,2025-03-13 13:57:06+00:00,"48.851617204999, 2.4015135973077",Paris,75056,0.10204081632653061,14
10004,Metz - Faubourg Saint-Denis,OUI,44,13,31,27,4,OUI,OUI,2025-03-13 14:00:01+00:00,"48.870893, 2.353521",Paris,75056,0.7045454545454546,14
13033,Porte d'Italie,OUI,13,8,5,1,4,OUI,OUI,2025-03-13 13:57:38+00:00,"48.817161987718954, 2.360236309468746",Paris,75056,0.38461538461538464,14
21118,Neuilly - Petit,OUI,14,7,7,6,1,OUI,OUI,2025-03-13 14:01:01+00:00,"48.898965361341254, 2.29627937078476",Clichy,92024,0.5,14
42701,Charles Gide - Fort de Bicêtre,OUI,29,16,13,1,12,OUI,OUI,2025-03-13 14:01:59+00:00,"48.8071937956922, 2.353984415531159",Le Kremlin-Bicêtre,94043,0.4482758620689655,14
11103,Pelée - Alphonse Baudin,OUI,35,19,16,9,7,OUI,OUI,2025-03-13 14:01:11+00:00,"48.8600265, 2.3710541",Paris,75056,0.45714285714285713,14
13126,Place Nationale - Château-des-Rentiers,OUI,18,8,10,2,8,OUI,OUI,2025-03-13 14:01:05+00:00,"48.829268, 2.365212",Paris,75056,0.5555555555555556,14
10017,Gare de l'Est - Fidélité,OUI,11,3,8,5,3,OUI,OUI,2025-03-13 14:01:58+00:00,"48.874575, 2.356796",Paris,75056,0.7272727272727273,14
14101,Gare Montparnasse - Edgar Quinet,OUI,33,30,3,0,3,OUI,OUI,2025-03-13 13:59:16+00:00,"48.841487851079, 2.3233232282801",Paris,75056,0.09090909090909091,14
22013,Mairie de Neuilly sur Seine,OUI,30,25,5,3,2,OUI,OUI,2025-03-13 14:01:20+00:00,"48.88494728765838, 2.2677031159400944",Neuilly-sur-Seine,92051,0.16666666666666666,14
15023,La Motte-Picquet - Grenelle,OUI,34,4,30,22,8,OUI,OUI,2025-03-13 14:01:04+00:00,"48.84858321339195, 2.299347817897797",Paris,75056,0.8823529411764706,14
19025,Botzaris - Crimée,OUI,20,19,1,0,1,OUI,OUI,2025-03-13 13:59:55+00:00,"48.87959698690176, 2.3887913337477067",Paris,75056,0.05,14
22501,Théâtre de La Garenne,OUI,20,12,8,2,6,OUI,OUI,2025-03-13 14:00:06+00:00,"48.905658361454, 2.2345951981176",La Garenne-Colombes,92035,0.4,14
16009,Saint-Didier - Raymond Poincaré,OUI,17,12,5,0,5,OUI,OUI,2025-03-13 14:01:22+00:00,"48.86642312020962, 2.285863497192411",Paris,75056,0.29411764705882354,14
4001,Arcole - Notre-Dame,OUI,28,19,9,2,7,OUI,OUI,2025-03-13 13:59:38+00:00,"48.853883541328, 2.3493797332048",Paris,75056,0.32142857142857145,14
10153,Gare du Nord - Denain,OUI,20,15,5,0,5,OUI,OUI,2025-03-13 14:01:26+00:00,"48.879595787608, 2.3544725775719",Paris,75056,0.25,14
40009,Lycée Saint Exupéry - Juliette Savar,OUI,29,18,11,8,3,OUI,OUI,2025-03-13 14:00:53+00:00,"48.783021513972, 2.4637357216879",Créteil,94028,0.3793103448275862,14
16003,André Maurois - Joseph et Marie Hackin,OUI,27,13,14,11,3,OUI,OUI,2025-03-13 14:01:10+00:00,"48.8778983, 2.2789591",Paris,75056,0.5185185185185185,14
23003,Président Wilson - Baudin,OUI,28,9,19,14,5,OUI,OUI,2025-03-13 13:59:59+00:00,"48.89826887103676, 2.2849336266517644",Levallois-Perret,92044,0.6785714285714286,14
16014,Eylau - Trocadéro,OUI,22,14,8,1,7,OUI,OUI,2025-03-13 14:00:33+00:00,"48.863354122371, 2.2864209115505",Paris,75056,0.36363636363636365,14
14131,Jourdan - Monticelli,OUI,30,26,4,0,4,OUI,OUI,2025-03-13 14:01:08+00:00,"48.822032, 2.329095",Paris,75056,0.13333333333333333,14
16007,Longchamp - Place d'Iéna,OUI,25,9,16,4,12,OUI,OUI,2025-03-13 14:01:56+00:00,"48.864917233434, 2.2926748171449",Paris,75056,0.64,14
19108,Gaston Tessier - Rosa Parks RER,OUI,37,35,2,0,2,OUI,OUI,2025-03-13 13:58:54+00:00,"48.8963765, 2.3743692",Paris,75056,0.05405405405405406,14
21115,Chancé Milly - Cimetière Communal Sud,OUI,32,18,14,13,1,OUI,OUI,2025-03-13 14:01:23+00:00,"48.89687189382465, 2.303922325372696",Clichy,92024,0.4375,14
4002,Marché aux fleurs,OUI,20,5,15,7,8,OUI,OUI,2025-03-13 14:01:55+00:00,"48.855258115391, 2.3473754525185",Paris,75056,0.75,14
21708,Marcel Yol - Jullien,OUI,28,22,6,5,1,OUI,OUI,2025-03-13 14:01:47+00:00,"48.82537611802588, 2.287235018058929",Vanves,92075,0.21428571428571427,14
17003,Jacques Kellner - Saint-Ouen,OUI,43,43,0,0,0,OUI,OUI,2025-03-13 13:59:38+00:00,"48.895809485802886, 2.327897409164145",Paris,75056,0.0,14
13048,Wurtz - Tolbiac,OUI,28,28,0,0,0,NON,NON,2025-03-13 12:52:17+00:00,"48.82631195621, 2.344585955143",Paris,75056,0.0,13
42501,Raspail - Albert Schweitzer,OUI,27,8,19,18,1,OUI,OUI,2025-03-13 14:01:55+00:00,"48.81031545, 2.34395871",Gentilly,94037,0.7037037037037037,14
11109,Pierre Levée - Fontaine Timbaud,OUI,21,16,5,0,5,OUI,OUI,2025-03-13 13:59:36+00:00,"48.86632723374305, 2.3711163550615306",Paris,75056,0.23809523809523808,14
21204,Estienne d'Orves - Henri Ginoux,OUI,30,29,1,0,1,OUI,OUI,2025-03-13 14:00:17+00:00,"48.815388220397274, 2.320886790760933",Montrouge,92049,0.03333333333333333,14
44002,Paul Vaillant-Couturier - Gare RER,OUI,25,2,23,19,4,OUI,OUI,2025-03-13 14:01:14+00:00,"48.80108159069614, 2.402097210288048",Vitry-sur-Seine,94081,0.92,14
22206,Louis Pasteur - Albert Petit,OUI,30,27,3,0,3,OUI,OUI,2025-03-13 14:01:04+00:00,"48.796261, 2.317289",Bagneux,92007,0.1,14
16115,Raffet - Montmorency,OUI,40,31,9,2,7,OUI,OUI,2025-03-13 14:00:59+00:00,"48.85258670812, 2.2629252456151954",Paris,75056,0.225,14
11021,Charonne - Pierre Bayle,OUI,23,20,3,0,3,OUI,OUI,2025-03-13 14:01:46+00:00,"48.858445054262, 2.3903981223891",Paris,75056,0.13043478260869565,14
13039,Ivry - Simone Weil,OUI,18,12,6,4,2,OUI,OUI,2025-03-13 13:59:56+00:00,"48.823283932030755, 2.3659095168113713",Paris,75056,0.3333333333333333,14
21217,Louis Rolland - République,OUI,26,26,0,0,0,OUI,OUI,2025-03-13 13:59:22+00:00,"48.81710889740748, 2.3193106434955717",Montrouge,92049,0.0,14
21030,Fessart - Château,OUI,20,0,20,15,5,OUI,OUI,2025-03-13 14:01:33+00:00,"48.84245, 2.23989",Boulogne-Billancourt,92012,1.0,14
12007,Gare de Lyon - Chalon,OUI,45,15,30,18,12,OUI,OUI,2025-03-13 14:00:45+00:00,"48.845666194202, 2.3741452395916",Paris,75056,0.6666666666666666,14
15043,Brancion - Lefebvre,OUI,9,7,2,0,2,OUI,OUI,2025-03-13 13:57:53+00:00,"48.82900222785569, 2.301431038163409",Paris,75056,0.2222222222222222,14
35007,Benjamin Delessert - Jean Lolive,OUI,20,17,3,0,3,OUI,OUI,2025-03-13 14:00:27+00:00,"48.89392043619345, 2.417981922626496",Pantin,93055,0.15,14
22604,Hôtel de Ville de Fontenay-aux-Roses,OUI,32,32,0,0,0,OUI,OUI,2025-03-13 13:52:55+00:00,"48.790844603480856, 2.2871455930319455",Fontenay-aux-Roses,92032,0.0,14
47001,Place de la Gare,OUI,45,2,43,39,4,OUI,OUI,2025-03-13 14:01:08+00:00,"48.80253358011283, 2.4275037646293645",Maisons-Alfort,94046,0.9555555555555556,14
20009,Docteurs Déjérine - Pte de Montreuil,OUI,19,17,2,1,1,OUI,OUI,2025-03-13 13:57:11+00:00,"48.85398448133697, 2.41208288897222",Paris,75056,0.10526315789473684,14
44101,Place Mongolfier,OUI,37,15,22,13,9,OUI,OUI,2025-03-13 14:00:32+00:00,"48.815160030060376, 2.4592879414558415",Saint-Maurice,94069,0.5945945945945946,14
11032,Jean-Pierre Timbaud - Vaucouleurs,OUI,45,35,10,4,6,OUI,OUI,2025-03-13 14:00:23+00:00,"48.867937, 2.377885",Paris,75056,0.2222222222222222,14
14010,Jean Moulin - Place Victor et Hélène Basch,OUI,38,34,4,0,4,OUI,OUI,2025-03-13 14:01:18+00:00,"48.82764910241, 2.3261967301369",Paris,75056,0.10526315789473684,14
16101,Malakoff - Place de la Porte Maillot,OUI,26,10,16,5,11,OUI,OUI,2025-03-13 13:55:28+00:00,"48.876733496638, 2.2834577411413",Paris,75056,0.6153846153846154,14
22303,Lucien Lanternier - Le Luth,OUI,25,9,16,12,4,OUI,OUI,2025-03-13 14:00:34+00:00,"48.93159430558871, 2.2889783978462224",Gennevilliers,92036,0.64,14
13121,Bruneseau - Quai d'Ivry,OUI,46,2,44,44,0,OUI,OUI,2025-03-13 14:01:45+00:00,"48.824945637583, 2.3885661363602",Ivry-sur-Seine,94041,0.9565217391304348,14
17107,Berthier - Place Stuart Merril,OUI,35,20,15,12,3,OUI,OUI,2025-03-13 14:00:26+00:00,"48.885927922355044, 2.2933450341224675",Paris,75056,0.42857142857142855,14
21307,Victor Cresson - Telles de la Poterie,OUI,29,14,15,11,4,OUI,OUI,2025-03-13 13:56:20+00:00,"48.822698842979, 2.2686498274964",Issy-les-Moulineaux,92040,0.5172413793103449,14
15004,Vaugirard - Pasteur,OUI,21,20,1,0,1,OUI,OUI,2025-03-13 13:59:25+00:00,"48.84040868803496, 2.3154367133975033",Paris,75056,0.047619047619047616,14
10012,Vinaigriers - Magenta,OUI,24,16,8,4,4,OUI,OUI,2025-03-13 14:01:54+00:00,"48.8731167, 2.3593052",Paris,75056,0.3333333333333333,14
23010,Voltaire - Anatole France,OUI,26,4,22,13,9,OUI,OUI,2025-03-13 13:59:44+00:00,"48.891999360256904, 2.284262739121914",Levallois-Perret,92044,0.8461538461538461,14
21028,Pierre Lefaucheux - Traversière,OUI,34,6,28,18,10,OUI,OUI,2025-03-13 14:01:30+00:00,"48.82435208303827, 2.2417913004755974",Boulogne-Billancourt,92012,0.8235294117647058,14
19128,Quai de l'Oise - Aisne,OUI,28,25,3,1,2,OUI,OUI,2025-03-13 14:00:52+00:00,"48.8906231, 2.3833701",Paris,75056,0.10714285714285714,14
10018,Square Alban Satragne,OUI,29,26,3,0,3,OUI,OUI,2025-03-13 13:53:35+00:00,"48.875388227727, 2.3559567333359",Paris,75056,0.10344827586206896,14
15005,Place Jacques et Thérèse Tréfouël,OUI,42,28,14,9,5,OUI,OUI,2025-03-13 14:01:23+00:00,"48.842726498317, 2.3125657439232",Paris,75056,0.3333333333333333,14
32301,Mairie de Romainville,OUI,17,17,0,0,0,OUI,OUI,2025-03-13 13:55:17+00:00,"48.885109, 2.435679",Romainville,93063,0.0,14
18006,Square Louise Michel,OUI,35,32,3,0,3,OUI,OUI,2025-03-13 14:01:40+00:00,"48.884687354509, 2.3441386967897",Paris,75056,0.08571428571428572,14
20108,Jardin de l'Hospice Debrousse,OUI,23,21,2,0,2,OUI,OUI,2025-03-13 13:53:13+00:00,"48.861451061938, 2.40568600595",Paris,75056,0.08695652173913043,14
21401,Mairie de Clamart,OUI,31,27,4,0,4,OUI,OUI,2025-03-13 14:01:32+00:00,"48.800612, 2.262151",Clamart,92023,0.12903225806451613,14
13011,Hôpital - Campo-Formio,OUI,11,5,6,0,6,OUI,OUI,2025-03-13 14:01:50+00:00,"48.835405, 2.358218",Paris,75056,0.5454545454545454,14
13044,Place Jeanne d'Arc,OUI,35,35,0,0,0,OUI,OUI,2025-03-13 13:55:52+00:00,"48.829575, 2.369126",Paris,75056,0.0,14
8549,George V - Christophe Colomb,OUI,24,0,24,6,18,OUI,OUI,2025-03-13 14:01:50+00:00,"48.87046, 2.30104",Paris,75056,1.0,14
17108,Bessières - Porte de Clichy,OUI,30,16,14,12,2,OUI,OUI,2025-03-13 14:02:00+00:00,"48.89611762451474, 2.31790903955698",Paris,75056,0.4666666666666667,14
20122,Vitruve - Davout,OUI,23,21,2,0,2,OUI,OUI,2025-03-13 13:59:14+00:00,"48.86053161154489, 2.4091592812626543",Paris,75056,0.08695652173913043,14
16020,Place de la Porte de Passy,OUI,34,33,1,0,1,OUI,OUI,2025-03-13 13:46:14+00:00,"48.857341095470794, 2.2644165538827115",Paris,75056,0.029411764705882353,14
22408,Place du 14 Juillet,OUI,22,21,1,1,0,OUI,OUI,2025-03-13 13:59:57+00:00,"48.819266959525, 2.3011998832226",Malakoff,92046,0.045454545454545456,14
8020,Batignolles - Beudant,OUI,43,39,4,3,1,OUI,OUI,2025-03-13 14:01:34+00:00,"48.88216401466375, 2.319852970540523",Paris,75056,0.09302325581395349,14
5012,Estrapade - Ulm,OUI,16,6,10,1,9,OUI,OUI,2025-03-13 13:58:45+00:00,"48.84512772828, 2.3454568170362",Paris,75056,0.625,14
17015,Place de Lévis,OUI,48,45,3,1,2,OUI,OUI,2025-03-13 14:00:46+00:00,"48.883546851533254, 2.3131933808326726",Paris,75056,0.0625,14
1021,Halles - Bourdonnais,OUI,19,2,17,12,5,OUI,OUI,2025-03-13 14:01:28+00:00,"48.860448992575, 2.3460162431002",Paris,75056,0.8947368421052632,14
42003,Place de l'Insurrection d'Août 1944,OUI,30,7,23,22,1,OUI,OUI,2025-03-13 14:00:37+00:00,"48.81477852751594, 2.398074567317963",Ivry-sur-Seine,94041,0.7666666666666667,14
33015,Charles Tillon - Cimetière Communal,OUI,26,1,25,6,19,OUI,OUI,2025-03-13 14:00:44+00:00,"48.91844023641836, 2.3935630917549138",Aubervilliers,93001,0.9615384615384616,14
12043,Daumesnil - Hébrard,OUI,39,17,22,19,3,OUI,OUI,2025-03-13 14:01:48+00:00,"48.8429, 2.38474",Paris,75056,0.5641025641025641,14
7017,La Motte-Picquet - La Tour Maubourg,OUI,40,23,17,11,6,OUI,OUI,2025-03-13 13:57:28+00:00,"48.856926701847, 2.3096215831203",Paris,75056,0.425,14
15311,Quai du Président Roosevelt - Pont Aval,OUI,30,0,30,20,10,OUI,OUI,2025-03-13 14:00:06+00:00,"48.8343883676388, 2.2656820714473724",Paris,75056,1.0,14
17023,Porte d'Asnières,OUI,33,23,10,8,2,OUI,OUI,2025-03-13 13:58:42+00:00,"48.89035817610495, 2.3036286234855656",Paris,75056,0.30303030303030304,14
35006,Delizy - Louis Nadot,OUI,21,18,3,1,2,OUI,OUI,2025-03-13 14:01:15+00:00,"48.896212845581346, 2.4094578623771667",Pantin,93055,0.14285714285714285,14
44007,Camille Groult - Guy Môquet,OUI,21,3,18,11,7,OUI,OUI,2025-03-13 13:59:17+00:00,"48.787482746521306, 2.3976725712418556",Vitry-sur-Seine,94081,0.8571428571428571,14
22015,Île de la Jatte,OUI,23,5,18,4,14,OUI,OUI,2025-03-13 13:59:13+00:00,"48.894036161302104, 2.2666339203715324",Neuilly-sur-Seine,92051,0.782608695652174,14
10105,Mazagran - Bonne Nouvelle,OUI,25,13,12,11,1,OUI,OUI,2025-03-13 14:00:28+00:00,"48.870047123655, 2.3511248454452",Paris,75056,0.48,14
9004,Gérando - Rochechouart,OUI,21,20,1,0,1,OUI,OUI,2025-03-13 13:57:21+00:00,"48.88294340845, 2.3464846238494",Paris,75056,0.047619047619047616,14
6008,Assas - Luxembourg,OUI,32,4,28,7,21,OUI,OUI,2025-03-13 14:01:27+00:00,"48.843734468779, 2.3334283818759",Paris,75056,0.875,14
51002,Placette Grégoire Collas,OUI,25,15,10,4,6,OUI,OUI,2025-03-13 13:54:54+00:00,"48.94342014002797, 2.2487476095557213",Argenteuil,95018,0.4,14
13109,Brillat-Savarin - Küss,OUI,21,16,5,4,1,OUI,OUI,2025-03-13 14:01:27+00:00,"48.822203, 2.350422",Paris,75056,0.23809523809523808,14
32601,Porte des Lilas - Faidherbe,OUI,39,38,1,1,0,OUI,OUI,2025-03-13 13:55:00+00:00,"48.87861855668978, 2.4120327830314636",Les Lilas,93045,0.02564102564102564,14
42209,Place de l'Europe - Quai de Bercy,OUI,15,4,11,9,2,OUI,OUI,2025-03-13 14:01:17+00:00,"48.82529858840266, 2.3945679143071175",Charenton-le-Pont,94018,0.7333333333333333,14
33016,Fort d'Aubervilliers,OUI,22,9,13,10,3,OUI,OUI,2025-03-13 13:55:39+00:00,"48.91502382370325, 2.4035281687974925",Aubervilliers,93001,0.5909090909090909,14
43001,Paris - Laitières,OUI,22,9,13,4,9,OUI,OUI,2025-03-13 14:01:09+00:00,"48.84630274151258, 2.4207553267478947",Vincennes,94080,0.5909090909090909,14
10162,Alexandre Parodi - Quai de Valmy,OUI,24,24,0,0,0,OUI,OUI,2025-03-13 13:59:10+00:00,"48.879359419425, 2.3665961623192",Paris,75056,0.0,14
15030,Emeriau - Beaugrenelle,OUI,72,12,60,50,10,OUI,OUI,2025-03-13 14:00:10+00:00,"48.84791249714942, 2.2843059897422795",Paris,75056,0.8333333333333334,14
13009,Auguste Blanqui - Corvisart,OUI,26,22,4,0,4,OUI,OUI,2025-03-13 14:00:57+00:00,"48.8300989, 2.3502726",Paris,75056,0.15384615384615385,14
9114,Faubourg Poissonnière - Dunkerque,OUI,29,27,2,1,1,OUI,OUI,2025-03-13 14:01:25+00:00,"48.880883445404436, 2.349934279918671",Paris,75056,0.06896551724137931,14
17111,Lemercier - Cardinet,OUI,24,22,2,1,1,OUI,OUI,2025-03-13 14:01:05+00:00,"48.890097168851746, 2.317377626895905",Paris,75056,0.08333333333333333,14
16011,Victor Hugo - La Pompe,OUI,40,31,9,2,7,OUI,OUI,2025-03-13 13:59:05+00:00,"48.86795222470859, 2.28146318346262",Paris,75056,0.225,14
9102,Londres - Place d'Estienne d'Orves,OUI,24,1,23,14,9,OUI,OUI,2025-03-13 13:58:49+00:00,"48.876693805756986, 2.3305362090468407",Paris,75056,0.9583333333333334,14
25001,Colmar - Victor Hugo,OUI,31,7,24,10,14,OUI,OUI,2025-03-13 13:59:18+00:00,"48.88652251096166, 2.173960916697979",Rueil-Malmaison,92063,0.7741935483870968,14
9006,Dunkerque - Trudaine,OUI,16,15,1,0,1,OUI,OUI,2025-03-13 13:59:19+00:00,"48.88215166773376, 2.3463253676891327",Paris,75056,0.0625,14
13032,Italie - Jardin Joan Miro,OUI,24,21,3,2,1,OUI,OUI,2025-03-13 14:00:44+00:00,"48.81990914045756, 2.3592948541045193",Paris,75056,0.125,14
92006,Place Nelson Mandela,OUI,30,17,13,2,11,OUI,OUI,2025-03-13 13:59:54+00:00,"48.897874318180556, 2.2182820737361912",Nanterre,92050,0.43333333333333335,14
10165,Gare de l'Est - Place du 11 Novembre 1918,OUI,39,38,1,0,1,OUI,OUI,2025-03-13 14:00:56+00:00,"48.876327, 2.3585464",Paris,75056,0.02564102564102564,14
12038,Picpus - Louis Braille,OUI,43,40,3,2,1,OUI,OUI,2025-03-13 14:00:53+00:00,"48.839988788912, 2.4005256685521",Paris,75056,0.06976744186046512,14
15064,Javel - André Citroën,OUI,44,8,36,33,3,OUI,OUI,2025-03-13 14:00:31+00:00,"48.846276485475, 2.2786368057132",Paris,75056,0.8181818181818182,14
12155,Rottembourg - Général Michel Bizot,OUI,42,35,7,6,1,OUI,OUI,2025-03-13 13:59:45+00:00,"48.83787825992554, 2.4044052511453633",Paris,75056,0.16666666666666666,14
13128,Quai de la Gare - Pont de Bercy,OUI,29,4,25,22,3,OUI,OUI,2025-03-13 13:56:42+00:00,"48.83730787972, 2.3740861260598",Paris,75056,0.8620689655172413,14
9011,Geoffroy - Marie,OUI,17,4,13,10,3,OUI,OUI,2025-03-13 14:01:23+00:00,"48.873781940593325, 2.344513876337893",Paris,75056,0.7647058823529411,14
92001,Mairie de quartier du Plateau - Mont-Valérien,OUI,20,14,6,4,2,OUI,OUI,2025-03-13 13:54:38+00:00,"48.8799933, 2.2072437",Nanterre,92050,0.3,14
9034,Godot de Mauroy - Madeleine,OUI,21,2,19,5,14,OUI,OUI,2025-03-13 14:01:25+00:00,"48.869789, 2.326347",Paris,75056,0.9047619047619048,14
43010,La Jarry - Place Diderot,OUI,25,20,5,1,4,OUI,OUI,2025-03-13 13:58:41+00:00,"48.849726940367326, 2.452013790607453",Vincennes,94080,0.2,14
10021,Marché Saint-Quentin,OUI,14,11,3,1,2,OUI,OUI,2025-03-13 14:01:54+00:00,"48.877356057652, 2.3545114456374",Paris,75056,0.21428571428571427,14
15057,Lucien Bossoutrot - Général Martial Vallin,OUI,38,10,28,20,8,OUI,OUI,2025-03-13 14:01:28+00:00,"48.836956046311, 2.2741072252393",Paris,75056,0.7368421052631579,14
5115,Buffon - Jardin des Plantes,OUI,30,2,28,19,9,OUI,OUI,2025-03-13 13:59:49+00:00,"48.842668466104875, 2.3618587106466293",Paris,75056,0.9333333333333333,14
16002,Pergolèse - Malakoff,OUI,37,28,9,3,6,OUI,OUI,2025-03-13 14:00:34+00:00,"48.87521088779225, 2.2842781618237495",Paris,75056,0.24324324324324326,14
41211,Louis Xavier de Ricard - Ancienne Mairie,OUI,34,32,2,2,0,OUI,OUI,2025-03-13 13:59:23+00:00,"48.84629899065091, 2.472420372068882",Fontenay-sous-Bois,94033,0.058823529411764705,14
6027,Blaise-Desgoffe - Vaugirard,OUI,32,20,12,7,5,OUI,OUI,2025-03-13 13:58:55+00:00,"48.846128877747, 2.3242672160268",Paris,75056,0.375,14
12101,Charenton - Prague,OUI,28,11,17,15,2,OUI,OUI,2025-03-13 14:01:23+00:00,"48.848175129981, 2.3763584494312",Paris,75056,0.6071428571428571,14
18007,Goutte d'or - Barbès,OUI,20,18,2,0,2,OUI,OUI,2025-03-13 14:00:44+00:00,"48.885124323627, 2.3496962338686",Paris,75056,0.1,14
5001,Harpe - Saint-Germain,OUI,43,18,25,20,5,OUI,OUI,2025-03-13 14:00:40+00:00,"48.851518815017, 2.3436703160405",Paris,75056,0.5813953488372093,14
9027,Douai - Pierre Fontaine,OUI,23,20,3,2,1,OUI,OUI,2025-03-13 13:57:32+00:00,"48.88229101148092, 2.33324121683836",Paris,75056,0.13043478260869565,14
51001,Gare d'Argenteuil,OUI,37,19,18,4,14,OUI,OUI,2025-03-13 13:58:31+00:00,"48.947022436806705, 2.256898172199726",Argenteuil,95018,0.4864864864864865,14
4020,Place Edmond Michelet,OUI,23,10,13,12,1,OUI,OUI,2025-03-13 14:00:49+00:00,"48.860134890542, 2.3500636965036",Paris,75056,0.5652173913043478,14
21315,Jules Guesdes - Général de Gaulle,OUI,24,23,1,0,1,OUI,OUI,2025-03-13 13:59:34+00:00,"48.81930581291959, 2.278934195637703",Issy-les-Moulineaux,92040,0.041666666666666664,14
15022,Emile Zola - Fondary,OUI,41,13,28,21,7,OUI,OUI,2025-03-13 14:01:36+00:00,"48.847051143113745, 2.2953405976295476",Paris,75056,0.6829268292682927,14
23102,Hôtel de Ville de Sèvres,OUI,31,16,15,12,3,OUI,OUI,2025-03-13 13:53:08+00:00,"48.824363561289, 2.2131047397852",Sèvres,92072,0.4838709677419355,14
23004,Paul Vaillant-Couturier - Victor Hugo,OUI,34,8,26,23,3,OUI,OUI,2025-03-13 14:00:09+00:00,"48.89819702263572, 2.293848017974069",Levallois-Perret,92044,0.7647058823529411,14
15036,Croix Nivert - Square Saint-Lambert,OUI,47,47,0,0,0,NON,NON,2025-03-03 09:03:43+00:00,"48.843051521591, 2.2952004522085",Paris,75056,0.0,9
8037,Monceau - Malesherbes,OUI,37,28,9,4,5,OUI,OUI,2025-03-13 14:01:31+00:00,"48.8795079, 2.3145456",Paris,75056,0.24324324324324326,14
6022,Marché Saint-Germain,OUI,19,0,19,12,7,OUI,OUI,2025-03-13 14:00:45+00:00,"48.85165625855281, 2.335500307381153",Paris,75056,1.0,14
11017,Charonne - Bureau,OUI,44,44,0,0,0,OUI,OUI,2025-03-13 14:00:14+00:00,"48.854176, 2.396093",Paris,75056,0.0,14
15006,Cherche-Midi - Hôpital Necker,OUI,35,22,13,8,5,OUI,OUI,2025-03-13 13:58:47+00:00,"48.84461063309956, 2.317914068698883",Paris,75056,0.37142857142857144,14
21306,Place Lafayette,OUI,61,6,55,46,9,OUI,OUI,2025-03-13 14:01:34+00:00,"48.829654975522, 2.2638675570488",Issy-les-Moulineaux,92040,0.9016393442622951,14
41403,Gare RER - Malleret-Joinville,OUI,20,9,11,9,2,OUI,OUI,2025-03-13 13:59:40+00:00,"48.802936, 2.42531",Alfortville,94002,0.55,14
41205,Maréchal Joffre - Verdun,OUI,20,18,2,0,2,OUI,OUI,2025-03-13 14:01:56+00:00,"48.85385, 2.470307",Fontenay-sous-Bois,94033,0.1,14
33014,Parc Eli Lotar,OUI,19,15,4,2,2,OUI,OUI,2025-03-13 14:00:34+00:00,"48.91844993053703, 2.3727085813879967",Aubervilliers,93001,0.21052631578947367,14
12018,Saint-Mandé - Fabre d'Eglantine,OUI,32,18,14,6,8,OUI,OUI,2025-03-13 14:01:36+00:00,"48.8453579, 2.3965022",Paris,75056,0.4375,14
15127,Place Charles Michels,OUI,35,10,25,22,3,OUI,OUI,2025-03-13 14:01:45+00:00,"48.846401, 2.28502",Paris,75056,0.7142857142857143,14
44016,Balzac - Olympes de Gouges,OUI,28,10,18,8,10,OUI,OUI,2025-03-13 13:59:48+00:00,"48.77850332486751, 2.4006786569952965",Vitry-sur-Seine,94081,0.6428571428571429,14
20105,Benoît Frachon - République,OUI,28,26,2,1,1,OUI,OUI,2025-03-13 14:00:50+00:00,"48.85230729014318, 2.415605485439301",Paris,75056,0.07142857142857142,14
44005,Place Saint-Just,OUI,22,14,8,3,5,OUI,OUI,2025-03-13 14:01:54+00:00,"48.790379518724265, 2.3895226791501045",Vitry-sur-Seine,94081,0.36363636363636365,14
33103,Jean Jaurès - Jules Jacquemin,OUI,21,21,0,0,0,OUI,OUI,2025-03-13 13:56:45+00:00,"48.88433053604843, 2.4082902455152104",Le Pré-Saint-Gervais,93061,0.0,14
17119,Toqueville - Cardinet,OUI,31,25,6,3,3,OUI,OUI,2025-03-13 13:57:01+00:00,"48.88490187110713, 2.3109393194317818",Paris,75056,0.1935483870967742,14
14032,Mairie du 14ème,OUI,32,30,2,0,2,OUI,OUI,2025-03-13 13:59:53+00:00,"48.83254578123, 2.3254923149943",Paris,75056,0.0625,14
15011,Cambronne - Villa Croix Nivert,OUI,60,49,11,9,2,OUI,OUI,2025-03-13 14:01:52+00:00,"48.845847561366, 2.3017574474216",Paris,75056,0.18333333333333332,14
14011,Place des Droits de l'Enfant,OUI,39,36,3,1,2,OUI,OUI,2025-03-13 14:01:50+00:00,"48.8274804, 2.3319217",Paris,75056,0.07692307692307693,14
12026,Place Ginette Hamelin,OUI,50,22,28,24,4,OUI,OUI,2025-03-13 13:59:04+00:00,"48.837853, 2.382064",Paris,75056,0.56,14
16019,Porte de la Muette,OUI,34,14,20,4,16,OUI,OUI,2025-03-13 14:00:39+00:00,"48.86302317841182, 2.2687188170157406",Paris,75056,0.5882352941176471,14
6012,Saint-Germain - Ciseaux,OUI,18,3,15,12,3,OUI,OUI,2025-03-13 13:59:24+00:00,"48.853305277595, 2.3344654618827",Paris,75056,0.8333333333333334,14
33012,Landy - Heurtault,OUI,29,29,0,0,0,OUI,OUI,2025-03-13 13:59:17+00:00,"48.915096534520316, 2.375951372087002",Aubervilliers,93001,0.0,14
27005,Gare du Stade,OUI,18,12,6,2,4,OUI,OUI,2025-03-13 13:55:56+00:00,"48.9312676, 2.2603778",Colombes,92025,0.3333333333333333,14
2013,Favart - Italiens,OUI,17,4,13,2,11,OUI,OUI,2025-03-13 14:01:27+00:00,"48.871446353921, 2.3382901058508",Paris,75056,0.7647058823529411,14
15071,Suffren - Champ de Mars,OUI,23,15,8,8,0,OUI,OUI,2025-03-13 14:00:55+00:00,"48.8547194, 2.2952168",Paris,75056,0.34782608695652173,14
3102,Bourg l'Abbé - Saint-Martin,OUI,36,1,35,22,13,OUI,OUI,2025-03-13 14:01:07+00:00,"48.86393331949257, 2.352406270802021",Paris,75056,0.9722222222222222,14
9024,Taitbout - La Fayette,OUI,51,6,45,26,19,OUI,OUI,2025-03-13 14:01:36+00:00,"48.8733298892, 2.3352625966072",Paris,75056,0.8823529411764706,14
11033,Bréguet - Sabin,OUI,29,9,20,18,2,OUI,OUI,2025-03-13 13:58:34+00:00,"48.856931678257, 2.3706749462105",Paris,75056,0.6896551724137931,14
8201,Arsène Houssaye - Friedland,OUI,29,23,6,0,6,OUI,OUI,2025-03-13 14:01:46+00:00,"48.874510616163, 2.2994716674148",Paris,75056,0.20689655172413793,14
10033,Gare du Nord - Saint-Vincent de Paul,OUI,24,21,3,1,2,OUI,OUI,2025-03-13 13:53:11+00:00,"48.880955741648, 2.3524305148385",Paris,75056,0.125,14
21319,Esplanade du Foncet - Camille Desmoulins,OUI,27,1,26,19,7,OUI,OUI,2025-03-13 14:01:37+00:00,"48.827090233494964, 2.2606857866048813",Issy-les-Moulineaux,92040,0.9629629629629629,14
18039,Jardins d'Eole,OUI,19,16,3,0,3,OUI,OUI,2025-03-13 13:58:22+00:00,"48.8869703, 2.3668488",Paris,75056,0.15789473684210525,14
8116,Champs-Elysees - Bassano,OUI,25,25,0,0,0,NON,NON,2021-02-21 19:09:18+00:00,"48.871811807816, 2.300238981843",Paris,75056,0.0,19
18030,Joseph Dijon - Ornano,OUI,36,34,2,2,0,OUI,OUI,2025-03-13 14:00:50+00:00,"48.89374453351521, 2.3476678133010864",Paris,75056,0.05555555555555555,14
20022,Porte de Bagnolet,OUI,33,33,0,0,0,OUI,OUI,2025-03-13 14:00:51+00:00,"48.864707139122984, 2.408344637349607",Paris,75056,0.0,14
5024,Place Monge,OUI,21,13,8,2,6,OUI,OUI,2025-03-13 14:00:58+00:00,"48.842761803051, 2.3524079471827",Paris,75056,0.38095238095238093,14
12036,Reuilly - Place Felix Eboue,OUI,41,37,4,2,2,OUI,OUI,2025-03-13 14:00:15+00:00,"48.84030274499962, 2.394630398715453",Paris,75056,0.0975609756097561,14
31005,Square Denise Buisson,OUI,45,45,0,0,0,OUI,OUI,2025-03-13 14:00:30+00:00,"48.8562322730982, 2.426436245441437",Montreuil,93048,0.0,14
14026,Plantes - Moulin Vert,OUI,45,41,4,1,3,OUI,OUI,2025-03-13 14:00:19+00:00,"48.83005755305626, 2.3232302069664006",Paris,75056,0.08888888888888889,14
21314,Chemin de Bretagne,OUI,28,0,28,22,6,OUI,OUI,2025-03-13 14:01:57+00:00,"48.824753068884, 2.2588385956052",Issy-les-Moulineaux,92040,1.0,14
10008,Cité Riverin - Château d'Eau,OUI,17,6,11,9,2,OUI,OUI,2025-03-13 13:59:33+00:00,"48.870702423554306, 2.358739863900845",Paris,75056,0.6470588235294118,14
12005,Crozatier - Faubourg Saint-Antoine,OUI,39,11,28,25,3,OUI,OUI,2025-03-13 14:01:14+00:00,"48.850440013405, 2.378901366211",Paris,75056,0.717948717948718,14
8117,Place de la Madeleine - Royale,OUI,43,0,43,27,16,OUI,OUI,2025-03-13 14:01:19+00:00,"48.869228052648, 2.324421107769",Paris,75056,1.0,14
13516,Glacière - Soeur Catherine Marie,OUI,40,31,9,3,6,OUI,OUI,2025-03-13 14:00:43+00:00,"48.829522989420596, 2.343570403754711",Paris,75056,0.225,14
10032,Claude Vellefaux - Hôpital Saint-Louis,OUI,32,26,6,2,4,OUI,OUI,2025-03-13 13:55:40+00:00,"48.872859139003, 2.3700717069851",Paris,75056,0.1875,14
12028,Vivaldi - Antoine-Julien Hénard,OUI,27,26,1,0,1,OUI,OUI,2025-03-13 13:59:35+00:00,"48.841923663276546, 2.389728979467376",Paris,75056,0.037037037037037035,14
48004,Maxime Gorki - Louis Aragon,OUI,20,17,3,2,1,OUI,OUI,2025-03-13 13:57:53+00:00,"48.78909814728443, 2.368387877941132",Villejuif,94076,0.15,14
12035,Madagascar - Meuniers,OUI,32,30,2,1,1,OUI,OUI,2025-03-13 13:56:00+00:00,"48.83460464474706, 2.3970650508999825",Paris,75056,0.0625,14
11112,Jules Vallès - Charonne,OUI,23,14,9,4,5,OUI,OUI,2025-03-13 13:59:25+00:00,"48.854284379935, 2.3847674578428",Paris,75056,0.391304347826087,14
44011,Lebrun - Colonel Fabien,OUI,27,26,1,0,1,OUI,OUI,2025-03-13 13:52:22+00:00,"48.78266870733145, 2.381317801773548",Vitry-sur-Seine,94081,0.037037037037037035,14
5007,Ecoles - Carmes,OUI,34,2,32,15,17,OUI,OUI,2025-03-13 14:00:06+00:00,"48.848904447989405, 2.3473486304283147",Paris,75056,0.9411764705882353,14
2108,Vivienne - Montmartre,OUI,37,2,35,18,17,OUI,OUI,2025-03-13 14:02:00+00:00,"48.871347597383, 2.3414588347077",Paris,75056,0.9459459459459459,14
16105,Crevaux - Bugeaud,OUI,31,28,3,0,3,OUI,OUI,2025-03-13 13:56:02+00:00,"48.87080942867, 2.2811490076919",Paris,75056,0.0967741935483871,14
21707,Square Etienne Jarousse,OUI,22,22,0,0,0,OUI,OUI,2025-03-13 14:00:58+00:00,"48.82485182597129, 2.2925933450460434",Vanves,92075,0.0,14
4006,Bourdon - Pont Morland,OUI,51,22,29,23,6,OUI,OUI,2025-03-13 14:01:48+00:00,"48.8478103, 2.3659356",Paris,75056,0.5686274509803921,14
4019,Cloître Saint-Merri - Renard,OUI,31,2,29,21,8,OUI,OUI,2025-03-13 14:01:46+00:00,"48.858835448898, 2.3518279194832",Paris,75056,0.9354838709677419,14
18202,Diane Arbus,OUI,37,36,1,1,0,OUI,OUI,2025-03-13 13:54:37+00:00,"48.898800717199, 2.3524022474885",Paris,75056,0.02702702702702703,14
15129,Hôpital Necker,OUI,37,18,19,14,5,OUI,OUI,2025-03-13 13:58:26+00:00,"48.846043490118454, 2.313245013356209",Paris,75056,0.5135135135135135,14
3008,Perle - Vieille du Temple,OUI,35,3,32,24,8,OUI,OUI,2025-03-13 14:01:36+00:00,"48.8601346, 2.3611206",Paris,75056,0.9142857142857143,14
8027,Mairie du 8ème,OUI,14,4,10,6,4,OUI,OUI,2025-03-13 14:01:57+00:00,"48.877932, 2.318264",Paris,75056,0.7142857142857143,14
6010,Chevreuse - Montparnasse,OUI,15,7,8,2,6,OUI,OUI,2025-03-13 13:57:14+00:00,"48.841739161231, 2.3315522167367",Paris,75056,0.5333333333333333,14
15039,Abbé Groult - Convention,OUI,12,12,0,0,0,OUI,OUI,2025-03-13 14:00:02+00:00,"48.83596927866069, 2.302064039509349",Paris,75056,0.0,14
1007,Turbigo - Française,OUI,16,1,15,8,7,OUI,OUI,2025-03-13 14:00:28+00:00,"48.86358858111446, 2.3477794602513313",Paris,75056,0.9375,14
21402,Place Aimé Césaire,OUI,27,23,4,0,4,OUI,OUI,2025-03-13 13:54:02+00:00,"48.783194713067815, 2.2429127991199493",Clamart,92023,0.14814814814814814,14
47003,Charentonneau - Maisons Alfort,OUI,20,17,3,2,1,OUI,OUI,2025-03-13 14:01:52+00:00,"48.809932980484355, 2.443288456496946",Maisons-Alfort,94046,0.15,14
13018,Bruant - Vincent Auriol,OUI,25,9,16,12,4,OUI,OUI,2025-03-13 14:01:27+00:00,"48.834848452929, 2.3668264996271",Paris,75056,0.64,14
18034,Leibniz - Jean Dollfus,OUI,32,32,0,0,0,OUI,OUI,2025-03-13 13:47:52+00:00,"48.896328348515986, 2.333390423834684",Paris,75056,0.0,14
21303,Jean Monnet - Iles,OUI,32,4,28,26,2,OUI,OUI,2025-03-13 14:01:55+00:00,"48.823393984057304, 2.2497073194874866",Issy-les-Moulineaux,92040,0.875,14
18140,Porte de Clignancourt - Ney,OUI,38,34,4,3,1,OUI,OUI,2025-03-13 13:54:56+00:00,"48.899641123987095, 2.344321422278881",Paris,75056,0.10526315789473684,14
9007,Condorcet - Turgot,OUI,19,15,4,0,4,OUI,OUI,2025-03-13 13:52:24+00:00,"48.87985155789093, 2.345232367515564",Paris,75056,0.21052631578947367,14
9009,Square Montholon,OUI,18,10,8,1,7,OUI,OUI,2025-03-13 13:57:57+00:00,"48.876620377545024, 2.3457641154527664",Paris,75056,0.4444444444444444,14
13052,Leredde - Tolbiac,OUI,43,15,28,16,12,OUI,OUI,2025-03-13 13:59:04+00:00,"48.82887629664, 2.3744382709265",Paris,75056,0.6511627906976745,14
13005,Cordelières - Arago,OUI,45,8,37,32,5,OUI,OUI,2025-03-13 14:01:13+00:00,"48.83548071896613, 2.348572461702221",Paris,75056,0.8222222222222222,14
17024,Villiers - Batignolles,OUI,23,19,4,0,4,OUI,OUI,2025-03-13 13:59:56+00:00,"48.88125253846116, 2.31653843075037",Paris,75056,0.17391304347826086,14
19002,Centquatre,OUI,38,29,9,1,8,NON,NON,2025-03-13 14:02:00+00:00,"48.889333538455, 2.3707854375243",Paris,75056,0.23684210526315788,14
41401,Marne - Charles de Gaulle,OUI,25,16,9,9,0,OUI,OUI,2025-03-13 14:00:35+00:00,"48.815071719544434, 2.4121668934822087",Alfortville,94002,0.36,14
17019,Phalsbourg - Villiers,OUI,18,6,12,5,7,OUI,OUI,2025-03-13 13:54:21+00:00,"48.88242307900951, 2.3090453445911407",Paris,75056,0.6666666666666666,14
6002,Saint-Benoît - Jacob,OUI,21,10,11,9,2,OUI,OUI,2025-03-13 14:00:08+00:00,"48.85545136013941, 2.3334722220897675",Paris,75056,0.5238095238095238,14
15132,Bargue -  Dutot,OUI,21,14,7,4,3,OUI,OUI,2025-03-13 14:01:29+00:00,"48.837884, 2.308876",Paris,75056,0.3333333333333333,14
14031,Didot - Place de Moro-Giafferi,OUI,20,20,0,0,0,OUI,OUI,2025-03-13 14:00:17+00:00,"48.8337, 2.3215",Paris,75056,0.0,14
14137,Maurice d'Ocagne - General Maudhuy,OUI,29,25,4,1,3,OUI,OUI,2025-03-13 13:56:08+00:00,"48.82414282524159, 2.3158789426088333",Paris,75056,0.13793103448275862,14
20044,Davout - Volga,OUI,27,23,4,2,2,OUI,OUI,2025-03-13 13:59:25+00:00,"48.852919679957296, 2.410522909779111",Paris,75056,0.14814814814814814,14
14019,Sarrette - Général Leclerc,OUI,22,18,4,0,4,OUI,OUI,2025-03-13 13:59:10+00:00,"48.825030852925, 2.3264128693982",Paris,75056,0.18181818181818182,14
10019,Paradis - Hauteville,OUI,31,8,23,19,4,OUI,OUI,2025-03-13 13:58:14+00:00,"48.874999954666755, 2.3522757401923404",Paris,75056,0.7419354838709677,14
10027,Dunkerque - Alsace,OUI,20,19,1,1,0,OUI,OUI,2025-03-13 14:01:27+00:00,"48.879355, 2.358379",Paris,75056,0.05,14
41203,Stalingrad - Rigollots,OUI,50,49,1,0,1,OUI,OUI,2025-03-13 13:58:49+00:00,"48.84997403844251, 2.45557576417923",Fontenay-sous-Bois,94033,0.02,14
12002,Lacuée - Lyon,OUI,16,3,13,10,3,OUI,OUI,2025-03-13 14:01:41+00:00,"48.849268481958, 2.3704585433006",Paris,75056,0.8125,14
21506,Maurice Payret-Dortail,OUI,22,21,1,0,1,OUI,OUI,2025-03-13 13:53:05+00:00,"48.87811957063342, 2.2233625128865246",Suresnes,92073,0.045454545454545456,14
16012,Flandrin - Longchamp,OUI,40,1,39,13,26,OUI,OUI,2025-03-13 14:01:36+00:00,"48.86877849178477, 2.274354539176829",Paris,75056,0.975,14
4103,Archives - Rivoli,OUI,20,1,19,13,6,OUI,OUI,2025-03-13 14:01:29+00:00,"48.857346707443, 2.3539767041802",Paris,75056,0.95,14
16036,Porte Molitor,OUI,59,9,50,34,16,OUI,OUI,2025-03-13 14:01:36+00:00,"48.84524763511433, 2.2569015249609947",Paris,75056,0.847457627118644,14
14103,Maine - Liancourt,OUI,25,24,1,0,1,OUI,OUI,2025-03-13 14:01:47+00:00,"48.835064363954, 2.323731449974",Paris,75056,0.04,14
42505,Charles Frérot - Albert Guilpin,OUI,29,27,2,0,2,OUI,OUI,2025-03-13 14:00:10+00:00,"48.8155839183714, 2.3505029082298283",Gentilly,94037,0.06896551724137931,14
3001,Beaumarchais - Saint-Gilles,OUI,44,33,11,7,4,OUI,OUI,2025-03-13 13:59:09+00:00,"48.8580378, 2.3679352",Paris,75056,0.25,14
12015,Place de la Nation - Picpus,OUI,35,35,0,0,0,OUI,OUI,2025-03-13 14:01:05+00:00,"48.846821681548, 2.4001130461693",Paris,75056,0.0,14
9037,Parme - Clichy,OUI,23,20,3,2,1,OUI,OUI,2025-03-13 14:00:20+00:00,"48.881266424227, 2.3281970934506",Paris,75056,0.13043478260869565,14
14001,Edgar Quinet - Gaité,OUI,27,17,10,1,9,OUI,OUI,2025-03-13 13:57:06+00:00,"48.841160928966, 2.324595451355",Paris,75056,0.37037037037037035,14
2015,Louis le Grand - Italiens,OUI,33,8,25,17,8,OUI,OUI,2025-03-13 14:00:36+00:00,"48.870508937204, 2.3340544619393",Paris,75056,0.7575757575757576,14
26004,Gare RER les Grésillons,OUI,22,16,6,6,0,OUI,OUI,2025-03-13 13:59:22+00:00,"48.919898633572764, 2.31458459136273",Asnières-sur-Seine,92004,0.2727272727272727,14
21026,Sèvres - Général Leclerc,OUI,29,6,23,18,5,OUI,OUI,2025-03-13 14:01:36+00:00,"48.830121559055, 2.2314262390137",Boulogne-Billancourt,92012,0.7931034482758621,14
18139,Poissonniers - Championnet,OUI,28,25,3,1,2,OUI,OUI,2025-03-13 14:00:44+00:00,"48.89543299733937, 2.3530178144574165",Paris,75056,0.10714285714285714,14
19129,Solitaires - Place des Fêtes,OUI,29,29,0,0,0,NON,NON,2025-02-23 09:26:05+00:00,"48.876601, 2.391769",Paris,75056,0.0,9
16042,Murat - Porte de Saint-Cloud,OUI,38,2,36,32,4,OUI,OUI,2025-03-13 13:59:04+00:00,"48.83750862621299, 2.2577651962637906",Paris,75056,0.9473684210526315,14
20029,Frères Flavien - Porte des Lilas,OUI,23,23,0,0,0,OUI,OUI,2025-03-13 13:56:20+00:00,"48.8780992764359, 2.41104629853209",Paris,75056,0.0,14
1006,Grande Truanderie - Saint-Denis,OUI,28,15,13,11,2,OUI,OUI,2025-03-13 14:00:52+00:00,"48.8626302, 2.3498075",Paris,75056,0.4642857142857143,14
22503,Joffre - Aigle,OUI,19,13,6,5,1,OUI,OUI,2025-03-13 14:00:17+00:00,"48.904033, 2.245096",La Garenne-Colombes,92035,0.3157894736842105,14
15001,Gare Montparnasse - Arrivée,OUI,41,28,13,4,9,OUI,OUI,2025-03-13 14:01:45+00:00,"48.843827994315, 2.3225811123848",Paris,75056,0.3170731707317073,14
1102,Française - Etienne Marcel,OUI,36,15,21,15,6,OUI,OUI,2025-03-13 14:00:14+00:00,"48.864053304653766, 2.347587011754513",Paris,75056,0.5833333333333334,14
15008,Sèvres - Lecourbe,OUI,60,27,33,25,8,OUI,OUI,2025-03-13 14:01:56+00:00,"48.8447677, 2.3110086",Paris,75056,0.55,14
13017,Nationale - Vincent Auriol,OUI,33,28,5,1,4,OUI,OUI,2025-03-13 13:58:19+00:00,"48.83252708397293, 2.362354410392119",Paris,75056,0.15151515151515152,14
19110,Square Claude Bernard,OUI,28,17,11,7,4,OUI,OUI,2025-03-13 13:59:55+00:00,"48.89876016219984, 2.375325746834278",Paris,75056,0.39285714285714285,14
12020,Cours de Vincennes - Soult,OUI,44,39,5,2,3,OUI,OUI,2025-03-13 13:53:57+00:00,"48.846918761569, 2.4105220288038",Paris,75056,0.11363636363636363,14
22201,Henri Ravera - Gabriel Péri,OUI,28,28,0,0,0,OUI,OUI,2025-03-13 13:58:06+00:00,"48.79722273833844, 2.302115857601166",Bagneux,92007,0.0,14
24006,Adolphe Lalyre - Armand Silvestre,OUI,38,38,0,0,0,OUI,OUI,2025-03-13 13:59:04+00:00,"48.90406266961591, 2.273416221141815",Courbevoie,92026,0.0,14
5015,Epée de Bois - Mouffetard,OUI,62,50,12,9,3,OUI,OUI,2025-03-13 13:57:08+00:00,"48.841508690388835, 2.350066713988781",Paris,75056,0.1935483870967742,14
3009,Temple - Haudriettes,OUI,19,1,18,14,4,OUI,OUI,2025-03-13 13:59:50+00:00,"48.861636880212, 2.3566960206458",Paris,75056,0.9473684210526315,14
45002,Roger Salengro - Général de Gaulle,OUI,27,15,12,4,8,OUI,OUI,2025-03-13 13:59:00+00:00,"48.820029010376956, 2.4846760556101803",Champigny-sur-Marne,94017,0.4444444444444444,14
4014,Blancs-Manteaux - Archives,OUI,29,1,28,23,5,OUI,OUI,2025-03-13 13:59:51+00:00,"48.85941800703, 2.3559471219778",Paris,75056,0.9655172413793104,14
15128,Cadix - Hameau,OUI,36,28,8,6,2,OUI,OUI,2025-03-13 14:01:47+00:00,"48.8340107632249, 2.289516180753708",Paris,75056,0.2222222222222222,14
3012,Square Emile - Chautemps,OUI,23,5,18,13,5,OUI,OUI,2025-03-13 14:00:35+00:00,"48.867433724231, 2.3536357283592",Paris,75056,0.782608695652174,14
44014,Camille Risch - Paul Armangot,OUI,25,16,9,4,5,OUI,OUI,2025-03-13 14:01:04+00:00,"48.774703, 2.373685",Vitry-sur-Seine,94081,0.36,14
23702,Hôtel de Ville de Chaville,OUI,20,19,1,0,1,OUI,OUI,2025-03-13 13:58:26+00:00,"48.80887149094033, 2.188134044408798",Chaville,92022,0.05,14
12037,Reuilly - Daumesnil,OUI,36,32,4,0,4,OUI,OUI,2025-03-13 13:57:25+00:00,"48.8395385, 2.3972516",Paris,75056,0.1111111111111111,14
2002,Etienne Marcel - Montorgueil,OUI,25,3,22,18,4,OUI,OUI,2025-03-13 14:01:29+00:00,"48.86450567259199, 2.3461959511041637",Paris,75056,0.88,14
18004,Place des Abbesses,OUI,12,11,1,0,1,OUI,OUI,2025-03-13 13:59:01+00:00,"48.884542726149725, 2.3386867716908455",Paris,75056,0.08333333333333333,14
14023,Adolphe Pinard - Victor Hugo,OUI,51,49,2,0,2,OUI,OUI,2025-03-13 13:54:08+00:00,"48.8236825874564, 2.3077843710780144",Malakoff,92046,0.0392156862745098,14
16013,Mairie du 16ème,OUI,35,33,2,1,1,OUI,OUI,2025-03-13 14:00:39+00:00,"48.863936848471994, 2.2765953093767166",Paris,75056,0.05714285714285714,14
3006,Mairie du 3ème,OUI,23,3,20,17,3,OUI,OUI,2025-03-13 14:00:58+00:00,"48.86446178139141, 2.361762821674347",Paris,75056,0.8695652173913043,14
7012,Cité Vaneau,OUI,23,10,13,8,5,OUI,OUI,2025-03-13 13:58:14+00:00,"48.8542210666207, 2.319614924490452",Paris,75056,0.5652173913043478,14
20001,Place de la Nation - Charonne,OUI,35,33,2,0,2,OUI,OUI,2025-03-13 13:59:35+00:00,"48.848364667777, 2.3997623859813",Paris,75056,0.05714285714285714,14
4015,Mairie du 4ème,OUI,41,1,40,33,7,OUI,OUI,2025-03-13 14:01:36+00:00,"48.855949910497, 2.3563823103905",Paris,75056,0.975609756097561,14
20008,Pyrénées - Avron,OUI,31,28,3,1,2,OUI,OUI,2025-03-13 13:58:42+00:00,"48.853246898211985, 2.405871044529538",Paris,75056,0.0967741935483871,14
19111,Cesaria Evora - Rosa Parks,OUI,36,31,5,3,2,OUI,OUI,2025-03-13 14:01:57+00:00,"48.89717672825043, 2.3745173960924144",Paris,75056,0.1388888888888889,14
12019,Gare de Reuilly - Picpus,OUI,27,18,9,4,5,OUI,OUI,2025-03-13 14:01:34+00:00,"48.84267354116789, 2.3972943797707558",Paris,75056,0.3333333333333333,14
9111,Victoire - Laffitte,OUI,19,3,16,16,0,OUI,OUI,2025-03-13 14:00:07+00:00,"48.87514373494672, 2.338118505144376",Paris,75056,0.8421052631578947,14
20104,Louis Lumière.,OUI,22,21,1,1,0,OUI,OUI,2025-03-13 13:58:57+00:00,"48.86216198070008, 2.41112578185621",Paris,75056,0.045454545454545456,14
5122,Saint-Michel - Luxembourg,OUI,28,9,19,2,17,OUI,OUI,2025-03-13 14:01:56+00:00,"48.84501507626, 2.3394941166043",Paris,75056,0.6785714285714286,14
14135,Jourdan - Cité Universitaire,OUI,39,27,12,3,9,OUI,OUI,2025-03-13 13:52:01+00:00,"48.819897343156676, 2.3397007964124366",Paris,75056,0.3076923076923077,14
13125,Gare d'Austerlitz - Pont Charles de Gaulle,OUI,55,13,42,22,20,OUI,OUI,2025-03-13 14:01:44+00:00,"48.842319830109, 2.3670300096273",Paris,75056,0.7636363636363637,14
8110,Gare Saint-Lazare - Stockholm,OUI,31,18,13,2,11,OUI,OUI,2025-03-13 14:01:38+00:00,"48.877127316667654, 2.322417162358761",Paris,75056,0.41935483870967744,14
21110,Parc Roger Salengro,OUI,30,6,24,21,3,OUI,OUI,2025-03-13 14:01:33+00:00,"48.905303858642, 2.31055945158",Clichy,92024,0.8,14
20024,Gambetta - Père Lachaise,OUI,27,26,1,0,1,OUI,OUI,2025-03-13 13:57:13+00:00,"48.864295696165875, 2.398228667282044",Paris,75056,0.037037037037037035,14
8036,Lisbonne - Monceau,OUI,46,4,42,17,25,OUI,OUI,2025-03-13 13:59:43+00:00,"48.877455676814, 2.3096942214195",Paris,75056,0.9130434782608695,14
3010,Beaubourg - Michel-le-Comte,OUI,15,2,13,10,3,OUI,OUI,2025-03-13 14:00:23+00:00,"48.862534941806, 2.3543103039265",Paris,75056,0.8666666666666667,14
6031,Pierre Sarrazin - Saint-Michel,OUI,31,0,31,24,7,OUI,OUI,2025-03-13 14:01:24+00:00,"48.850908146398, 2.342130728066",Paris,75056,1.0,14
12156,Niger - Soult,OUI,23,20,3,2,1,OUI,OUI,2025-03-13 14:00:34+00:00,"48.84369906369085, 2.410361237220498",Paris,75056,0.13043478260869565,14
48005,Eugène Varlin - Place de la Paix,OUI,23,21,2,1,1,OUI,OUI,2025-03-13 13:54:31+00:00,"48.792862, 2.363093",Villejuif,94076,0.08695652173913043,14
4012,Tiron - Rivoli,OUI,27,0,27,20,7,OUI,OUI,2025-03-13 14:00:34+00:00,"48.855692253233, 2.3579058051109",Paris,75056,1.0,14
10034,Louis Blanc - La Chapelle,OUI,21,20,1,0,1,OUI,OUI,2025-03-13 13:54:14+00:00,"48.884008964514, 2.3599335551262",Paris,75056,0.047619047619047616,14
21215,Verdier - Jean Jaurès,OUI,32,29,3,2,1,OUI,OUI,2025-03-13 14:00:53+00:00,"48.81614048711214, 2.3123561963438988",Montrouge,92049,0.09375,14
6104,Herschel - Observatoire,OUI,36,4,32,3,29,OUI,OUI,2025-03-13 14:01:51+00:00,"48.84342376221923, 2.3376645147800446",Paris,75056,0.8888888888888888,14
26006,Bas - Gabriel Péri,OUI,30,14,16,14,2,OUI,OUI,2025-03-13 14:00:03+00:00,"48.91585580539625, 2.2948095202445984",Asnières-sur-Seine,92004,0.5333333333333333,14
21309,Mairie d'Issy,OUI,39,29,10,6,4,OUI,OUI,2025-03-13 14:01:47+00:00,"48.823767792468, 2.2723111510277",Issy-les-Moulineaux,92040,0.2564102564102564,14
42211,Séminaire de Conflans - Liberté,OUI,24,6,18,11,7,OUI,OUI,2025-03-13 14:00:34+00:00,"48.823194, 2.404179",Charenton-le-Pont,94018,0.75,14
16102,Pergolèse - Marbeau,OUI,26,21,5,0,5,OUI,OUI,2025-03-13 13:55:22+00:00,"48.873568706869, 2.2815125225299",Paris,75056,0.19230769230769232,14
2012,Choiseul - Quatre Septembre,OUI,44,13,31,12,19,OUI,OUI,2025-03-13 14:01:33+00:00,"48.8699355331869, 2.3359975218772893",Paris,75056,0.7045454545454546,14
4021,Centre Georges Pompidou,OUI,26,2,24,16,8,OUI,OUI,2025-03-13 14:01:37+00:00,"48.861419, 2.352581",Paris,75056,0.9230769230769231,14
3002,Saint-Gilles - Turenne,OUI,15,4,11,4,7,OUI,OUI,2025-03-13 14:00:12+00:00,"48.858158956779, 2.3647149920992",Paris,75056,0.7333333333333333,14
20034,Sorbier - Ménilmontant,OUI,24,24,0,0,0,OUI,OUI,2025-03-13 14:01:24+00:00,"48.868542395661, 2.3897721245885",Paris,75056,0.0,14
13054,Pau Casals - Neuve Tolbiac,OUI,53,4,49,20,29,OUI,OUI,2025-03-13 14:01:52+00:00,"48.8311602, 2.3774395",Paris,75056,0.9245283018867925,14
19201,Petit - Georges Thill,OUI,23,21,2,0,2,OUI,OUI,2025-03-13 13:56:56+00:00,"48.88603131999171, 2.3895753175020222",Paris,75056,0.08695652173913043,14
1012,Jean-Jacques Rousseau - Deux Ecus,OUI,22,0,22,16,6,OUI,OUI,2025-03-13 13:59:41+00:00,"48.86297805972131, 2.3414635285735126",Paris,75056,1.0,14
19010,Emile Reynaud - Porte de la Villette,OUI,22,21,1,0,1,OUI,OUI,2025-03-13 13:58:27+00:00,"48.90098953630053, 2.3887022584676743",Paris,75056,0.045454545454545456,14
2004,Square Pierre Lazareff,OUI,17,10,7,4,3,OUI,OUI,2025-03-13 14:00:11+00:00,"48.867141720746, 2.3483933508396",Paris,75056,0.4117647058823529,14
10009,Mairie du 10ème,OUI,18,2,16,11,5,OUI,OUI,2025-03-13 14:00:06+00:00,"48.872089449907, 2.3575825989246",Paris,75056,0.8888888888888888,14
35012,Candale - Mehul,OUI,25,23,2,0,2,OUI,OUI,2025-03-13 13:56:24+00:00,"48.8893935006175, 2.414379715919495",Pantin,93055,0.08,14
22301,Chausson - Gabriel Péri,OUI,20,15,5,5,0,OUI,OUI,2025-03-13 14:01:49+00:00,"48.921891003481115, 2.2952306270599365",Gennevilliers,92036,0.25,14
2016,Aboukir - Alexandrie,OUI,21,8,13,13,0,OUI,OUI,2025-03-13 14:01:31+00:00,"48.86868344444473, 2.3502043269474897",Paris,75056,0.6190476190476191,14
41405,Place de l'Europe - Alfortville,OUI,24,6,18,18,0,OUI,OUI,2025-03-13 13:58:27+00:00,"48.78913702405837, 2.4284800887107854",Alfortville,94002,0.75,14
16044,Porte de Saint Cloud - Parc des Princes,OUI,31,16,15,9,6,OUI,OUI,2025-03-13 14:00:24+00:00,"48.838662757066, 2.2525164484978",Paris,75056,0.4838709677419355,14
20006,Pyrénées - Plaine,OUI,12,11,1,0,1,OUI,OUI,2025-03-13 13:52:50+00:00,"48.85026702458, 2.4062821269035",Paris,75056,0.08333333333333333,14
4009,Village Saint-Paul,OUI,27,4,23,17,6,OUI,OUI,2025-03-13 14:01:53+00:00,"48.852639866625, 2.3607301712036",Paris,75056,0.8518518518518519,14
8028,Arsène Houssaye - Champs-Elysées,OUI,28,9,19,0,19,OUI,OUI,2025-03-13 14:00:32+00:00,"48.873409276267, 2.2977904602885",Paris,75056,0.6785714285714286,14
4101,Bastille - Beaumarchais,OUI,20,0,20,13,7,OUI,OUI,2025-03-13 14:00:32+00:00,"48.853833463852, 2.3685702681541",Paris,75056,1.0,14
10011,Bourse du Travail,OUI,16,13,3,2,1,OUI,OUI,2025-03-13 13:56:49+00:00,"48.868976638826, 2.3623438552022",Paris,75056,0.1875,14
33020,Waldeck Rochet - Germaine Tillon,OUI,30,1,29,18,11,OUI,OUI,2025-03-13 13:58:14+00:00,"48.91105960199651, 2.3676301538944244",Aubervilliers,93001,0.9666666666666667,14
21953,Gare de Bellevue,OUI,20,18,2,0,2,OUI,OUI,2025-03-13 13:57:51+00:00,"48.8192404685572, 2.2295309230685234",Meudon,92048,0.1,14
32019,Place du 8 mai 1945.,OUI,28,16,12,6,6,OUI,OUI,2025-03-13 13:58:22+00:00,"48.938882272105, 2.3566243797541",Saint-Denis,93066,0.42857142857142855,14
3011,Turbigo - Réaumur,OUI,31,10,21,20,1,OUI,OUI,2025-03-13 14:00:45+00:00,"48.865574047531, 2.3564198613167",Paris,75056,0.6774193548387096,14
9039,Chaussée d'Antin - Haussmann,OUI,23,4,19,10,9,OUI,OUI,2025-03-13 14:01:09+00:00,"48.87243, 2.33359",Paris,75056,0.8260869565217391,14
31709,Place de la Fraternité,OUI,22,19,3,1,2,OUI,OUI,2025-03-13 13:46:12+00:00,"48.85716405838368, 2.422847449779511",Montreuil,93048,0.13636363636363635,14
2008,Mairie du 2ème,OUI,28,1,27,17,10,OUI,OUI,2025-03-13 13:57:14+00:00,"48.8672190355135, 2.3404625437747044",Paris,75056,0.9642857142857143,14
10006,Petites Ecuries - Faubourg Saint-Denis,OUI,27,22,5,2,3,OUI,OUI,2025-03-13 14:01:52+00:00,"48.87287120589831, 2.3542150855064397",Paris,75056,0.18518518518518517,14
18015,Custine - Ramey,OUI,40,37,3,1,2,OUI,OUI,2025-03-13 13:56:52+00:00,"48.888735896947, 2.3469526693225",Paris,75056,0.075,14
22401,Charles de Gaulle - Plateau de Vanves,OUI,32,31,1,0,1,OUI,OUI,2025-03-13 13:56:55+00:00,"48.82233088973263, 2.298571803412886",Malakoff,92046,0.03125,14
1116,Ventadour - Opéra,OUI,27,3,24,14,10,OUI,OUI,2025-03-13 13:59:44+00:00,"48.866810653323, 2.3343884482519",Paris,75056,0.8888888888888888,14
7021,Bosquet - Saint-Dominique,OUI,28,14,14,9,5,OUI,OUI,2025-03-13 13:57:36+00:00,"48.858651709526, 2.3037165802346",Paris,75056,0.5,14
32024,Port - Confluence,OUI,23,17,6,3,3,OUI,OUI,2025-03-13 13:56:34+00:00,"48.936093926526, 2.3436167797955",Saint-Denis,93066,0.2608695652173913,14
32013,Saint-Denis - Université,OUI,18,2,16,6,10,OUI,OUI,2025-03-13 13:58:43+00:00,"48.94563430946964, 2.3638297989964485",Saint-Denis,93066,0.8888888888888888,14
23107,Gare de Sèvres - Ville d'Avray,OUI,22,21,1,1,0,OUI,OUI,2025-03-13 13:55:50+00:00,"48.826262366227, 2.2001516849313",Sèvres,92072,0.045454545454545456,14
2003,Saint-Denis - Réaumur,OUI,31,10,21,10,11,OUI,OUI,2025-03-13 14:01:52+00:00,"48.8661116315789, 2.3507790675507594",Paris,75056,0.6774193548387096,14
6026,Saint-Placide - Cherche Midi,OUI,66,40,26,15,11,OUI,OUI,2025-03-13 14:01:21+00:00,"48.8490535919234, 2.325317971408367",Paris,75056,0.3939393939393939,14
15111,Olivier de Serres - Leriche,OUI,24,21,3,0,3,OUI,OUI,2025-03-13 13:59:49+00:00,"48.83460221715206, 2.2957482933998112",Paris,75056,0.125,14
42018,Amédée Huon - Fort d'Ivry,OUI,31,29,2,0,2,OUI,OUI,2025-03-13 14:02:00+00:00,"48.805131376899986, 2.388489693403244",Ivry-sur-Seine,94041,0.06451612903225806,14
2021,Cléry - Montmartre,OUI,58,27,31,15,16,OUI,OUI,2025-03-13 14:01:38+00:00,"48.867458, 2.3445211",Paris,75056,0.5344827586206896,14
1023,Saint-Honoré - Musée du Louvre,OUI,21,0,21,10,11,OUI,OUI,2025-03-13 14:01:28+00:00,"48.863443132848, 2.3348781846405",Paris,75056,1.0,14
14132,Bézout - Général Leclerc,OUI,28,27,1,0,1,OUI,OUI,2025-03-13 13:59:04+00:00,"48.82884804502439, 2.3285973072052",Paris,75056,0.03571428571428571,14
48008,Guy Môquet - Parvis Georges Marchais,OUI,30,30,0,0,0,OUI,OUI,2025-03-13 14:01:51+00:00,"48.79518840095975, 2.35943466424942",Villejuif,94076,0.0,14
2005,Montmartre - Etienne Marcel,OUI,16,3,13,12,1,OUI,OUI,2025-03-13 13:58:49+00:00,"48.86502194581, 2.3450684401448",Paris,75056,0.8125,14
5003,Le Goff - Gay-Lussac,OUI,34,7,27,9,18,OUI,OUI,2025-03-13 14:00:14+00:00,"48.846102400979, 2.3412207886577",Paris,75056,0.7941176470588235,14
14022,Didot - Mariniers,OUI,35,33,2,2,0,OUI,OUI,2025-03-13 14:01:38+00:00,"48.82650543613106, 2.313136198271666",Paris,75056,0.05714285714285714,14
19012,Lally-Tollendal - Armand Carrel,OUI,27,26,1,1,0,OUI,OUI,2025-03-13 14:01:44+00:00,"48.88270066221072, 2.374717555940151",Paris,75056,0.037037037037037035,14
3007,Archives - Pastourelle,OUI,26,5,21,15,6,OUI,OUI,2025-03-13 14:01:02+00:00,"48.8623615, 2.3595041",Paris,75056,0.8076923076923077,14
31001,Lagny - Auguste Blanqui,OUI,26,9,17,13,4,OUI,OUI,2025-03-13 14:00:11+00:00,"48.84922568052601, 2.4218603968620305",Montreuil,93048,0.6538461538461539,14
35005,Quai de l'Aisne - Général Leclerc,OUI,26,20,6,0,6,OUI,OUI,2025-03-13 14:01:24+00:00,"48.895713, 2.400571",Pantin,93055,0.23076923076923078,14
21507,Gardenat-Lapostol - Velettes,OUI,20,12,8,2,6,OUI,OUI,2025-03-13 13:55:15+00:00,"48.87387, 2.224185",Suresnes,92073,0.4,14
42028,Verdun - Carnot,OUI,28,28,0,0,0,OUI,OUI,2025-03-13 13:59:37+00:00,"48.808439376064946, 2.373795211315155",Ivry-sur-Seine,94041,0.0,14
22306,Place du 17 Octobre,OUI,16,8,8,5,3,OUI,OUI,2025-03-13 13:58:13+00:00,"48.91962690034779, 2.2978286134199792",Gennevilliers,92036,0.5,14
12166,Parc Floral du Bel Air,OUI,24,12,12,7,5,OUI,OUI,2025-03-13 14:00:39+00:00,"48.839285711865735, 2.438560165464878",Paris,75056,0.5,14
22502,Kléber - National,OUI,20,17,3,3,0,OUI,OUI,2025-03-13 13:59:00+00:00,"48.906333898712234, 2.2393910586833954",La Garenne-Colombes,92035,0.15,14
22603,Place de la Division Leclerc,OUI,33,33,0,0,0,OUI,OUI,2025-03-13 14:00:53+00:00,"48.793824988636516, 2.2731140430551027",Fontenay-aux-Roses,92032,0.0,14
3003,Fille du Calvaire - Turenne,OUI,26,3,23,20,3,OUI,OUI,2025-03-13 13:58:03+00:00,"48.86210505412563, 2.3649600148200993",Paris,75056,0.8846153846153846,14
12113,Cardinal Lavigerie,OUI,46,9,37,28,9,OUI,OUI,2025-03-13 14:01:44+00:00,"48.832934193699835, 2.402636749399156",Paris,75056,0.8043478260869565,14
14133,Froidevaux - Boulard,OUI,35,34,1,0,1,OUI,OUI,2025-03-13 13:58:17+00:00,"48.835147319625, 2.3294411972165",Paris,75056,0.02857142857142857,14
21119,Belfort - Victor Hugo,OUI,21,7,14,9,5,OUI,OUI,2025-03-13 13:59:17+00:00,"48.9018492, 2.3172724",Clichy,92024,0.6666666666666666,14
41208,Alouettes - Maréchal de Lattre de Tassigny,OUI,21,10,11,2,9,OUI,OUI,2025-03-13 14:01:13+00:00,"48.85511009293948, 2.4930700287222862",Fontenay-sous-Bois,94033,0.5238095238095238,14
16010,Belles Feuilles - Place de Mexico,OUI,22,19,3,2,1,OUI,OUI,2025-03-13 14:00:16+00:00,"48.865804746474, 2.2829206287861",Paris,75056,0.13636363636363635,14
42704,Mairie du Kremlin-Bicêtre,OUI,25,25,0,0,0,OUI,OUI,2025-03-13 13:57:39+00:00,"48.81191981537702, 2.3570189997553825",Le Kremlin-Bicêtre,94043,0.0,14
16201,Porte Dauphine,OUI,60,43,17,2,15,OUI,OUI,2025-03-13 14:00:05+00:00,"48.871139344351, 2.2749781616017",Paris,75056,0.2833333333333333,14
21706,Jean Bleuzen - Square du 11 Novembre,OUI,45,42,3,1,2,OUI,OUI,2025-03-13 14:01:40+00:00,"48.8232579, 2.2965213",Vanves,92075,0.06666666666666667,14
23042,André Theuriet - Blagis,OUI,29,18,11,10,1,OUI,OUI,2025-03-13 13:57:50+00:00,"48.77977325745441, 2.3130525648593903",Bourg-la-Reine,92014,0.3793103448275862,14
1014,Rivoli - Musée du Louvre,OUI,22,1,21,10,11,OUI,OUI,2025-03-13 14:01:09+00:00,"48.86364636851945, 2.33409583568573",Paris,75056,0.9545454545454546,14
4017,Place de l'Hôtel de Ville,OUI,13,2,11,10,1,OUI,OUI,2025-03-13 14:00:39+00:00,"48.8573314, 2.351458",Paris,75056,0.8461538461538461,14
27006,Victor Hugo - Gare,OUI,19,17,2,2,0,OUI,OUI,2025-03-13 13:55:29+00:00,"48.923133952658, 2.2600970417261",Colombes,92025,0.10526315789473684,14
42026,Barbès - Monique Maunoury,OUI,40,38,2,1,1,OUI,OUI,2025-03-13 13:56:25+00:00,"48.81552718820216, 2.3687169334905405",Ivry-sur-Seine,94041,0.05,14
1015,Place André Malraux,OUI,18,1,17,7,10,OUI,OUI,2025-03-13 14:00:58+00:00,"48.863925158727, 2.3356226831675",Paris,75056,0.9444444444444444,14
12163,Hippodrome Paris-Vincennes,OUI,42,40,2,1,1,OUI,OUI,2025-03-13 13:55:09+00:00,"48.82048387758518, 2.446271181106568",Paris,75056,0.047619047619047616,14
2006,Place des Victoires,OUI,23,1,22,14,8,OUI,OUI,2025-03-13 14:01:39+00:00,"48.8660354, 2.3420333",Paris,75056,0.9565217391304348,14
21509,Gardenat Lapostol - Franklin Roosevelt,OUI,24,22,2,0,2,OUI,OUI,2025-03-13 14:01:59+00:00,"48.871839, 2.222505",Suresnes,92073,0.08333333333333333,14
1024,Coquillière - Louvre,OUI,17,1,16,4,12,OUI,OUI,2025-03-13 14:01:28+00:00,"48.863795909662, 2.3425736278296",Paris,75056,0.9411764705882353,14
19130,Place Paul Delouvrier,OUI,26,23,3,2,1,OUI,OUI,2025-03-13 13:57:09+00:00,"48.89197621431365, 2.3851288855075836",Paris,75056,0.11538461538461539,14
19046,Porte de Pantin.,OUI,33,31,2,0,2,OUI,OUI,2025-03-13 13:59:06+00:00,"48.889199725577, 2.3950181901455",Paris,75056,0.06060606060606061,14
21505,Édouard Vaillant - Place Jean Jaurès,OUI,20,17,3,2,1,OUI,OUI,2025-03-13 13:56:50+00:00,"48.86265537999924, 2.2089037319128613",Suresnes,92073,0.15,14
2020,Danielle Casanova - Opéra,OUI,20,2,18,11,7,OUI,OUI,2025-03-13 14:01:33+00:00,"48.867643242297, 2.3333894088864",Paris,75056,0.9,14
4018,Saint-Bon - Rivoli,OUI,14,4,10,8,2,OUI,OUI,2025-03-13 14:00:07+00:00,"48.857999643315, 2.3502172809763",Paris,75056,0.7142857142857143,14
44001,Quai Jules Guesde - Saint-Simon,OUI,30,1,29,26,3,OUI,OUI,2025-03-13 14:01:05+00:00,"48.80391487219, 2.4089661620274",Vitry-sur-Seine,94081,0.9666666666666667,14
10201,Magenta - Chabrol,OUI,23,17,6,2,4,OUI,OUI,2025-03-13 14:01:17+00:00,"48.876495350882, 2.3560990020633",Paris,75056,0.2608695652173913,14
4007,Place de la Bastille - Bourdon,OUI,33,9,24,8,16,OUI,OUI,2025-03-13 14:00:52+00:00,"48.852364355271, 2.3681089282036",Paris,75056,0.7272727272727273,14
12016,Saint-Mande - Picpus,OUI,33,28,5,2,3,OUI,OUI,2025-03-13 13:57:23+00:00,"48.845127728278, 2.4015686296482",Paris,75056,0.15151515151515152,14
5004,Saint-Jacques - Val de Grâce,OUI,19,1,18,1,17,OUI,OUI,2025-03-13 14:00:54+00:00,"48.8417514, 2.3413893",Paris,75056,0.9473684210526315,14
42210,Victor Hugo - Paul Eluard,OUI,31,2,29,24,5,OUI,OUI,2025-03-13 13:57:12+00:00,"48.819602554907, 2.4114319673051",Charenton-le-Pont,94018,0.9354838709677419,14
10041,Gare du Nord - La Chapelle,OUI,18,18,0,0,0,OUI,OUI,2025-03-13 13:53:41+00:00,"48.884178287286, 2.3561057075858",Paris,75056,0.0,14
34013,Blanqui - Docteur Bauer,OUI,20,8,12,9,3,OUI,OUI,2025-03-13 13:59:09+00:00,"48.907735489085, 2.3407192814591",Saint-Ouen-sur-Seine,93070,0.6,14
22506,Gare des Vallées,OUI,18,12,6,4,2,OUI,OUI,2025-03-13 13:58:28+00:00,"48.913179, 2.257726",La Garenne-Colombes,92035,0.3333333333333333,14
44008,Youri Gagarine - Commune de Paris,OUI,32,12,20,10,10,OUI,OUI,2025-03-13 13:58:35+00:00,"48.782427463041, 2.3939734697342",Vitry-sur-Seine,94081,0.625,14
1025,Oratoire - Rivoli,OUI,17,1,16,9,7,OUI,OUI,2025-03-13 13:54:12+00:00,"48.861342760889, 2.3400047421455",Paris,75056,0.9411764705882353,14
23104,Quai de Sèvres - Manufacture Nationale,OUI,27,11,16,7,9,OUI,OUI,2025-03-13 14:01:01+00:00,"48.828688, 2.22499",Sèvres,92072,0.5925925925925926,14
1018,Alger - Rivoli,OUI,17,3,14,9,5,OUI,OUI,2025-03-13 13:56:01+00:00,"48.864773553495, 2.3294493936128",Paris,75056,0.8235294117647058,14
21011,Silly - Louis Blériot,OUI,23,6,17,4,13,OUI,OUI,2025-03-13 13:59:21+00:00,"48.83219045374266, 2.2340199351310734",Boulogne-Billancourt,92012,0.7391304347826086,14
1026,Place du Lieutenant Henri Karcher,OUI,29,0,29,22,7,OUI,OUI,2025-03-13 14:01:41+00:00,"48.863490871724466, 2.3400671035051346",Paris,75056,1.0,14
20140,Paganini - Davout,OUI,21,19,2,0,2,OUI,OUI,2025-03-13 13:56:14+00:00,"48.85135, 2.412021",Paris,75056,0.09523809523809523,14
23101,Grande Rue - Europe,OUI,25,17,8,6,2,OUI,OUI,2025-03-13 14:01:30+00:00,"48.8218104687602, 2.205879874527455",Sèvres,92072,0.32,14
23303,Gare de Robinson,OUI,29,28,1,0,1,OUI,OUI,2025-03-13 13:54:49+00:00,"48.7799259211605, 2.281828634440899",Sceaux,92071,0.034482758620689655,14
17106,Berthier - Porte de Clichy,OUI,24,16,8,3,5,OUI,OUI,2025-03-13 14:00:26+00:00,"48.894222687781, 2.3125872006816",Paris,75056,0.3333333333333333,14
20010,Sorbier - Gasnier-Guy,OUI,34,33,1,0,1,OUI,OUI,2025-03-13 14:00:56+00:00,"48.865217631011, 2.3936596512794",Paris,75056,0.029411764705882353,14
1017,Saint-Honoré - 29 juillet,OUI,20,5,15,11,4,OUI,OUI,2025-03-13 14:01:10+00:00,"48.86557114282421, 2.330567417577153",Paris,75056,0.75,14
42022,Gare RER - Maurice Grandcoing,OUI,37,6,31,28,3,OUI,OUI,2025-03-13 13:59:57+00:00,"48.813881, 2.392429",Ivry-sur-Seine,94041,0.8378378378378378,14
15040,Saint-Amand - Labrouste,OUI,34,31,3,0,3,OUI,OUI,2025-03-13 14:00:33+00:00,"48.834097274832295, 2.3087677359581",Paris,75056,0.08823529411764706,14
15018,Dutot - Place Alleray,OUI,56,52,4,1,3,OUI,OUI,2025-03-13 13:58:35+00:00,"48.836826091766, 2.3071701095578",Paris,75056,0.07142857142857142,14
6201,Saint Pères - Saint Germain,OUI,22,13,9,6,3,OUI,OUI,2025-03-13 13:58:42+00:00,"48.853729675265, 2.3300181032703",Paris,75056,0.4090909090909091,14
26012,Jardin Modèle - Pierre Boudou,OUI,15,10,5,3,2,OUI,OUI,2025-03-13 14:00:57+00:00,"48.914866710946, 2.3057010525935",Asnières-sur-Seine,92004,0.3333333333333333,14
22601,Marx Dormoy - Château Sainte-Barbe,OUI,20,17,3,0,3,OUI,OUI,2025-03-13 13:55:38+00:00,"48.791782341055324, 2.297856844961643",Fontenay-aux-Roses,92032,0.15,14
20048,Bagnolet - Place Saint-Blaise,OUI,27,23,4,1,3,OUI,OUI,2025-03-13 14:01:34+00:00,"48.85973, 2.40334",Paris,75056,0.14814814814814814,14
12164,Stade Pershing,OUI,26,26,0,0,0,NON,NON,2025-02-26 05:58:32+00:00,"48.829107826857, 2.4583535268903",Paris,75056,0.0,6
45004,République - Louis Loucheur,OUI,37,3,34,5,29,OUI,OUI,2025-03-13 14:01:25+00:00,"48.823549261189, 2.5101865455508",Champigny-sur-Marne,94017,0.918918918918919,14
19202,Marseillaise - Grenade,OUI,44,37,7,0,7,OUI,OUI,2025-03-13 13:59:17+00:00,"48.889371092747, 2.3979396821544",Paris,75056,0.1590909090909091,14
17202,Mariotte - Batignolles,OUI,18,15,3,0,3,OUI,OUI,2025-03-13 13:56:57+00:00,"48.884571659595, 2.321469503475",Paris,75056,0.16666666666666666,14
14201,Decrès - Alésia,OUI,30,29,1,0,1,OUI,OUI,2025-03-13 13:54:30+00:00,"48.832200060759, 2.3139070151575",Paris,75056,0.03333333333333333,14
8202,Londres - Europe,OUI,27,17,10,3,7,OUI,OUI,2025-03-13 14:01:43+00:00,"48.878618556803, 2.3248164693922",Paris,75056,0.37037037037037035,14
27001,Square Victor Basch,OUI,19,7,12,11,1,OUI,OUI,2025-03-13 13:52:23+00:00,"48.914304862261, 2.2289156913757",Colombes,92025,0.631578947368421,14
32011,Stade de France - Francis de Pressensé,OUI,43,6,37,4,33,OUI,OUI,2025-03-13 14:02:00+00:00,"48.919141953558, 2.3620655760169",Saint-Denis,93066,0.8604651162790697,14
17021,Jouffroy d'Abbans - Villiers,OUI,30,20,10,7,3,OUI,OUI,2025-03-13 13:59:53+00:00,"48.884215547037, 2.3056533560157",Paris,75056,0.3333333333333333,14
17020,Jouffroy d'Abbans - Malesherbes,OUI,26,6,20,2,18,OUI,OUI,2025-03-13 14:00:21+00:00,"48.8850134, 2.3070717",Paris,75056,0.7692307692307693,14
31020,Résistance - Parmentier,OUI,32,28,4,1,3,OUI,OUI,2025-03-13 13:55:48+00:00,"48.85965138131299, 2.436705082654953",Montreuil,93048,0.125,14
12202,Charenton - Wattignies,OUI,40,36,4,3,1,OUI,OUI,2025-03-13 14:01:31+00:00,"48.836919119234, 2.3916775206425",Paris,75056,0.1,14
28005,Jean Jaurès - Paul Lafargue,OUI,27,1,26,5,21,OUI,OUI,2025-03-13 13:59:50+00:00,"48.884933177666, 2.2484488785267",Puteaux,92062,0.9629629629629629,14
8040,Pierre Charron - Champs-Elysées,OUI,30,6,24,9,15,OUI,OUI,2025-03-13 13:59:03+00:00,"48.870103359864, 2.3043501377106",Paris,75056,0.8,14
18112,Arthur Ranc - Hôpital Bichat,OUI,23,19,4,4,0,OUI,OUI,2025-03-13 14:01:12+00:00,"48.8978712500682, 2.333521842956543",Paris,75056,0.17391304347826086,14
10202,Bichat - Grange aux Belles,OUI,29,28,1,1,0,OUI,OUI,2025-03-13 14:01:01+00:00,"48.873688, 2.365015",Paris,75056,0.034482758620689655,14
16139,Suresnes - Muette à Neuilly,OUI,29,22,7,4,3,OUI,OUI,2025-03-13 13:57:01+00:00,"48.868570404348, 2.266000919044",Paris,75056,0.2413793103448276,14
42030,Stéphanie Bouvard - Gambetta,OUI,30,20,10,9,1,OUI,OUI,2025-03-13 14:01:40+00:00,"48.814548138856, 2.4024386957288",Ivry-sur-Seine,94041,0.3333333333333333,14
6007,Bréa - Raspail,OUI,23,12,11,1,10,OUI,OUI,2025-03-13 14:01:56+00:00,"48.842738478258, 2.3297942217634",Paris,75056,0.4782608695652174,14
42019,Lampes,OUI,43,6,37,37,0,OUI,OUI,2025-03-13 13:59:48+00:00,"48.81152481985875, 2.4017931148409843",Ivry-sur-Seine,94041,0.8604651162790697,14
48001,Chastenet de Géry - Marcel Paul,OUI,25,23,2,0,2,OUI,OUI,2025-03-13 14:00:04+00:00,"48.800123, 2.3567359",Villejuif,94076,0.08,14
32020,Jules Guesdes - Carnot,OUI,14,14,0,0,0,OUI,OUI,2025-03-13 14:00:31+00:00,"48.93828169931872, 2.3508992046117783",Saint-Denis,93066,0.0,14
51008,Martyrs de Châteaubriant - Jean Grandel,OUI,38,27,11,1,10,OUI,OUI,2025-03-13 13:58:17+00:00,"48.951432, 2.211214",Argenteuil,95018,0.2894736842105263,14
1008,Les Halles - Saint-Eustache,OUI,32,1,31,12,19,OUI,OUI,2025-03-13 14:01:29+00:00,"48.86362695901683, 2.342623919248581",Paris,75056,0.96875,14
21704,Place du Maréchal de Lattre de Tassigny,OUI,27,25,2,1,1,OUI,OUI,2025-03-13 14:00:43+00:00,"48.821707715257055, 2.2853431485432423",Vanves,92075,0.07407407407407407,14
9019,Victor Massé - Jean-Baptiste Pigalle,OUI,18,11,7,0,7,OUI,OUI,2025-03-13 13:59:16+00:00,"48.8811043724, 2.3366955667734",Paris,75056,0.3888888888888889,14
25007,Bons Raisins - Voltaire,OUI,24,23,1,1,0,OUI,OUI,2025-03-13 14:01:24+00:00,"48.87282451461399, 2.1947155570850896",Rueil-Malmaison,92063,0.041666666666666664,14
44004,Place de l'Eglise - Vitry-sur-Seine,OUI,28,5,23,23,0,OUI,OUI,2025-03-13 14:01:12+00:00,"48.791922819921815, 2.395057752728462",Vitry-sur-Seine,94081,0.8214285714285714,14
19114,Manin - Secrétan,OUI,20,20,0,0,0,OUI,OUI,2025-03-13 13:54:27+00:00,"48.8791665, 2.3787959",Paris,75056,0.0,14
2102,Saint-Marc - Feydeau,OUI,37,5,32,15,17,OUI,OUI,2025-03-13 14:01:21+00:00,"48.870326843044, 2.3418715826353",Paris,75056,0.8648648648648649,14
12123,Château de Vincennes,OUI,49,48,1,0,1,OUI,OUI,2025-03-13 13:57:55+00:00,"48.84423193255657, 2.439209537709179",Paris,75056,0.02040816326530612,14
6029,Vaugirard - Monsieur le Prince,OUI,24,0,24,8,16,OUI,OUI,2025-03-13 14:01:56+00:00,"48.848951441614, 2.3411329463124",Paris,75056,1.0,14
23041,Général Leclerc - Bièvre,OUI,24,20,4,3,1,OUI,OUI,2025-03-13 14:01:42+00:00,"48.782414428747316, 2.3166695237159733",Bourg-la-Reine,92014,0.16666666666666666,14
23301,Les Blagis,OUI,24,12,12,9,3,OUI,OUI,2025-03-13 14:01:26+00:00,"48.785205, 2.302526",Sceaux,92071,0.5,14
24005,Edith Cavell - Volta,OUI,32,27,5,2,3,OUI,OUI,2025-03-13 13:59:25+00:00,"48.901616564286975, 2.269354350864887",Courbevoie,92026,0.15625,14
48012,Stalingrad - Henri Luisette,OUI,26,25,1,0,1,OUI,OUI,2025-03-13 13:52:34+00:00,"48.78363092456589, 2.366935946761926",Villejuif,94076,0.038461538461538464,14
31104,Mairie de Rosny-sous-Bois,OUI,26,12,14,10,4,OUI,OUI,2025-03-13 13:59:54+00:00,"48.871256519012, 2.4865807592869",Rosny-sous-Bois,93064,0.5384615384615384,14
10166,Strasbourg - Saint-Denis,OUI,16,3,13,7,6,OUI,OUI,2025-03-13 14:01:56+00:00,"48.869601642433, 2.3542908579111",Paris,75056,0.8125,14
42024,Danielle Casanova - Ledru-Rollin,OUI,28,4,24,20,4,OUI,OUI,2025-03-13 13:55:59+00:00,"48.815783497876815, 2.383259721100331",Ivry-sur-Seine,94041,0.8571428571428571,14
23202,Henri Barbusse - Gabriel Péri,OUI,17,16,1,0,1,OUI,OUI,2025-03-13 13:58:14+00:00,"48.801773795836, 2.2874166362216",Châtillon,92020,0.058823529411764705,14
5027,Gobelins - Port-Royal,OUI,36,3,33,28,5,OUI,OUI,2025-03-13 14:01:44+00:00,"48.837135900263, 2.3515201359987",Paris,75056,0.9166666666666666,14
13049,Vincent Auriol - Louise Weiss,OUI,22,4,18,11,7,OUI,OUI,2025-03-13 14:00:33+00:00,"48.834001935501, 2.3703888058662",Paris,75056,0.8181818181818182,14
11111,Léon Frot - Charonne,OUI,18,9,9,6,3,OUI,OUI,2025-03-13 14:00:52+00:00,"48.854963800335234, 2.387217085372007",Paris,75056,0.5,14
6015,André Mazet - Saint-André des Arts,OUI,55,2,53,44,9,OUI,OUI,2025-03-13 14:01:00+00:00,"48.85375581057431, 2.3390958085656166",Paris,75056,0.9636363636363636,14
48006,Maxime Gorki - Paul Vaillant-Couturier,OUI,19,19,0,0,0,OUI,OUI,2025-03-13 14:01:59+00:00,"48.79673508795443, 2.3683342337608337",Villejuif,94076,0.0,14
32605,Mairie,OUI,20,20,0,0,0,OUI,OUI,2025-03-13 13:58:39+00:00,"48.87914304162, 2.4163350908311",Les Lilas,93045,0.0,14
19117,Euryale Dehaynin - Loire,OUI,30,22,8,1,7,OUI,OUI,2025-03-13 13:59:13+00:00,"48.886248917304805, 2.3774591088294987",Paris,75056,0.26666666666666666,14
23206,Béranger - Félix Faure,OUI,26,25,1,0,1,OUI,OUI,2025-03-13 13:55:41+00:00,"48.80404828621485, 2.2848263373723436",Châtillon,92020,0.038461538461538464,14
21022,Dôme - République,OUI,24,2,22,21,1,OUI,OUI,2025-03-13 13:58:40+00:00,"48.832681, 2.250257",Boulogne-Billancourt,92012,0.9166666666666666,14
8018,Saint-Augustin,OUI,31,4,27,12,15,OUI,OUI,2025-03-13 13:57:27+00:00,"48.8762009747008, 2.319786250591278",Paris,75056,0.8709677419354839,14
15041,Franquet - Labrouste,OUI,37,35,2,0,2,OUI,OUI,2025-03-13 14:00:31+00:00,"48.83287705011431, 2.306762784719467",Paris,75056,0.05405405405405406,14
20142,Mûriers - Père Lachaise,OUI,19,17,2,0,2,OUI,OUI,2025-03-13 13:56:25+00:00,"48.864130509668044, 2.39164982067019",Paris,75056,0.10526315789473684,14
11022,Roquette - Auguste Laurent,OUI,16,8,8,4,4,OUI,OUI,2025-03-13 14:01:25+00:00,"48.858001906023354, 2.381797702650783",Paris,75056,0.5,14
41602,Place Charles Digeon,OUI,31,31,0,0,0,OUI,OUI,2025-03-13 14:01:30+00:00,"48.84354203133597, 2.418427169322968",Saint-Mandé,94067,0.0,14
18135,Ney - Porte de Montmartre,OUI,23,20,3,1,2,OUI,OUI,2025-03-13 14:01:43+00:00,"48.897918, 2.3364872",Paris,75056,0.13043478260869565,14
13028,Gouthière - Poterne des Peupliers,OUI,32,27,5,1,4,OUI,OUI,2025-03-13 13:59:05+00:00,"48.820507, 2.351342",Paris,75056,0.15625,14
24101,Place Charles de Gaulle,OUI,24,21,3,0,3,OUI,OUI,2025-03-13 14:00:10+00:00,"48.826073335699, 2.1894485725692",Ville-d'Avray,92077,0.125,14
14004,Port Royal - Hôpital Cochin,OUI,22,18,4,0,4,OUI,OUI,2025-03-13 13:59:15+00:00,"48.838608030238, 2.3406994164846",Paris,75056,0.18181818181818182,14
34011,Clef des Champs - Albert Dhalenne,OUI,25,10,15,10,5,OUI,OUI,2025-03-13 13:59:21+00:00,"48.914938, 2.330665",Saint-Ouen-sur-Seine,93070,0.6,14
14027,Gergovie - Alésia,OUI,54,53,1,0,1,OUI,OUI,2025-03-13 14:01:47+00:00,"48.83088717455243, 2.318882101207347",Paris,75056,0.018518518518518517,14
21329,Gare - Aristide Briand,OUI,28,6,22,18,4,OUI,OUI,2025-03-13 13:59:29+00:00,"48.821410564722, 2.2555950104387",Issy-les-Moulineaux,92040,0.7857142857142857,14
48002,LCL Campus - Place Oscar Niemeyer,OUI,37,37,0,0,0,OUI,OUI,2025-03-13 13:46:34+00:00,"48.805342480621576, 2.363983690738678",Villejuif,94076,0.0,14
19121,Belleville -  Pré Saint-Gervais,OUI,21,21,0,0,0,OUI,OUI,2025-03-13 13:58:33+00:00,"48.875565910073, 2.3930460959673",Paris,75056,0.0,14
35013,Guillaume Tell - Parc Henri Barbusse,OUI,19,16,3,1,2,OUI,OUI,2025-03-13 13:57:17+00:00,"48.88958925894009, 2.4198862910270695",Pantin,93055,0.15789473684210525,14
13015,Chevaleret - Louise Weiss,OUI,35,7,28,17,11,OUI,OUI,2025-03-13 14:01:05+00:00,"48.832586513351, 2.37121138812",Paris,75056,0.8,14
20020,Pyrénées - Charles Renouvier,OUI,29,28,1,0,1,OUI,OUI,2025-03-13 14:01:18+00:00,"48.86095933229224, 2.400421852042113",Paris,75056,0.034482758620689655,14
21002,Place Denfert-Rochereau,OUI,20,14,6,4,2,OUI,OUI,2025-03-13 14:01:53+00:00,"48.843252536286684, 2.245987951755524",Boulogne-Billancourt,92012,0.3,14
12008,Hector Malot - Daumesnil,OUI,52,1,51,48,3,OUI,OUI,2025-03-13 14:01:25+00:00,"48.84693552991762, 2.3770876228809357",Paris,75056,0.9807692307692307,14
13024,Bobillot - Tolbiac,OUI,33,24,9,4,5,OUI,OUI,2025-03-13 14:01:52+00:00,"48.8255961335041, 2.350204177200794",Paris,75056,0.2727272727272727,14
12102,Bercy - Traversiére,OUI,30,0,30,27,3,OUI,OUI,2025-03-13 14:01:05+00:00,"48.846192642574, 2.3703800886869",Paris,75056,1.0,14
24004,Paix - Verdun,OUI,33,22,11,6,5,OUI,OUI,2025-03-13 13:58:35+00:00,"48.900504, 2.261173",Courbevoie,92026,0.3333333333333333,14
13120,Pierre Joseph Desault,OUI,18,7,11,9,2,OUI,OUI,2025-03-13 14:01:41+00:00,"48.82110230800372, 2.378775402903557",Paris,75056,0.6111111111111112,14
15203,Porte de Versailles,OUI,27,14,13,6,7,OUI,OUI,2025-03-13 14:01:39+00:00,"48.832324016657, 2.2875617349045",Paris,75056,0.48148148148148145,14
15024,Suffren - La Motte-Piquet,OUI,23,3,20,12,8,OUI,OUI,2025-03-13 14:01:39+00:00,"48.850881230919, 2.3012199997902",Paris,75056,0.8695652173913043,14
13116,Place du Docteur Yersin,OUI,50,45,5,1,4,OUI,OUI,2025-03-13 14:01:57+00:00,"48.82010494991975, 2.3725583776831627",Paris,75056,0.1,14
12119,Dom-Pérignon - Gravelle,OUI,46,31,15,13,2,OUI,OUI,2025-03-13 14:01:38+00:00,"48.825481574435, 2.409880310297",Paris,75056,0.32608695652173914,14
15012,Cambronne - Mademoiselle,OUI,66,64,2,2,0,OUI,OUI,2025-03-13 13:58:43+00:00,"48.843277330035214, 2.30230766886348",Paris,75056,0.030303030303030304,14
15050,Dominique Pado - Croix Nivert,OUI,22,16,6,3,3,OUI,OUI,2025-03-13 14:01:50+00:00,"48.83648798164934, 2.2897250577807426",Paris,75056,0.2727272727272727,14
18016,Francoeur - Caulaincourt,OUI,33,32,1,0,1,OUI,OUI,2025-03-13 13:57:51+00:00,"48.8899944409612, 2.342529706656933",Paris,75056,0.030303030303030304,14
16025,Jean de la Fontaine - Boulainvilliers,OUI,66,10,56,45,11,OUI,OUI,2025-03-13 14:01:38+00:00,"48.85264791461651, 2.2758664190769196",Paris,75056,0.8484848484848485,14
15053,Lecourbe - Convention,OUI,44,27,17,14,3,OUI,OUI,2025-03-13 14:01:37+00:00,"48.83923319241899, 2.2915197908878326",Paris,75056,0.38636363636363635,14
14009,Tombe Issoire - René Coty,OUI,35,31,4,1,3,OUI,OUI,2025-03-13 14:00:59+00:00,"48.830512876709, 2.3343613743782",Paris,75056,0.11428571428571428,14
20003,Pyrénées - Cours de Vincennes,OUI,19,16,3,0,3,OUI,OUI,2025-03-13 13:57:47+00:00,"48.847796779935, 2.4061721563339",Paris,75056,0.15789473684210525,14
16017,Siam - La Pompe,OUI,16,14,2,0,2,OUI,OUI,2025-03-13 13:53:34+00:00,"48.861720329027264, 2.275346568555312",Paris,75056,0.125,14
10003,Hauteville - Bonne Nouvelle,OUI,15,3,12,11,1,OUI,OUI,2025-03-13 14:00:19+00:00,"48.87077436024, 2.3496496368327",Paris,75056,0.8,14
18021,Marcadet - Ramey,OUI,21,19,2,0,2,OUI,OUI,2025-03-13 14:00:46+00:00,"48.890875, 2.3449019",Paris,75056,0.09523809523809523,14
41103,Place de la vache noire,OUI,23,20,3,0,3,OUI,OUI,2025-03-13 14:01:37+00:00,"48.81040517059777, 2.327060401439667",Arcueil,94003,0.13043478260869565,14
16116,George Sand - Jean de La Fontaine,OUI,28,19,9,6,3,OUI,OUI,2025-03-13 13:57:04+00:00,"48.84986918764119, 2.268257387525699",Paris,75056,0.32142857142857145,14
15069,Félix Faure - Convention,OUI,44,24,20,12,8,OUI,OUI,2025-03-13 13:58:05+00:00,"48.841249336041, 2.2883866008495",Paris,75056,0.45454545454545453,14
5033,Saint-Séverin - Saint-Michel,OUI,30,1,29,23,6,OUI,OUI,2025-03-13 14:00:58+00:00,"48.852731305488, 2.3440927639604",Paris,75056,0.9666666666666667,14
20012,Buzenval - Vignoles,OUI,17,16,1,0,1,OUI,OUI,2025-03-13 13:58:17+00:00,"48.853858171688, 2.4000040814281",Paris,75056,0.058823529411764705,14
15045,Porte de la Plaine,OUI,35,34,1,1,0,OUI,OUI,2025-03-13 13:58:58+00:00,"48.82805169605981, 2.2924277186393742",Paris,75056,0.02857142857142857,14
42303,Place Eustache Deschamps,OUI,20,12,8,5,3,OUI,OUI,2025-03-13 13:57:30+00:00,"48.793855, 2.336637",Cachan,94016,0.4,14
42205,Place Aristide Briand,OUI,35,23,12,10,2,OUI,OUI,2025-03-13 14:00:21+00:00,"48.82189236575831, 2.413003742694855",Charenton-le-Pont,94018,0.34285714285714286,14
41605,Général De Gaulle - Vivien,OUI,21,18,3,1,2,OUI,OUI,2025-03-13 13:58:23+00:00,"48.83607420090204, 2.4189166724681854",Saint-Mandé,94067,0.14285714285714285,14
20032,Square des Amandiers,OUI,26,24,2,0,2,OUI,OUI,2025-03-13 13:53:50+00:00,"48.86615630668046, 2.3891324177384377",Paris,75056,0.07692307692307693,14
30003,Moscou - Edouard Vaillant,OUI,29,20,9,4,5,OUI,OUI,2025-03-13 14:00:21+00:00,"48.90755810177, 2.4689837335263",Bobigny,93008,0.3103448275862069,14
30004,Jean Jaurès - Place de la Libération,OUI,28,5,23,10,13,OUI,OUI,2025-03-13 13:53:44+00:00,"48.90617751921, 2.4391458057475",Bobigny,93008,0.8214285714285714,14
13006,Duméril - Jeanne d'Arc,OUI,40,29,11,8,3,OUI,OUI,2025-03-13 14:00:46+00:00,"48.838151608087, 2.3571084495564",Paris,75056,0.275,14
14035,Maine - Jean Zay,OUI,47,40,7,2,5,OUI,OUI,2025-03-13 13:59:19+00:00,"48.837925263898, 2.3225428909063",Paris,75056,0.14893617021276595,14
43007,Hôtel de Ville de Vincennes,OUI,26,13,13,8,5,OUI,OUI,2025-03-13 14:01:20+00:00,"48.84827609706963, 2.4398955702781677",Vincennes,94080,0.5,14
8046,Marceau - Président Wilson,OUI,30,11,19,17,2,OUI,OUI,2025-03-13 14:01:05+00:00,"48.8652359, 2.3002513",Paris,75056,0.6333333333333333,14
13036,Olympiades,OUI,36,30,6,3,3,OUI,OUI,2025-03-13 14:01:14+00:00,"48.826764665199, 2.3650860786438",Paris,75056,0.16666666666666666,14
8007,Rome - Provence,OUI,29,5,24,20,4,OUI,OUI,2025-03-13 14:01:50+00:00,"48.874230055580306, 2.325570111724113",Paris,75056,0.8275862068965517,14
43004,Montreuil - République,OUI,23,17,6,1,5,OUI,OUI,2025-03-13 14:01:39+00:00,"48.85026349463687, 2.4345204234123234",Vincennes,94080,0.2608695652173913,14
21218,Gabriel Péri - Place de la Libération,OUI,17,15,2,2,0,OUI,OUI,2025-03-13 13:55:27+00:00,"48.819828421929, 2.3117361743705",Montrouge,92049,0.11764705882352941,14
17117,Pereire - Saussure,OUI,31,25,6,6,0,OUI,OUI,2025-03-13 14:00:49+00:00,"48.888229075478, 2.3101296275854",Paris,75056,0.1935483870967742,14
21207,Verdier - République,OUI,29,26,3,1,2,OUI,OUI,2025-03-13 14:01:23+00:00,"48.815403766277, 2.31739372015",Montrouge,92049,0.10344827586206896,14
20013,Alexandre Dumas - Place de la Réunion,OUI,45,44,1,0,1,OUI,OUI,2025-03-13 13:57:10+00:00,"48.85533710742046, 2.3997703687646292",Paris,75056,0.022222222222222223,14
11016,Philippe-Auguste,OUI,48,44,4,1,3,OUI,OUI,2025-03-13 14:00:43+00:00,"48.851853488265, 2.3932945355773",Paris,75056,0.08333333333333333,14
25004,Marcel Pourtout - Édouard Manet,OUI,24,6,18,18,0,OUI,OUI,2025-03-13 13:59:37+00:00,"48.87555620763429, 2.1655967831611638",Rueil-Malmaison,92063,0.75,14
16033,Marché d'Auteuil,OUI,31,11,20,20,0,OUI,OUI,2025-03-13 14:01:02+00:00,"48.84842761367387, 2.265253821160005",Paris,75056,0.6451612903225806,14
12022,Sahel - Général Michel Bizot,OUI,30,20,10,4,6,OUI,OUI,2025-03-13 14:01:58+00:00,"48.840872964793355, 2.4044444784522057",Paris,75056,0.3333333333333333,14
21205,Arthur Auger - Jean Jaurès,OUI,23,20,3,1,2,OUI,OUI,2025-03-13 13:52:56+00:00,"48.813736445585235, 2.3069277405738835",Montrouge,92049,0.13043478260869565,14
15027,Duhamel - André Gide,OUI,20,20,0,0,0,OUI,OUI,2025-03-13 13:54:47+00:00,"48.8365662244334, 2.312707121097412",Paris,75056,0.0,14
16023,Passy - Place du Costa Rica,OUI,29,28,1,0,1,OUI,OUI,2025-03-13 14:02:00+00:00,"48.8584893, 2.2839655",Paris,75056,0.034482758620689655,14
21023,Ancienne Mairie - André Morizet,OUI,25,11,14,8,6,OUI,OUI,2025-03-13 13:59:03+00:00,"48.838311, 2.234077",Boulogne-Billancourt,92012,0.56,14
24007,Jean-Baptiste Charcot - Sainte-Geneviève,OUI,21,21,0,0,0,OUI,OUI,2025-03-13 14:02:01+00:00,"48.90310883721567, 2.278892956674099",Courbevoie,92026,0.0,14
31105,Lavoisier - Missak Manouchian,OUI,15,10,5,1,4,OUI,OUI,2025-03-13 14:00:40+00:00,"48.86286468896063, 2.495676465332508",Rosny-sous-Bois,93064,0.3333333333333333,14
13055,M.- A. Lagroua Weill-Hallé -  F. Dolto,OUI,59,8,51,27,24,OUI,OUI,2025-03-13 14:01:22+00:00,"48.828595283857425, 2.380220606266108",Paris,75056,0.864406779661017,14
22701,Général Leclerc - République,OUI,28,9,19,16,3,OUI,OUI,2025-03-13 13:59:53+00:00,"48.915885074177, 2.2682306702811",Bois-Colombes,92009,0.6785714285714286,14
22014,Victor Hugo - Bineau,OUI,24,20,4,3,1,OUI,OUI,2025-03-13 14:01:23+00:00,"48.88758225888669, 2.2783890366554265",Neuilly-sur-Seine,92051,0.16666666666666666,14
17110,Legendre - Nollet,OUI,29,28,1,0,1,OUI,OUI,2025-03-13 14:00:19+00:00,"48.887742186754224, 2.320293079881375",Paris,75056,0.034482758620689655,14
6005,Montparnasse -  Square Ozanam,OUI,49,32,17,11,6,OUI,OUI,2025-03-13 14:00:47+00:00,"48.843310567822, 2.3265242949128",Paris,75056,0.3469387755102041,14
31701,Mairie de Bagnolet,OUI,28,25,3,1,2,OUI,OUI,2025-03-13 13:54:34+00:00,"48.868421318555, 2.4179587885737",Bagnolet,93006,0.10714285714285714,14
16022,Jean Bologne - Passy,OUI,19,17,2,0,2,OUI,OUI,2025-03-13 13:58:59+00:00,"48.857566889784465, 2.280027395306772",Paris,75056,0.10526315789473684,14
22404,Pierre Brossolette - 12 Février 1934,OUI,23,18,5,4,1,OUI,OUI,2025-03-13 13:57:24+00:00,"48.8176962416867, 2.3076123744249344",Malakoff,92046,0.21739130434782608,14
20011,Pyrénées - Dagorno,OUI,20,19,1,0,1,OUI,OUI,2025-03-13 14:01:55+00:00,"48.855425770695085, 2.4051643162965775",Paris,75056,0.05,14
20014,Charonne - Alexandre Dumas,OUI,34,31,3,2,1,OUI,OUI,2025-03-13 13:59:21+00:00,"48.856077415056, 2.3948693275452",Paris,75056,0.08823529411764706,14
19001,Crimée - Ourcq,OUI,56,50,6,3,3,OUI,OUI,2025-03-13 13:56:29+00:00,"48.894104140316, 2.3729460884673",Paris,75056,0.10714285714285714,14
20110,Gambetta - Tourelles,OUI,20,20,0,0,0,OUI,OUI,2025-03-13 13:54:11+00:00,"48.875337902264, 2.4059921130538",Paris,75056,0.0,14
14005,René Coty - Place Denfert-Rochereau,OUI,36,31,5,2,3,OUI,OUI,2025-03-13 13:58:38+00:00,"48.833056477316, 2.3329411447048",Paris,75056,0.1388888888888889,14
13023,Bobillot - Moulin des Prés,OUI,28,28,0,0,0,OUI,OUI,2025-03-13 14:01:46+00:00,"48.828657346203, 2.353020646317",Paris,75056,0.0,14
17006,Guy Môquet - Compoint,OUI,35,34,1,0,1,OUI,OUI,2025-03-13 13:58:31+00:00,"48.89213559044868, 2.32321947813034",Paris,75056,0.02857142857142857,14
12040,Porte de Charenton,OUI,66,58,8,4,4,OUI,OUI,2025-03-13 13:57:39+00:00,"48.831240105856, 2.3989107459784",Paris,75056,0.12121212121212122,14
18101,Championnet.,OUI,20,17,3,1,2,OUI,OUI,2025-03-13 14:01:16+00:00,"48.8953643, 2.3498166",Paris,75056,0.15,14
20106,Mairie du 20ème,OUI,27,25,2,0,2,OUI,OUI,2025-03-13 14:01:59+00:00,"48.865302324275, 2.3990669846535",Paris,75056,0.07407407407407407,14
6028,Quatre Vents - Carrefour de l'Odéon,OUI,37,0,37,20,17,OUI,OUI,2025-03-13 13:59:51+00:00,"48.851751374458864, 2.338161695134053",Paris,75056,1.0,14
21007,Rond-Point Rhin et Danube,OUI,53,41,12,6,6,OUI,OUI,2025-03-13 13:59:57+00:00,"48.840452820991764, 2.2280225157737736",Boulogne-Billancourt,92012,0.22641509433962265,14
20005,Reynaldo Hahn - Lagny,OUI,19,18,1,0,1,OUI,OUI,2025-03-13 13:57:32+00:00,"48.849266043601794, 2.412330328844772",Paris,75056,0.05263157894736842,14
5105,Geoffroy-Saint-Hilaire - Saint-Marcel,OUI,17,11,6,4,2,OUI,OUI,2025-03-13 14:00:46+00:00,"48.83907826424974, 2.356877340669728",Paris,75056,0.35294117647058826,14
12122,Bois de Vincennes - Polygone,OUI,51,46,5,2,3,OUI,OUI,2025-03-13 14:00:14+00:00,"48.83544491617421, 2.431421081436563",Paris,75056,0.09803921568627451,14
22007,Commandant Charcot - Bretteville,OUI,31,14,17,12,5,OUI,OUI,2025-03-13 14:01:10+00:00,"48.87530570765423, 2.2558460757136345",Neuilly-sur-Seine,92051,0.5483870967741935,14
15120,Colonel Pierre Avia,OUI,28,12,16,11,5,OUI,OUI,2025-03-13 14:00:22+00:00,"48.8296843300915, 2.275342586850291",Paris,75056,0.5714285714285714,14
12039,Général Michel Bizot - Claude Decaen,OUI,37,31,6,2,4,OUI,OUI,2025-03-13 14:00:15+00:00,"48.83481262982544, 2.400927788127704",Paris,75056,0.16216216216216217,14
6004,Regard - Rennes,OUI,46,29,17,12,5,OUI,OUI,2025-03-13 14:01:55+00:00,"48.847385404956, 2.3268555477262",Paris,75056,0.3695652173913043,14
13037,Ivry - Baudricourt,OUI,20,16,4,2,2,OUI,OUI,2025-03-13 14:01:33+00:00,"48.824695995415006, 2.363106073577468",Paris,75056,0.2,14
15114,Pasteur - Cotentin,OUI,9,9,0,0,0,OUI,OUI,2025-03-13 14:01:46+00:00,"48.8389284, 2.316356",Paris,75056,0.0,14
5031,Lacépède - Linné,OUI,49,7,42,28,14,OUI,OUI,2025-03-13 14:01:54+00:00,"48.8437035476636, 2.354651279747486",Paris,75056,0.8571428571428571,14
11029,Ménilmontant - Oberkampf,OUI,39,27,12,4,8,OUI,OUI,2025-03-13 14:01:13+00:00,"48.866617658681, 2.3830134404158",Paris,75056,0.3076923076923077,14
14025,Jacquier - Didot,OUI,30,29,1,0,1,OUI,OUI,2025-03-13 13:53:03+00:00,"48.82953336292279, 2.318179272115231",Paris,75056,0.03333333333333333,14
19014,Lorraine - Jean Jaurès,OUI,19,17,2,0,2,OUI,OUI,2025-03-13 13:59:56+00:00,"48.8863865, 2.3825772",Paris,75056,0.10526315789473684,14
6009,Guynemer - Jardin du Luxembourg,OUI,34,14,20,10,10,OUI,OUI,2025-03-13 14:01:40+00:00,"48.8466127, 2.3325478",Paris,75056,0.5882352941176471,14
15014,Volontaires - Vaugirard,OUI,33,32,1,0,1,OUI,OUI,2025-03-13 14:00:26+00:00,"48.84132050184004, 2.30808901725357",Paris,75056,0.030303030303030304,14
16104,Paul Valery - Victor Hugo,OUI,34,22,12,0,12,OUI,OUI,2025-03-13 14:00:48+00:00,"48.87137406080164, 2.2887128591537476",Paris,75056,0.35294117647058826,14
11028,Guillaume Bertrand - République,OUI,38,24,14,1,13,OUI,OUI,2025-03-13 14:00:38+00:00,"48.863825174341, 2.380906377155",Paris,75056,0.3684210526315789,14
20033,Etienne Dolet - Place Maurice Chevalier,OUI,47,45,2,2,0,OUI,OUI,2025-03-13 13:56:27+00:00,"48.86798303359366, 2.3851405311143026",Paris,75056,0.0425531914893617,14
21027,Fief - République,OUI,25,1,24,21,3,OUI,OUI,2025-03-13 14:01:59+00:00,"48.83170888166024, 2.255771979689598",Boulogne-Billancourt,92012,0.96,14
15044,Dantzig - Lefebvre,OUI,33,27,6,2,4,OUI,OUI,2025-03-13 13:58:05+00:00,"48.83013921586756, 2.295934036374092",Paris,75056,0.18181818181818182,14
17050,Batignolles - Abel Truchet,OUI,26,24,2,1,1,OUI,OUI,2025-03-13 13:55:33+00:00,"48.883103904582, 2.3238347490884",Paris,75056,0.07692307692307693,14
25002,Hôtel de Ville de Rueil-Malmaison,OUI,19,3,16,11,5,OUI,OUI,2025-03-13 14:00:52+00:00,"48.878194, 2.181724",Rueil-Malmaison,92063,0.8421052631578947,14
21510,Fontaine du Tertre - Calvaire,OUI,23,22,1,0,1,OUI,OUI,2025-03-13 13:54:32+00:00,"48.8702539, 2.2187778",Suresnes,92073,0.043478260869565216,14
15113,Arsonval - Falguière,OUI,24,21,3,2,1,OUI,OUI,2025-03-13 13:58:01+00:00,"48.84040040365445, 2.313117867297474",Paris,75056,0.125,14
51007,Résistance - Romain Rolland,OUI,28,26,2,0,2,OUI,OUI,2025-03-13 13:59:02+00:00,"48.950873482371, 2.2310190077797",Argenteuil,95018,0.07142857142857142,14
6020,Place Saint-André des Arts,OUI,33,2,31,23,8,OUI,OUI,2025-03-13 14:01:55+00:00,"48.852886173881, 2.3426544293761",Paris,75056,0.9393939393939394,14
17036,Place Tristan Bernard,OUI,28,26,2,0,2,OUI,OUI,2025-03-13 14:00:48+00:00,"48.8794936, 2.2915423",Paris,75056,0.07142857142857142,14
19007,Flandre - Ourcq,OUI,29,22,7,5,2,OUI,OUI,2025-03-13 14:01:54+00:00,"48.89260159189023, 2.3790915682911873",Paris,75056,0.2413793103448276,14
11040,Temple - Jean-Pierre Timbaud,OUI,32,5,27,21,6,OUI,OUI,2025-03-13 14:01:50+00:00,"48.86446597201, 2.3660597205162",Paris,75056,0.84375,14
21016,Point du Jour - Jean Jaurès,OUI,39,25,14,13,1,OUI,OUI,2025-03-13 14:01:57+00:00,"48.828753141436465, 2.245911467014621",Boulogne-Billancourt,92012,0.358974358974359,14
13008,Place d'Italie - Soeur Rosalie,OUI,51,42,9,2,7,OUI,OUI,2025-03-13 14:00:30+00:00,"48.831908520394, 2.3546943448098",Paris,75056,0.17647058823529413,14
11018,Saint-Maur - République,OUI,36,29,7,3,4,OUI,OUI,2025-03-13 13:58:53+00:00,"48.864185861455, 2.3783174157143",Paris,75056,0.19444444444444445,14
21112,Claude Debussy - Marc Bloch,OUI,52,42,10,9,1,OUI,OUI,2025-03-13 14:00:40+00:00,"48.910388180512, 2.3117771744728",Clichy,92024,0.19230769230769232,14
19123,Metz - Marne,OUI,29,20,9,5,4,OUI,OUI,2025-03-13 14:00:34+00:00,"48.891163, 2.3865705",Paris,75056,0.3103448275862069,14
24010,Charles de Gaulle - Rue de l'Alma,OUI,27,6,21,5,16,OUI,OUI,2025-03-13 14:00:42+00:00,"48.896620592993, 2.252313240191",Courbevoie,92026,0.7777777777777778,14
21107,Bertrand Sincholle - Henri Barbusse,OUI,18,12,6,5,1,OUI,OUI,2025-03-13 13:57:40+00:00,"48.89925982394349, 2.3042294383049016",Clichy,92024,0.3333333333333333,14
25009,Place des Arts - Jean Mermoz,OUI,20,6,14,13,1,OUI,OUI,2025-03-13 14:01:06+00:00,"48.880391139734, 2.1832160452221",Rueil-Malmaison,92063,0.7,14
12017,Saint-Mandé - Docteur Arnold Netter,OUI,36,26,10,6,4,OUI,OUI,2025-03-13 13:58:25+00:00,"48.84462585769668, 2.404946386814118",Paris,75056,0.2777777777777778,14
26010,Louis Armand - Bernard Palissy,OUI,17,8,9,7,2,OUI,OUI,2025-03-13 13:56:19+00:00,"48.916974, 2.313384",Asnières-sur-Seine,92004,0.5294117647058824,14
42027,Verdun - Pierre et Marie Curie,OUI,26,24,2,0,2,OUI,OUI,2025-03-13 14:01:12+00:00,"48.812822398263286, 2.3707106709480286",Ivry-sur-Seine,94041,0.07692307692307693,14
16140,Hippodrome de Longchamp,OUI,24,5,19,15,4,OUI,OUI,2025-03-13 14:01:02+00:00,"48.86413226532, 2.239905372262",Paris,75056,0.7916666666666666,14
30005,Convention - Campus de Bobigny,OUI,30,18,12,3,9,OUI,OUI,2025-03-13 13:58:04+00:00,"48.914920058264, 2.4172238067445",Bobigny,93008,0.4,14
20035,Pyrénées - Ménilmontant,OUI,24,22,2,0,2,OUI,OUI,2025-03-13 13:58:05+00:00,"48.8693268535238, 2.395084574818611",Paris,75056,0.08333333333333333,14
13013,Saint-Marcel - Hôpital,OUI,20,5,15,10,5,OUI,OUI,2025-03-13 14:01:02+00:00,"48.839504424583, 2.3609894170229",Paris,75056,0.75,14
19045,Macdonald - Césaria Evora,OUI,66,41,25,9,16,OUI,OUI,2025-03-13 13:59:48+00:00,"48.89883, 2.37933",Paris,75056,0.3787878787878788,14
8044,Alfred de Vigny - Place du Général Brocard,OUI,32,20,12,5,7,OUI,OUI,2025-03-13 13:54:35+00:00,"48.87836138361425, 2.305254448220567",Paris,75056,0.375,14
9029,Saint-Lazare - Place d'Estienne d'Orves,OUI,39,2,37,21,16,OUI,OUI,2025-03-13 13:59:46+00:00,"48.8768345, 2.3329067",Paris,75056,0.9487179487179487,14
1201,Perrault - Place du Louvre,OUI,28,8,20,8,12,OUI,OUI,2025-03-13 14:01:55+00:00,"48.860273568996, 2.3412468419093",Paris,75056,0.7142857142857143,14
48011,Epi d'Or - Chevilly,OUI,20,18,2,0,2,OUI,OUI,2025-03-13 13:54:45+00:00,"48.781109786782, 2.3549050362061",Villejuif,94076,0.1,14
11038,Temple - Charlot,OUI,42,5,37,32,5,OUI,OUI,2025-03-13 14:00:32+00:00,"48.865709343796, 2.3652737250724",Paris,75056,0.8809523809523809,14
41304,Port - Maurice Chevalier,OUI,30,5,25,23,2,OUI,OUI,2025-03-13 14:01:03+00:00,"48.832474421632, 2.490257616467",Nogent-sur-Marne,94052,0.8333333333333334,14
21511,Marcel Monge - Marcel Dassault,OUI,46,10,36,31,5,OUI,OUI,2025-03-13 14:01:30+00:00,"48.86096384533371, 2.2246733296048142",Suresnes,92073,0.782608695652174,14
7007,Musée d'Orsay,OUI,63,2,61,43,18,OUI,OUI,2025-03-13 14:01:19+00:00,"48.859726157909, 2.3258604481816",Paris,75056,0.9682539682539683,14
21033,Sèvres - Maréchal Juin,OUI,18,8,10,10,0,OUI,OUI,2025-03-13 14:00:52+00:00,"48.8324305, 2.2292812",Boulogne-Billancourt,92012,0.5555555555555556,14
8031,Jean Mermoz - Champs-Elysées,OUI,46,10,36,12,24,OUI,OUI,2025-03-13 14:00:59+00:00,"48.869689856852, 2.3107324540615",Paris,75056,0.782608695652174,14
8003,Galilée - Vernet,OUI,47,29,18,3,15,OUI,OUI,2025-03-13 14:00:03+00:00,"48.871715878697, 2.2985444962978",Paris,75056,0.3829787234042553,14
26011,Ménil - Argenteuil,OUI,18,12,6,4,2,OUI,OUI,2025-03-13 13:56:48+00:00,"48.925901818305, 2.2741496502338",Asnières-sur-Seine,92004,0.3333333333333333,14
22703,Place Jean Mermoz,OUI,30,23,7,3,4,OUI,OUI,2025-03-13 14:01:32+00:00,"48.9220937, 2.2718348",Bois-Colombes,92009,0.23333333333333334,14
22208,Stalingrad - Barbara,OUI,19,16,3,0,3,OUI,OUI,2025-03-13 13:53:06+00:00,"48.809223658808, 2.3175904558822",Bagneux,92007,0.15789473684210525,14
41101,Paul Doumer - Stalingrad,OUI,24,20,4,4,0,OUI,OUI,2025-03-13 13:56:42+00:00,"48.806518992199, 2.3368880152702",Arcueil,94003,0.16666666666666666,14
45005,Stalingrad - Général de Gaulle,OUI,26,10,16,4,12,OUI,OUI,2025-03-13 14:01:35+00:00,"48.823450589614, 2.4965062363218",Champigny-sur-Marne,94017,0.6153846153846154,14
20030,Ménilmontant - Père Lachaise,OUI,40,34,6,0,6,OUI,OUI,2025-03-13 13:57:31+00:00,"48.863287291502, 2.3869940266013",Paris,75056,0.15,14
18045,Pierre Ginier - Clichy,OUI,16,14,2,0,2,OUI,OUI,2025-03-13 13:59:36+00:00,"48.8867667, 2.326228",Paris,75056,0.125,14
3201,Payenne - Square George Caïn,OUI,22,2,20,18,2,OUI,OUI,2025-03-13 14:00:38+00:00,"48.8578329, 2.3622643",Paris,75056,0.9090909090909091,14
10025,Jemmapes - Ecluses Saint-Martin,OUI,12,11,1,0,1,OUI,OUI,2025-03-13 13:55:19+00:00,"48.87748519186726, 2.3660067468881607",Paris,75056,0.08333333333333333,14
23106,Pavé des Gardes - Charles Vaillant,OUI,20,15,5,5,0,OUI,OUI,2025-03-13 13:57:42+00:00,"48.81168551728, 2.2111820107205",Sèvres,92072,0.25,14
11201,Faubourg St-Antoine - Place de la Nation,OUI,16,12,4,3,1,OUI,OUI,2025-03-13 14:00:16+00:00,"48.8487726, 2.393606",Paris,75056,0.25,14
21508,Georges Pompidou - Verdun,OUI,24,9,15,11,4,OUI,OUI,2025-03-13 13:58:31+00:00,"48.875481, 2.232443",Suresnes,92073,0.625,14
22602,Place Henri Dunant - Gare RER,OUI,30,29,1,0,1,OUI,OUI,2025-03-13 13:58:32+00:00,"48.788093281931, 2.2909234046643",Fontenay-aux-Roses,92032,0.03333333333333333,14
15032,Félix Faure - Lourmel,OUI,54,42,12,12,0,OUI,OUI,2025-03-13 14:01:33+00:00,"48.83868901709515, 2.2818081825971603",Paris,75056,0.2222222222222222,14
12106,Gare de Lyon - Roland Barthes,OUI,68,8,60,59,1,OUI,OUI,2025-03-13 14:00:48+00:00,"48.84395729494058, 2.3790882155299187",Paris,75056,0.8823529411764706,14
20037,Gambetta - Saint Fargeau,OUI,24,21,3,0,3,OUI,OUI,2025-03-13 13:57:44+00:00,"48.871244610447015, 2.4039056897163396",Paris,75056,0.125,14
23205,Parc des Pierrettes,OUI,22,20,2,0,2,OUI,OUI,2025-03-13 14:00:56+00:00,"48.7973062, 2.2909969",Châtillon,92020,0.09090909090909091,14
22302,Gare RER - Général de Gaulle,OUI,38,19,19,13,6,OUI,OUI,2025-03-13 14:00:11+00:00,"48.933548439566, 2.3064726536317",Gennevilliers,92036,0.5,14
23201,Avenir,OUI,42,37,5,4,1,OUI,OUI,2025-03-13 13:58:38+00:00,"48.8103438, 2.3003776",Châtillon,92020,0.11904761904761904,14
13053,Chevaleret - Tolbiac,OUI,21,9,12,11,1,OUI,OUI,2025-03-13 13:56:11+00:00,"48.82941, 2.375934",Paris,75056,0.5714285714285714,14
11001,Richard Lenoir - Place de la Bastille,OUI,46,15,31,24,7,OUI,OUI,2025-03-13 14:00:47+00:00,"48.8538327, 2.3697222",Paris,75056,0.6739130434782609,14
21327,Jean Bouin - Gouverneur Général Eboué,OUI,31,4,27,26,1,OUI,OUI,2025-03-13 14:01:23+00:00,"48.824792734266, 2.2651904328524",Issy-les-Moulineaux,92040,0.8709677419354839,14
41212,Nungesser - Santé,OUI,22,20,2,0,2,OUI,OUI,2025-03-13 13:54:41+00:00,"48.852335, 2.448967",Fontenay-sous-Bois,94033,0.09090909090909091,14
17126,Hélène et François Missoffe - Emile Borel,OUI,28,11,17,15,2,OUI,OUI,2025-03-13 13:58:43+00:00,"48.89990653843488, 2.321543991674844",Paris,75056,0.6071428571428571,14
34009,Dora Maar - Nadia Guendouz,OUI,28,10,18,16,2,OUI,OUI,2025-03-13 14:00:42+00:00,"48.905452421305, 2.3220406472683",Saint-Ouen-sur-Seine,93070,0.6428571428571429,14
34005,Adrien Lesesne - Docteur Bauer,OUI,29,27,2,1,1,OUI,OUI,2025-03-13 13:59:25+00:00,"48.90263867304635, 2.348248063431511",Saint-Ouen-sur-Seine,93070,0.06896551724137931,14
10151,Gare du Nord - Faubourg Saint-Denis,OUI,28,27,1,0,1,OUI,OUI,2025-03-13 13:58:58+00:00,"48.879612765504, 2.3568402975798",Paris,75056,0.03571428571428571,14
34012,Bateliers - Quai de Seine,OUI,22,14,8,4,4,OUI,OUI,2025-03-13 13:56:33+00:00,"48.915817585516, 2.3239533298594",Saint-Ouen-sur-Seine,93070,0.36363636363636365,14
22209,Verdun - Henri Barbusse,OUI,23,22,1,0,1,OUI,OUI,2025-03-13 13:59:34+00:00,"48.802056061754, 2.3159965061736",Bagneux,92007,0.043478260869565216,14
31303,Simone Signoret - Paris,OUI,26,16,10,5,5,OUI,OUI,2025-03-13 13:58:14+00:00,"48.903600624712865, 2.465406596265139",Noisy-le-Sec,93053,0.38461538461538464,14
35021,Cartier Bresson - Denis Papin,OUI,31,28,3,1,2,OUI,OUI,2025-03-13 13:57:30+00:00,"48.902616, 2.397814",Pantin,93055,0.0967741935483871,14
10026,Gare de l'Est - Chateau Landon,OUI,54,43,11,4,7,OUI,OUI,2025-03-13 14:01:17+00:00,"48.879305, 2.362424",Paris,75056,0.2037037037037037,14
14110,Abbé Carton - Plantes,OUI,25,24,1,1,0,OUI,OUI,2025-03-13 14:00:58+00:00,"48.827673823166, 2.3209181427956",Paris,75056,0.04,14
17010,Jonquière - Docteur Paul Brousse,OUI,37,28,9,4,5,OUI,OUI,2025-03-13 14:01:41+00:00,"48.894799816683985, 2.318705212173216",Paris,75056,0.24324324324324326,14
18018,Carpeaux - Place Jacques Froment,OUI,17,15,2,0,2,OUI,OUI,2025-03-13 14:01:28+00:00,"48.8906542, 2.3309428",Paris,75056,0.11764705882352941,14
18024,Clignancourt - Ordener,OUI,35,32,3,1,2,OUI,OUI,2025-03-13 14:01:10+00:00,"48.891457726153774, 2.348636478060487",Paris,75056,0.08571428571428572,14
32305,Saint-Germain - Verdun,OUI,29,29,0,0,0,OUI,OUI,2025-03-13 13:58:00+00:00,"48.882877330093, 2.4331868384644",Romainville,93063,0.0,14
19018,Cité de la Musique,OUI,54,33,21,10,11,OUI,OUI,2025-03-13 14:01:57+00:00,"48.888796556487, 2.3925811931922",Paris,75056,0.3888888888888889,14
22305,Jean Jaurès - Place du Dr Roux,OUI,34,23,11,8,3,OUI,OUI,2025-03-13 13:57:55+00:00,"48.927567032796, 2.2947337017374",Gennevilliers,92036,0.3235294117647059,14
7201,Place De Fontenoy - Saxe,OUI,18,2,16,10,6,OUI,OUI,2025-03-13 14:01:14+00:00,"48.850270554523, 2.3069813815839",Paris,75056,0.8888888888888888,14
21954,Val-Fleury,OUI,23,17,6,2,4,OUI,OUI,2025-03-13 13:58:51+00:00,"48.807671407991, 2.2407217696309",Meudon,92048,0.2608695652173913,14
31201,Suzanne Masson,OUI,33,10,23,13,10,OUI,OUI,2025-03-13 13:58:14+00:00,"48.923306888013, 2.3847292397611",La Courneuve,93027,0.696969696969697,14
22507,Châteaudun - Place de la Liberté,OUI,25,21,4,2,2,OUI,OUI,2025-03-13 13:54:25+00:00,"48.90970830301211, 2.2454486480600626",La Garenne-Colombes,92035,0.16,14
15013,Volontaires - Lecourbe,OUI,29,22,7,5,2,OUI,OUI,2025-03-13 14:01:22+00:00,"48.84351378799, 2.3065522313118",Paris,75056,0.2413793103448276,14
32023,Guy Môquet - Jean Moulin,OUI,27,10,17,10,7,OUI,OUI,2025-03-13 13:59:33+00:00,"48.940931521020836, 2.363948999931771",Saint-Denis,93066,0.6296296296296297,14
25010,Maréchal Leclerc de Hauteclocque - Marché Buzenval,OUI,29,25,4,2,2,OUI,OUI,2025-03-13 13:55:06+00:00,"48.858446, 2.192077",Rueil-Malmaison,92063,0.13793103448275862,14
47007,Liberté - Vert-de-Maisons,OUI,20,4,16,15,1,OUI,OUI,2025-03-13 13:53:50+00:00,"48.790147809608, 2.4328628182411",Maisons-Alfort,94046,0.8,14
12165,Champs de Manoeuvre - Cartoucherie,OUI,32,4,28,14,14,OUI,OUI,2025-03-13 14:00:37+00:00,"48.835261, 2.447974",Paris,75056,0.875,14
13051,Halle Freyssinet - Parvis Alan Turing,OUI,23,7,16,7,9,OUI,OUI,2025-03-13 14:00:33+00:00,"48.832846814471, 2.3711421713233",Paris,75056,0.6956521739130435,14
12001,Bastille - Biscornet,OUI,59,0,59,46,13,OUI,OUI,2025-03-13 14:01:35+00:00,"48.851355779579, 2.369220033288",Paris,75056,1.0,14
5201,Saint-Jacques - Soufflot,OUI,16,1,15,1,14,OUI,OUI,2025-03-13 14:02:00+00:00,"48.846280383395, 2.3430785379567",Paris,75056,0.9375,14
22018,Charles de Gaulle - Les Sablons,OUI,35,17,18,11,7,OUI,OUI,2025-03-13 14:00:45+00:00,"48.880987514929, 2.2715748726513",Neuilly-sur-Seine,92051,0.5142857142857142,14
11037,Faubourg Du Temple - Republique,OUI,38,14,24,20,4,OUI,OUI,2025-03-13 14:01:50+00:00,"48.867872484749, 2.3648982158072",Paris,75056,0.631578947368421,14
21320,Président Roosevelt - Rouget de Lisle,OUI,40,0,40,24,16,OUI,OUI,2025-03-13 13:57:10+00:00,"48.83047518749, 2.2616135525345",Issy-les-Moulineaux,92040,1.0,14
11014,Place de la Nation - Taillebourg,OUI,46,40,6,1,5,OUI,OUI,2025-03-13 14:01:41+00:00,"48.8488408, 2.3973043",Paris,75056,0.13043478260869565,14
23203,Division Leclerc - Kléber,OUI,25,21,4,1,3,OUI,OUI,2025-03-13 14:00:55+00:00,"48.798666226364, 2.2833752789972",Châtillon,92020,0.16,14
8039,Colisée - Champs-Elysées,OUI,16,4,12,4,8,OUI,OUI,2025-03-13 13:55:22+00:00,"48.870475399387, 2.3076190799475",Paris,75056,0.75,14
9035,Gare Saint-Lazare - Place de Budapest,OUI,43,18,25,15,10,OUI,OUI,2025-03-13 13:58:50+00:00,"48.877753, 2.327339",Paris,75056,0.5813953488372093,14
11102,Alexandre Dumas - Voltaire,OUI,58,53,5,0,5,OUI,OUI,2025-03-13 14:00:57+00:00,"48.852888670365, 2.3891476408096",Paris,75056,0.08620689655172414,14
17127,Porte de Clichy - Place des Nations Unies,OUI,37,1,36,34,2,OUI,OUI,2025-03-13 14:00:44+00:00,"48.896737263309504, 2.310542999196392",Paris,75056,0.972972972972973,14
12157,Fabre d'Eglantine - Place de la Nation,OUI,66,65,1,1,0,OUI,OUI,2025-03-13 14:01:37+00:00,"48.8471116, 2.3956204",Paris,75056,0.015151515151515152,14
26008,Henri Barbusse - Bourguignons,OUI,32,26,6,1,5,OUI,OUI,2025-03-13 13:53:50+00:00,"48.91301722799713, 2.2734212270774417",Asnières-sur-Seine,92004,0.1875,14
11046,Place de la République - Voltaire,OUI,16,1,15,14,1,OUI,OUI,2025-03-13 14:00:35+00:00,"48.866830968942, 2.3654810339212",Paris,75056,0.9375,14
26009,Marceau Delorme - Pierre Brossolette,OUI,26,22,4,1,3,OUI,OUI,2025-03-13 13:58:17+00:00,"48.91206062860357, 2.295897423568745",Asnières-sur-Seine,92004,0.15384615384615385,14
35001,Jean Jaurès - Ouvrières Pivéreuses,OUI,21,18,3,0,3,OUI,OUI,2025-03-13 13:57:40+00:00,"48.910423437526, 2.3995766043663",Pantin,93055,0.14285714285714285,14
34008,Garibaldi - Gabriel Péri,OUI,28,21,7,3,4,OUI,OUI,2025-03-13 14:01:06+00:00,"48.905741911394, 2.3316044208059",Saint-Ouen-sur-Seine,93070,0.25,14
15060,Place de la Montagne du Goulet,OUI,20,8,12,11,1,OUI,OUI,2025-03-13 14:01:15+00:00,"48.8443415, 2.2773844",Paris,75056,0.6,14
23204,Roland Garros - Jean Bouin,OUI,28,27,1,0,1,OUI,OUI,2025-03-13 13:53:01+00:00,"48.809460857173, 2.2853198638301",Châtillon,92020,0.03571428571428571,14
11011,Richard Lenoir - Voltaire,OUI,25,11,14,8,6,OUI,OUI,2025-03-13 13:59:51+00:00,"48.86164273878, 2.3727491497993",Paris,75056,0.56,14
31301,Gare RER,OUI,27,19,8,0,8,OUI,OUI,2025-03-13 14:00:30+00:00,"48.896280181078, 2.4581568985227",Noisy-le-Sec,93053,0.2962962962962963,14
11012,Montreuil - Voltaire,OUI,32,27,5,0,5,OUI,OUI,2025-03-13 13:54:22+00:00,"48.850507011842, 2.3930755582745",Paris,75056,0.15625,14
21514,Place de la Paix - Abbé Saint-Pierre,OUI,24,22,2,1,1,OUI,OUI,2025-03-13 13:58:33+00:00,"48.86462724459225, 2.2047570338469806",Suresnes,92073,0.08333333333333333,14
15105,Fédération - Suffren,OUI,25,16,9,6,3,OUI,OUI,2025-03-13 13:58:26+00:00,"48.852828153442, 2.2978776320815",Paris,75056,0.36,14
5107,Pontoise - La Tournelle,OUI,22,2,20,17,3,OUI,OUI,2025-03-13 13:59:17+00:00,"48.850458009188, 2.3524542754922",Paris,75056,0.9090909090909091,14
8057,Hoche - Tilsitt,OUI,31,25,6,2,4,OUI,OUI,2025-03-13 14:01:55+00:00,"48.874836457837, 2.2971323132515",Paris,75056,0.1935483870967742,14
18023,Ordener - Poissonniers,OUI,35,34,1,0,1,OUI,OUI,2025-03-13 13:57:51+00:00,"48.891213890844654, 2.351288666219873",Paris,75056,0.02857142857142857,14
7109,Place Joffre - Frédéric le Play,OUI,37,26,11,8,3,OUI,OUI,2025-03-13 14:00:11+00:00,"48.853754486938, 2.3044242337346",Paris,75056,0.2972972972972973,14
18026,Ruisseau - Ordener,OUI,33,30,3,1,2,OUI,OUI,2025-03-13 13:56:42+00:00,"48.89299462568024, 2.340144887566567",Paris,75056,0.09090909090909091,14
12105,Bercy - Villot,OUI,36,8,28,22,6,OUI,OUI,2025-03-13 14:01:56+00:00,"48.841795009027, 2.3767850184816",Paris,75056,0.7777777777777778,14
16006,Lauriston - Copernic,OUI,19,16,3,0,3,OUI,OUI,2025-03-13 14:01:38+00:00,"48.86926, 2.289918",Paris,75056,0.15789473684210525,14
40010,Haut du Mont-Mesly,OUI,21,17,4,3,1,OUI,OUI,2025-03-13 13:55:53+00:00,"48.780191921646, 2.4685737495183",Créteil,94028,0.19047619047619047,14
8008,Joseph Sansboeuf - Saint Lazare,OUI,32,17,15,10,5,OUI,OUI,2025-03-13 14:00:51+00:00,"48.875315630653, 2.3229019716382",Paris,75056,0.46875,14
40013,Hôtel de Ville de Créteil,OUI,36,15,21,14,7,OUI,OUI,2025-03-13 13:59:53+00:00,"48.77699496201, 2.4552552404284",Créteil,94028,0.5833333333333334,14
13205,Choisy - Pointe d'Ivry,OUI,24,20,4,1,3,OUI,OUI,2025-03-13 14:00:59+00:00,"48.822154170359, 2.3633708034878",Paris,75056,0.16666666666666666,14
12107,Diderot - Pierre Bourdan,OUI,21,7,14,6,8,OUI,OUI,2025-03-13 14:00:25+00:00,"48.847648620797, 2.3902582749724",Paris,75056,0.6666666666666666,14
31202,Gabriel Péri - Jules Ferry,OUI,27,10,17,15,2,OUI,OUI,2025-03-13 14:01:28+00:00,"48.926182814311, 2.3912295762525",La Courneuve,93027,0.6296296296296297,14
40014,Créteil Pointe du Lac,OUI,28,2,26,9,17,OUI,OUI,2025-03-13 14:01:21+00:00,"48.769807356177, 2.4623027310281",Créteil,94028,0.9285714285714286,14
13204,Tolbiac - Boussingault,OUI,41,36,5,4,1,OUI,OUI,2025-03-13 13:59:23+00:00,"48.826177754027, 2.3420378552202",Paris,75056,0.12195121951219512,14
16005,Raymond Poincaré - Place Victor Hugo,OUI,22,8,14,3,11,OUI,OUI,2025-03-13 13:59:10+00:00,"48.87030612437, 2.2850745414202",Paris,75056,0.6363636363636364,14
13035,Choisy - Tolbiac,OUI,20,17,3,1,2,OUI,OUI,2025-03-13 13:58:26+00:00,"48.82591155587, 2.3602393269539",Paris,75056,0.15,14
23801,Place de la Gare,OUI,20,16,4,1,3,OUI,OUI,2025-03-13 13:55:27+00:00,"48.838513582184, 2.1866139007512",Garches,92033,0.2,14
40008,Créteil Pompadour,OUI,44,16,28,11,17,OUI,OUI,2025-03-13 14:01:17+00:00,"48.773011623355, 2.435166164893",Créteil,94028,0.6363636363636364,14
15062,Convention - Lourmel,OUI,35,16,19,14,5,OUI,OUI,2025-03-13 13:59:44+00:00,"48.842055041656, 2.2859910875559",Paris,75056,0.5428571428571428,14
10114,Granges aux Belles - Hôpital Saint-Louis,OUI,59,57,2,2,0,OUI,OUI,2025-03-13 14:01:26+00:00,"48.874794994841, 2.366669436985",Paris,75056,0.03389830508474576,14
51005,Yves Farges - Route d'Enghien,OUI,33,16,17,6,11,OUI,OUI,2025-03-13 13:59:16+00:00,"48.95756799268, 2.2834496977978",Argenteuil,95018,0.5151515151515151,14
18134,Ney - Porte de Clignancourt,OUI,24,24,0,0,0,OUI,OUI,2025-03-13 13:56:11+00:00,"48.8978867, 2.3458001",Paris,75056,0.0,14
13203,Square de Choisy - Eastman,OUI,23,12,11,2,9,OUI,OUI,2025-03-13 13:57:40+00:00,"48.828543456283, 2.3583075090494",Paris,75056,0.4782608695652174,14
32004,Wilson - Landy,OUI,38,16,22,16,6,OUI,OUI,2025-03-13 14:01:33+00:00,"48.91516726221354, 2.357633225619793",Saint-Denis,93066,0.5789473684210527,14
13202,Place Farhat Hached,OUI,28,4,24,9,15,OUI,OUI,2025-03-13 14:01:44+00:00,"48.825487045602, 2.3816306985827",Paris,75056,0.8571428571428571,14
35014,Charles de Gaulle - Jean Lolive,OUI,26,23,3,3,0,OUI,OUI,2025-03-13 14:01:23+00:00,"48.8932644350857, 2.4126765131950383",Pantin,93055,0.11538461538461539,14
8038,François 1er - Montaigne,OUI,52,10,42,26,16,OUI,OUI,2025-03-13 14:00:25+00:00,"48.866887649978, 2.3066755757207",Paris,75056,0.8076923076923077,14
31708,Noisy le Sec - Jean-Baptiste Clément,OUI,21,19,2,0,2,OUI,OUI,2025-03-13 14:00:18+00:00,"48.874515389637, 2.4152836203575",Bagnolet,93006,0.09523809523809523,14
21501,Pont de Suresnes,OUI,15,11,4,2,2,OUI,OUI,2025-03-13 13:57:07+00:00,"48.867415092322, 2.2258946679617",Suresnes,92073,0.26666666666666666,14
15103,Cauchy - Cévennes,OUI,50,6,44,41,3,OUI,OUI,2025-03-13 14:01:38+00:00,"48.843372571022, 2.2751328349113",Paris,75056,0.88,14
19204,Rampal - Belleville,OUI,19,19,0,0,0,OUI,OUI,2025-03-13 14:01:09+00:00,"48.873114661405, 2.3798409114805",Paris,75056,0.0,14
15026,Bir Hakeim,OUI,32,13,19,11,8,OUI,OUI,2025-03-13 14:01:01+00:00,"48.853844054334, 2.289705348222",Paris,75056,0.59375,14
18042,Place Pigalle,OUI,20,18,2,0,2,OUI,OUI,2025-03-13 13:56:00+00:00,"48.8827555, 2.3361566",Paris,75056,0.1,14
41301,Bois de Vincennes - Gare,OUI,50,47,3,2,1,OUI,OUI,2025-03-13 13:59:46+00:00,"48.836022242887, 2.470833995083",Nogent-sur-Marne,94052,0.06,14
18041,Rochechouart - Martyrs,OUI,17,14,3,1,2,OUI,OUI,2025-03-13 13:58:52+00:00,"48.882193779572, 2.3405495658517",Paris,75056,0.17647058823529413,14
19203,Pailleron - Bouret,OUI,27,26,1,1,0,OUI,OUI,2025-03-13 14:00:29+00:00,"48.880516995482, 2.3763902374411",Paris,75056,0.037037037037037035,14
35002,Jean Jaurès - Presles,OUI,31,26,5,2,3,OUI,OUI,2025-03-13 14:01:48+00:00,"48.907134414988, 2.3960057280531",Pantin,93055,0.16129032258064516,14
18043,Clichy - Place Blanche,OUI,18,13,5,2,3,OUI,OUI,2025-03-13 14:01:07+00:00,"48.883601088297, 2.3332237824798",Paris,75056,0.2777777777777778,14
11020,Belfort - Voltaire,OUI,39,29,10,4,6,OUI,OUI,2025-03-13 13:58:50+00:00,"48.8563358, 2.3829901",Paris,75056,0.2564102564102564,14
34014,Michelet - Dr Bauer,OUI,30,28,2,0,2,OUI,OUI,2025-03-13 14:00:59+00:00,"48.906125424194, 2.3440374449846",Saint-Ouen-sur-Seine,93070,0.06666666666666667,14
18044,Clichy - Douai,OUI,32,28,4,0,4,OUI,OUI,2025-03-13 13:54:47+00:00,"48.883687771522, 2.328063700029",Paris,75056,0.125,14
1002,Victoria - Place du Chatelet,OUI,19,3,16,9,7,OUI,OUI,2025-03-13 14:01:33+00:00,"48.857992591527, 2.3469167947769",Paris,75056,0.8421052631578947,14
16103,Traktir - Foch,OUI,20,2,18,2,16,OUI,OUI,2025-03-13 13:59:07+00:00,"48.872755334614, 2.2915497802487",Paris,75056,0.9,14
8052,Balzac - Champs Elysées,OUI,30,10,20,10,10,OUI,OUI,2025-03-13 13:56:46+00:00,"48.872699639621, 2.3001953959465",Paris,75056,0.6666666666666666,14
21213,Vanne - Général de Gaulle,OUI,24,22,2,0,2,OUI,OUI,2025-03-13 13:56:56+00:00,"48.815007, 2.328318",Montrouge,92049,0.08333333333333333,14
12010,Daumesnil - Picpus,OUI,20,10,10,9,1,OUI,OUI,2025-03-13 13:58:24+00:00,"48.8374688, 2.401765",Paris,75056,0.5,14
3004,Place de la République - Temple,OUI,17,3,14,8,6,OUI,OUI,2025-03-13 14:01:03+00:00,"48.867211201859, 2.3635464370545",Paris,75056,0.8235294117647058,14
32001,Proudhon - Président Wilson,OUI,29,14,15,11,4,OUI,OUI,2025-03-13 14:00:16+00:00,"48.906442763495, 2.3584905266762",Saint-Denis,93066,0.5172413793103449,14
11009,Boulets - Voltaire,OUI,24,22,2,0,2,OUI,OUI,2025-03-13 14:01:52+00:00,"48.85218705621, 2.3890301585197",Paris,75056,0.08333333333333333,14
8002,Gare Saint-Lazare - Cour du Havre,OUI,43,15,28,10,18,OUI,OUI,2025-03-13 14:01:52+00:00,"48.875674400851, 2.3265598341823",Paris,75056,0.6511627906976745,14
7111,Ecole Militaire - Place Joffre,OUI,25,9,16,13,3,OUI,OUI,2025-03-13 13:59:30+00:00,"48.852060203583, 2.3017993569374",Paris,75056,0.64,14
21302,Aristide Briand - Place de la Résistance,OUI,38,3,35,33,2,OUI,OUI,2025-03-13 13:59:13+00:00,"48.82124248401006, 2.2511002421379094",Issy-les-Moulineaux,92040,0.9210526315789473,14
18205,Mauroy - Cheminots,OUI,30,23,7,2,5,OUI,OUI,2025-03-13 13:58:18+00:00,"48.897715198403, 2.357895075822",Paris,75056,0.23333333333333334,14
9104,Caumartin - Provence,OUI,22,6,16,14,2,OUI,OUI,2025-03-13 14:01:20+00:00,"48.874422773426545, 2.3284685611724854",Paris,75056,0.7272727272727273,14
7023,Bourdonnais - Tour Eiffel,OUI,56,5,51,39,12,OUI,OUI,2025-03-13 14:01:59+00:00,"48.860897797941, 2.295599598447",Paris,75056,0.9107142857142857,14
9025,Taitbout - Châteaudun,OUI,53,2,51,46,5,OUI,OUI,2025-03-13 14:01:07+00:00,"48.876383969379, 2.3353566779335",Paris,75056,0.9622641509433962,14
7025,Octave Gréard - Tour Eiffel,OUI,32,7,25,12,13,OUI,OUI,2025-03-13 14:01:48+00:00,"48.856502977696, 2.2931787543289",Paris,75056,0.78125,14
4108,Quai de Béthune - Pont de la Tournelle,OUI,25,1,24,17,7,OUI,OUI,2025-03-13 14:01:14+00:00,"48.85097433194, 2.3563072085381",Paris,75056,0.96,14
40007,Préfecture de Créteil,OUI,27,5,22,14,8,OUI,OUI,2025-03-13 14:01:27+00:00,"48.783680285918, 2.4544713672215",Créteil,94028,0.8148148148148148,14
40012,Stade de la Habette,OUI,16,14,2,0,2,OUI,OUI,2025-03-13 13:56:33+00:00,"48.774397033806, 2.4668785263921",Créteil,94028,0.125,14
23011,Bineau - Louise Michel,OUI,26,15,11,6,5,OUI,OUI,2025-03-13 13:54:23+00:00,"48.88666162207, 2.2843274474144",Levallois-Perret,92044,0.4230769230769231,14
12201,Dugommier,OUI,53,47,6,5,1,OUI,OUI,2025-03-13 13:54:31+00:00,"48.838811048815, 2.3896577954292",Paris,75056,0.11320754716981132,14
26005,Hôtel de Ville d'Asnières sur Seine,OUI,25,18,7,2,5,OUI,OUI,2025-03-13 13:56:02+00:00,"48.90999330025577, 2.288238108158112",Asnières-sur-Seine,92004,0.28,14
40003,Centre Hospitalier Intercommunal de Créteil,OUI,17,17,0,0,0,OUI,OUI,2025-03-13 14:00:45+00:00,"48.797078298909, 2.463801423807",Créteil,94028,0.0,14
40004,Créteil Village,OUI,25,4,21,7,14,OUI,OUI,2025-03-13 14:01:36+00:00,"48.79122395576, 2.4642198533952",Créteil,94028,0.84,14
23703,Gare de Chaville Rive Gauche,OUI,18,16,2,1,1,OUI,OUI,2025-03-13 13:57:53+00:00,"48.805160304345, 2.188277207315",Chaville,92022,0.1111111111111111,14
14021,Place de la Porte de Châtillon,OUI,59,59,0,0,0,OUI,OUI,2025-03-13 13:59:46+00:00,"48.8242469, 2.3186306",Paris,75056,0.0,14
13106,Bobillot - Paulin Mery,OUI,21,20,1,0,1,OUI,OUI,2025-03-13 14:00:49+00:00,"48.829899841747, 2.3543356766749",Paris,75056,0.047619047619047616,14
40015,Iles de Loisirs de Créteil,OUI,24,5,19,10,9,OUI,OUI,2025-03-13 14:01:19+00:00,"48.780258200618, 2.4455094301232",Créteil,94028,0.7916666666666666,14
10031,Louis Blanc - Aqueduc,OUI,36,35,1,1,0,OUI,OUI,2025-03-13 14:01:09+00:00,"48.882030182599, 2.363561578095",Paris,75056,0.027777777777777776,14
20137,Borrégo - Gambetta,OUI,25,24,1,0,1,OUI,OUI,2025-03-13 13:55:33+00:00,"48.87330497045532, 2.4014145880937576",Paris,75056,0.04,14
1003,Saint-Denis - Rivoli,OUI,43,5,38,24,14,OUI,OUI,2025-03-13 14:01:23+00:00,"48.859059340842, 2.3476943001151",Paris,75056,0.8837209302325582,14
10013,Alibert - Jemmapes,OUI,58,53,5,2,3,OUI,OUI,2025-03-13 14:01:54+00:00,"48.871044051984, 2.3661044619878",Paris,75056,0.08620689655172414,14
1022,Danielle Casanova - Place Vendôme,OUI,37,4,33,22,11,OUI,OUI,2025-03-13 14:00:10+00:00,"48.868266498223, 2.3304839059711",Paris,75056,0.8918918918918919,14
32012,Carrefour Pleyel,OUI,65,29,36,16,20,OUI,OUI,2025-03-13 13:59:41+00:00,"48.92034156960326, 2.3438543826341625",Saint-Denis,93066,0.5538461538461539,14
27004,Gare de la Garenne-Colombes,OUI,27,17,10,7,3,OUI,OUI,2025-03-13 14:01:08+00:00,"48.909752, 2.239145",Colombes,92025,0.37037037037037035,14
21404,Jean Jaurès - Gare de Clamart,OUI,20,19,1,1,0,OUI,OUI,2025-03-13 13:54:23+00:00,"48.81321981219, 2.2716768079163",Clamart,92023,0.05,14
17123,Mstislav Rostropovitch - Berthier,OUI,18,12,6,2,4,OUI,OUI,2025-03-13 13:58:04+00:00,"48.892120821173975, 2.309234105050564",Paris,75056,0.3333333333333333,14
6001,Institut de France,OUI,17,3,14,8,6,OUI,OUI,2025-03-13 14:00:21+00:00,"48.857615678565, 2.3358313530377",Paris,75056,0.8235294117647058,14
17038,Grande Armée - Brunel,OUI,60,27,33,10,23,OUI,OUI,2025-03-13 14:01:42+00:00,"48.876116, 2.288124",Paris,75056,0.55,14
4104,Sebastopol - Rambuteau,OUI,15,0,15,9,6,OUI,OUI,2025-03-13 14:01:49+00:00,"48.86181809267, 2.3501381278038",Paris,75056,1.0,14
13123,BNF - Bibliothèque Nationale de France,OUI,44,2,42,27,15,OUI,OUI,2025-03-13 14:01:51+00:00,"48.8350268238, 2.3760157451034",Paris,75056,0.9545454545454546,14
40002,Bleuets - Bordières,OUI,21,17,4,2,2,OUI,OUI,2025-03-13 13:58:49+00:00,"48.802117531472, 2.4543687905029",Créteil,94028,0.19047619047619047,14
33019,Madeleine Vionnet,OUI,45,9,36,12,24,OUI,OUI,2025-03-13 14:01:29+00:00,"48.902519074064, 2.3740895837545",Aubervilliers,93001,0.8,14
21021,Enfants du Paradis - Peupliers,OUI,62,0,62,33,29,OUI,OUI,2025-03-13 14:01:52+00:00,"48.833122686454, 2.2571459412575",Boulogne-Billancourt,92012,1.0,14
12127,Tremblay - Lac des Minimes,OUI,53,8,45,16,29,OUI,OUI,2025-03-13 14:02:01+00:00,"48.834131261494, 2.4547516554594",Paris,75056,0.8490566037735849,14
15056,Place Balard,OUI,28,2,26,21,5,OUI,OUI,2025-03-13 14:01:54+00:00,"48.836395736424, 2.2784192115068",Paris,75056,0.9285714285714286,14
8004,Malesherbes - Place de la Madeleine,OUI,78,8,70,30,40,OUI,OUI,2025-03-13 14:01:14+00:00,"48.870406028483, 2.323243509808",Paris,75056,0.8974358974358975,14
16107,Benjamin Godard - Victor Hugo,OUI,32,30,2,1,1,OUI,OUI,2025-03-13 15:01:43+00:00,"48.865983, 2.275725",Paris,75056,0.0625,15
44015,Rouget de L'isle - Watteau,OUI,20,9,11,0,11,OUI,OUI,2025-03-13 14:49:01+00:00,"48.778192750803, 2.3963020229163",Vitry-sur-Seine,94081,0.55,15
40001,Hôpital Mondor,OUI,28,10,18,10,8,OUI,OUI,2025-03-13 15:00:39+00:00,"48.798922410229, 2.4537451531298",Créteil,94028,0.6428571428571429,15
9020,Toudouze - Clauzel,OUI,21,18,3,1,2,OUI,OUI,2025-03-13 14:59:11+00:00,"48.87929591733507, 2.3373600840568547",Paris,75056,0.14285714285714285,15
11104,Charonne - Robert et Sonia Delaunay,OUI,20,17,3,1,2,OUI,OUI,2025-03-13 14:56:11+00:00,"48.855907555969, 2.3925706744194",Paris,75056,0.15,15
14111,Cassini - Denfert-Rochereau,OUI,23,22,1,0,1,OUI,OUI,2025-03-13 15:00:00+00:00,"48.837525839067, 2.3360354080796",Paris,75056,0.043478260869565216,15
7002,Vaneau - Sèvres,OUI,35,13,22,20,2,OUI,OUI,2025-03-13 15:02:05+00:00,"48.848563233059, 2.3204218259346",Paris,75056,0.6285714285714286,15
14014,Jourdan - Stade Charléty,OUI,58,50,8,1,7,OUI,OUI,2025-03-13 15:01:47+00:00,"48.819428333369, 2.3433353751898",Paris,75056,0.13793103448275862,15
6108,Saint-Romain - Cherche-Midi,OUI,16,8,8,5,3,OUI,OUI,2025-03-13 15:01:48+00:00,"48.84708159081946, 2.321374788880348",Paris,75056,0.5,15
32017,Basilique,OUI,20,10,10,3,7,OUI,OUI,2025-03-13 15:00:44+00:00,"48.93626891059109, 2.3588666820200914",Saint-Denis,93066,0.5,15
33006,André Karman - République,OUI,30,29,1,0,1,OUI,OUI,2025-03-13 14:57:53+00:00,"48.91039875761846, 2.3851355910301213",Aubervilliers,93001,0.03333333333333333,15
8026,Messine - Place Du Pérou,OUI,12,1,11,4,7,OUI,OUI,2025-03-13 15:01:51+00:00,"48.875448033960744, 2.315508019010038",Paris,75056,0.9166666666666666,15
40011,Bas du Mont-Mesly,OUI,26,17,9,6,3,OUI,OUI,2025-03-13 15:02:06+00:00,"48.779035118572, 2.4609763908985",Créteil,94028,0.34615384615384615,15
13007,Le Brun - Gobelins,OUI,48,36,12,12,0,OUI,OUI,2025-03-13 14:59:47+00:00,"48.835092787824, 2.3534681351338",Paris,75056,0.25,15
25006,Place Nelson Mandela,OUI,22,21,1,0,1,OUI,OUI,2025-03-13 15:01:38+00:00,"48.862453313908, 2.1961666225454",Rueil-Malmaison,92063,0.045454545454545456,15
6003,Saint-Sulpice,OUI,21,4,17,11,6,OUI,OUI,2025-03-13 15:02:01+00:00,"48.85165383178419, 2.3308077827095985",Paris,75056,0.8095238095238095,15
30002,Jean Rostand - Paul Vaillant Couturier,OUI,39,25,14,8,6,OUI,OUI,2025-03-13 15:01:57+00:00,"48.908168131015, 2.4530601033354",Bobigny,93008,0.358974358974359,15
5110,Lacépède - Monge,OUI,22,18,4,1,3,OUI,OUI,2025-03-13 14:59:32+00:00,"48.84389286531899, 2.3519663885235786",Paris,75056,0.18181818181818182,15
32304,Charcot - Benfleet,OUI,28,27,1,0,1,NON,NON,2025-03-13 14:54:30+00:00,"48.878370277021, 2.440523876268",Romainville,93063,0.03571428571428571,15
42016,Pierre et Marie Curie - Maurice Thorez,OUI,26,18,8,4,4,OUI,OUI,2025-03-13 14:59:14+00:00,"48.81580226360801, 2.376804985105991",Ivry-sur-Seine,94041,0.3076923076923077,15
17041,Guersant - Gouvion-Saint-Cyr,OUI,33,15,18,7,11,OUI,OUI,2025-03-13 14:58:33+00:00,"48.88287775178599, 2.287667370814871",Paris,75056,0.5454545454545454,15
21010,Silly - Galliéni,OUI,25,10,15,8,7,OUI,OUI,2025-03-13 15:00:48+00:00,"48.835583838706, 2.2325500845909",Boulogne-Billancourt,92012,0.6,15
5016,Thouin - Cardinal Lemoine,OUI,16,8,8,0,8,OUI,OUI,2025-03-13 15:00:30+00:00,"48.84504716661511, 2.3494647851273465",Paris,75056,0.5,15
7003,Square Boucicaut,OUI,58,30,28,24,4,OUI,OUI,2025-03-13 15:02:02+00:00,"48.851296433665276, 2.325061820447445",Paris,75056,0.4827586206896552,15
12109,Mairie du 12ème,OUI,30,23,7,5,2,OUI,OUI,2025-03-13 14:58:36+00:00,"48.840855311763, 2.3875549435616",Paris,75056,0.23333333333333334,15
11025,Froment - Bréguet,OUI,43,28,15,13,2,OUI,OUI,2025-03-13 14:55:29+00:00,"48.8570414504784, 2.37289470306807",Paris,75056,0.3488372093023256,15
14108,Le Brix et Mesmin - Jourdan,OUI,20,17,3,2,1,OUI,OUI,2025-03-13 14:59:51+00:00,"48.82234096593411, 2.327861653302471",Paris,75056,0.15,15
15047,Morillons - Dantzig,OUI,51,50,1,1,0,OUI,OUI,2025-03-13 14:55:28+00:00,"48.83310149953933, 2.299380004405976",Paris,75056,0.0196078431372549,15
17044,Porte de Saint-Ouen - Bessières,OUI,42,32,10,6,4,OUI,OUI,2025-03-13 15:01:52+00:00,"48.89792240854517, 2.32851451022192",Paris,75056,0.23809523809523808,15
17026,Jouffroy d'Abbans - Wagram,OUI,39,19,20,10,10,OUI,OUI,2025-03-13 14:59:01+00:00,"48.881973298352, 2.301132157445",Paris,75056,0.5128205128205128,15
19033,Cambrai - Benjamin Constant,OUI,40,37,3,2,1,OUI,OUI,2025-03-13 15:01:29+00:00,"48.89594736851349, 2.381133802246315",Paris,75056,0.075,15
6021,Beaux-Arts - Bonaparte,OUI,19,5,14,11,3,OUI,OUI,2025-03-13 15:01:41+00:00,"48.856451985396, 2.3348518833518",Paris,75056,0.7368421052631579,15
21326,Moulin de Pierre - Abbé Grégoire,OUI,20,12,8,0,8,OUI,OUI,2025-03-13 14:59:22+00:00,"48.822036188382, 2.2754641655975",Issy-les-Moulineaux,92040,0.4,15
15202,Bracion - Périphérique,OUI,30,29,1,0,1,OUI,OUI,2025-03-13 14:54:14+00:00,"48.826103771275, 2.3004549373748",Paris,75056,0.03333333333333333,15
16138,Saint-Cloud - Hippodrome,OUI,30,21,9,4,5,OUI,OUI,2025-03-13 15:00:05+00:00,"48.85772148887421, 2.2549109905958176",Paris,75056,0.3,15
8050,Boétie - Ponthieu,OUI,43,4,39,15,24,OUI,OUI,2025-03-13 15:01:48+00:00,"48.871417284355, 2.3076787590981",Paris,75056,0.9069767441860465,15
21216,Louis Lejeune - Barbès,OUI,24,23,1,0,1,OUI,OUI,2025-03-13 14:59:49+00:00,"48.81807418981508, 2.3267009854316716",Montrouge,92049,0.041666666666666664,15
13101,Croulebarde - Corvisart,OUI,33,24,9,5,4,OUI,OUI,2025-03-13 15:01:12+00:00,"48.830981659316855, 2.3481646925210953",Paris,75056,0.2727272727272727,15
15068,Général Martial Valin - Pont du Garigliano,OUI,14,9,5,1,4,OUI,OUI,2025-03-13 14:56:43+00:00,"48.83823094269141, 2.270506024360657",Paris,75056,0.35714285714285715,15
31024,Romainville - Vaillant-Couturier,OUI,36,32,4,0,4,OUI,OUI,2025-03-13 15:00:52+00:00,"48.86785, 2.446748",Montreuil,93048,0.1111111111111111,15
22207,Rond-point du Dr Albert Schweitzer,OUI,22,17,5,2,3,OUI,OUI,2025-03-13 14:59:13+00:00,"48.78980918988166, 2.3143940046429634",Bagneux,92007,0.22727272727272727,15
2022,Saint-Fiacre - Poissonière,OUI,33,5,28,14,14,OUI,OUI,2025-03-13 15:02:01+00:00,"48.870828911558, 2.3459213599563",Paris,75056,0.8484848484848485,15
92002,Théâtre des Amandiers - Palais des sports,OUI,23,8,15,8,7,OUI,OUI,2025-03-13 14:52:48+00:00,"48.892648526839, 2.2136941552162",Nanterre,92050,0.6521739130434783,15
17025,Chazelles - Courcelles,OUI,32,27,5,2,3,OUI,OUI,2025-03-13 15:01:19+00:00,"48.879406604954, 2.3034455627202988",Paris,75056,0.15625,15
19027,Serrurier,OUI,18,17,1,0,1,OUI,OUI,2025-03-13 15:00:17+00:00,"48.880493403246, 2.398064173758",Paris,75056,0.05555555555555555,15
20143,Ramponeau - Belleville,OUI,44,43,1,0,1,OUI,OUI,2025-03-13 15:01:21+00:00,"48.871031137596, 2.379056852114",Paris,75056,0.022727272727272728,15
31028,Raspail Barbès,OUI,28,28,0,0,0,OUI,OUI,2025-03-13 14:53:27+00:00,"48.8529945, 2.4247387",Montreuil,93048,0.0,15
43002,Lagny - Victor Basch,OUI,24,24,0,0,0,OUI,OUI,2025-03-13 15:00:41+00:00,"48.84884147189881, 2.426325418925233",Vincennes,94080,0.0,15
44017,Jules Guesde - Pont du Port à l'Anglais,OUI,26,0,26,25,1,OUI,OUI,2025-03-13 15:01:25+00:00,"48.79628807093802, 2.417212128639221",Vitry-sur-Seine,94081,1.0,15
17048,De Toqueville - Terrasse,OUI,30,27,3,2,1,OUI,OUI,2025-03-13 15:02:01+00:00,"48.882428, 2.314002",Paris,75056,0.1,15
16118,Michel-Ange - Parent de Rosan,OUI,23,21,2,1,1,OUI,OUI,2025-03-13 15:01:15+00:00,"48.840579923690115, 2.2584119439125065",Paris,75056,0.08695652173913043,15
2017,Caire - Dussoubs,OUI,39,13,26,25,1,OUI,OUI,2025-03-13 15:01:52+00:00,"48.86785342111862, 2.349364310503006",Paris,75056,0.6666666666666666,15
9008,Tour d'Auvergne - Rodier,OUI,16,14,2,0,2,OUI,OUI,2025-03-13 14:55:13+00:00,"48.879161, 2.343698",Paris,75056,0.125,15
13030,Italie - Tolbiac,OUI,21,19,2,0,2,OUI,OUI,2025-03-13 14:54:59+00:00,"48.82557229464416, 2.3576171323657036",Paris,75056,0.09523809523809523,15
8103,Artois - Berri,OUI,22,3,19,12,7,OUI,OUI,2025-03-13 15:01:39+00:00,"48.87393521240818, 2.3064258322119713",Paris,75056,0.8636363636363636,15
9002,Abbeville - Faubourg Poissonnière,OUI,14,12,2,2,0,OUI,OUI,2025-03-13 15:01:36+00:00,"48.879223, 2.349147",Paris,75056,0.14285714285714285,15
8048,Marceau - Chaillot,OUI,21,7,14,2,12,OUI,OUI,2025-03-13 14:55:56+00:00,"48.868834023334, 2.2986030816809",Paris,75056,0.6666666666666666,15
48003,Youri Gagarine - Karl Marx,OUI,22,19,3,1,2,OUI,OUI,2025-03-13 14:58:02+00:00,"48.78448485079149, 2.35908430069685",Villejuif,94076,0.13636363636363635,15
14013,Liard - Amiral Mouchez,OUI,26,26,0,0,0,OUI,OUI,2025-03-13 15:01:33+00:00,"48.8214169, 2.342167",Paris,75056,0.0,15
16110,Octave Feuillet - Albéric Magnard,OUI,21,9,12,0,12,OUI,OUI,2025-03-13 14:59:35+00:00,"48.86106902949534, 2.2730283066630363",Paris,75056,0.5714285714285714,15
13118,Regnault - Patay,OUI,63,12,51,46,5,OUI,OUI,2025-03-13 15:02:03+00:00,"48.82435782216384, 2.377065159380436",Paris,75056,0.8095238095238095,15
43009,Place Jean-Spire-Lemaître,OUI,47,47,0,0,0,OUI,OUI,2025-03-13 14:55:29+00:00,"48.8468428626593, 2.452062070369721",Vincennes,94080,0.0,15
15112,Vigée-Lebrun - Anselme Payen,OUI,23,23,0,0,0,OUI,OUI,2025-03-13 14:52:53+00:00,"48.838683941628375, 2.3110422492027287",Paris,75056,0.0,15
9001,Bellefond - Poissonnière,OUI,15,9,6,3,3,OUI,OUI,2025-03-13 15:02:01+00:00,"48.87759897050706, 2.348463758826256",Paris,75056,0.4,15
18111,Félix Ziem - Armand Gauthier,OUI,23,23,0,0,0,OUI,OUI,2025-03-13 15:00:17+00:00,"48.88949630486821, 2.333393658804396",Paris,75056,0.0,15
17032,Jean Oestreicher - Porte de Champerret,OUI,21,0,21,10,11,OUI,OUI,2025-03-13 15:01:21+00:00,"48.88655580065981, 2.288640439510346",Paris,75056,1.0,15
8016,Square Louis XVI,OUI,29,5,24,16,8,OUI,OUI,2025-03-13 15:01:56+00:00,"48.87320440102894, 2.323658830743138",Paris,75056,0.8275862068965517,15
10115,Granges aux Belles,OUI,27,25,2,1,1,OUI,OUI,2025-03-13 14:58:07+00:00,"48.8761373390584, 2.3680844979417",Paris,75056,0.07407407407407407,15
10029,Dunkerque - Rocroy,OUI,24,24,0,0,0,OUI,OUI,2025-03-13 15:00:02+00:00,"48.880726, 2.351464",Paris,75056,0.0,15
12031,Gabriel Lamé,OUI,34,29,5,4,1,OUI,OUI,2025-03-13 15:01:21+00:00,"48.8351212784276, 2.385534569621086",Paris,75056,0.14705882352941177,15
10161,Gare de l'Est - Faubourg-Saint-Martin,OUI,32,25,7,3,4,OUI,OUI,2025-03-13 15:01:32+00:00,"48.875642647477, 2.3594588041306",Paris,75056,0.21875,15
5022,Boulangers - Cardinal Lemoine,OUI,18,8,10,6,4,OUI,OUI,2025-03-13 14:59:42+00:00,"48.8462904, 2.3521495",Paris,75056,0.5555555555555556,15
41303,Gare de Nogent-le-Perreux,OUI,31,18,13,10,3,OUI,OUI,2025-03-13 14:56:24+00:00,"48.83842553348809, 2.493693307042122",Nogent-sur-Marne,94052,0.41935483870967744,15
17040,Pereire - Ternes,OUI,48,37,11,5,6,OUI,OUI,2025-03-13 15:01:11+00:00,"48.87973954830735, 2.288012132048607",Paris,75056,0.22916666666666666,15
1001,Quai de l'Horloge - Pont Neuf,OUI,16,3,13,8,5,OUI,OUI,2025-03-13 14:58:07+00:00,"48.857058739111, 2.3417982839439",Paris,75056,0.8125,15
9038,Douai - Bruxelles,OUI,26,23,3,0,3,OUI,OUI,2025-03-13 14:59:47+00:00,"48.88320784122797, 2.3308449949028507",Paris,75056,0.11538461538461539,15
21328,Verger - Colonel Guichard,OUI,29,25,4,0,4,OUI,OUI,2025-03-13 14:57:33+00:00,"48.816376985087, 2.2670380088932",Issy-les-Moulineaux,92040,0.13793103448275862,15
17008,Porte Pouchet-Bessières,OUI,23,12,11,7,4,OUI,OUI,2025-03-13 15:00:01+00:00,"48.8978765, 2.3230632",Paris,75056,0.4782608695652174,15
13104,Gare d'Austerlitz - Quai Saint-Bernard,OUI,26,2,24,15,9,OUI,OUI,2025-03-13 14:55:36+00:00,"48.84369030864, 2.3657163977623",Paris,75056,0.9230769230769231,15
18203,Lamarck - Saint-Ouen,OUI,40,40,0,0,0,NON,NON,2025-03-13 14:59:26+00:00,"48.891334555236, 2.3272445342326",Paris,75056,0.0,15
8009,Gare Saint-Lazare - Isly,OUI,24,18,6,3,3,OUI,OUI,2025-03-13 15:01:16+00:00,"48.874777677621296, 2.326515804784655",Paris,75056,0.25,15
5005,Gay Lussac - Saint-Jacques,OUI,24,8,16,5,11,OUI,OUI,2025-03-13 14:57:34+00:00,"48.844730256132, 2.3419239448664",Paris,75056,0.6666666666666666,15
31103,Gare Rosny-Bois-Perrier,OUI,32,12,20,0,20,OUI,OUI,2025-03-13 15:00:35+00:00,"48.88115023337061, 2.480436824262142",Rosny-sous-Bois,93064,0.625,15
21323,Charlot - Stade Gabriel Voisin,OUI,31,0,31,27,4,OUI,OUI,2025-03-13 15:02:08+00:00,"48.827228120536, 2.268122527474",Issy-les-Moulineaux,92040,1.0,15
7018,Ségur - d'Estrées,OUI,19,6,13,5,8,OUI,OUI,2025-03-13 15:01:37+00:00,"48.851419978983, 2.3097044974566",Paris,75056,0.6842105263157895,15
8053,Place Georges Guillaumin,OUI,27,15,12,6,6,OUI,OUI,2025-03-13 14:57:04+00:00,"48.874750203957, 2.301771435326",Paris,75056,0.4444444444444444,15
9014,Faubourg Montmartre - La Fayette,OUI,33,8,25,18,7,OUI,OUI,2025-03-13 15:00:14+00:00,"48.875254549053, 2.3408536612988",Paris,75056,0.7575757575757576,15
19105,Ambroise Rendu - Porte Brunet,OUI,17,13,4,1,3,OUI,OUI,2025-03-13 15:01:25+00:00,"48.883667, 2.395733",Paris,75056,0.23529411764705882,15
9106,Boudreau - Auber,OUI,27,8,19,7,12,OUI,OUI,2025-03-13 15:00:15+00:00,"48.87219, 2.329423",Paris,75056,0.7037037037037037,15
22409,Henri Barbusse - Stalingrad,OUI,16,11,5,1,4,OUI,OUI,2025-03-13 14:55:20+00:00,"48.814183748660554, 2.2872862592339516",Malakoff,92046,0.3125,15
31706,Château - République,OUI,24,20,4,0,4,OUI,OUI,2025-03-13 14:58:56+00:00,"48.862923800596, 2.4155035614967",Bagnolet,93006,0.16666666666666666,15
19015,Thionville - Ourcq,OUI,23,19,4,2,2,OUI,OUI,2025-03-13 15:01:15+00:00,"48.88917613743794, 2.3833653330802917",Paris,75056,0.17391304347826086,15
17004,Legendre - Clichy,OUI,38,31,7,2,5,OUI,OUI,2025-03-13 14:59:33+00:00,"48.88896161855884, 2.322528975094376",Paris,75056,0.18421052631578946,15
9022,Rossini - Laffitte,OUI,33,2,31,18,13,OUI,OUI,2025-03-13 15:01:10+00:00,"48.87334627510507, 2.337980867701675",Paris,75056,0.9393939393939394,15
12151,Gare de Lyon - Place Louis Armand,OUI,58,5,53,41,12,OUI,OUI,2025-03-13 15:00:51+00:00,"48.845515089794, 2.3726498446286",Paris,75056,0.9137931034482759,15
26003,Argenteuil - Voltaire,OUI,16,7,9,3,6,OUI,OUI,2025-03-13 14:59:38+00:00,"48.91864865955558, 2.2814112156629562",Asnières-sur-Seine,92004,0.5625,15
92007,Pesaro - Préfecture,OUI,21,14,7,2,5,OUI,OUI,2025-03-13 14:54:16+00:00,"48.89577046284005, 2.223908342421055",Nanterre,92050,0.3333333333333333,15
19003,Quai de la Seine,OUI,24,21,3,0,3,OUI,OUI,2025-03-13 15:01:08+00:00,"48.884492238407525, 2.3703941702842717",Paris,75056,0.125,15
9028,Moncey - Blanche,OUI,17,12,5,1,4,OUI,OUI,2025-03-13 15:02:00+00:00,"48.88006587474148, 2.3310810327529907",Paris,75056,0.29411764705882354,15
5020,Institut du Monde Arabe - Saint-Germain,OUI,37,3,34,30,4,OUI,OUI,2025-03-13 15:01:49+00:00,"48.849063299501, 2.3558086529374",Paris,75056,0.918918918918919,15
10107,Gare du Nord - Hôpital Lariboisière,OUI,49,48,1,0,1,OUI,OUI,2025-03-13 15:00:55+00:00,"48.881949, 2.352339",Paris,75056,0.02040816326530612,15
16026,Ranelagh - Mozart,OUI,7,5,2,1,1,OUI,OUI,2025-03-13 15:02:03+00:00,"48.8554439, 2.2704418",Paris,75056,0.2857142857142857,15
17043,Belidor - Gouvion-Saint-Cyr,OUI,38,26,12,11,1,OUI,OUI,2025-03-13 14:57:46+00:00,"48.88022154052015, 2.2854680567979813",Paris,75056,0.3157894736842105,15
26002,Redoute - Les Courtilles,OUI,37,15,22,17,5,OUI,OUI,2025-03-13 15:02:00+00:00,"48.929867194519, 2.2836696356535",Asnières-sur-Seine,92004,0.5945945945945946,15
16039,Exelmans - Versailles,OUI,48,18,30,26,4,OUI,OUI,2025-03-13 15:01:18+00:00,"48.84097491091973, 2.264390252530575",Paris,75056,0.625,15
19026,Place de Rhin et Danube,OUI,14,13,1,0,1,OUI,OUI,2025-03-13 14:57:31+00:00,"48.88192765861766, 2.392586767673493",Paris,75056,0.07142857142857142,15
11023,Saint-Maur - Roquette,OUI,46,37,9,5,4,OUI,OUI,2025-03-13 14:55:18+00:00,"48.858688774062955, 2.383553994571467",Paris,75056,0.1956521739130435,15
45003,11 Novembre 1918 - 8 Mai 1945,OUI,36,13,23,14,9,OUI,OUI,2025-03-13 14:57:39+00:00,"48.80889533774377, 2.5382421165704727",Champigny-sur-Marne,94017,0.6388888888888888,15
11047,Amelot - Saint-Sébastien,OUI,29,5,24,15,9,OUI,OUI,2025-03-13 15:02:04+00:00,"48.861142162761, 2.3677996181077",Paris,75056,0.8275862068965517,15
11002,Roquette - Thiéré,OUI,21,0,21,16,5,OUI,OUI,2025-03-13 14:58:15+00:00,"48.85507930579506, 2.3733686318721463",Paris,75056,1.0,15
19043,Delphine Seyrig - Général Leclerc,OUI,52,49,3,1,2,OUI,OUI,2025-03-13 15:01:17+00:00,"48.893923963057865, 2.39790290594101",Pantin,93055,0.057692307692307696,15
12111,Claude Decaen - Cannebière,OUI,27,25,2,1,1,OUI,OUI,2025-03-13 14:54:40+00:00,"48.83761417037952, 2.397253782195704",Paris,75056,0.07407407407407407,15
18107,Chartres - La Charbonnière,OUI,34,33,1,0,1,OUI,OUI,2025-03-13 14:59:54+00:00,"48.8847601, 2.3534657",Paris,75056,0.029411764705882353,15
8034,Berri - Haussmann,OUI,34,4,30,15,15,OUI,OUI,2025-03-13 15:00:41+00:00,"48.874746047357135, 2.3082953318953514",Paris,75056,0.8823529411764706,15
12128,Pyramide - Ecole du Breuil,OUI,33,33,0,0,0,OUI,OUI,2025-03-13 14:54:57+00:00,"48.82237977153955, 2.4586871266365056",Paris,75056,0.0,15
5032,Panthéon - Valette,OUI,39,19,20,1,19,OUI,OUI,2025-03-13 15:01:24+00:00,"48.847020571652, 2.3464982619671",Paris,75056,0.5128205128205128,15
31022,Mairie de Montreuil,OUI,51,48,3,3,0,OUI,OUI,2025-03-13 15:00:53+00:00,"48.86131452758348, 2.440614402294159",Montreuil,93048,0.058823529411764705,15
20042,Pyrénées - Emmery,OUI,39,37,2,0,2,OUI,OUI,2025-03-13 14:58:34+00:00,"48.872010281270974, 2.392039597034455",Paris,75056,0.05128205128205128,15
46002,Rouget de Lisle,OUI,35,6,29,16,13,OUI,OUI,2025-03-13 14:57:49+00:00,"48.764615483395254, 2.4071189761161804",Choisy-le-Roi,94022,0.8285714285714286,15
15067,Desaix - Edgar Faure,OUI,11,4,7,5,2,OUI,OUI,2025-03-13 14:55:40+00:00,"48.852804604940296, 2.293077029857222",Paris,75056,0.6363636363636364,15
41302,Charles de Gaulle - Beauté,OUI,48,47,1,0,1,OUI,OUI,2025-03-13 14:54:37+00:00,"48.83649602312711, 2.479562651149885",Nogent-sur-Marne,94052,0.020833333333333332,15
17030,Pereire - Rennequin,OUI,22,15,7,4,3,OUI,OUI,2025-03-13 15:00:16+00:00,"48.88364782887555, 2.2952447086572647",Paris,75056,0.3181818181818182,15
33017,Anatole France - President Roosevelt,OUI,25,19,6,3,3,OUI,OUI,2025-03-13 15:00:42+00:00,"48.9155156, 2.3814103",Aubervilliers,93001,0.24,15
6006,Notre-Dame-des-Champs - Stanislas,OUI,19,6,13,9,4,OUI,OUI,2025-03-13 15:01:39+00:00,"48.84479928858768, 2.329337755887181",Paris,75056,0.6842105263157895,15
33102,Gabriel Péri - Francisco Ferrer,OUI,18,13,5,0,5,OUI,OUI,2025-03-13 14:56:27+00:00,"48.88633710236977, 2.407338917255402",Le Pré-Saint-Gervais,93061,0.2777777777777778,15
11027,Saint-Ambroise - Parmentier,OUI,35,29,6,6,0,OUI,OUI,2025-03-13 14:59:37+00:00,"48.862147844548, 2.3772348091006",Paris,75056,0.17142857142857143,15
19120,Carducci - Place Hannah Arendt,OUI,27,24,3,0,3,OUI,OUI,2025-03-13 15:00:01+00:00,"48.877436681515796, 2.3860743641853337",Paris,75056,0.1111111111111111,15
8010,Liège - Moscou,OUI,15,13,2,2,0,OUI,OUI,2025-03-13 15:01:07+00:00,"48.8795431, 2.3264628",Paris,75056,0.13333333333333333,15
18003,Cimetière de Montmartre,OUI,43,43,0,0,0,OUI,OUI,2025-03-13 14:56:16+00:00,"48.886472466142, 2.3328901827335",Paris,75056,0.0,15
10016,Récollets - Square Villemin,OUI,16,14,2,1,1,OUI,OUI,2025-03-13 15:00:21+00:00,"48.875034655883944, 2.359801238597928",Paris,75056,0.125,15
14003,Schoelcher - Raspail,OUI,47,42,5,2,3,OUI,OUI,2025-03-13 15:01:03+00:00,"48.83681733526843, 2.3312794080411474",Paris,75056,0.10638297872340426,15
31009,Place Du Général De Gaulle,OUI,25,22,3,0,3,OUI,OUI,2025-03-13 15:00:48+00:00,"48.8687591, 2.4329931",Montreuil,93048,0.12,15
5018,Mutualité,OUI,37,1,36,28,8,OUI,OUI,2025-03-13 15:01:47+00:00,"48.848225572724, 2.3502873256803",Paris,75056,0.972972972972973,15
14020,Cimetière de Montrouge,OUI,58,57,1,0,1,OUI,OUI,2025-03-13 14:57:48+00:00,"48.821466904768, 2.3215785772007",Paris,75056,0.017241379310344827,15
19103,Manin - Carrières d'Amérique,OUI,17,15,2,0,2,OUI,OUI,2025-03-13 15:00:07+00:00,"48.88467214209463, 2.3919698596000676",Paris,75056,0.11764705882352941,15
15042,Henry Farman,OUI,16,3,13,10,3,OUI,OUI,2025-03-13 14:56:32+00:00,"48.83372430280548, 2.2713854536414146",Paris,75056,0.8125,15
12114,Victor Hugo - Jeanne Jugan,OUI,28,27,1,0,1,OUI,OUI,2025-03-13 14:56:41+00:00,"48.843949064031825, 2.415081394834419",Paris,75056,0.03571428571428571,15
18011,Pajol - Place Herbert,OUI,39,36,3,1,2,OUI,OUI,2025-03-13 15:00:32+00:00,"48.8927825, 2.3635598",Paris,75056,0.07692307692307693,15
46003,Conservatoire de Musique,OUI,24,2,22,19,3,OUI,OUI,2025-03-13 15:02:08+00:00,"48.77093586667601, 2.4034014344215398",Choisy-le-Roi,94022,0.9166666666666666,15
42706,Roger Salengro - Fontainebleau,OUI,25,19,6,5,1,OUI,OUI,2025-03-13 15:00:48+00:00,"48.814548697325, 2.3611663654447",Le Kremlin-Bicêtre,94043,0.24,15
41209,Cimetière de Fontenay-sous-Bois,OUI,15,13,2,0,2,OUI,OUI,2025-03-13 15:00:56+00:00,"48.84706173362218, 2.4787822365760808",Fontenay-sous-Bois,94033,0.13333333333333333,15
21212,Marne - Germain Dardan,OUI,21,19,2,1,1,OUI,OUI,2025-03-13 14:55:27+00:00,"48.81217465201, 2.3035024699104",Montrouge,92049,0.09523809523809523,15
21312,Lucie Aubrac - Fort,OUI,30,27,3,0,3,OUI,OUI,2025-03-13 14:56:49+00:00,"48.818144834008976, 2.271184623241425",Issy-les-Moulineaux,92040,0.1,15
44006,Concorde - Stalingrad,OUI,35,27,8,2,6,OUI,OUI,2025-03-13 14:59:22+00:00,"48.7985844, 2.3821302",Vitry-sur-Seine,94081,0.22857142857142856,15
13001,Port-Royal - Hôpital du Val-de-Grâce,OUI,17,10,7,4,3,OUI,OUI,2025-03-13 15:01:49+00:00,"48.837668272811, 2.3448138346607",Paris,75056,0.4117647058823529,15
11113,Richard Lenoir - Republique,OUI,57,28,29,28,1,OUI,OUI,2025-03-13 15:01:42+00:00,"48.8667175, 2.3692541",Paris,75056,0.5087719298245614,15
8017,Rocher - Laborde,OUI,64,51,13,10,3,OUI,OUI,2025-03-13 15:01:31+00:00,"48.87590240712654, 2.322616316378116",Paris,75056,0.203125,15
15104,Hôpital Européen Georges Pompidou,OUI,64,12,52,50,2,OUI,OUI,2025-03-13 14:46:22+00:00,"48.837695319163, 2.2753742337227",Paris,75056,0.8125,15
15054,Lecourbe - Jean Maridor,OUI,18,8,10,8,2,OUI,OUI,2025-03-13 14:57:39+00:00,"48.83796366147599, 2.2877392172813416",Paris,75056,0.5555555555555556,15
43008,Fontenay - Libération,OUI,25,23,2,1,1,OUI,OUI,2025-03-13 15:01:53+00:00,"48.847803063647, 2.4451419711113",Vincennes,94080,0.08,15
5124,Erasme - Ulm,OUI,22,11,11,0,11,OUI,OUI,2025-03-13 14:59:51+00:00,"48.84264375274712, 2.3445946723222733",Paris,75056,0.5,15
19101,Square Simon Bolivar,OUI,23,19,4,1,3,OUI,OUI,2025-03-13 14:58:46+00:00,"48.875089888322, 2.3826304078102",Paris,75056,0.17391304347826086,15
14106,Marc Sangnier - Porte de Vanves,OUI,20,17,3,0,3,OUI,OUI,2025-03-13 14:57:31+00:00,"48.825218683556734, 2.3107116669416428",Paris,75056,0.15,15
14138,Porte de Vanves,OUI,30,28,2,1,1,OUI,OUI,2025-03-13 14:57:13+00:00,"48.828012849445, 2.3056878894567",Paris,75056,0.06666666666666667,15
18022,Marcadet - Barbès,OUI,34,33,1,0,1,OUI,OUI,2025-03-13 15:02:06+00:00,"48.890451120965, 2.3490573929687",Paris,75056,0.029411764705882353,15
14008,Mouton Duvernet - Général Leclerc,OUI,26,21,5,0,5,OUI,OUI,2025-03-13 14:57:24+00:00,"48.831632518293, 2.3293121159077",Paris,75056,0.19230769230769232,15
8054,Bertie Albrecht - Hoche,OUI,32,18,14,7,7,OUI,OUI,2025-03-13 15:00:35+00:00,"48.87614039826388, 2.301303138307601",Paris,75056,0.4375,15
18028,Championnet - Vauvenargues,OUI,31,26,5,0,5,OUI,OUI,2025-03-13 15:01:59+00:00,"48.89401874744574, 2.3319872841238976",Paris,75056,0.16129032258064516,15
14012,Sibelle - Alésia,OUI,37,37,0,0,0,OUI,OUI,2025-03-13 14:55:20+00:00,"48.826701758539215, 2.3384983465075493",Paris,75056,0.0,15
15106,Grenelle - Violet,OUI,34,11,23,18,5,OUI,OUI,2025-03-13 15:02:04+00:00,"48.84993035512154, 2.294612042605877",Paris,75056,0.6764705882352942,15
21005,Hôtel de Ville de Boulogne Billancourt,OUI,26,3,23,11,12,OUI,OUI,2025-03-13 15:01:09+00:00,"48.83495885166784, 2.2416803240776066",Boulogne-Billancourt,92012,0.8846153846153846,15
18046,Etienne Jodelle - Saint Ouen,OUI,32,32,0,0,0,OUI,OUI,2025-03-13 14:58:04+00:00,"48.88794016394694, 2.326124420314341",Paris,75056,0.0,15
10042,Enghien - Faubourg Poissonnière,OUI,31,19,12,9,3,OUI,OUI,2025-03-13 15:01:11+00:00,"48.872420063053, 2.3483952362828",Paris,75056,0.3870967741935484,15
22406,Guy Môquet - Etienne Dolet,OUI,22,20,2,1,1,OUI,OUI,2025-03-13 15:00:25+00:00,"48.81527009991819, 2.298078276995073",Malakoff,92046,0.09090909090909091,15
17203,Place de la Porte de Champeret,OUI,28,11,17,14,3,OUI,OUI,2025-03-13 15:00:44+00:00,"48.886062068226, 2.2917001576821",Paris,75056,0.6071428571428571,15
31102,Boissière - Etienne Dolet,OUI,20,18,2,1,1,OUI,OUI,2025-03-13 14:59:01+00:00,"48.876111, 2.4677312",Montreuil,93048,0.1,15
8045,Place de la Reine Astrid,OUI,57,16,41,27,14,OUI,OUI,2025-03-13 15:02:05+00:00,"48.864920982538, 2.3025491823859",Paris,75056,0.7192982456140351,15
2111,Chabanais - Petits Champs,OUI,30,2,28,20,8,OUI,OUI,2025-03-13 14:58:55+00:00,"48.86703740186721, 2.336716018617153",Paris,75056,0.9333333333333333,15
14124,David Weill - Parc Montsouris,OUI,22,16,6,0,6,OUI,OUI,2025-03-13 14:59:17+00:00,"48.821092374256104, 2.333725690841675",Paris,75056,0.2727272727272727,15
15109,Cevennes - Bergers,OUI,28,18,10,5,5,OUI,OUI,2025-03-13 15:01:19+00:00,"48.84240765130395, 2.281037718057633",Paris,75056,0.35714285714285715,15
15133,Saint Lambert - Blomet,OUI,26,24,2,0,2,OUI,OUI,2025-03-13 15:01:13+00:00,"48.83659148147257, 2.2930556908249855",Paris,75056,0.07692307692307693,15
21209,Molière - République,OUI,30,27,3,0,3,OUI,OUI,2025-03-13 14:56:33+00:00,"48.81111581390707, 2.3145738624448158",Montrouge,92049,0.1,15
15110,Place Robert Guillemard,OUI,22,1,21,17,4,OUI,OUI,2025-03-13 15:01:23+00:00,"48.836191728066666, 2.2811267160086417",Paris,75056,0.9545454545454546,15
35010,Hoche - Jean Lolive,OUI,20,16,4,0,4,OUI,OUI,2025-03-13 15:02:01+00:00,"48.89110239200789, 2.402843534946442",Pantin,93055,0.2,15
21006,Marcelin Berthelot,OUI,27,21,6,3,3,OUI,OUI,2025-03-13 14:55:33+00:00,"48.8415473058801, 2.233161628246308",Boulogne-Billancourt,92012,0.2222222222222222,15
42014,Place Marcel Cachin,OUI,32,9,23,22,1,OUI,OUI,2025-03-13 14:59:27+00:00,"48.81411442356866, 2.39090770483017",Ivry-sur-Seine,94041,0.71875,15
4016,Lobau - Hôtel de Ville,OUI,59,1,58,47,11,OUI,OUI,2025-03-13 15:01:42+00:00,"48.8562118, 2.3532536",Paris,75056,0.9830508474576272,15
21015,Nationale - Place Jules Guesde,OUI,23,8,15,11,4,OUI,OUI,2025-03-13 15:00:10+00:00,"48.82753962462998, 2.2416052222251897",Boulogne-Billancourt,92012,0.6521739130434783,15
44013,Edouard Tremblay - Julian Grimaux,OUI,30,30,0,0,0,OUI,OUI,2025-03-13 14:56:25+00:00,"48.781383825117, 2.3723508417606",Vitry-sur-Seine,94081,0.0,15
41202,Gare Rer de Fontenay sous Bois,OUI,60,56,4,2,2,OUI,OUI,2025-03-13 14:55:38+00:00,"48.8436279, 2.4630465",Fontenay-sous-Bois,94033,0.06666666666666667,15
20131,Repos - Cimetière du Père Lachaise,OUI,33,32,1,1,0,OUI,OUI,2025-03-13 14:56:14+00:00,"48.859358523593, 2.3896131366845",Paris,75056,0.030303030303030304,15
42021,Raspail - Manufacture des Oeillets,OUI,31,8,23,21,2,OUI,OUI,2025-03-13 15:00:09+00:00,"48.8094458, 2.3903009",Ivry-sur-Seine,94041,0.7419354838709677,15
6025,Assas - Rennes,OUI,31,11,20,12,8,OUI,OUI,2025-03-13 15:01:07+00:00,"48.8492084999386, 2.32851454623001",Paris,75056,0.6451612903225806,15
35020,Marcelle - Thalie,OUI,20,20,0,0,0,OUI,OUI,2025-03-13 15:01:26+00:00,"48.8835462, 2.4137883",Pantin,93055,0.0,15
44003,Gabriel Péri - Danielle Casanova,OUI,20,8,12,8,4,OUI,OUI,2025-03-13 15:00:47+00:00,"48.790114, 2.4025777",Vitry-sur-Seine,94081,0.6,15
25003,Henri Ste-Claire Déville - Paul Héroult,OUI,21,7,14,6,8,OUI,OUI,2025-03-13 15:02:04+00:00,"48.892663, 2.172411",Rueil-Malmaison,92063,0.6666666666666666,15
15034,Lakanal - Commerce,OUI,48,14,34,30,4,OUI,OUI,2025-03-13 15:00:58+00:00,"48.84442462786544, 2.294059172272682",Paris,75056,0.7083333333333334,15
20115,Louis Lumière - Porte de Bagnolet,OUI,20,19,1,1,0,OUI,OUI,2025-03-13 14:58:21+00:00,"48.86431136000005, 2.4105210229754443",Paris,75056,0.05,15
5028,Censier - Jardin des Plantes,OUI,28,6,22,19,3,OUI,OUI,2025-03-13 15:00:46+00:00,"48.84107178161383, 2.355475388467312",Paris,75056,0.7857142857142857,15
22402,Jean Jaurès - Salvador Allende,OUI,42,39,3,0,3,OUI,OUI,2025-03-13 14:52:18+00:00,"48.821475594736775, 2.3026576638221745",Malakoff,92046,0.07142857142857142,15
48010,Karl Marx,OUI,16,6,10,1,9,OUI,OUI,2025-03-13 14:55:57+00:00,"48.784527937293184, 2.3646667979455587",Villejuif,94076,0.625,15
11039,Richard Lenoir - Jean-Pierre Timbaud,OUI,35,19,16,15,1,OUI,OUI,2025-03-13 15:01:43+00:00,"48.865804276686, 2.3693370749669",Paris,75056,0.45714285714285713,15
22203,Tertres - Fontaine,OUI,27,25,2,0,2,OUI,OUI,2025-03-13 14:59:47+00:00,"48.787553654715644, 2.306235730648041",Bagneux,92007,0.07407407407407407,15
17013,Legendre - Dulong,OUI,23,20,3,0,3,OUI,OUI,2025-03-13 14:58:47+00:00,"48.885325169402904, 2.316423766314984",Paris,75056,0.13043478260869565,15
1119,Cossonnerie - Sébastopol,OUI,23,8,15,12,3,OUI,OUI,2025-03-13 14:59:26+00:00,"48.86132665908402, 2.349419631063938",Paris,75056,0.6521739130434783,15
11026,Chemin Vert - Saint-Maur,OUI,44,35,9,0,9,OUI,OUI,2025-03-13 15:02:03+00:00,"48.86112461407359, 2.381299026310444",Paris,75056,0.20454545454545456,15
1020,Cambon - Rivoli,OUI,34,5,29,16,13,OUI,OUI,2025-03-13 15:01:05+00:00,"48.866143390992, 2.3251800647137",Paris,75056,0.8529411764705882,15
19024,Botzaris - Parc des Buttes Chaumont,OUI,20,18,2,0,2,OUI,OUI,2025-03-13 14:55:46+00:00,"48.877951, 2.381464",Paris,75056,0.1,15
31003,Paris - Emile Zola,OUI,29,27,2,1,1,OUI,OUI,2025-03-13 14:53:48+00:00,"48.854898095789295, 2.4186685681343083",Montreuil,93048,0.06896551724137931,15
23006,Jules Guesde - Alsace,OUI,24,4,20,12,8,OUI,OUI,2025-03-13 14:59:17+00:00,"48.890566275506, 2.2950777411461",Levallois-Perret,92044,0.8333333333333334,15
9116,Victoire - Chaussée d'Antin,OUI,24,6,18,8,10,OUI,OUI,2025-03-13 15:01:02+00:00,"48.875065791004396, 2.3316738009452824",Paris,75056,0.75,15
15021,Joseph Liouville - Croix Nivert,OUI,62,38,24,24,0,OUI,OUI,2025-03-13 14:55:42+00:00,"48.844835471244416, 2.297508493065834",Paris,75056,0.3870967741935484,15
11030,Oberkampf - République,OUI,20,16,4,2,2,OUI,OUI,2025-03-13 14:59:24+00:00,"48.86531608707, 2.37611478491",Paris,75056,0.2,15
9010,Rochechouart lamartine,OUI,24,15,9,0,9,OUI,OUI,2025-03-13 15:00:53+00:00,"48.876719895109, 2.344393021854",Paris,75056,0.375,15
32604,Square du Théâtre du Garde-Chasse,OUI,50,49,1,0,1,OUI,OUI,2025-03-13 14:54:37+00:00,"48.881287375060616, 2.420119643211365",Les Lilas,93045,0.02,15
18009,Jean-François Lépine - Stephenson,OUI,20,19,1,0,1,OUI,OUI,2025-03-13 14:55:57+00:00,"48.88611466796807, 2.356855627529275",Paris,75056,0.05,15
41601,Général De Gaulle - Alouette,OUI,25,21,4,1,3,OUI,OUI,2025-03-13 14:58:58+00:00,"48.839109, 2.4175664",Saint-Mandé,94067,0.16,15
16108,Sablons - Georges Mandel,OUI,38,36,2,1,1,OUI,OUI,2025-03-13 15:01:38+00:00,"48.863875, 2.28189",Paris,75056,0.05263157894736842,15
17105,Place Madeleine Daniélou,OUI,42,27,15,15,0,OUI,OUI,2025-03-13 15:02:07+00:00,"48.883498, 2.282015",Paris,75056,0.35714285714285715,15
43005,Gare RER de Vincennes,OUI,47,33,14,11,3,OUI,OUI,2025-03-13 15:01:53+00:00,"48.847563015126106, 2.433383166790009",Vincennes,94080,0.2978723404255319,15
11105,Parmentier - République,OUI,22,18,4,2,2,OUI,OUI,2025-03-13 15:02:01+00:00,"48.8644954, 2.3750124",Paris,75056,0.18181818181818182,15
19022,Marché Secrétan,OUI,25,22,3,2,1,OUI,OUI,2025-03-13 14:59:33+00:00,"48.88125496379482, 2.373463287949562",Paris,75056,0.12,15
17125,Marie-Georges Picquart - Pereire,OUI,31,27,4,2,2,OUI,OUI,2025-03-13 15:01:04+00:00,"48.88863669349711, 2.3111706599593163",Paris,75056,0.12903225806451613,15
21701,Larmeroux - Baudelaire,OUI,28,23,5,2,3,OUI,OUI,2025-03-13 14:59:29+00:00,"48.816939911292, 2.2809894804846",Vanves,92075,0.17857142857142858,15
16136,Théophile Gautier - François Millet,OUI,27,2,25,19,6,OUI,OUI,2025-03-13 15:01:51+00:00,"48.85034821320644, 2.273029983043671",Paris,75056,0.9259259259259259,15
16008,Galilée - Kléber,OUI,30,15,15,1,14,OUI,OUI,2025-03-13 15:02:07+00:00,"48.867411865714, 2.2907813801148",Paris,75056,0.5,15
19032,Villette - Belleville,OUI,39,29,10,4,6,OUI,OUI,2025-03-13 15:01:27+00:00,"48.8726877314, 2.376461327076",Paris,75056,0.2564102564102564,15
13050,Quai Panhard et Levassor,OUI,57,6,51,33,18,OUI,OUI,2025-03-13 15:00:31+00:00,"48.828374828097, 2.3842737458056",Paris,75056,0.8947368421052632,15
22003,Beffroy,OUI,26,5,21,6,15,OUI,OUI,2025-03-13 15:01:00+00:00,"48.886591074488, 2.2613945603371",Neuilly-sur-Seine,92051,0.8076923076923077,15
11024,Mairie du 11ème,OUI,50,44,6,1,5,OUI,OUI,2025-03-13 15:01:57+00:00,"48.858925, 2.3789759",Paris,75056,0.12,15
21008,Victor Hugo - Galliéni,OUI,33,17,16,16,0,OUI,OUI,2025-03-13 15:00:37+00:00,"48.838020154411, 2.2460845112801",Boulogne-Billancourt,92012,0.48484848484848486,15
20134,Lieutenant Chauré - Etienne Marey,OUI,19,19,0,0,0,OUI,OUI,2025-03-13 14:58:57+00:00,"48.86746195408435, 2.405970990657807",Paris,75056,0.0,15
24001,Arche - Léonard de Vinci,OUI,27,21,6,4,2,OUI,OUI,2025-03-13 14:55:43+00:00,"48.89790972494496, 2.2383723043644914",Courbevoie,92026,0.2222222222222222,15
22016,Charles de Gaulle - Sablonville,OUI,26,16,10,5,5,OUI,OUI,2025-03-13 14:59:48+00:00,"48.87991924860035, 2.2763770446181297",Neuilly-sur-Seine,92051,0.38461538461538464,15
11035,Parmentier - Abel Rabaud,OUI,49,40,9,5,4,OUI,OUI,2025-03-13 15:01:39+00:00,"48.86921273836114, 2.371688821240712",Paris,75056,0.1836734693877551,15
14136,Auguste Cain - Jean Moulin,OUI,40,40,0,0,0,OUI,OUI,2025-03-13 15:00:02+00:00,"48.82577028927573, 2.3210415244102482",Paris,75056,0.0,15
15046,Parc Georges Brassens - Brancion,OUI,28,27,1,0,1,OUI,OUI,2025-03-13 14:56:15+00:00,"48.83227829269761, 2.3022570088505745",Paris,75056,0.03571428571428571,15
32302,Chemin Vert - Fraternité,OUI,20,18,2,0,2,OUI,OUI,2025-03-13 15:00:46+00:00,"48.877141208359035, 2.4461565166711807",Romainville,93063,0.1,15
46001,Place Paul Eluard,OUI,19,2,17,9,8,OUI,OUI,2025-03-13 14:59:46+00:00,"48.7672039733195, 2.4144977331161503",Choisy-le-Roi,94022,0.8947368421052632,15
10014,Marseille - Beaurepaire,OUI,46,3,43,37,6,OUI,OUI,2025-03-13 15:01:00+00:00,"48.871624306962985, 2.3639265082738348",Paris,75056,0.9347826086956522,15
16040,Exelmans - Michel-Ange,OUI,30,14,16,14,2,OUI,OUI,2025-03-13 14:58:38+00:00,"48.84309486651855, 2.2597770800669053",Paris,75056,0.5333333333333333,15
42010,Mairie d'Ivry-sur-Seine,OUI,51,24,27,24,3,OUI,OUI,2025-03-13 15:00:39+00:00,"48.81057120969284, 2.3842826485633855",Ivry-sur-Seine,94041,0.5294117647058824,15
21301,Saint-Vincent - Verdun,OUI,33,21,12,9,3,OUI,OUI,2025-03-13 15:01:51+00:00,"48.819211549234495, 2.254007756710053",Issy-les-Moulineaux,92040,0.36363636363636365,15
22006,Pierret - Madrid,OUI,27,8,19,16,3,OUI,OUI,2025-03-13 15:00:16+00:00,"48.882976576876565, 2.260125767248034",Neuilly-sur-Seine,92051,0.7037037037037037,15
19029,Seine - Flandre,OUI,19,17,2,0,2,OUI,OUI,2025-03-13 14:59:40+00:00,"48.886785741479684, 2.3746193200349808",Paris,75056,0.10526315789473684,15
17028,Reims - Raymond Pitet,OUI,36,16,20,17,3,OUI,OUI,2025-03-13 15:01:17+00:00,"48.8888, 2.296319",Paris,75056,0.5555555555555556,15
9032,Mathurins - Auber,OUI,35,7,28,24,4,OUI,OUI,2025-03-13 15:01:19+00:00,"48.872988840744, 2.3294984212276",Paris,75056,0.8,15
42302,Aristide Briand - Gare de Bagneux,OUI,20,18,2,0,2,OUI,OUI,2025-03-13 14:59:43+00:00,"48.79387269664978, 2.321148812770844",Cachan,94016,0.1,15
11042,Grand Prieuré - Crussol,OUI,46,22,24,23,1,OUI,OUI,2025-03-13 15:00:53+00:00,"48.864660627935, 2.3692265531829",Paris,75056,0.5217391304347826,15
19016,Hautpoul - Jean Jaurès,OUI,30,27,3,0,3,OUI,OUI,2025-03-13 15:01:01+00:00,"48.886393679436, 2.3865414544355",Paris,75056,0.1,15
32026,Leroy des Barres - Médiathèque,OUI,27,1,26,10,16,OUI,OUI,2025-03-13 15:01:40+00:00,"48.928253687082, 2.3681719727966",Saint-Denis,93066,0.9629629629629629,15
32003,Wilson - Métallurgie,OUI,28,10,18,10,8,OUI,OUI,2025-03-13 15:02:06+00:00,"48.909423010092326, 2.3584435880184174",Saint-Denis,93066,0.6428571428571429,15
9005,Square d'Anvers,OUI,32,30,2,0,2,OUI,OUI,2025-03-13 14:58:39+00:00,"48.882633484311, 2.3448844062122",Paris,75056,0.0625,15
21104,Madame de Sanzillon - Mozart,OUI,22,8,14,14,0,OUI,OUI,2025-03-13 15:01:41+00:00,"48.90379820774301, 2.3187401890754704",Clichy,92024,0.6363636363636364,15
1013,Place du Palais Royal,OUI,65,1,64,41,23,OUI,OUI,2025-03-13 15:01:47+00:00,"48.862382970647, 2.3384822532535",Paris,75056,0.9846153846153847,15
8025,Miromesnil - La Boétie,OUI,32,19,13,11,2,OUI,OUI,2025-03-13 15:01:57+00:00,"48.873722412917, 2.3158480972052",Paris,75056,0.40625,15
7102,Mairie du 7ème,OUI,48,5,43,29,14,OUI,OUI,2025-03-13 15:01:51+00:00,"48.8577967, 2.3192664",Paris,75056,0.8958333333333334,15
13002,Arago - Glacière,OUI,26,18,8,4,4,OUI,OUI,2025-03-13 15:01:49+00:00,"48.83486054775774, 2.3445770524322067",Paris,75056,0.3076923076923077,15
19013,Laumière - Petit,OUI,31,31,0,0,0,OUI,OUI,2025-03-13 14:56:10+00:00,"48.88467368538326, 2.380039058625698",Paris,75056,0.0,15
20121,Boyer - Ménilmontant,OUI,19,17,2,0,2,OUI,OUI,2025-03-13 14:59:53+00:00,"48.868895162679, 2.3919824145635",Paris,75056,0.10526315789473684,15
20111,Villiers de l'Isle Adam - Pyrénées,OUI,20,19,1,0,1,OUI,OUI,2025-03-13 14:54:24+00:00,"48.867362, 2.396222",Paris,75056,0.05,15
42301,Gare Arcueil - Cachan,OUI,25,22,3,0,3,OUI,OUI,2025-03-13 14:59:20+00:00,"48.799824, 2.328171",Arcueil,94003,0.12,15
42015,Place Jean Ferrat,OUI,23,20,3,1,2,OUI,OUI,2025-03-13 15:01:17+00:00,"48.8184945213025, 2.3744174838066106",Ivry-sur-Seine,94041,0.13043478260869565,15
42504,Gare RER de Gentilly,OUI,30,24,6,3,3,OUI,OUI,2025-03-13 14:55:06+00:00,"48.814280450380224, 2.3410347104072575",Gentilly,94037,0.2,15
31010,Stalingrad - Désiré Chevalier,OUI,42,40,2,0,2,OUI,OUI,2025-03-13 15:01:58+00:00,"48.85670169739857, 2.445072233676911",Montreuil,93048,0.047619047619047616,15
26013,Quai du docteur Dervaux,OUI,26,17,9,8,1,OUI,OUI,2025-03-13 14:59:45+00:00,"48.910482, 2.297998",Asnières-sur-Seine,92004,0.34615384615384615,15
19008,Flandre - Alphonse Karr,OUI,26,25,1,0,1,OUI,OUI,2025-03-13 14:59:16+00:00,"48.89465, 2.381868",Paris,75056,0.038461538461538464,15
20043,Charonne - Avron,OUI,25,25,0,0,0,OUI,OUI,2025-03-13 14:56:41+00:00,"48.851602665222, 2.3984030470379",Paris,75056,0.0,15
11004,Charonne - Faubourg Saint-Antoine,OUI,32,19,13,8,5,OUI,OUI,2025-03-13 15:00:50+00:00,"48.852191909696, 2.3740932717919",Paris,75056,0.40625,15
32016,Place de la Porte de Paris,OUI,33,23,10,5,5,OUI,OUI,2025-03-13 15:01:48+00:00,"48.93009363207303, 2.3564037680625916",Saint-Denis,93066,0.30303030303030304,15
18201,Tristan Tzara -  Tchaïkovski,OUI,33,33,0,0,0,OUI,OUI,2025-03-13 15:00:51+00:00,"48.89490221746837, 2.3648490384221077",Paris,75056,0.0,15
15201,Place Amédée Gordini - Lefebvre,OUI,37,32,5,3,2,OUI,OUI,2025-03-13 15:02:01+00:00,"48.83061737745, 2.2920634208276",Paris,75056,0.13513513513513514,15
51004,Général Delambre - Prebuard,OUI,28,16,12,3,9,OUI,OUI,2025-03-13 14:57:17+00:00,"48.93870344444, 2.2234171606307",Argenteuil,95018,0.42857142857142855,15
92008,Hôtel de Ville de Nanterre,OUI,35,13,22,11,11,OUI,OUI,2025-03-13 15:01:56+00:00,"48.892371898250424, 2.205548956990242",Nanterre,92050,0.6285714285714286,15
18012,Stephenson - Doudeauville,OUI,35,35,0,0,0,OUI,OUI,2025-03-13 15:01:00+00:00,"48.888537048944826, 2.3561610281467438",Paris,75056,0.0,15
41402,Victor Hugo - Ecoles,OUI,22,10,12,7,5,OUI,OUI,2025-03-13 15:00:00+00:00,"48.80476007936134, 2.4180373930262093",Alfortville,94002,0.5454545454545454,15
12009,Charenton - Diderot,OUI,18,5,13,8,5,OUI,OUI,2025-03-13 15:02:06+00:00,"48.846171461187, 2.3793068155646",Paris,75056,0.7222222222222222,15
19125,Place de l'Édit de Nantes,OUI,27,26,1,1,0,OUI,OUI,2025-03-13 15:01:25+00:00,"48.88879, 2.3785",Paris,75056,0.037037037037037035,15
14036,Boulard - Daguerre,OUI,43,37,6,0,6,OUI,OUI,2025-03-13 15:02:04+00:00,"48.83446472680611, 2.3293386027216907",Paris,75056,0.13953488372093023,15
19205,Simon Bolivar - Henri Turot,OUI,23,21,2,2,0,OUI,OUI,2025-03-13 14:58:10+00:00,"48.877475489801, 2.3739709492211",Paris,75056,0.08695652173913043,15
43003,Hôpital Bégin,OUI,26,26,0,0,0,NON,NON,2025-03-13 15:00:15+00:00,"48.84571672113, 2.4272462725639",Vincennes,94080,0.0,15
5123,Saint-Germain - Thenard,OUI,29,0,29,13,16,OUI,OUI,2025-03-13 15:01:29+00:00,"48.850571, 2.3471015",Paris,75056,1.0,15
9021,Saint Georges - d'Aumale,OUI,23,18,5,3,2,OUI,OUI,2025-03-13 15:01:42+00:00,"48.87778639599673, 2.337429821491241",Paris,75056,0.21739130434782608,15
11036,Jules Ferry - Faubourg du Temple Paris,OUI,56,28,28,25,3,OUI,OUI,2025-03-13 15:00:51+00:00,"48.868397, 2.3678933",Paris,75056,0.5,15
12027,Montgallet - Charenton,OUI,15,1,14,14,0,OUI,OUI,2025-03-13 14:59:55+00:00,"48.842647778701, 2.3861649278137",Paris,75056,0.9333333333333333,15
23009,Anatole France - Louise Michel,OUI,47,42,5,2,3,OUI,OUI,2025-03-13 15:00:34+00:00,"48.88873214926474, 2.2881576418876652",Levallois-Perret,92044,0.10638297872340426,15
21313,Guynemer - Séverine,OUI,24,0,24,17,7,OUI,OUI,2025-03-13 15:00:31+00:00,"48.83091743371036, 2.2790706530213356",Issy-les-Moulineaux,92040,1.0,15
42029,Stalingrad - Germaine Tailleferre,OUI,28,27,1,1,0,OUI,OUI,2025-03-13 14:55:30+00:00,"48.80257200481316, 2.3786691203713417",Ivry-sur-Seine,94041,0.03571428571428571,15
26007,Square Gilbert Thomain,OUI,19,14,5,4,1,OUI,OUI,2025-03-13 14:57:51+00:00,"48.90717373809284, 2.2695400938391685",Asnières-sur-Seine,92004,0.2631578947368421,15
8035,Bienfaisance - Place de Narvik,OUI,34,11,23,14,9,OUI,OUI,2025-03-13 15:02:06+00:00,"48.87660163459077, 2.3129771277308464",Paris,75056,0.6764705882352942,15
11007,Jean Macé - Faidherbe,OUI,57,52,5,0,5,OUI,OUI,2025-03-13 15:02:07+00:00,"48.85337548426, 2.3828620836139",Paris,75056,0.08771929824561403,15
17102,Alfred Roll - Berthier,OUI,28,20,8,4,4,OUI,OUI,2025-03-13 14:55:22+00:00,"48.887808570529, 2.3000952981763",Paris,75056,0.2857142857142857,15
15025,Dupleix - du Guesclin,OUI,45,22,23,20,3,OUI,OUI,2025-03-13 14:59:42+00:00,"48.85147910413369, 2.296709530055523",Paris,75056,0.5111111111111111,15
28001,Richard Wallace - Place du 8 Mai 1945,OUI,29,3,26,15,11,OUI,OUI,2025-03-13 15:01:57+00:00,"48.87866794788021, 2.2420343756675725",Puteaux,92062,0.896551724137931,15
19005,Flandre - Riquet,OUI,20,19,1,0,1,OUI,OUI,2025-03-13 14:56:37+00:00,"48.888013281448, 2.3737595955229",Paris,75056,0.05,15
16111,Faustin Hélie - Desbordes-Valmore,OUI,27,22,5,1,4,OUI,OUI,2025-03-13 14:57:19+00:00,"48.859403, 2.276522",Paris,75056,0.18518518518518517,15
10113,Parmentier - Hôpital Saint-Louis,OUI,40,36,4,2,2,OUI,OUI,2025-03-13 14:58:36+00:00,"48.871379874257, 2.3698963836667",Paris,75056,0.1,15
35018,Ancien Canal - Hélène Brion,OUI,23,22,1,1,0,OUI,OUI,2025-03-13 14:58:26+00:00,"48.89484799296163, 2.4188338592648506",Pantin,93055,0.043478260869565216,15
41606,Pasteur - Gambetta,OUI,19,9,10,9,1,OUI,OUI,2025-03-13 14:58:07+00:00,"48.84572797384512, 2.4236011505126953",Saint-Mandé,94067,0.5263157894736842,15
18110,Departement - Pajol,OUI,16,13,3,1,2,OUI,OUI,2025-03-13 15:01:13+00:00,"48.886674849730184, 2.3613611608743668",Paris,75056,0.1875,15
17011,Fragonard - Porte de Clichy,OUI,55,30,25,22,3,OUI,OUI,2025-03-13 15:00:34+00:00,"48.894155633419, 2.3143893107772",Paris,75056,0.45454545454545453,15
17045,Place des Ternes.,OUI,44,43,1,0,1,OUI,OUI,2025-03-13 14:57:49+00:00,"48.878438631226516, 2.297727763652802",Paris,75056,0.022727272727272728,15
43402,Place de Verdun,OUI,40,20,20,19,1,OUI,OUI,2025-03-13 15:00:43+00:00,"48.8202823, 2.473775",Joinville-le-Pont,94042,0.5,15
33018,Edouard Poisson - Victor Hugo,OUI,27,25,2,1,1,OUI,OUI,2025-03-13 14:54:52+00:00,"48.91118557052621, 2.379864752692811",Aubervilliers,93001,0.07407407407407407,15
12013,Montgallet - Reuilly,OUI,14,10,4,0,4,OUI,OUI,2025-03-13 14:58:16+00:00,"48.844291, 2.3896481",Paris,75056,0.2857142857142857,15
11115,Montreuil - Gonnet,OUI,24,19,5,2,3,OUI,OUI,2025-03-13 14:56:18+00:00,"48.850500564921, 2.3890856287864",Paris,75056,0.20833333333333334,15
21305,Place Jacques Madaule,OUI,23,1,22,20,2,OUI,OUI,2025-03-13 15:01:55+00:00,"48.823933787309, 2.2606918215752",Issy-les-Moulineaux,92040,0.9565217391304348,15
7015,Varenne,OUI,43,14,29,23,6,OUI,OUI,2025-03-13 15:00:54+00:00,"48.857202661803, 2.3152771219611",Paris,75056,0.6744186046511628,15
5021,Jussieu - Fossés Saint-Bernard,OUI,37,13,24,22,2,OUI,OUI,2025-03-13 15:01:26+00:00,"48.847185510023, 2.3534858599305",Paris,75056,0.6486486486486487,15
8033,Commandant Rivière,OUI,38,1,37,21,16,OUI,OUI,2025-03-13 15:01:46+00:00,"48.872933, 2.309796",Paris,75056,0.9736842105263158,15
6013,Jacques Callot - Mazarine,OUI,27,1,26,23,3,OUI,OUI,2025-03-13 14:55:42+00:00,"48.855280175332, 2.3375743255019",Paris,75056,0.9629629629629629,15
16121,Jardin d'Acclimatation,OUI,30,23,7,4,3,OUI,OUI,2025-03-13 15:01:20+00:00,"48.878772242510465, 2.270772233605385",Paris,75056,0.23333333333333334,15
12115,Porte de Vincennes,OUI,32,26,6,3,3,OUI,OUI,2025-03-13 15:01:00+00:00,"48.846454, 2.415514",Paris,75056,0.1875,15
23001,Paul Vaillant Couturier - Chaptal,OUI,36,6,30,22,8,OUI,OUI,2025-03-13 15:02:00+00:00,"48.893479576183, 2.2775253653526",Levallois-Perret,92044,0.8333333333333334,15
15010,Square Cambronne,OUI,59,4,55,53,2,OUI,OUI,2025-03-13 15:01:06+00:00,"48.84756654526, 2.3025691509247",Paris,75056,0.9322033898305084,15
18141,Clignancourt - Sofia,OUI,19,19,0,0,0,OUI,OUI,2025-03-13 14:52:25+00:00,"48.88511992309783, 2.34719488842051",Paris,75056,0.0,15
41102,Gare de Laplace,OUI,43,42,1,1,0,OUI,OUI,2025-03-13 14:57:09+00:00,"48.80893199114179, 2.3349460959434514",Arcueil,94003,0.023255813953488372,15
16124,Route de Sèvres - Porte de Bagatelle,OUI,66,4,62,52,10,OUI,OUI,2025-03-13 15:00:17+00:00,"48.87525984132485, 2.249415814876557",Paris,75056,0.9393939393939394,15
17037,Bayen - Pereire,OUI,21,15,6,5,1,OUI,OUI,2025-03-13 14:58:28+00:00,"48.881804409079656, 2.2921088710427284",Paris,75056,0.2857142857142857,15
33009,Félix Faure - Sadi Carnot,OUI,33,28,5,3,2,OUI,OUI,2025-03-13 14:58:56+00:00,"48.90812110228388, 2.378623187541962",Aubervilliers,93001,0.15151515151515152,15
33003,Bordier - Félix Faure,OUI,45,36,9,6,3,OUI,OUI,2025-03-13 14:59:11+00:00,"48.90390751882016, 2.3830059170722966",Aubervilliers,93001,0.2,15
25005,18 juin 1940 - Buzenval,OUI,25,19,6,3,3,OUI,OUI,2025-03-13 14:59:50+00:00,"48.868807, 2.185428",Rueil-Malmaison,92063,0.24,15
5106,Cujas - Saint-Michel,OUI,19,1,18,1,17,OUI,OUI,2025-03-13 15:02:06+00:00,"48.848191348584, 2.341831654854",Paris,75056,0.9473684210526315,15
13045,Jean Colly - Tolbiac,OUI,35,30,5,1,4,OUI,OUI,2025-03-13 14:59:09+00:00,"48.827817291597846, 2.3705490678548813",Paris,75056,0.14285714285714285,15
22505,Mairie de La Garenne Colombes,OUI,22,17,5,5,0,OUI,OUI,2025-03-13 14:58:47+00:00,"48.90663823468682, 2.24679596722126",La Garenne-Colombes,92035,0.22727272727272727,15
19115,Porte de la Villette,OUI,26,25,1,1,0,OUI,OUI,2025-03-13 14:57:02+00:00,"48.89835196548483, 2.386150136590004",Paris,75056,0.038461538461538464,15
16018,Flandrin - Henri Martin,OUI,17,14,3,0,3,OUI,OUI,2025-03-13 14:55:48+00:00,"48.8643275, 2.2724174",Paris,75056,0.17647058823529413,15
14034,Ouest - Château,OUI,23,20,3,0,3,OUI,OUI,2025-03-13 15:01:17+00:00,"48.83617286014242, 2.319392143923804",Paris,75056,0.13043478260869565,15
19044,Grands Moulins de Pantin,OUI,50,42,8,5,3,OUI,OUI,2025-03-13 14:59:07+00:00,"48.89738369720229, 2.3959985375404362",Paris,75056,0.16,15
32010,Place aux Étoiles,OUI,37,7,30,5,25,OUI,OUI,2025-03-13 15:01:13+00:00,"48.91835629408464, 2.3523425683379173",Saint-Denis,93066,0.8108108108108109,15
24002,Gare de Courbevoie,OUI,32,23,9,4,5,OUI,OUI,2025-03-13 14:57:42+00:00,"48.8993867, 2.2506506",Courbevoie,92026,0.28125,15
12034,Pirogues de Bercy - Libourne,OUI,48,26,22,10,12,OUI,OUI,2025-03-13 14:59:55+00:00,"48.832308, 2.38637",Paris,75056,0.4583333333333333,15
33001,Victor Hugo - Magasins Généraux,OUI,34,23,11,4,7,OUI,OUI,2025-03-13 14:59:02+00:00,"48.903281401126755, 2.368072383105755",Aubervilliers,93001,0.3235294117647059,15
15033,Place Violet,OUI,28,20,8,5,3,OUI,OUI,2025-03-13 15:01:28+00:00,"48.84487893836502, 2.2905756533145905",Paris,75056,0.2857142857142857,15
7009,Assemblée Nationale,OUI,75,4,71,30,41,OUI,OUI,2025-03-13 14:58:12+00:00,"48.861411014652, 2.3201214185208",Paris,75056,0.9466666666666667,15
25008,Place du 8 Mai 1945,OUI,18,14,4,4,0,OUI,OUI,2025-03-13 15:01:52+00:00,"48.871552174017, 2.2025031970585",Rueil-Malmaison,92063,0.2222222222222222,15
15122,Place Charles Vallin,OUI,26,20,6,2,4,OUI,OUI,2025-03-13 15:01:22+00:00,"48.835523812041, 2.3025986552238",Paris,75056,0.23076923076923078,15
16034,Porte d'Auteuil,OUI,32,25,7,4,3,OUI,OUI,2025-03-13 14:56:28+00:00,"48.8479394142243, 2.2608396783471107",Paris,75056,0.21875,15
42707,Place Jean-Baptiste Clément,OUI,23,20,3,0,3,OUI,OUI,2025-03-13 14:55:31+00:00,"48.81240466867336, 2.3617091774940495",Le Kremlin-Bicêtre,94043,0.13043478260869565,15
41404,Carnot - Pâquerettes,OUI,23,5,18,18,0,OUI,OUI,2025-03-13 15:01:40+00:00,"48.79592939432515, 2.4261841177940373",Alfortville,94002,0.782608695652174,15
5119,Jussieu - Guy de la Brosse,OUI,38,10,28,21,7,OUI,OUI,2025-03-13 15:01:47+00:00,"48.845665, 2.355653",Paris,75056,0.7368421052631579,15
20132,Réunion - Avron,OUI,26,24,2,1,1,OUI,OUI,2025-03-13 14:54:56+00:00,"48.852566752033766, 2.403928068708116",Paris,75056,0.07692307692307693,15
35009,Jean Lolive - Parc Stalingrad,OUI,22,19,3,1,2,OUI,OUI,2025-03-13 14:58:54+00:00,"48.89206174403158, 2.4091735482215886",Pantin,93055,0.13636363636363635,15
92003,Chanzy - Sud-Est,OUI,25,25,0,0,0,OUI,OUI,2025-03-13 15:01:18+00:00,"48.888912037698766, 2.195632159709931",Nanterre,92050,0.0,15
27002,Parc Pierre Lagravère,OUI,30,11,19,9,10,OUI,OUI,2025-03-13 15:00:45+00:00,"48.92650488131725, 2.239069678491417",Colombes,92025,0.6333333333333333,15
19019,Petit - Manin,OUI,22,22,0,0,0,NON,NON,2025-03-13 14:57:14+00:00,"48.886506875343, 2.3938155401308",Paris,75056,0.0,15
23701,Parvis Robert Schuman - Roger Salengro,OUI,24,16,8,2,6,OUI,OUI,2025-03-13 15:00:21+00:00,"48.812657470558754, 2.1921751275658607",Chaville,92022,0.3333333333333333,15
8055,Courcelles - Place des Ternes,OUI,29,22,7,4,3,OUI,OUI,2025-03-13 14:58:23+00:00,"48.878199928923124, 2.2992860188665043",Paris,75056,0.2413793103448276,15
17007,Navier - Epinettes,OUI,36,28,8,5,3,OUI,OUI,2025-03-13 14:54:07+00:00,"48.89587780769155, 2.3226776719093327",Paris,75056,0.2222222222222222,15
21109,Guichet - Jean Jaurès,OUI,23,20,3,2,1,OUI,OUI,2025-03-13 14:56:05+00:00,"48.905169868129036, 2.3023840785026555",Clichy,92024,0.13043478260869565,15
21502,Verdun - Place Henri IV,OUI,26,7,19,13,6,OUI,OUI,2025-03-13 15:01:39+00:00,"48.870797375639214, 2.2277003154158592",Suresnes,92073,0.7307692307692307,15
31012,Place Carnot,OUI,23,19,4,0,4,OUI,OUI,2025-03-13 14:58:11+00:00,"48.85593932186797, 2.441531717777252",Montreuil,93048,0.17391304347826086,15
16129,Ceinture du Lac Inferieure - Saint-Cloud,OUI,41,39,2,0,2,OUI,OUI,2025-03-13 14:56:48+00:00,"48.86218070933143, 2.2617871686816216",Paris,75056,0.04878048780487805,15
12024,Gare de Bercy,OUI,35,13,22,20,2,OUI,OUI,2025-03-13 15:02:01+00:00,"48.839794573906, 2.3826066032052",Paris,75056,0.6285714285714286,15
35019,Anatole France - Jean Lolive,OUI,27,24,3,1,2,OUI,OUI,2025-03-13 15:01:13+00:00,"48.8949922, 2.4253764",Pantin,93055,0.1111111111111111,15
14104,Boyer-Barret - Raymond Losserand,OUI,22,20,2,0,2,OUI,OUI,2025-03-13 14:52:53+00:00,"48.83329880233322, 2.3173383995890617",Paris,75056,0.09090909090909091,15
23802,Raymond Poincaré - Allée de la Marche,OUI,22,15,7,7,0,OUI,OUI,2025-03-13 14:59:47+00:00,"48.838634069623, 2.1724102640451",Garches,92033,0.3181818181818182,15
20113,Piat - Parc de Belleville,OUI,21,17,4,0,4,OUI,OUI,2025-03-13 15:01:01+00:00,"48.87195626635528, 2.384981390278095",Paris,75056,0.19047619047619047,15
20036,Ménilmontant - Pelleport,OUI,31,29,2,0,2,OUI,OUI,2025-03-13 15:00:09+00:00,"48.870682633845, 2.3989596023316",Paris,75056,0.06451612903225806,15
20119,Square des Saint-Simoniens,OUI,25,24,1,0,1,OUI,OUI,2025-03-13 14:59:12+00:00,"48.8701796, 2.3967273",Paris,75056,0.04,15
15017,Place Falguière,OUI,23,18,5,2,3,OUI,OUI,2025-03-13 15:00:48+00:00,"48.83629973941847, 2.3104464635252953",Paris,75056,0.21739130434782608,15
31705,Champeaux - Gallieni,OUI,47,43,4,2,2,OUI,OUI,2025-03-13 14:59:48+00:00,"48.864459134684644, 2.4161778017878532",Bagnolet,93006,0.0851063829787234,15
10005,Petites Ecuries - Faubourg Poissonnière,OUI,16,4,12,11,1,OUI,OUI,2025-03-13 15:01:31+00:00,"48.87397217237368, 2.348388757504776",Paris,75056,0.75,15
6030,Assas - Vaugirard,OUI,34,16,18,7,11,OUI,OUI,2025-03-13 15:01:18+00:00,"48.848274111398, 2.3292413726449",Paris,75056,0.5294117647058824,15
43006,Vignerons - Minimes,OUI,29,17,12,10,2,OUI,OUI,2025-03-13 14:59:30+00:00,"48.841486, 2.430793",Vincennes,94080,0.41379310344827586,15
12126,Gravelle - Route du Bac,OUI,49,43,6,4,2,OUI,OUI,2025-03-13 15:01:47+00:00,"48.824407, 2.418455",Paris,75056,0.12244897959183673,15
7004,Raspail - Varenne,OUI,16,13,3,1,2,OUI,OUI,2025-03-13 15:02:04+00:00,"48.853147816545, 2.3263905197382",Paris,75056,0.1875,15
41604,Lagny - Joffre,OUI,30,21,9,9,0,OUI,OUI,2025-03-13 15:01:48+00:00,"48.84930687084088, 2.417949736118317",Saint-Mandé,94067,0.3,15
21013,Pierre Grenier - Pont de Billancourt,OUI,21,17,4,2,2,OUI,OUI,2025-03-13 14:57:06+00:00,"48.8258020742942, 2.2487989068031315",Boulogne-Billancourt,92012,0.19047619047619047,15
15029,Emeriau - Place de Brazzaville,OUI,51,15,36,34,2,OUI,OUI,2025-03-13 15:01:41+00:00,"48.850785261674964, 2.2871585190296173",Paris,75056,0.7058823529411765,15
2010,Uzès - Montmartre,OUI,26,1,25,11,14,OUI,OUI,2025-03-13 15:01:38+00:00,"48.870790980240706, 2.3431010171771054",Paris,75056,0.9615384615384616,15
17018,Parc Monceau,OUI,18,6,12,8,4,OUI,OUI,2025-03-13 14:55:11+00:00,"48.881077914129, 2.3095492646098",Paris,75056,0.6666666666666666,15
5116,Place Valhubert,OUI,51,0,51,44,7,OUI,OUI,2025-03-13 15:00:23+00:00,"48.844182577315, 2.3640366643667",Paris,75056,1.0,15
18005,Tardieu - Chappe,OUI,16,16,0,0,0,OUI,OUI,2025-03-13 14:57:13+00:00,"48.884146759782, 2.341845408082",Paris,75056,0.0,15
7006,Quai Voltaire,OUI,31,7,24,22,2,OUI,OUI,2025-03-13 15:02:07+00:00,"48.858942986179, 2.3314182047146",Paris,75056,0.7741935483870968,15
26001,Gare d'Asnières sur Seine,OUI,21,9,12,12,0,OUI,OUI,2025-03-13 15:02:08+00:00,"48.90636459217474, 2.2835066914558415",Asnières-sur-Seine,92004,0.5714285714285714,15
7014,Saint-François-Xavier,OUI,42,12,30,21,9,OUI,OUI,2025-03-13 15:01:08+00:00,"48.85154484769, 2.3146149516106",Paris,75056,0.7142857142857143,15
92004,Nanterre - Université,OUI,19,7,12,10,2,OUI,OUI,2025-03-13 15:00:26+00:00,"48.901365, 2.212693",Nanterre,92050,0.631578947368421,15
17017,Gare de Pont-Cardinet,OUI,31,27,4,1,3,OUI,OUI,2025-03-13 15:01:53+00:00,"48.88713901475306, 2.314494143994255",Paris,75056,0.12903225806451613,15
18020,Francoeur - Marcadet,OUI,20,19,1,0,1,OUI,OUI,2025-03-13 15:00:18+00:00,"48.89104123261663, 2.340014585442034",Paris,75056,0.05,15
10023,Gare de l'Est - Verdun,OUI,13,9,4,2,2,OUI,OUI,2025-03-13 15:00:00+00:00,"48.876156054271, 2.3609149083206",Paris,75056,0.3076923076923077,15
20136,Henri Chevreau - Couronnes,OUI,26,24,2,1,1,OUI,OUI,2025-03-13 14:57:45+00:00,"48.87033205312931, 2.388777695596218",Paris,75056,0.07692307692307693,15
34002,Capitaine Glarner - Gabriel Péri,OUI,24,18,6,4,2,OUI,OUI,2025-03-13 14:59:25+00:00,"48.902449900418745, 2.3304807533425724",Saint-Ouen-sur-Seine,93070,0.25,15
5026,Pascal - Claude Bernard,OUI,48,23,25,24,1,OUI,OUI,2025-03-13 15:01:26+00:00,"48.839061952159746, 2.3499782010912895",Paris,75056,0.5208333333333334,15
23002,Pont de Levallois-bécon,OUI,49,20,29,15,14,OUI,OUI,2025-03-13 15:01:45+00:00,"48.8984179, 2.2791311",Levallois-Perret,92044,0.5918367346938775,15
5002,Sommerard - Saint-Jacques,OUI,34,5,29,24,5,OUI,OUI,2025-03-13 14:57:07+00:00,"48.850310432924466, 2.345015835298588",Paris,75056,0.8529411764705882,15
15055,Vasco de Gama,OUI,54,23,31,25,6,OUI,OUI,2025-03-13 15:00:57+00:00,"48.83671783466264, 2.283664085650799",Paris,75056,0.5740740740740741,15
15028,Grenelle - Dr Finlay,OUI,71,11,60,60,0,OUI,OUI,2025-03-13 15:02:02+00:00,"48.851315406715976, 2.2919502854347233",Paris,75056,0.8450704225352113,15
14130,Jonquoy - Didot,OUI,30,22,8,1,7,OUI,OUI,2025-03-13 15:00:17+00:00,"48.82890454823947, 2.31648076325655",Paris,75056,0.26666666666666666,15
8102,Lamennais - Washington,OUI,25,5,20,10,10,OUI,OUI,2025-03-13 15:01:39+00:00,"48.87352990026496, 2.303444892168045",Paris,75056,0.8,15
10015,Lucien Sampaix - Récollets,OUI,41,33,8,2,6,OUI,OUI,2025-03-13 15:00:27+00:00,"48.874330377560476, 2.3621229082345963",Paris,75056,0.1951219512195122,15
14018,Porte d'Orléans,OUI,45,42,3,1,2,OUI,OUI,2025-03-13 15:01:56+00:00,"48.8227639, 2.3249313",Paris,75056,0.06666666666666667,15
12011,Charenton - Place du Col Bourgoin,OUI,35,21,14,9,5,OUI,OUI,2025-03-13 15:02:03+00:00,"48.844867319554, 2.3825789350545",Paris,75056,0.4,15
31702,Pierre et Marie Curie - Julien Grimau,OUI,18,16,2,0,2,OUI,OUI,2025-03-13 14:57:09+00:00,"48.870714014863225, 2.424097023904324",Bagnolet,93006,0.1111111111111111,15
21308,Bara - Henri Farman,OUI,58,5,53,34,19,OUI,OUI,2025-03-13 15:00:13+00:00,"48.833218027457846, 2.2677567601203923",Issy-les-Moulineaux,92040,0.9137931034482759,15
42503,Vladimir Ilitch Lénine - Andrée Chedid,OUI,31,29,2,0,2,OUI,OUI,2025-03-13 15:00:57+00:00,"48.813240124373, 2.3319716067039",Gentilly,94037,0.06451612903225806,15
12032,Porte Dorée,OUI,35,21,14,12,2,OUI,OUI,2025-03-13 15:02:07+00:00,"48.8354337, 2.4077132",Paris,75056,0.4,15
21111,Professeur René Leriche - Général Leclerc,OUI,50,36,14,10,4,OUI,OUI,2025-03-13 14:58:58+00:00,"48.90782845483013, 2.307887971401215",Clichy,92024,0.28,15
7005,Raspail - Bac,OUI,51,15,36,25,11,OUI,OUI,2025-03-13 14:59:16+00:00,"48.855628721101, 2.3256602883339",Paris,75056,0.7058823529411765,15
11114,Ledru-Rollin - Charonne,OUI,32,7,25,19,6,OUI,OUI,2025-03-13 15:00:18+00:00,"48.85345855607243, 2.3772463581947094",Paris,75056,0.78125,15
21019,Edouard Vaillant - Paul-Adolphe Souriau,OUI,26,6,20,17,3,OUI,OUI,2025-03-13 15:00:22+00:00,"48.834845858829, 2.2479459643364",Boulogne-Billancourt,92012,0.7692307692307693,15
8012,Batignolles - Place de Clichy,OUI,47,40,7,3,4,OUI,OUI,2025-03-13 15:00:40+00:00,"48.883474535757, 2.326493114233",Paris,75056,0.14893617021276595,15
19109,Tanger - Place du Maroc,OUI,19,16,3,2,1,OUI,OUI,2025-03-13 14:56:48+00:00,"48.8862524447104, 2.3689296841621403",Paris,75056,0.15789473684210525,15
20040,Parc de Belleville - Julien Lacroix,OUI,26,23,3,1,2,OUI,OUI,2025-03-13 15:02:08+00:00,"48.8703459, 2.3842214",Paris,75056,0.11538461538461539,15
31019,Vincennes - Douy-Delcupe,OUI,37,33,4,1,3,OUI,OUI,2025-03-13 14:57:52+00:00,"48.85493692155721, 2.436049282550812",Montreuil,93048,0.10810810810810811,15
13026,Place Jean Delay,OUI,33,23,10,2,8,OUI,OUI,2025-03-13 15:01:44+00:00,"48.823316, 2.354336",Paris,75056,0.30303030303030304,15
32014,Place du Cornillon - Stade de France,OUI,33,6,27,19,8,OUI,OUI,2025-03-13 15:01:59+00:00,"48.92540695835961, 2.3644426837563515",Saint-Denis,93066,0.8181818181818182,15
14139,Pierre Larousse - Raymond Losserand,OUI,30,29,1,0,1,OUI,OUI,2025-03-13 15:00:29+00:00,"48.83059564231877, 2.3119183257222176",Paris,75056,0.03333333333333333,15
18032,Porte de Clignancourt.,OUI,55,54,1,0,1,OUI,OUI,2025-03-13 14:58:12+00:00,"48.897488, 2.343996",Paris,75056,0.01818181818181818,15
13102,Pitié-Salpêtrière,OUI,49,19,30,15,15,OUI,OUI,2025-03-13 15:01:47+00:00,"48.83748810318667, 2.365213818848133",Paris,75056,0.6122448979591837,15
31016,Lucie Aubrac - Franklin,OUI,35,33,2,1,1,OUI,OUI,2025-03-13 14:57:23+00:00,"48.86223916006812, 2.4435862898826604",Montreuil,93048,0.05714285714285714,15
11101,Charles Delescluze,OUI,48,20,28,26,2,OUI,OUI,2025-03-13 15:01:02+00:00,"48.85242200848887, 2.380632497370243",Paris,75056,0.5833333333333334,15
51003,Hôtel de Ville d'Argenteuil,OUI,29,12,17,11,6,OUI,OUI,2025-03-13 14:55:06+00:00,"48.946504, 2.2496396",Argenteuil,95018,0.5862068965517241,15
41207,Place du Général de Gaulle,OUI,28,17,11,0,11,OUI,OUI,2025-03-13 15:01:21+00:00,"48.8525288, 2.4877332",Fontenay-sous-Bois,94033,0.39285714285714285,15
44102,Verdun - Adrien Damalix,OUI,26,21,5,4,1,OUI,OUI,2025-03-13 15:00:50+00:00,"48.8222334178559, 2.4215328320860863",Saint-Maurice,94069,0.19230769230769232,15
19037,Belleville - Porte des Lilas,OUI,29,26,3,0,3,OUI,OUI,2025-03-13 14:55:50+00:00,"48.87660391892763, 2.404769691129476",Paris,75056,0.10344827586206896,15
9115,Milton - Manuel,OUI,21,20,1,0,1,OUI,OUI,2025-03-13 14:55:51+00:00,"48.878249, 2.341181",Paris,75056,0.047619047619047616,15
6103,Mézières - Rennes,OUI,53,48,5,1,4,OUI,OUI,2025-03-13 15:01:57+00:00,"48.85023459321703, 2.3303819820284843",Paris,75056,0.09433962264150944,15
16032,Eglise d'Auteuil,OUI,21,19,2,0,2,OUI,OUI,2025-03-13 14:59:07+00:00,"48.84749841771691, 2.26848387135299",Paris,75056,0.09523809523809523,15
15038,Place Adolphe Cherioux - Vaugirard,OUI,61,57,4,1,3,OUI,OUI,2025-03-13 14:59:43+00:00,"48.83959442800459, 2.3010657727718353",Paris,75056,0.06557377049180328,15
14122,Colonel Monteil - Brune,OUI,19,16,3,1,2,OUI,OUI,2025-03-13 14:59:58+00:00,"48.82650293311, 2.3092747998272",Paris,75056,0.15789473684210525,15
21032,Sèvres-Gallieni,OUI,25,1,24,16,8,OUI,OUI,2025-03-13 14:58:50+00:00,"48.837809408957, 2.2281519323587",Boulogne-Billancourt,92012,0.96,15
16123,Mahatma Gandhi,OUI,24,3,21,13,8,OUI,OUI,2025-03-13 14:58:47+00:00,"48.876356, 2.264205",Paris,75056,0.875,15
20021,Indre - Prairies,OUI,38,32,6,0,6,OUI,OUI,2025-03-13 15:01:45+00:00,"48.86254398506782, 2.403290458023548",Paris,75056,0.15789473684210525,15
31007,Paris - Désiré Préaux,OUI,44,38,6,3,3,OUI,OUI,2025-03-13 15:00:31+00:00,"48.85742876694898, 2.4323049187660217",Montreuil,93048,0.13636363636363635,15
6018,Michelet - Assas,OUI,17,9,8,2,6,OUI,OUI,2025-03-13 15:01:50+00:00,"48.842741502832, 2.3350211977959",Paris,75056,0.47058823529411764,15
15108,Lourmel - Marie Skobtsov,OUI,22,14,8,6,2,OUI,OUI,2025-03-13 14:59:26+00:00,"48.844974, 2.287283",Paris,75056,0.36363636363636365,15
21105,Morice - Général Leclerc,OUI,25,14,11,5,6,OUI,OUI,2025-03-13 14:56:33+00:00,"48.90245471981591, 2.3128929734230046",Clichy,92024,0.44,15
17047,Courcelles - Pierre Demours,OUI,26,7,19,11,8,OUI,OUI,2025-03-13 15:01:39+00:00,"48.883769733273496, 2.29858466343129",Paris,75056,0.7307692307692307,15
17124,Porte de Saint-Ouen - Henri Huchard,OUI,26,11,15,14,1,OUI,OUI,2025-03-13 14:55:11+00:00,"48.898708366365064, 2.3295360803604126",Paris,75056,0.5769230769230769,15
6016,Danton - Serpente,OUI,21,4,17,15,2,OUI,OUI,2025-03-13 14:59:23+00:00,"48.852297362582, 2.3414132371545",Paris,75056,0.8095238095238095,15
44012,Génie - Mozart,OUI,18,16,2,1,1,OUI,OUI,2025-03-13 14:54:31+00:00,"48.794902381218904, 2.3734183609485626",Vitry-sur-Seine,94081,0.1111111111111111,15
41204,République - Danton,OUI,19,18,1,0,1,OUI,OUI,2025-03-13 14:53:58+00:00,"48.85249172181667, 2.462034523487091",Fontenay-sous-Bois,94033,0.05263157894736842,15
17027,Place du Maréchal Juin - Péreire,OUI,44,16,28,23,5,OUI,OUI,2025-03-13 15:01:21+00:00,"48.885263, 2.298286",Paris,75056,0.6363636363636364,15
17121,Square des Epinettes,OUI,20,20,0,0,0,OUI,OUI,2025-03-13 14:59:44+00:00,"48.89383909781389, 2.325953990221024",Paris,75056,0.0,15
22101,Gare Routière de Saint Cloud,OUI,30,9,21,15,6,OUI,OUI,2025-03-13 15:01:01+00:00,"48.84288183896324, 2.222245037555695",Saint-Cloud,92064,0.7,15
19009,Cité des Sciences et de l'Industrie,OUI,27,17,10,4,6,OUI,OUI,2025-03-13 15:02:01+00:00,"48.89659571178903, 2.384599149227142",Paris,75056,0.37037037037037035,15
13016,Primo Levi - Frigos,OUI,33,1,32,24,8,OUI,OUI,2025-03-13 15:01:33+00:00,"48.83094844846017, 2.37965351592796",Paris,75056,0.9696969696969697,15
18109,Pajol - Riquet,OUI,45,37,8,2,6,OUI,OUI,2025-03-13 15:01:26+00:00,"48.88960028134536, 2.3628534749150276",Paris,75056,0.17777777777777778,15
13043,Dunois - Clisson,OUI,50,47,3,2,1,OUI,OUI,2025-03-13 15:01:46+00:00,"48.832294, 2.3674523",Paris,75056,0.06,15
21703,Square du Carrefour de l'Insurrection,OUI,20,17,3,1,2,OUI,OUI,2025-03-13 14:59:53+00:00,"48.820864559770676, 2.291113436222077",Vanves,92075,0.15,15
8051,Batignolles - Rome,OUI,11,11,0,0,0,OUI,OUI,2025-03-13 15:01:41+00:00,"48.881823370566806, 2.3202589899301524",Paris,75056,0.0,15
9117,Bellefond - Maubeuge,OUI,28,27,1,0,1,OUI,OUI,2025-03-13 15:01:55+00:00,"48.878255397645, 2.3452642187476",Paris,75056,0.03571428571428571,15
2009,Filles Saint-Thomas - Place de la Bourse,OUI,58,3,55,23,32,OUI,OUI,2025-03-13 15:02:06+00:00,"48.868899890853, 2.3397543845203",Paris,75056,0.9482758620689655,15
14002,Edgar Quinet - Raspail,OUI,44,39,5,0,5,OUI,OUI,2025-03-13 15:00:41+00:00,"48.83940266673835, 2.32971478253603",Paris,75056,0.11363636363636363,15
19039,Edouard Pailleron - Simon Bolivar,OUI,23,22,1,0,1,OUI,OUI,2025-03-13 15:00:11+00:00,"48.87979886049996, 2.374839261174202",Paris,75056,0.043478260869565216,15
18049,Porte d'Aubervilliers,OUI,53,46,7,7,0,OUI,OUI,2025-03-13 15:00:07+00:00,"48.89859661942376, 2.3689722642302513",Paris,75056,0.1320754716981132,15
21003,Jean Jaurès - Jean Baptiste Clément,OUI,39,30,9,5,4,OUI,OUI,2025-03-13 14:59:54+00:00,"48.84576261454011, 2.2369650006294255",Boulogne-Billancourt,92012,0.23076923076923078,15
18113,Lepic - Armée d'Orient,OUI,24,23,1,1,0,OUI,OUI,2025-03-13 14:59:48+00:00,"48.887536403814, 2.3343077301979",Paris,75056,0.041666666666666664,15
22001,Château - Bineau,OUI,21,2,19,10,9,OUI,OUI,2025-03-13 15:01:45+00:00,"48.890404028589806, 2.270106375217438",Neuilly-sur-Seine,92051,0.9047619047619048,15
18025,Mairie du 18ème,OUI,40,39,1,0,1,OUI,OUI,2025-03-13 14:58:37+00:00,"48.892939296937605, 2.3445510864257812",Paris,75056,0.025,15
11041,Square Saint-Ambroise,OUI,39,14,25,23,2,OUI,OUI,2025-03-13 15:02:03+00:00,"48.860934, 2.375841",Paris,75056,0.6410256410256411,15
17122,Bridaine - Lamandé,OUI,28,27,1,0,1,OUI,OUI,2025-03-13 14:59:13+00:00,"48.8862074, 2.3206239",Paris,75056,0.03571428571428571,15
31703,Sadi Carnot - François Mitterrand,OUI,26,19,7,1,6,OUI,OUI,2025-03-13 15:01:29+00:00,"48.87532687671517, 2.4241617321968083",Bagnolet,93006,0.2692307692307692,15
20027,Porte de Ménilmontant,OUI,15,15,0,0,0,OUI,OUI,2025-03-13 14:59:51+00:00,"48.8691543609174, 2.40932246879487",Paris,75056,0.0,15
11006,Ledru-Rollin - Place du Père Chaillet,OUI,37,7,30,18,12,OUI,OUI,2025-03-13 15:00:59+00:00,"48.856433706943704, 2.379020587761426",Paris,75056,0.8108108108108109,15
9023,Laffitte - Italiens,OUI,31,4,27,17,10,OUI,OUI,2025-03-13 14:59:08+00:00,"48.871815737396, 2.3372015478451",Paris,75056,0.8709677419354839,15
47005,Ecole Vétérinaire,OUI,35,17,18,16,2,OUI,OUI,2025-03-13 15:01:47+00:00,"48.81488859822486, 2.4224362157778994",Maisons-Alfort,94046,0.5142857142857142,15
19040,Belleville - Télégraphe,OUI,40,40,0,0,0,OUI,OUI,2025-03-13 14:55:46+00:00,"48.8756045, 2.3995549",Paris,75056,0.0,15
19127,Aubervilliers - Curial,OUI,23,20,3,0,3,OUI,OUI,2025-03-13 15:00:41+00:00,"48.89088305227546, 2.3688579350709915",Paris,75056,0.13043478260869565,15
17046,Mac-Mahon - Brey,OUI,24,13,11,5,6,OUI,OUI,2025-03-13 14:59:36+00:00,"48.877532084130166, 2.294512536052928",Paris,75056,0.4583333333333333,15
16015,Bassano -  Iéna,OUI,15,8,7,1,6,OUI,OUI,2025-03-13 14:58:18+00:00,"48.868144510482075, 2.296149600985935",Paris,75056,0.4666666666666667,15
19038,Lassus - Delouvain,OUI,19,17,2,0,2,OUI,OUI,2025-03-13 15:00:03+00:00,"48.8755044846, 2.3890327325519",Paris,75056,0.10526315789473684,15
15070,Balard - Montagne de la Fage,OUI,34,4,30,28,2,OUI,OUI,2025-03-13 15:00:07+00:00,"48.83850740333351, 2.2782871127128606",Paris,75056,0.8823529411764706,15
18029,Emile Blemont - Poteau,OUI,39,35,4,0,4,OUI,OUI,2025-03-13 15:01:59+00:00,"48.8943782, 2.3415122",Paris,75056,0.10256410256410256,15
1120,Lavandieres Sainte Opportune - Rivoli,OUI,26,3,23,18,5,OUI,OUI,2025-03-13 15:01:14+00:00,"48.859279702476, 2.3466217517853",Paris,75056,0.8846153846153846,15
35017,Toffier Decaux - Cartier Bresson,OUI,18,17,1,1,0,OUI,OUI,2025-03-13 15:01:31+00:00,"48.90165072551549, 2.4017545580863957",Pantin,93055,0.05555555555555555,15
14112,Méchain - Faubourg Saint-Jacques,OUI,14,12,2,1,1,OUI,OUI,2025-03-13 14:59:58+00:00,"48.83586772099485, 2.33798034198275",Paris,75056,0.14285714285714285,15
20118,Orteaux - Mouraud,OUI,24,21,3,0,3,OUI,OUI,2025-03-13 14:57:28+00:00,"48.85558642847872, 2.408762907764669",Paris,75056,0.125,15
47004,Stade Auguste Delaune,OUI,21,3,18,18,0,OUI,OUI,2025-03-13 14:59:42+00:00,"48.80896378683884, 2.4345204234123234",Maisons-Alfort,94046,0.8571428571428571,15
16021,François Ponsard - La Muette,OUI,22,19,3,1,2,OUI,OUI,2025-03-13 14:58:18+00:00,"48.8583666, 2.2744515",Paris,75056,0.13636363636363635,15
9026,Jean-Baptiste Pigalle - La Bruyere,OUI,17,11,6,1,5,OUI,OUI,2025-03-13 15:01:53+00:00,"48.87939826447722, 2.333709173337285",Paris,75056,0.35294117647058826,15
9031,Provence - Chaussée d'Antin,OUI,24,8,16,8,8,OUI,OUI,2025-03-13 14:56:38+00:00,"48.87428447542072, 2.332976511564311",Paris,75056,0.6666666666666666,15
18033,Belliard - Damrémont,OUI,34,32,2,1,1,OUI,OUI,2025-03-13 14:55:15+00:00,"48.89669238777841, 2.338023450388167",Paris,75056,0.058823529411764705,15
20023,Pelleport - Belgrand,OUI,14,12,2,0,2,OUI,OUI,2025-03-13 14:56:25+00:00,"48.86500081847653, 2.403980836377493",Paris,75056,0.14285714285714285,15
11010,Boulets - Faubourg Saint-Antoine,OUI,42,40,2,2,0,OUI,OUI,2025-03-13 15:01:39+00:00,"48.849259262115, 2.3917546141943",Paris,75056,0.047619047619047616,15
15035,Place Etienne Pernet,OUI,43,11,32,31,1,OUI,OUI,2025-03-13 15:01:25+00:00,"48.84243457133779, 2.2921819612383847",Paris,75056,0.7441860465116279,15
16122,Route de la Muette - Porte de Neuilly,OUI,49,42,7,2,5,OUI,OUI,2025-03-13 15:01:03+00:00,"48.8798926, 2.2587671",Paris,75056,0.14285714285714285,15
10020,Chabrol - d'Hauteville,OUI,11,8,3,2,1,OUI,OUI,2025-03-13 15:01:03+00:00,"48.877018388033, 2.3513179644942",Paris,75056,0.2727272727272727,15
15002,Maine - Antoine Bourdelle,OUI,17,10,7,4,3,OUI,OUI,2025-03-13 15:01:49+00:00,"48.84308531746595, 2.320263946784738",Paris,75056,0.4117647058823529,15
35003,Gabrielle Josserand - Edouard Vaillant,OUI,24,21,3,0,3,OUI,OUI,2025-03-13 15:01:59+00:00,"48.90271566255436, 2.3933270573616032",Pantin,93055,0.125,15
23007,Président Wilson - Jean Jaures,OUI,25,12,13,6,7,OUI,OUI,2025-03-13 15:01:12+00:00,"48.89034054052266, 2.2920683026313786",Levallois-Perret,92044,0.52,15
15031,Théâtre - Lourmel,OUI,52,15,37,36,1,OUI,OUI,2025-03-13 15:00:08+00:00,"48.8482070397636, 2.2898658737540245",Paris,75056,0.7115384615384616,15
20016,Pyrénées - Maraîchers,OUI,32,30,2,0,2,OUI,OUI,2025-03-13 14:59:03+00:00,"48.85714001395299, 2.4043509364128113",Paris,75056,0.0625,15
21014,Hameau Fleuri - Marché,OUI,21,3,18,7,11,OUI,OUI,2025-03-13 15:01:23+00:00,"48.831448892608314, 2.2412404417991643",Boulogne-Billancourt,92012,0.8571428571428571,15
32015,Gare RER de Saint-Denis,OUI,36,26,10,7,3,OUI,OUI,2025-03-13 14:57:35+00:00,"48.93554324248177, 2.3471488058567047",Saint-Denis,93066,0.2777777777777778,15
5121,Square René Viviani - Montebello,OUI,33,2,31,28,3,OUI,OUI,2025-03-13 15:01:47+00:00,"48.851904891406, 2.3478421568871",Paris,75056,0.9393939393939394,15
10010,Place Jacques Bonsergent,OUI,34,3,31,23,8,OUI,OUI,2025-03-13 15:02:01+00:00,"48.870948218595, 2.3612049221992",Paris,75056,0.9117647058823529,15
21001,Transvaal - Charles de Gaulle,OUI,27,17,10,8,2,OUI,OUI,2025-03-13 14:59:39+00:00,"48.848280403628806, 2.2373420120857195",Boulogne-Billancourt,92012,0.37037037037037035,15
16027,Mozart - Jasmin,OUI,62,59,3,3,0,OUI,OUI,2025-03-13 14:56:30+00:00,"48.85286124871689, 2.268483570651513",Paris,75056,0.04838709677419355,15
21310,Kléber - Gouverneur Général Eboué,OUI,22,0,22,15,7,OUI,OUI,2025-03-13 14:59:40+00:00,"48.826885843069796, 2.2723413258790965",Issy-les-Moulineaux,92040,1.0,15
6107,Place Alphonse Deville,OUI,22,1,21,16,5,OUI,OUI,2025-03-13 15:02:02+00:00,"48.850188262662, 2.3275961726904",Paris,75056,0.9545454545454546,15
16043,Place de Passy,OUI,12,11,1,0,1,OUI,OUI,2025-03-13 15:01:56+00:00,"48.85780291711202, 2.277500546942199",Paris,75056,0.08333333333333333,15
8019,Naples - Rome,OUI,25,16,9,1,8,OUI,OUI,2025-03-13 14:58:48+00:00,"48.879960700846226, 2.321358695626259",Paris,75056,0.36,15
20116,Haies - Réunion,OUI,20,19,1,1,0,OUI,OUI,2025-03-13 14:53:34+00:00,"48.85386896766491, 2.402426162238911",Paris,75056,0.05,15
18008,Square Léon,OUI,33,29,4,0,4,OUI,OUI,2025-03-13 14:59:21+00:00,"48.88667396788626, 2.353205569088459",Paris,75056,0.12121212121212122,15
16029,Maison de Radio - France,OUI,42,6,36,36,0,OUI,OUI,2025-03-13 15:02:04+00:00,"48.85132886434057, 2.277785539627075",Paris,75056,0.8571428571428571,15
16112,Chernoviz - Raynouard,OUI,36,33,3,0,3,OUI,OUI,2025-03-13 15:00:50+00:00,"48.8569864146289, 2.282173218142987",Paris,75056,0.08333333333333333,15
9017,Lallier - Trudaine,OUI,28,25,3,0,3,OUI,OUI,2025-03-13 15:00:02+00:00,"48.88109246617963, 2.3408224806189537",Paris,75056,0.10714285714285714,15
20201,Eugène Reisz - Davout,OUI,20,17,3,0,3,OUI,OUI,2025-03-13 14:59:58+00:00,"48.85631874632638, 2.410396970808506",Paris,75056,0.15,15
7008,Villersexel - Saint-Germain,OUI,16,8,8,4,4,OUI,OUI,2025-03-13 14:59:39+00:00,"48.858297001218, 2.3237934708595",Paris,75056,0.5,15
13046,Eugène Oudiné - Dessous Des Berges,OUI,44,18,26,16,10,OUI,OUI,2025-03-13 15:02:05+00:00,"48.8256423, 2.3750226",Paris,75056,0.5909090909090909,15
42703,Fontainebleau - Edmond Michelet,OUI,45,44,1,0,1,OUI,OUI,2025-03-13 14:57:52+00:00,"48.80956436844049, 2.3626908659935",Le Kremlin-Bicêtre,94043,0.022222222222222223,15
4110,Neuve Saint-Pierre - Beautreillis,OUI,20,8,12,11,1,OUI,OUI,2025-03-13 15:01:38+00:00,"48.85355351439652, 2.3639122769236565",Paris,75056,0.6,15
14030,Pernety - Raymond Losserand,OUI,32,32,0,0,0,OUI,OUI,2025-03-13 14:56:37+00:00,"48.834254627953, 2.317609339387",Paris,75056,0.0,15
6032,Sabot - Rennes,OUI,26,5,21,17,4,OUI,OUI,2025-03-13 14:59:46+00:00,"48.852575112948415, 2.331552766263485",Paris,75056,0.8076923076923077,15
22102,Mont Valérien - Michel Salles,OUI,24,9,15,12,3,OUI,OUI,2025-03-13 14:59:48+00:00,"48.8561915, 2.2152966",Saint-Cloud,92064,0.625,15
6017,Sénat - Condé,OUI,31,0,31,20,11,OUI,OUI,2025-03-13 15:01:21+00:00,"48.84954227788459, 2.337939441204071",Paris,75056,1.0,15
15003,Gare Montparnasse - Vaugirard,OUI,66,57,9,0,9,OUI,OUI,2025-03-13 15:01:57+00:00,"48.8418071798797, 2.31951002690117",Paris,75056,0.13636363636363635,15
13103,Hôpital Pitié Salpêtrière,OUI,48,43,5,2,3,OUI,OUI,2025-03-13 14:58:42+00:00,"48.8377016, 2.3604946",Paris,75056,0.10416666666666667,15
17022,Pereire - Place de Wagram,OUI,45,41,4,1,3,OUI,OUI,2025-03-13 15:00:22+00:00,"48.887070607581215, 2.304111124531457",Paris,75056,0.08888888888888889,15
15107,Palais des Sports,OUI,20,1,19,16,3,OUI,OUI,2025-03-13 15:02:03+00:00,"48.833468517426, 2.2858720645308",Paris,75056,0.95,15
7020,Champ de Mars - Cler,OUI,39,13,26,23,3,OUI,OUI,2025-03-13 15:01:37+00:00,"48.856691550115315, 2.306646779179573",Paris,75056,0.6666666666666666,15
18017,Caulaincourt - Place Constantin Pecqueur,OUI,42,37,5,0,5,OUI,OUI,2025-03-13 15:00:17+00:00,"48.889677905028, 2.3381787144261",Paris,75056,0.11904761904761904,15
10036,Aqueduc - Villette,OUI,24,20,4,0,4,OUI,OUI,2025-03-13 15:01:56+00:00,"48.883886063895, 2.367198803315",Paris,75056,0.16666666666666666,15
19041,Belleville - Pyrénées,OUI,38,37,1,0,1,OUI,OUI,2025-03-13 14:59:05+00:00,"48.8741908, 2.3860039",Paris,75056,0.02631578947368421,15
23304,Mairie de Sceaux,OUI,33,30,3,1,2,OUI,OUI,2025-03-13 15:01:51+00:00,"48.778916905132, 2.2887361764861",Sceaux,92071,0.09090909090909091,15
11043,Place Pasdeloup,OUI,20,3,17,15,2,OUI,OUI,2025-03-13 15:01:49+00:00,"48.862654215631, 2.3670325062844",Paris,75056,0.85,15
12161,Diderot - Reuilly,OUI,44,7,37,34,3,OUI,OUI,2025-03-13 15:01:59+00:00,"48.847208456061, 2.3861273378134",Paris,75056,0.8409090909090909,15
1117,Pont Neuf - Rivoli,OUI,25,1,24,13,11,OUI,OUI,2025-03-13 15:02:08+00:00,"48.860089892617, 2.344057559967",Paris,75056,0.96,15
9101,Cadet - La Fayette,OUI,18,3,15,11,4,OUI,OUI,2025-03-13 15:01:52+00:00,"48.875601632672, 2.3435704037547",Paris,75056,0.8333333333333334,15
13010,Place d'Italie - Vincent Auriol,OUI,39,34,5,2,3,OUI,OUI,2025-03-13 15:01:01+00:00,"48.831481874467, 2.3567550292319",Paris,75056,0.1282051282051282,15
23903,Stade Gaston Bouillant,OUI,29,23,6,3,3,OUI,OUI,2025-03-13 14:59:49+00:00,"48.939958667023, 2.3279571813836",Villeneuve-la-Garenne,92078,0.20689655172413793,15
31704,Jeanne Hornet - Girardot,OUI,28,27,1,0,1,OUI,OUI,2025-03-13 14:53:03+00:00,"48.873802681432146, 2.427820265293122",Bagnolet,93006,0.03571428571428571,15
32603,Calmette,OUI,31,28,3,1,2,OUI,OUI,2025-03-13 15:02:00+00:00,"48.88104925098552, 2.424993216991425",Les Lilas,93045,0.0967741935483871,15
15059,Parc André Citroën,OUI,64,7,57,53,4,OUI,OUI,2025-03-13 15:01:59+00:00,"48.840639944296655, 2.2780618071556096",Paris,75056,0.890625,15
17201,Porte Maillot - Perreire,OUI,50,28,22,6,16,OUI,OUI,2025-03-13 15:01:47+00:00,"48.878021154637, 2.2842371277102",Paris,75056,0.44,15
23403,Chateau,OUI,21,18,3,2,1,OUI,OUI,2025-03-13 15:01:28+00:00,"48.774661399959, 2.3135878035462",Bourg-la-Reine,92014,0.14285714285714285,15
21311,Parvis Corentin Celton,OUI,51,11,40,38,2,OUI,OUI,2025-03-13 15:01:32+00:00,"48.82747252522725, 2.2784319519996648",Issy-les-Moulineaux,92040,0.7843137254901961,15
45001,Hôtel de Ville de Champigny sur Marne,OUI,21,4,17,9,8,OUI,OUI,2025-03-13 15:02:00+00:00,"48.813810628405, 2.5096759200096",Champigny-sur-Marne,94017,0.8095238095238095,15
4013,Vieille du Temple - Francs Bourgeois,OUI,28,2,26,22,4,OUI,OUI,2025-03-13 15:01:27+00:00,"48.858256413365815, 2.35821794718504",Paris,75056,0.9285714285714286,15
21024,Billancourt - Général Leclerc,OUI,22,21,1,1,0,OUI,OUI,2025-03-13 15:01:26+00:00,"48.8322649, 2.2380413",Boulogne-Billancourt,92012,0.045454545454545456,15
31023,Place François Mitterand,OUI,34,33,1,0,1,OUI,OUI,2025-03-13 14:54:52+00:00,"48.86492782016328, 2.442958317697048",Montreuil,93048,0.029411764705882353,15
19023,Manin - Simon Bolivar,OUI,24,23,1,0,1,OUI,OUI,2025-03-13 14:55:56+00:00,"48.876499654127, 2.3794073625991",Paris,75056,0.041666666666666664,15
9118,Faubourg Poissonniere - Delta,OUI,36,36,0,0,0,OUI,OUI,2025-03-13 15:00:17+00:00,"48.882555807626765, 2.3497482016682625",Paris,75056,0.0,15
20019,Place du Maquis du Vercors,OUI,30,30,0,0,0,OUI,OUI,2025-03-13 14:54:41+00:00,"48.877321579493575, 2.4083782732486725",Paris,75056,0.0,15
10163,Gare du Nord - Demarquay,OUI,28,28,0,0,0,OUI,OUI,2025-03-13 14:59:51+00:00,"48.881154, 2.358411",Paris,75056,0.0,15
7101,Raspail - Chomel,OUI,49,5,44,28,16,OUI,OUI,2025-03-13 15:01:22+00:00,"48.852233164303, 2.3266580700874",Paris,75056,0.8979591836734694,15
2001,Greneta - Sebastopol,OUI,31,2,29,26,3,OUI,OUI,2025-03-13 15:00:55+00:00,"48.865242333228, 2.3516669869423",Paris,75056,0.9354838709677419,15
8056,Beaujon - Wagram,OUI,28,27,1,1,0,OUI,OUI,2025-03-13 14:59:12+00:00,"48.875352455985, 2.2964416444302",Paris,75056,0.03571428571428571,15
18137,Poissonniers - Nord,OUI,28,23,5,1,4,OUI,OUI,2025-03-13 15:02:01+00:00,"48.892511213520656, 2.3522228747606277",Paris,75056,0.17857142857142858,15
18138,Station Paris Basketball - Ney - Charles Hermite,OUI,20,11,9,5,4,OUI,OUI,2025-03-13 15:01:00+00:00,"48.898748039775, 2.3645754531026",Paris,75056,0.45,15
17116,Reims - Porte d'Asnières,OUI,26,17,9,5,4,OUI,OUI,2025-03-13 15:00:59+00:00,"48.891834448210986, 2.300144659954865",Paris,75056,0.34615384615384615,15
7016,Surcouf - Université,OUI,56,16,40,36,4,OUI,OUI,2025-03-13 15:01:35+00:00,"48.861273016278, 2.3094535509142",Paris,75056,0.7142857142857143,15
13041,Porte d'Ivry,OUI,50,45,5,4,1,OUI,OUI,2025-03-13 15:00:23+00:00,"48.821768747596, 2.3688706755638",Paris,75056,0.1,15
12041,Bois de Vincennes.,OUI,58,45,13,3,10,OUI,OUI,2025-03-13 14:55:28+00:00,"48.8338064, 2.4132221",Saint-Mandé,94067,0.22413793103448276,15
4011,Hôtel de Ville - Pont-Marie,OUI,33,3,30,27,3,OUI,OUI,2025-03-13 15:01:43+00:00,"48.853899645527, 2.3569472506642",Paris,75056,0.9090909090909091,15
12108,Bercy.,OUI,63,11,52,45,7,OUI,OUI,2025-03-13 15:01:13+00:00,"48.839966914994, 2.3788625746965",Paris,75056,0.8253968253968254,15
7013,Duroc - Place de Breteuil,OUI,46,23,23,21,2,OUI,OUI,2025-03-13 15:00:17+00:00,"48.847460641142, 2.3126140236855",Paris,75056,0.5,15
14006,Saint-Jacques - Tombe Issoire,OUI,20,18,2,1,1,OUI,OUI,2025-03-13 15:00:17+00:00,"48.833206330538864, 2.3369108140468597",Paris,75056,0.1,15
21114,Gustave Eiffel - Parc des Impressionnistes,OUI,29,27,2,1,1,OUI,OUI,2025-03-13 14:57:18+00:00,"48.90390619651018, 2.2946908324956894",Clichy,92024,0.06896551724137931,15
17016,Brochant - Square des Batignolles,OUI,31,31,0,0,0,OUI,OUI,2025-03-13 14:59:23+00:00,"48.88818698581028, 2.316861143151153",Paris,75056,0.0,15
31013,Centenaire - Sorins,OUI,42,40,2,0,2,OUI,OUI,2025-03-13 14:54:03+00:00,"48.85853523359734, 2.4273508787155156",Montreuil,93048,0.047619047619047616,15
20202,Dupont de l'Eure - Gambetta,OUI,29,28,1,0,1,OUI,OUI,2025-03-13 15:00:13+00:00,"48.8679385, 2.4003649",Paris,75056,0.034482758620689655,15
32018,Franciade - Gabriel Péri,OUI,26,17,9,8,1,OUI,OUI,2025-03-13 15:01:19+00:00,"48.93261499331498, 2.355954498052597",Saint-Denis,93066,0.34615384615384615,15
18019,Square Raymond Souplex,OUI,51,48,3,1,2,OUI,OUI,2025-03-13 14:57:42+00:00,"48.89183721478911, 2.335426103165901",Paris,75056,0.058823529411764705,15
11003,Keller - La Roquette,OUI,34,26,8,4,4,OUI,OUI,2025-03-13 15:00:17+00:00,"48.8555508, 2.3752778",Paris,75056,0.23529411764705882,15
11034,Parmentier - Fontaine au Roi,OUI,45,38,7,5,2,OUI,OUI,2025-03-13 14:59:47+00:00,"48.86787670551736, 2.372705978671471",Paris,75056,0.15555555555555556,15
15020,Mairie du 15ème,OUI,31,30,1,1,0,OUI,OUI,2025-03-13 14:58:23+00:00,"48.8417762, 2.2986539",Paris,75056,0.03225806451612903,15
9012,Rougemont - Poissonnière,OUI,30,4,26,16,10,OUI,OUI,2025-03-13 15:01:58+00:00,"48.871611569354755, 2.345873080193996",Paris,75056,0.8666666666666667,15
41206,Place des Larris,OUI,34,29,5,1,4,OUI,OUI,2025-03-13 14:59:55+00:00,"48.8568363, 2.4780236",Fontenay-sous-Bois,94033,0.14705882352941177,15
13114,Nationale - Marcel Duchamp,OUI,23,18,5,4,1,OUI,OUI,2025-03-13 14:54:47+00:00,"48.82463749337136, 2.3678014799952507",Paris,75056,0.21739130434782608,15
13113,Vistule - Choisy,OUI,33,31,2,2,0,OUI,OUI,2025-03-13 14:54:55+00:00,"48.82365543660611, 2.3615723848342896",Paris,75056,0.06060606060606061,15
15061,Square Desnouettes,OUI,21,6,15,13,2,OUI,OUI,2025-03-13 15:01:25+00:00,"48.83476837934194, 2.284142297394666",Paris,75056,0.7142857142857143,15
19031,Manin - Crimée,OUI,21,19,2,0,2,OUI,OUI,2025-03-13 15:01:23+00:00,"48.8831217743719, 2.3863670602440834",Paris,75056,0.09523809523809523,15
20017,Saint-Blaise - Mouraud,OUI,27,26,1,0,1,OUI,OUI,2025-03-13 15:01:53+00:00,"48.85696177597818, 2.40869477391243",Paris,75056,0.037037037037037035,15
8015,Roquépine - Malesherbes,OUI,52,11,41,25,16,OUI,OUI,2025-03-13 15:01:59+00:00,"48.87345073390807, 2.320404499769211",Paris,75056,0.7884615384615384,15
11019,Charonne - Philippe-Auguste,OUI,30,28,2,1,1,OUI,OUI,2025-03-13 14:58:45+00:00,"48.855603162026, 2.39054639062",Paris,75056,0.06666666666666667,15
21108,Mairie de Clichy,OUI,44,41,3,2,1,OUI,OUI,2025-03-13 15:00:42+00:00,"48.903653634661, 2.3059353232384",Clichy,92024,0.06818181818181818,15
23008,Hôtel de Ville de Levallois Perret,OUI,25,12,13,11,2,OUI,OUI,2025-03-13 14:58:13+00:00,"48.89314451997415, 2.2888818383216862",Levallois-Perret,92044,0.52,15
14116,Romain Rolland,OUI,25,22,3,2,1,OUI,OUI,2025-03-13 14:59:35+00:00,"48.820215229662765, 2.3234144234418346",Montrouge,92049,0.12,15
6014,Pont de Lodi - Dauphine,OUI,21,2,19,11,8,OUI,OUI,2025-03-13 15:00:56+00:00,"48.855296898603285, 2.339947307565249",Paris,75056,0.9047619047619048,15
47002,Les Juilliottes,OUI,21,7,14,10,4,OUI,OUI,2025-03-13 14:54:26+00:00,"48.8043072, 2.4437362",Maisons-Alfort,94046,0.6666666666666666,15
31018,Gambetta - Michelet,OUI,30,30,0,0,0,OUI,OUI,2025-03-13 15:01:35+00:00,"48.85273792380526, 2.429966032505036",Montreuil,93048,0.0,15
33005,République - Henri Barbusse,OUI,32,15,17,11,6,OUI,OUI,2025-03-13 15:01:16+00:00,"48.90661553626751, 2.389432489871979",Aubervilliers,93001,0.53125,15
2110,Jeûneurs - Mulhouse,OUI,27,17,10,6,4,OUI,OUI,2025-03-13 15:00:57+00:00,"48.868997, 2.346925",Paris,75056,0.37037037037037035,15
7026,Place de Finlande,OUI,24,3,21,17,4,OUI,OUI,2025-03-13 14:58:51+00:00,"48.862408335967, 2.3113624379039",Paris,75056,0.875,15
1016,Thérèse - Opéra,OUI,24,1,23,21,2,OUI,OUI,2025-03-13 14:59:39+00:00,"48.866483514509, 2.3344334212238",Paris,75056,0.9583333333333334,15
5019,Poissy - Saint-Germain,OUI,24,4,20,17,3,OUI,OUI,2025-03-13 14:59:16+00:00,"48.84969649427, 2.3529685288668",Paris,75056,0.8333333333333334,15
14007,Ferrus - Saint-Jacques,OUI,33,29,4,2,2,OUI,OUI,2025-03-13 15:01:18+00:00,"48.8313878, 2.3408563",Paris,75056,0.12121212121212122,15
17033,Carnot - Général Lanrezac,OUI,29,26,3,1,2,OUI,OUI,2025-03-13 14:54:03+00:00,"48.875443870736, 2.2938242935036",Paris,75056,0.10344827586206896,15
10164,Claude Vellefaux - Sambre et Meuse,OUI,32,30,2,2,0,OUI,OUI,2025-03-13 15:01:06+00:00,"48.875022, 2.370478",Paris,75056,0.0625,15
11107,Faidherbe - Dahomey,OUI,41,15,26,20,6,OUI,OUI,2025-03-13 15:00:29+00:00,"48.851358329771806, 2.383823134795429",Paris,75056,0.6341463414634146,15
9113,Bleue - Trévise,OUI,27,9,18,11,7,OUI,OUI,2025-03-13 15:02:05+00:00,"48.87578906564573, 2.347289621829987",Paris,75056,0.6666666666666666,15
20103,Le Vau - Maurice Bertaux,OUI,23,23,0,0,0,OUI,OUI,2025-03-13 14:55:04+00:00,"48.86803439043193, 2.411030612453627",Paris,75056,0.0,15
2014,Daunou - Louis le Grand,OUI,30,5,25,7,18,OUI,OUI,2025-03-13 15:01:21+00:00,"48.869113, 2.332515",Paris,75056,0.8333333333333334,15
3101,Porte Saint-Martin,OUI,31,4,27,23,4,OUI,OUI,2025-03-13 15:02:04+00:00,"48.86860172112996, 2.35570102930069",Paris,75056,0.8709677419354839,15
4109,Mornay - Sully,OUI,13,9,4,3,1,OUI,OUI,2025-03-13 15:01:22+00:00,"48.84970399548416, 2.364460788667202",Paris,75056,0.3076923076923077,15
8105,François 1er - Lincoln,OUI,29,9,20,0,20,OUI,OUI,2025-03-13 15:02:01+00:00,"48.869517979344, 2.3024262188416",Paris,75056,0.6896551724137931,15
15058,Place du Moulin de Javel,OUI,54,8,46,38,8,OUI,OUI,2025-03-13 15:01:52+00:00,"48.84021670922, 2.2716060653329",Paris,75056,0.8518518518518519,15
17104,Jardin Marguerite Long,OUI,21,14,7,2,5,OUI,OUI,2025-03-13 15:01:38+00:00,"48.8816985773914, 2.2836575657129288",Paris,75056,0.3333333333333333,15
11048,Place Mireille Havet,OUI,41,6,35,30,5,OUI,OUI,2025-03-13 15:02:07+00:00,"48.850533, 2.383756",Paris,75056,0.8536585365853658,15
21004,Jean Jaurès - Reine,OUI,31,6,25,21,4,OUI,OUI,2025-03-13 14:59:18+00:00,"48.84009622558849, 2.239872515201569",Boulogne-Billancourt,92012,0.8064516129032258,15
2101,Bachaumont - Montmartre,OUI,33,8,25,24,1,OUI,OUI,2025-03-13 14:58:48+00:00,"48.86617395079137, 2.3449775576591496",Paris,75056,0.7575757575757576,15
13022,Butte aux Cailles - Esperance,OUI,30,28,2,1,1,OUI,OUI,2025-03-13 14:59:31+00:00,"48.82758774190948, 2.3492151126265526",Paris,75056,0.06666666666666667,15
8049,Georges V - François 1er,OUI,21,8,13,4,9,OUI,OUI,2025-03-13 15:02:00+00:00,"48.87034, 2.30082",Paris,75056,0.6190476190476191,15
5030,Sorbonne - Ecoles,OUI,47,11,36,8,28,OUI,OUI,2025-03-13 15:02:03+00:00,"48.849686566191, 2.3434996604919",Paris,75056,0.7659574468085106,15
12154,Square Georges Melies,OUI,38,27,11,7,4,OUI,OUI,2025-03-13 15:00:41+00:00,"48.84070239213081, 2.409667745232582",Paris,75056,0.2894736842105263,15
16041,Versailles - Claude Terrasse,OUI,44,19,25,23,2,OUI,OUI,2025-03-13 14:56:51+00:00,"48.840219338074, 2.263834191153",Paris,75056,0.5681818181818182,15
22017,Charles de Gaulle - Louis Philippe,OUI,25,19,6,4,2,OUI,OUI,2025-03-13 15:00:53+00:00,"48.881742142181, 2.2710045335353",Neuilly-sur-Seine,92051,0.24,15
9015,Lamartine - Faubourg Montmartre,OUI,30,14,16,11,5,OUI,OUI,2025-03-13 14:57:20+00:00,"48.876613982891, 2.3397656902671",Paris,75056,0.5333333333333333,15
19021,Mairie du 19ème,OUI,24,21,3,2,1,OUI,OUI,2025-03-13 15:00:54+00:00,"48.88256264247959, 2.3812624812126164",Paris,75056,0.125,15
16031,Vignes - Boulainvilliers,OUI,20,17,3,2,1,OUI,OUI,2025-03-13 14:58:14+00:00,"48.856399483950504, 2.275240458548069",Paris,75056,0.15,15
19030,Melun - Jean Jaurès,OUI,27,27,0,0,0,OUI,OUI,2025-03-13 14:57:07+00:00,"48.8837796723475, 2.376477420330048",Paris,75056,0.0,15
12153,Terroirs de France - Lheureux,OUI,55,18,37,20,17,OUI,OUI,2025-03-13 15:01:51+00:00,"48.83212027074841, 2.388618104159832",Paris,75056,0.6727272727272727,15
22002,Argenson - Château,OUI,24,4,20,17,3,OUI,OUI,2025-03-13 15:01:29+00:00,"48.888559314669514, 2.2642001509666447",Neuilly-sur-Seine,92051,0.8333333333333334,15
17005,Brochant - Clichy,OUI,52,48,4,1,3,OUI,OUI,2025-03-13 14:59:49+00:00,"48.89032998912038, 2.319730559929781",Paris,75056,0.07692307692307693,15
35008,Place de l'Eglise - Pantin,OUI,28,27,1,0,1,OUI,OUI,2025-03-13 15:01:04+00:00,"48.892809461520265, 2.4124351143836975",Pantin,93055,0.03571428571428571,15
21017,Place Marcel Sembat,OUI,55,4,51,41,10,OUI,OUI,2025-03-13 15:01:17+00:00,"48.83328865030686, 2.2441747784614567",Boulogne-Billancourt,92012,0.9272727272727272,15
20045,Louis Ganne - Davout,OUI,30,30,0,0,0,OUI,OUI,2025-03-13 14:59:08+00:00,"48.86338720692607, 2.409725748002529",Paris,75056,0.0,15
12033,François Truffaut - Saint Emilion,OUI,66,9,57,49,8,OUI,OUI,2025-03-13 15:01:28+00:00,"48.83372354344807, 2.386601903271428",Paris,75056,0.8636363636363636,15
13019,Fernand Braudel - Vincent Auriol,OUI,36,9,27,20,7,OUI,OUI,2025-03-13 15:01:21+00:00,"48.83637852318147, 2.3723404482007027",Paris,75056,0.75,15
18142,Jessaint - Marx Dormoy,OUI,30,29,1,0,1,OUI,OUI,2025-03-13 15:01:18+00:00,"48.88484543106364, 2.358930408954621",Paris,75056,0.03333333333333333,15
11044,Square du Bataclan,OUI,17,3,14,13,1,OUI,OUI,2025-03-13 14:59:34+00:00,"48.8633762, 2.3711327",Paris,75056,0.8235294117647058,15
23105,Sèvres Rive Gauche,OUI,33,20,13,13,0,OUI,OUI,2025-03-13 14:55:59+00:00,"48.821443218278, 2.2150785306885",Sèvres,92072,0.3939393939393939,15
21952,Place Tony de Graaff,OUI,42,16,26,18,8,OUI,OUI,2025-03-13 14:59:03+00:00,"48.8181645, 2.2458109",Meudon,92048,0.6190476190476191,15
15009,Suffren - Pérignon,OUI,45,6,39,31,8,OUI,OUI,2025-03-13 15:00:17+00:00,"48.84717561492764, 2.307052147596786",Paris,75056,0.8666666666666667,15
8029,Place du Canada,OUI,56,6,50,26,24,OUI,OUI,2025-03-13 15:01:19+00:00,"48.865346269363, 2.3101937879648",Paris,75056,0.8928571428571429,15
21120,Docteur Calmette - Martre,OUI,30,27,3,3,0,OUI,OUI,2025-03-13 15:00:16+00:00,"48.898969358483, 2.3086513252383",Clichy,92024,0.1,15
11110,Roquette - Folie Regnault,OUI,50,45,5,2,3,OUI,OUI,2025-03-13 15:02:05+00:00,"48.859246959155485, 2.386553623578705",Paris,75056,0.1,15
20117,Saint-Fargeau - Mortier,OUI,31,30,1,0,1,OUI,OUI,2025-03-13 14:53:58+00:00,"48.87266656122256, 2.407912909984589",Paris,75056,0.03225806451612903,15
14127,Odessa - Départ,OUI,39,27,12,7,5,OUI,OUI,2025-03-13 15:02:01+00:00,"48.842885590081, 2.3244281485677",Paris,75056,0.3076923076923077,15
48009,République - Auguste Perret,OUI,30,29,1,1,0,OUI,OUI,2025-03-13 14:57:55+00:00,"48.78695280952244, 2.3518594354391094",Villejuif,94076,0.03333333333333333,15
14016,René Coty - Parc Montsouris,OUI,54,50,4,2,2,OUI,OUI,2025-03-13 14:56:43+00:00,"48.82479134498032, 2.336124926805496",Paris,75056,0.07407407407407407,15
14125,Dareau - Broussais,OUI,21,17,4,0,4,OUI,OUI,2025-03-13 15:01:45+00:00,"48.8307758, 2.3361804",Paris,75056,0.19047619047619047,15
12120,Lac Daumesnil - Saint-Maurice,OUI,49,37,12,9,3,OUI,OUI,2025-03-13 14:56:27+00:00,"48.82774555743318, 2.4183654785156246",Paris,75056,0.24489795918367346,15
21009,Le Corbusier - Jean Jaurès,OUI,45,15,30,22,8,OUI,OUI,2025-03-13 14:58:47+00:00,"48.83780830557548, 2.2408381104469304",Boulogne-Billancourt,92012,0.6666666666666666,15
22012,Madeleine Michelis - Roule,OUI,23,12,11,3,8,OUI,OUI,2025-03-13 14:57:07+00:00,"48.88260431301364, 2.2773634269833565",Neuilly-sur-Seine,92051,0.4782608695652174,15
44103,Pont De Charenton,OUI,18,6,12,12,0,OUI,OUI,2025-03-13 15:02:07+00:00,"48.8179685, 2.4199531",Saint-Maurice,94069,0.6666666666666666,15
18035,René Binet - Porte de Montmartre,OUI,36,32,4,1,3,OUI,OUI,2025-03-13 15:02:04+00:00,"48.89905109950848, 2.3365534096956253",Paris,75056,0.1111111111111111,15
4107,Beaumarchais - Pas de la Mule,OUI,17,7,10,6,4,OUI,OUI,2025-03-13 15:02:07+00:00,"48.855580507049, 2.3684333673431",Paris,75056,0.5882352941176471,15
13110,Moulin de la Pointe,OUI,21,18,3,0,3,OUI,OUI,2025-03-13 14:59:19+00:00,"48.82092946051445, 2.3563179373741145",Paris,75056,0.14285714285714285,15
9013,Mairie du 9ème,OUI,24,5,19,13,6,OUI,OUI,2025-03-13 15:00:47+00:00,"48.873267137583, 2.3407534480528",Paris,75056,0.7916666666666666,15
23005,Gare de Clichy-Levallois,OUI,25,10,15,13,2,OUI,OUI,2025-03-13 15:01:45+00:00,"48.89679827481989, 2.2984680533409123",Levallois-Perret,92044,0.6,15
42004,Westermeyer - Paul Vaillant-Couturier,OUI,27,14,13,11,2,OUI,OUI,2025-03-13 15:01:50+00:00,"48.819116181578764, 2.3966637253761296",Ivry-sur-Seine,94041,0.48148148148148145,15
31017,Jean Moulin - Paul Doumer,OUI,17,14,3,0,3,OUI,OUI,2025-03-13 14:56:58+00:00,"48.8622179854695, 2.45533436536789",Montreuil,93048,0.17647058823529413,15
10039,Sambre et Meuse - Villette,OUI,24,18,6,0,6,OUI,OUI,2025-03-13 15:00:37+00:00,"48.874405666217, 2.3738072379951",Paris,75056,0.25,15
13047,Boutroux - Porte de Vitry,OUI,49,27,22,18,4,OUI,OUI,2025-03-13 14:59:24+00:00,"48.822632, 2.377738",Paris,75056,0.4489795918367347,15
19036,Hôpital Robert Debré,OUI,33,31,2,0,2,OUI,OUI,2025-03-13 14:58:36+00:00,"48.88005222200894, 2.4008650346327003",Paris,75056,0.06060606060606061,15
18114,Véron - Lepic,OUI,23,22,1,0,1,OUI,OUI,2025-03-13 15:01:21+00:00,"48.88526123395252, 2.334559857845307",Paris,75056,0.043478260869565216,15
35004,Place du Président Salvador Allende,OUI,58,51,7,1,6,OUI,OUI,2025-03-13 14:56:45+00:00,"48.897307310356055, 2.40079153681279",Pantin,93055,0.1206896551724138,15
22403,Pierre Brossolette - Adolphe Pinard,OUI,23,21,2,1,1,OUI,OUI,2025-03-13 15:01:04+00:00,"48.821772279548, 2.3131558299065",Malakoff,92046,0.08695652173913043,15
31707,Edouard Vaillant - Galliéni,OUI,48,44,4,1,3,OUI,OUI,2025-03-13 15:02:04+00:00,"48.858462881661, 2.4147954583168",Bagnolet,93006,0.08333333333333333,15
42011,Quai Marcel Boyer - Victor Hugo,OUI,29,5,24,22,2,OUI,OUI,2025-03-13 15:00:48+00:00,"48.822556366667, 2.3920395970345",Ivry-sur-Seine,94041,0.8275862068965517,15
13020,Paul Klee - Place Augusta Holmes,OUI,43,14,29,6,23,OUI,OUI,2025-03-13 15:00:50+00:00,"48.838946417408025, 2.3704235663952966",Paris,75056,0.6744186046511628,15
20047,Cours de Vincennes - Davout,OUI,48,41,7,3,4,OUI,OUI,2025-03-13 15:00:46+00:00,"48.847238029966, 2.4107042336225",Paris,75056,0.14583333333333334,15
19124,Alexander Fleming - Belvédère,OUI,31,31,0,0,0,OUI,OUI,2025-03-13 15:01:28+00:00,"48.88179064200294, 2.4030599377642674",Paris,75056,0.0,15
21951,Place Centrale,OUI,22,21,1,1,0,OUI,OUI,2025-03-13 14:54:10+00:00,"48.78740167690531, 2.2278830409049992",Meudon,92048,0.045454545454545456,15
32021,Place du Front Populaire - George Sand,OUI,64,44,20,15,5,OUI,OUI,2025-03-13 15:01:17+00:00,"48.90680713698062, 2.364541214992642",Saint-Denis,93066,0.3125,15
92005,Gare de Nanterre Ville,OUI,42,17,25,19,6,OUI,OUI,2025-03-13 15:01:15+00:00,"48.8950295, 2.1957932",Nanterre,92050,0.5952380952380952,15
7024,Rapp - Place du Général Gouraud,OUI,29,26,3,0,3,OUI,OUI,2025-03-13 14:51:35+00:00,"48.858102885107, 2.3004072904587",Paris,75056,0.10344827586206896,15
22103,Senard - Charles Blum,OUI,24,5,19,7,12,OUI,OUI,2025-03-13 14:59:41+00:00,"48.857315824799, 2.221091687679291",Saint-Cloud,92064,0.7916666666666666,15
11031,Jacquard - Ternaux,OUI,39,25,14,12,2,OUI,OUI,2025-03-13 15:01:46+00:00,"48.8646605, 2.373162",Paris,75056,0.358974358974359,15
19113,Pré Saint-Gervais - Lilas,OUI,27,24,3,0,3,OUI,OUI,2025-03-13 15:02:00+00:00,"48.877870626988, 2.3959073424339",Paris,75056,0.1111111111111111,15
12125,Pyramide - Parc Floral,OUI,50,45,5,2,3,OUI,OUI,2025-03-13 14:51:41+00:00,"48.837442, 2.440452",Paris,75056,0.1,15
14128,Gergovie - Vercingétorix,OUI,29,28,1,0,1,OUI,OUI,2025-03-13 14:52:42+00:00,"48.83453413883994, 2.313154547426182",Paris,75056,0.034482758620689655,15
9016,Choron - Martyrs,OUI,17,5,12,4,8,OUI,OUI,2025-03-13 14:57:08+00:00,"48.877851443503, 2.3396701365709",Paris,75056,0.7058823529411765,15
31101,Jules Guesde - Laennec,OUI,19,14,5,0,5,OUI,OUI,2025-03-13 14:56:57+00:00,"48.87628983900398, 2.5006942078471184",Rosny-sous-Bois,93064,0.2631578947368421,15
15131,Charles Lecocq - Lecourbe,OUI,28,20,8,5,3,OUI,OUI,2025-03-13 15:00:13+00:00,"48.84044, 2.294867",Paris,75056,0.2857142857142857,15
31026,Demi-Lune - Aristide Briand,OUI,20,18,2,0,2,OUI,OUI,2025-03-13 15:00:32+00:00,"48.87626381919953, 2.4562818557024",Montreuil,93048,0.1,15
15125,Parc Suzanne Lenglen,OUI,51,2,49,45,4,OUI,OUI,2025-03-13 15:01:45+00:00,"48.833250690537874, 2.2765403240919113",Paris,75056,0.9607843137254902,15
17001,Guy Môquet - Saint-Ouen,OUI,44,39,5,1,4,OUI,OUI,2025-03-13 15:00:21+00:00,"48.892777719023975, 2.3270335793495183",Paris,75056,0.11363636363636363,15
13117,Stade Georges Carpentier,OUI,39,37,2,1,1,OUI,OUI,2025-03-13 14:58:27+00:00,"48.820482438381, 2.3668321967125",Paris,75056,0.05128205128205128,15
12129,Bois de Vincennes - Porte Jaune,OUI,35,33,2,1,1,OUI,OUI,2025-03-13 14:55:30+00:00,"48.838751246689455, 2.4605489149689674",Paris,75056,0.05714285714285714,15
17029,Pierre Demours - Laugier,OUI,36,32,4,2,2,OUI,OUI,2025-03-13 14:58:03+00:00,"48.8813072, 2.294846",Paris,75056,0.1111111111111111,15
8011,Clapeyron - Moscou,OUI,15,12,3,2,1,OUI,OUI,2025-03-13 14:57:50+00:00,"48.88078819514121, 2.324815057218075",Paris,75056,0.2,15
10004,Metz - Faubourg Saint-Denis,OUI,44,18,26,24,2,OUI,OUI,2025-03-13 15:00:26+00:00,"48.870893, 2.353521",Paris,75056,0.5909090909090909,15
7010,Constantine - Université,OUI,58,3,55,47,8,OUI,OUI,2025-03-13 15:01:16+00:00,"48.860680473738, 2.3148481955842",Paris,75056,0.9482758620689655,15
22013,Mairie de Neuilly sur Seine,OUI,30,25,5,4,1,OUI,OUI,2025-03-13 15:00:31+00:00,"48.88494728765838, 2.2677031159400944",Neuilly-sur-Seine,92051,0.16666666666666666,15
14113,Santé - Arago,OUI,36,30,6,1,5,OUI,OUI,2025-03-13 15:00:36+00:00,"48.83507657562064, 2.3415737262044938",Paris,75056,0.16666666666666666,15
21316,Cimetière d'Issy-les-Moulineaux,OUI,23,23,0,0,0,OUI,OUI,2025-03-13 15:01:31+00:00,"48.817699773925, 2.2609312087297",Issy-les-Moulineaux,92040,0.0,15
35015,Averroès - Aimé Césaire,OUI,18,17,1,1,0,OUI,OUI,2025-03-13 14:55:16+00:00,"48.91405323432864, 2.412636950612068",Pantin,93055,0.05555555555555555,15
21029,Cours de l'Ile Seguin - Parc Billancourt,OUI,28,4,24,18,6,OUI,OUI,2025-03-13 15:00:39+00:00,"48.82714055843935, 2.234234511852265",Boulogne-Billancourt,92012,0.8571428571428571,15
15019,Paul Barruel - Vaugirard,OUI,36,31,5,2,3,OUI,OUI,2025-03-13 15:01:03+00:00,"48.84014918546239, 2.3044332861900334",Paris,75056,0.1388888888888889,15
10153,Gare du Nord - Denain,OUI,20,17,3,0,3,OUI,OUI,2025-03-13 15:01:53+00:00,"48.879595787608, 2.3544725775719",Paris,75056,0.15,15
20203,Evariste Galois,OUI,20,20,0,0,0,OUI,OUI,2025-03-13 14:53:21+00:00,"48.873341356228, 2.4133544409574",Paris,75056,0.0,15
12006,Gare de Lyon - Van Gogh,OUI,41,4,37,26,11,OUI,OUI,2025-03-13 14:59:17+00:00,"48.843839785643, 2.3704450240357",Paris,75056,0.9024390243902439,15
20004,Commandant l'Herminier - Gallieni,OUI,17,16,1,1,0,OUI,OUI,2025-03-13 15:00:59+00:00,"48.847040552603, 2.4160453677177",Paris,75056,0.058823529411764705,15
16014,Eylau - Trocadéro,OUI,22,15,7,0,7,OUI,OUI,2025-03-13 15:00:43+00:00,"48.863354122371, 2.2864209115505",Paris,75056,0.3181818181818182,15
12150,Bastille - Quai de la Rapée,OUI,27,1,26,22,4,OUI,OUI,2025-03-13 15:01:23+00:00,"48.84682410855, 2.3669364675879",Paris,75056,0.9629629629629629,15
21708,Marcel Yol - Jullien,OUI,28,28,0,0,0,OUI,OUI,2025-03-13 15:01:47+00:00,"48.82537611802588, 2.287235018058929",Vanves,92075,0.0,15
13515,Auguste Blanqui - Glacière,OUI,59,53,6,5,1,OUI,OUI,2025-03-13 15:01:40+00:00,"48.831151602964, 2.343822196126",Paris,75056,0.1016949152542373,15
21702,Gare SNCF Vanves-Malakoff,OUI,49,47,2,1,1,OUI,OUI,2025-03-13 14:58:52+00:00,"48.819002163836444, 2.292150005103606",Vanves,92075,0.04081632653061224,15
10152,Gare du Nord - Place de Valenciennes,OUI,23,18,5,2,3,OUI,OUI,2025-03-13 15:01:34+00:00,"48.879089, 2.354235",Paris,75056,0.21739130434782608,15
11109,Pierre Levée - Fontaine Timbaud,OUI,21,16,5,0,5,OUI,OUI,2025-03-13 14:58:23+00:00,"48.86632723374305, 2.3711163550615306",Paris,75056,0.23809523809523808,15
10037,Quai de Valmy,OUI,26,24,2,2,0,OUI,OUI,2025-03-13 15:00:38+00:00,"48.88126951579429, 2.368186041712761",Paris,75056,0.07692307692307693,15
15052,Convention - Vaugirard,OUI,45,28,17,5,12,OUI,OUI,2025-03-13 15:00:56+00:00,"48.83767682233156, 2.295586926020252",Paris,75056,0.37777777777777777,15
9036,Athènes - Clichy,OUI,18,8,10,5,5,OUI,OUI,2025-03-13 15:01:00+00:00,"48.878113787876, 2.32956021945824",Paris,75056,0.5555555555555556,15
31021,Résistance - Hoche,OUI,28,27,1,0,1,OUI,OUI,2025-03-13 14:57:57+00:00,"48.864273423741956, 2.435784414410591",Montreuil,93048,0.03571428571428571,15
13027,Mazagran - Pierre de Coubertin,OUI,15,9,6,2,4,OUI,OUI,2025-03-13 14:59:31+00:00,"48.816218640260445, 2.344226874411106",Paris,75056,0.4,15
44002,Paul Vaillant-Couturier - Gare RER,OUI,25,5,20,18,2,OUI,OUI,2025-03-13 15:00:47+00:00,"48.80108159069614, 2.402097210288048",Vitry-sur-Seine,94081,0.8,15
21118,Neuilly - Petit,OUI,14,5,9,6,3,OUI,OUI,2025-03-13 15:01:07+00:00,"48.898965361341254, 2.29627937078476",Clichy,92024,0.6428571428571429,15
21031,Cimetière de Boulogne-Billancourt,OUI,40,9,31,25,6,OUI,OUI,2025-03-13 15:01:47+00:00,"48.830764, 2.252024",Boulogne-Billancourt,92012,0.775,15
11103,Pelée - Alphonse Baudin,OUI,35,18,17,10,7,OUI,OUI,2025-03-13 15:01:09+00:00,"48.8600265, 2.3710541",Paris,75056,0.4857142857142857,15
16024,Ranelagh - Maison de la Radio,OUI,20,4,16,15,1,OUI,OUI,2025-03-13 14:58:35+00:00,"48.85293603169479, 2.280449643731117",Paris,75056,0.8,15
20039,Belleville - Couronnes,OUI,48,43,5,0,5,OUI,OUI,2025-03-13 14:59:31+00:00,"48.868831082877, 2.3809862136841",Paris,75056,0.10416666666666667,15
17039,Place Saint-Ferdinand,OUI,38,21,17,6,11,OUI,OUI,2025-03-13 15:01:41+00:00,"48.87815529789739, 2.288518047864942",Paris,75056,0.4473684210526316,15
4010,Saint-Antoine Sévigné,OUI,22,9,13,12,1,OUI,OUI,2025-03-13 15:00:29+00:00,"48.8550222, 2.3612322",Paris,75056,0.5909090909090909,15
8001,Petit Palais,OUI,45,10,35,19,16,OUI,OUI,2025-03-13 15:00:12+00:00,"48.8667692, 2.3157655",Paris,75056,0.7777777777777778,15
21203,Place Jules Ferry,OUI,28,28,0,0,0,OUI,OUI,2025-03-13 14:59:09+00:00,"48.812107928414775, 2.325837314128876",Montrouge,92049,0.0,15
13121,Bruneseau - Quai d'Ivry,OUI,46,0,46,45,1,OUI,OUI,2025-03-13 15:01:54+00:00,"48.824945637583, 2.3885661363602",Ivry-sur-Seine,94041,1.0,15
5034,Censier - Santeuil,OUI,66,25,41,39,2,OUI,OUI,2025-03-13 14:59:16+00:00,"48.840658921385234, 2.3537524044513702",Paris,75056,0.6212121212121212,15
21307,Victor Cresson - Telles de la Poterie,OUI,29,17,12,10,2,OUI,OUI,2025-03-13 14:56:29+00:00,"48.822698842979, 2.2686498274964",Issy-les-Moulineaux,92040,0.41379310344827586,15
10017,Gare de l'Est - Fidélité,OUI,11,0,11,8,3,OUI,OUI,2025-03-13 14:59:28+00:00,"48.874575, 2.356796",Paris,75056,1.0,15
10012,Vinaigriers - Magenta,OUI,24,14,10,8,2,OUI,OUI,2025-03-13 15:00:40+00:00,"48.8731167, 2.3593052",Paris,75056,0.4166666666666667,15
19025,Botzaris - Crimée,OUI,20,18,2,0,2,OUI,OUI,2025-03-13 15:00:04+00:00,"48.87959698690176, 2.3887913337477067",Paris,75056,0.1,15
21028,Pierre Lefaucheux - Traversière,OUI,34,6,28,18,10,OUI,OUI,2025-03-13 15:01:39+00:00,"48.82435208303827, 2.2417913004755974",Boulogne-Billancourt,92012,0.8235294117647058,15
16009,Saint-Didier - Raymond Poincaré,OUI,17,10,7,1,6,OUI,OUI,2025-03-13 15:01:29+00:00,"48.86642312020962, 2.285863497192411",Paris,75056,0.4117647058823529,15
13011,Hôpital - Campo-Formio,OUI,11,10,1,0,1,OUI,OUI,2025-03-13 15:01:25+00:00,"48.835405, 2.358218",Paris,75056,0.09090909090909091,15
16003,André Maurois - Joseph et Marie Hackin,OUI,27,14,13,11,2,OUI,OUI,2025-03-13 14:59:25+00:00,"48.8778983, 2.2789591",Paris,75056,0.48148148148148145,15
5014,Jean Calvin - Tournefort,OUI,28,22,6,5,1,OUI,OUI,2025-03-13 15:02:07+00:00,"48.84158856925782, 2.348489575088024",Paris,75056,0.21428571428571427,15
15072,Place Fernand Forest,OUI,28,1,27,21,6,OUI,OUI,2025-03-13 15:00:20+00:00,"48.849269143836, 2.281863167882",Paris,75056,0.9642857142857143,15
8549,George V - Christophe Colomb,OUI,24,1,23,5,18,OUI,OUI,2025-03-13 15:01:47+00:00,"48.87046, 2.30104",Paris,75056,0.9583333333333334,15
16007,Longchamp - Place d'Iéna,OUI,25,12,13,3,10,OUI,OUI,2025-03-13 15:01:54+00:00,"48.864917233434, 2.2926748171449",Paris,75056,0.52,15
20122,Vitruve - Davout,OUI,23,21,2,0,2,OUI,OUI,2025-03-13 14:59:30+00:00,"48.86053161154489, 2.4091592812626543",Paris,75056,0.08695652173913043,15
10110,Louis Blanc - Jemmapes,OUI,31,23,8,1,7,OUI,OUI,2025-03-13 14:58:39+00:00,"48.879330755297, 2.3684485629201",Paris,75056,0.25806451612903225,15
13126,Place Nationale - Château-des-Rentiers,OUI,18,10,8,2,6,OUI,OUI,2025-03-13 15:00:01+00:00,"48.829268, 2.365212",Paris,75056,0.4444444444444444,15
21115,Chancé Milly - Cimetière Communal Sud,OUI,32,17,15,13,2,OUI,OUI,2025-03-13 15:00:29+00:00,"48.89687189382465, 2.303922325372696",Clichy,92024,0.46875,15
8020,Batignolles - Beudant,OUI,43,38,5,2,3,OUI,OUI,2025-03-13 15:02:00+00:00,"48.88216401466375, 2.319852970540523",Paris,75056,0.11627906976744186,15
13048,Wurtz - Tolbiac,OUI,28,28,0,0,0,NON,NON,2025-03-13 12:52:17+00:00,"48.82631195621, 2.344585955143",Paris,75056,0.0,13
17015,Place de Lévis,OUI,48,46,2,1,1,OUI,OUI,2025-03-13 15:00:04+00:00,"48.883546851533254, 2.3131933808326726",Paris,75056,0.041666666666666664,15
41210,Hôtel de ville de Fontenay-sous-Bois,OUI,19,18,1,0,1,OUI,OUI,2025-03-13 14:54:41+00:00,"48.84949749106274, 2.4750164151191716",Fontenay-sous-Bois,94033,0.05263157894736842,15
4001,Arcole - Notre-Dame,OUI,28,15,13,3,10,OUI,OUI,2025-03-13 15:01:36+00:00,"48.853883541328, 2.3493797332048",Paris,75056,0.4642857142857143,15
42304,Marc Sangnier - Division Leclerc,OUI,21,6,15,12,3,OUI,OUI,2025-03-13 15:01:49+00:00,"48.78599652305309, 2.329955510795116",Cachan,94016,0.7142857142857143,15
42501,Raspail - Albert Schweitzer,OUI,27,9,18,18,0,OUI,OUI,2025-03-13 15:01:28+00:00,"48.81031545, 2.34395871",Gentilly,94037,0.6666666666666666,15
16115,Raffet - Montmorency,OUI,40,32,8,2,6,OUI,OUI,2025-03-13 15:01:24+00:00,"48.85258670812, 2.2629252456151954",Paris,75056,0.2,15
6008,Assas - Luxembourg,OUI,31,15,16,3,13,OUI,OUI,2025-03-13 15:01:39+00:00,"48.843734468779, 2.3334283818759",Paris,75056,0.5161290322580645,15
15123,Commerce - Letellier,OUI,43,30,13,6,7,OUI,OUI,2025-03-13 15:00:19+00:00,"48.84797660373612, 2.2966245196598805",Paris,75056,0.3023255813953488,15
13109,Brillat-Savarin - Küss,OUI,21,15,6,6,0,OUI,OUI,2025-03-13 14:58:03+00:00,"48.822203, 2.350422",Paris,75056,0.2857142857142857,15
13039,Ivry - Simone Weil,OUI,18,14,4,3,1,OUI,OUI,2025-03-13 15:00:22+00:00,"48.823283932030755, 2.3659095168113713",Paris,75056,0.2222222222222222,15
21204,Estienne d'Orves - Henri Ginoux,OUI,30,27,3,0,3,OUI,OUI,2025-03-13 15:00:23+00:00,"48.815388220397274, 2.320886790760933",Montrouge,92049,0.1,15
21030,Fessart - Château,OUI,20,2,18,14,4,OUI,OUI,2025-03-13 15:01:41+00:00,"48.84245, 2.23989",Boulogne-Billancourt,92012,0.9,15
42209,Place de l'Europe - Quai de Bercy,OUI,15,2,13,9,4,OUI,OUI,2025-03-13 15:01:55+00:00,"48.82529858840266, 2.3945679143071175",Charenton-le-Pont,94018,0.8666666666666667,15
15043,Brancion - Lefebvre,OUI,9,5,4,0,4,OUI,OUI,2025-03-13 15:00:47+00:00,"48.82900222785569, 2.301431038163409",Paris,75056,0.4444444444444444,15
43001,Paris - Laitières,OUI,22,11,11,2,9,OUI,OUI,2025-03-13 15:01:59+00:00,"48.84630274151258, 2.4207553267478947",Vincennes,94080,0.5,15
22604,Hôtel de Ville de Fontenay-aux-Roses,OUI,32,32,0,0,0,OUI,OUI,2025-03-13 14:53:23+00:00,"48.790844603480856, 2.2871455930319455",Fontenay-aux-Roses,92032,0.0,15
11021,Charonne - Pierre Bayle,OUI,23,21,2,1,1,OUI,OUI,2025-03-13 14:59:29+00:00,"48.858445054262, 2.3903981223891",Paris,75056,0.08695652173913043,15
20009,Docteurs Déjérine - Pte de Montreuil,OUI,19,16,3,2,1,OUI,OUI,2025-03-13 14:57:21+00:00,"48.85398448133697, 2.41208288897222",Paris,75056,0.15789473684210525,15
9114,Faubourg Poissonnière - Dunkerque,OUI,29,27,2,1,1,OUI,OUI,2025-03-13 15:01:50+00:00,"48.880883445404436, 2.349934279918671",Paris,75056,0.06896551724137931,15
42305,Vanne - Saussaies,OUI,20,17,3,0,3,OUI,OUI,2025-03-13 14:53:06+00:00,"48.786404, 2.338848",Cachan,94016,0.15,15
16011,Victor Hugo - La Pompe,OUI,40,33,7,2,5,OUI,OUI,2025-03-13 14:54:58+00:00,"48.86795222470859, 2.28146318346262",Paris,75056,0.175,15
11032,Jean-Pierre Timbaud - Vaucouleurs,OUI,45,32,13,6,7,OUI,OUI,2025-03-13 15:02:06+00:00,"48.867937, 2.377885",Paris,75056,0.28888888888888886,15
47001,Place de la Gare,OUI,45,4,41,38,3,OUI,OUI,2025-03-13 15:01:17+00:00,"48.80253358011283, 2.4275037646293645",Maisons-Alfort,94046,0.9111111111111111,15
21955,Vaugirard - Verrerie,OUI,24,3,21,17,4,OUI,OUI,2025-03-13 14:59:03+00:00,"48.820881336842, 2.2367222622987",Meudon,92048,0.875,15
10165,Gare de l'Est - Place du 11 Novembre 1918,OUI,39,33,6,1,5,OUI,OUI,2025-03-13 15:01:30+00:00,"48.876327, 2.3585464",Paris,75056,0.15384615384615385,15
16101,Malakoff - Place de la Porte Maillot,OUI,26,12,14,3,11,OUI,OUI,2025-03-13 14:55:53+00:00,"48.876733496638, 2.2834577411413",Paris,75056,0.5384615384615384,15
43010,La Jarry - Place Diderot,OUI,25,23,2,0,2,OUI,OUI,2025-03-13 14:57:05+00:00,"48.849726940367326, 2.452013790607453",Vincennes,94080,0.08,15
4003,Quai aux Fleurs - Pont Saint-Louis,OUI,21,8,13,11,2,OUI,OUI,2025-03-13 14:57:45+00:00,"48.852915956209, 2.3521957173944",Paris,75056,0.6190476190476191,15
17107,Berthier - Place Stuart Merril,OUI,35,20,15,13,2,OUI,OUI,2025-03-13 15:00:34+00:00,"48.885927922355044, 2.2933450341224675",Paris,75056,0.42857142857142855,15
10018,Square Alban Satragne,OUI,29,22,7,1,6,OUI,OUI,2025-03-13 15:01:06+00:00,"48.875388227727, 2.3559567333359",Paris,75056,0.2413793103448276,15
16002,Pergolèse - Malakoff,OUI,37,28,9,3,6,OUI,OUI,2025-03-13 14:55:36+00:00,"48.87521088779225, 2.2842781618237495",Paris,75056,0.24324324324324326,15
32301,Mairie de Romainville,OUI,17,17,0,0,0,OUI,OUI,2025-03-13 14:55:44+00:00,"48.885109, 2.435679",Romainville,93063,0.0,15
15004,Vaugirard - Pasteur,OUI,21,19,2,0,2,OUI,OUI,2025-03-13 15:00:57+00:00,"48.84040868803496, 2.3154367133975033",Paris,75056,0.09523809523809523,15
20108,Jardin de l'Hospice Debrousse,OUI,23,22,1,0,1,OUI,OUI,2025-03-13 15:00:51+00:00,"48.861451061938, 2.40568600595",Paris,75056,0.043478260869565216,15
6027,Blaise-Desgoffe - Vaugirard,OUI,32,26,6,2,4,OUI,OUI,2025-03-13 15:02:01+00:00,"48.846128877747, 2.3242672160268",Paris,75056,0.1875,15
21219,Amaury Duval - Gabriel Péri,OUI,36,36,0,0,0,OUI,OUI,2025-03-13 14:55:54+00:00,"48.81718759671675, 2.323841750621796",Montrouge,92049,0.0,15
18007,Goutte d'or - Barbès,OUI,20,18,2,0,2,OUI,OUI,2025-03-13 14:59:42+00:00,"48.885124323627, 2.3496962338686",Paris,75056,0.1,15
31025,Paul Signac - Aristide Briand,OUI,33,31,2,0,2,OUI,OUI,2025-03-13 14:56:20+00:00,"48.86950262156371, 2.4502260982990265",Montreuil,93048,0.06060606060606061,15
19128,Quai de l'Oise - Aisne,OUI,28,25,3,2,1,OUI,OUI,2025-03-13 15:01:18+00:00,"48.8906231, 2.3833701",Paris,75056,0.10714285714285714,15
23902,Gallieni - Lycée Charles Petitet,OUI,44,19,25,18,7,OUI,OUI,2025-03-13 15:00:42+00:00,"48.927640283627, 2.3308986340524",Villeneuve-la-Garenne,92078,0.5681818181818182,15
15005,Place Jacques et Thérèse Tréfouël,OUI,42,31,11,8,3,OUI,OUI,2025-03-13 15:01:28+00:00,"48.842726498317, 2.3125657439232",Paris,75056,0.2619047619047619,15
20007,Buzenval - Avron,OUI,49,47,2,0,2,OUI,OUI,2025-03-13 15:01:50+00:00,"48.851617204999, 2.4015135973077",Paris,75056,0.04081632653061224,15
21401,Mairie de Clamart,OUI,31,27,4,0,4,OUI,OUI,2025-03-13 15:01:58+00:00,"48.800612, 2.262151",Clamart,92023,0.12903225806451613,15
13033,Porte d'Italie,OUI,13,5,8,2,6,OUI,OUI,2025-03-13 14:58:47+00:00,"48.817161987718954, 2.360236309468746",Paris,75056,0.6153846153846154,15
13044,Place Jeanne d'Arc,OUI,35,34,1,0,1,OUI,OUI,2025-03-13 14:54:59+00:00,"48.829575, 2.369126",Paris,75056,0.02857142857142857,15
42701,Charles Gide - Fort de Bicêtre,OUI,29,18,11,0,11,OUI,OUI,2025-03-13 15:01:52+00:00,"48.8071937956922, 2.353984415531159",Le Kremlin-Bicêtre,94043,0.3793103448275862,15
9027,Douai - Pierre Fontaine,OUI,23,20,3,1,2,OUI,OUI,2025-03-13 14:57:00+00:00,"48.88229101148092, 2.33324121683836",Paris,75056,0.13043478260869565,15
16020,Place de la Porte de Passy,OUI,34,34,0,0,0,OUI,OUI,2025-03-13 14:54:28+00:00,"48.857341095470794, 2.2644165538827115",Paris,75056,0.0,15
14101,Gare Montparnasse - Edgar Quinet,OUI,33,26,7,1,6,OUI,OUI,2025-03-13 14:59:44+00:00,"48.841487851079, 2.3233232282801",Paris,75056,0.21212121212121213,15
4020,Place Edmond Michelet,OUI,23,6,17,14,3,OUI,OUI,2025-03-13 15:00:55+00:00,"48.860134890542, 2.3500636965036",Paris,75056,0.7391304347826086,15
15023,La Motte-Picquet - Grenelle,OUI,34,1,33,23,10,OUI,OUI,2025-03-13 14:57:14+00:00,"48.84858321339195, 2.299347817897797",Paris,75056,0.9705882352941176,15
15022,Emile Zola - Fondary,OUI,41,15,26,21,5,OUI,OUI,2025-03-13 15:01:56+00:00,"48.847051143113745, 2.2953405976295476",Paris,75056,0.6341463414634146,15
22501,Théâtre de La Garenne,OUI,20,13,7,1,6,OUI,OUI,2025-03-13 14:59:28+00:00,"48.905658361454, 2.2345951981176",La Garenne-Colombes,92035,0.35,15
23004,Paul Vaillant-Couturier - Victor Hugo,OUI,34,10,24,23,1,OUI,OUI,2025-03-13 14:59:18+00:00,"48.89819702263572, 2.293848017974069",Levallois-Perret,92044,0.7058823529411765,15
42003,Place de l'Insurrection d'Août 1944,OUI,30,6,24,22,2,OUI,OUI,2025-03-13 15:01:03+00:00,"48.81477852751594, 2.398074567317963",Ivry-sur-Seine,94041,0.8,15
22408,Place du 14 Juillet,OUI,22,21,1,0,1,OUI,OUI,2025-03-13 14:56:22+00:00,"48.819266959525, 2.3011998832226",Malakoff,92046,0.045454545454545456,15
40009,Lycée Saint Exupéry - Juliette Savar,OUI,29,18,11,8,3,OUI,OUI,2025-03-13 15:01:23+00:00,"48.783021513972, 2.4637357216879",Créteil,94028,0.3793103448275862,15
8037,Monceau - Malesherbes,OUI,37,27,10,4,6,OUI,OUI,2025-03-13 15:01:34+00:00,"48.8795079, 2.3145456",Paris,75056,0.2702702702702703,15
12043,Daumesnil - Hébrard,OUI,39,16,23,17,6,OUI,OUI,2025-03-13 15:01:57+00:00,"48.8429, 2.38474",Paris,75056,0.5897435897435898,15
11017,Charonne - Bureau,OUI,44,42,2,0,2,OUI,OUI,2025-03-13 14:59:15+00:00,"48.854176, 2.396093",Paris,75056,0.045454545454545456,15
1021,Halles - Bourdonnais,OUI,19,2,17,11,6,OUI,OUI,2025-03-13 15:00:01+00:00,"48.860448992575, 2.3460162431002",Paris,75056,0.8947368421052632,15
23003,Président Wilson - Baudin,OUI,28,7,21,15,6,OUI,OUI,2025-03-13 15:00:33+00:00,"48.89826887103676, 2.2849336266517644",Levallois-Perret,92044,0.75,15
33015,Charles Tillon - Cimetière Communal,OUI,26,1,25,6,19,OUI,OUI,2025-03-13 15:00:53+00:00,"48.91844023641836, 2.3935630917549138",Aubervilliers,93001,0.9615384615384616,15
14131,Jourdan - Monticelli,OUI,30,27,3,1,2,OUI,OUI,2025-03-13 15:01:37+00:00,"48.822032, 2.329095",Paris,75056,0.1,15
15311,Quai du Président Roosevelt - Pont Aval,OUI,30,0,30,20,10,OUI,OUI,2025-03-13 15:00:15+00:00,"48.8343883676388, 2.2656820714473724",Paris,75056,1.0,15
17023,Porte d'Asnières,OUI,33,24,9,7,2,OUI,OUI,2025-03-13 14:53:45+00:00,"48.89035817610495, 2.3036286234855656",Paris,75056,0.2727272727272727,15
35006,Delizy - Louis Nadot,OUI,21,16,5,1,4,OUI,OUI,2025-03-13 14:56:15+00:00,"48.896212845581346, 2.4094578623771667",Pantin,93055,0.23809523809523808,15
19108,Gaston Tessier - Rosa Parks RER,OUI,37,32,5,2,3,OUI,OUI,2025-03-13 14:59:20+00:00,"48.8963765, 2.3743692",Paris,75056,0.13513513513513514,15
41205,Maréchal Joffre - Verdun,OUI,20,17,3,0,3,OUI,OUI,2025-03-13 14:59:19+00:00,"48.85385, 2.470307",Fontenay-sous-Bois,94033,0.15,15
44007,Camille Groult - Guy Môquet,OUI,21,2,19,12,7,OUI,OUI,2025-03-13 14:59:29+00:00,"48.787482746521306, 2.3976725712418556",Vitry-sur-Seine,94081,0.9047619047619048,15
22015,Île de la Jatte,OUI,23,9,14,3,11,OUI,OUI,2025-03-13 14:59:24+00:00,"48.894036161302104, 2.2666339203715324",Neuilly-sur-Seine,92051,0.6086956521739131,15
4002,Marché aux fleurs,OUI,20,9,11,8,3,OUI,OUI,2025-03-13 15:00:02+00:00,"48.855258115391, 2.3473754525185",Paris,75056,0.55,15
12018,Saint-Mandé - Fabre d'Eglantine,OUI,31,27,4,0,4,OUI,OUI,2025-03-13 15:02:02+00:00,"48.8453579, 2.3965022",Paris,75056,0.12903225806451613,15
10105,Mazagran - Bonne Nouvelle,OUI,25,17,8,8,0,OUI,OUI,2025-03-13 15:00:46+00:00,"48.870047123655, 2.3511248454452",Paris,75056,0.32,15
44016,Balzac - Olympes de Gouges,OUI,28,9,19,8,11,OUI,OUI,2025-03-13 15:00:21+00:00,"48.77850332486751, 2.4006786569952965",Vitry-sur-Seine,94081,0.6785714285714286,15
17003,Jacques Kellner - Saint-Ouen,OUI,43,42,1,0,1,OUI,OUI,2025-03-13 15:00:42+00:00,"48.895809485802886, 2.327897409164145",Paris,75056,0.023255813953488372,15
9004,Gérando - Rochechouart,OUI,21,16,5,0,5,OUI,OUI,2025-03-13 14:59:56+00:00,"48.88294340845, 2.3464846238494",Paris,75056,0.23809523809523808,15
22206,Louis Pasteur - Albert Petit,OUI,30,29,1,0,1,OUI,OUI,2025-03-13 15:01:13+00:00,"48.796261, 2.317289",Bagneux,92007,0.03333333333333333,15
32601,Porte des Lilas - Faidherbe,OUI,39,38,1,1,0,OUI,OUI,2025-03-13 14:55:30+00:00,"48.87861855668978, 2.4120327830314636",Les Lilas,93045,0.02564102564102564,15
21217,Louis Rolland - République,OUI,26,24,2,1,1,OUI,OUI,2025-03-13 15:00:15+00:00,"48.81710889740748, 2.3193106434955717",Montrouge,92049,0.07692307692307693,15
33016,Fort d'Aubervilliers,OUI,22,13,9,8,1,OUI,OUI,2025-03-13 14:56:13+00:00,"48.91502382370325, 2.4035281687974925",Aubervilliers,93001,0.4090909090909091,15
15030,Emeriau - Beaugrenelle,OUI,73,12,61,47,14,OUI,OUI,2025-03-13 15:01:55+00:00,"48.84791249714942, 2.2843059897422795",Paris,75056,0.8356164383561644,15
10162,Alexandre Parodi - Quai de Valmy,OUI,24,21,3,0,3,OUI,OUI,2025-03-13 14:59:51+00:00,"48.879359419425, 2.3665961623192",Paris,75056,0.125,15
12007,Gare de Lyon - Chalon,OUI,45,14,31,18,13,OUI,OUI,2025-03-13 15:00:54+00:00,"48.845666194202, 2.3741452395916",Paris,75056,0.6888888888888889,15
13009,Auguste Blanqui - Corvisart,OUI,26,19,7,2,5,OUI,OUI,2025-03-13 14:57:07+00:00,"48.8300989, 2.3502726",Paris,75056,0.2692307692307692,15
25001,Colmar - Victor Hugo,OUI,31,7,24,10,14,OUI,OUI,2025-03-13 14:59:28+00:00,"48.88652251096166, 2.173960916697979",Rueil-Malmaison,92063,0.7741935483870968,15
27005,Gare du Stade,OUI,18,12,6,3,3,OUI,OUI,2025-03-13 14:56:22+00:00,"48.9312676, 2.2603778",Colombes,92025,0.3333333333333333,15
35007,Benjamin Delessert - Jean Lolive,OUI,20,17,3,0,3,OUI,OUI,2025-03-13 15:01:28+00:00,"48.89392043619345, 2.417981922626496",Pantin,93055,0.15,15
9024,Taitbout - La Fayette,OUI,51,8,43,26,17,OUI,OUI,2025-03-13 15:01:59+00:00,"48.8733298892, 2.3352625966072",Paris,75056,0.8431372549019608,15
44101,Place Mongolfier,OUI,37,15,22,13,9,OUI,OUI,2025-03-13 15:00:42+00:00,"48.815160030060376, 2.4592879414558415",Saint-Maurice,94069,0.5945945945945946,15
17111,Lemercier - Cardinet,OUI,24,24,0,0,0,OUI,OUI,2025-03-13 14:55:23+00:00,"48.890097168851746, 2.317377626895905",Paris,75056,0.0,15
13032,Italie - Jardin Joan Miro,OUI,24,21,3,1,2,OUI,OUI,2025-03-13 15:00:54+00:00,"48.81990914045756, 2.3592948541045193",Paris,75056,0.125,15
21319,Esplanade du Foncet - Camille Desmoulins,OUI,27,1,26,20,6,OUI,OUI,2025-03-13 15:01:46+00:00,"48.827090233494964, 2.2606857866048813",Issy-les-Moulineaux,92040,0.9629629629629629,15
15064,Javel - André Citroën,OUI,44,3,41,36,5,OUI,OUI,2025-03-13 15:00:42+00:00,"48.846276485475, 2.2786368057132",Paris,75056,0.9318181818181818,15
9102,Londres - Place d'Estienne d'Orves,OUI,24,2,22,14,8,OUI,OUI,2025-03-13 14:58:46+00:00,"48.876693805756986, 2.3305362090468407",Paris,75056,0.9166666666666666,15
14010,Jean Moulin - Place Victor et Hélène Basch,OUI,38,36,2,0,2,OUI,OUI,2025-03-13 15:02:04+00:00,"48.82764910241, 2.3261967301369",Paris,75056,0.05263157894736842,15
9006,Dunkerque - Trudaine,OUI,16,15,1,0,1,OUI,OUI,2025-03-13 14:55:58+00:00,"48.88215166773376, 2.3463253676891327",Paris,75056,0.0625,15
13128,Quai de la Gare - Pont de Bercy,OUI,29,4,25,23,2,OUI,OUI,2025-03-13 14:57:34+00:00,"48.83730787972, 2.3740861260598",Paris,75056,0.8620689655172413,15
31005,Square Denise Buisson,OUI,45,43,2,0,2,OUI,OUI,2025-03-13 15:00:56+00:00,"48.8562322730982, 2.426436245441437",Montreuil,93048,0.044444444444444446,15
22303,Lucien Lanternier - Le Luth,OUI,25,9,16,12,4,OUI,OUI,2025-03-13 15:00:43+00:00,"48.93159430558871, 2.2889783978462224",Gennevilliers,92036,0.64,15
21314,Chemin de Bretagne,OUI,28,1,27,21,6,OUI,OUI,2025-03-13 15:02:06+00:00,"48.824753068884, 2.2588385956052",Issy-les-Moulineaux,92040,0.9642857142857143,15
92001,Mairie de quartier du Plateau - Mont-Valérien,OUI,20,15,5,4,1,OUI,OUI,2025-03-13 14:55:05+00:00,"48.8799933, 2.2072437",Nanterre,92050,0.25,15
12038,Picpus - Louis Braille,OUI,43,42,1,0,1,OUI,OUI,2025-03-13 15:01:19+00:00,"48.839988788912, 2.4005256685521",Paris,75056,0.023255813953488372,15
15057,Lucien Bossoutrot - Général Martial Vallin,OUI,38,16,22,20,2,OUI,OUI,2025-03-13 15:01:53+00:00,"48.836956046311, 2.2741072252393",Paris,75056,0.5789473684210527,15
12005,Crozatier - Faubourg Saint-Antoine,OUI,39,8,31,22,9,OUI,OUI,2025-03-13 15:02:01+00:00,"48.850440013405, 2.378901366211",Paris,75056,0.7948717948717948,15
23010,Voltaire - Anatole France,OUI,26,7,19,13,6,OUI,OUI,2025-03-13 14:59:53+00:00,"48.891999360256904, 2.284262739121914",Levallois-Perret,92044,0.7307692307692307,15
13516,Glacière - Soeur Catherine Marie,OUI,40,34,6,3,3,OUI,OUI,2025-03-13 14:56:43+00:00,"48.829522989420596, 2.343570403754711",Paris,75056,0.15,15
18006,Square Louise Michel,OUI,35,34,1,0,1,OUI,OUI,2025-03-13 15:01:54+00:00,"48.884687354509, 2.3441386967897",Paris,75056,0.02857142857142857,15
12028,Vivaldi - Antoine-Julien Hénard,OUI,27,25,2,0,2,OUI,OUI,2025-03-13 15:00:01+00:00,"48.841923663276546, 2.389728979467376",Paris,75056,0.07407407407407407,15
17108,Bessières - Porte de Clichy,OUI,30,16,14,10,4,OUI,OUI,2025-03-13 14:56:06+00:00,"48.89611762451474, 2.31790903955698",Paris,75056,0.4666666666666667,15
9034,Godot de Mauroy - Madeleine,OUI,21,1,20,4,16,OUI,OUI,2025-03-13 15:01:30+00:00,"48.869789, 2.326347",Paris,75056,0.9523809523809523,15
5012,Estrapade - Ulm,OUI,16,5,11,1,10,OUI,OUI,2025-03-13 15:01:55+00:00,"48.84512772828, 2.3454568170362",Paris,75056,0.6875,15
12035,Madagascar - Meuniers,OUI,32,28,4,1,3,OUI,OUI,2025-03-13 14:58:13+00:00,"48.83460464474706, 2.3970650508999825",Paris,75056,0.125,15
21306,Place Lafayette,OUI,61,8,53,47,6,OUI,OUI,2025-03-13 15:02:00+00:00,"48.829654975522, 2.2638675570488",Issy-les-Moulineaux,92040,0.8688524590163934,15
10021,Marché Saint-Quentin,OUI,14,12,2,0,2,OUI,OUI,2025-03-13 14:55:24+00:00,"48.877356057652, 2.3545114456374",Paris,75056,0.14285714285714285,15
7017,La Motte-Picquet - La Tour Maubourg,OUI,40,25,15,10,5,OUI,OUI,2025-03-13 14:59:23+00:00,"48.856926701847, 2.3096215831203",Paris,75056,0.375,15
5115,Buffon - Jardin des Plantes,OUI,30,0,30,19,11,OUI,OUI,2025-03-13 14:59:58+00:00,"48.842668466104875, 2.3618587106466293",Paris,75056,1.0,15
44005,Place Saint-Just,OUI,22,15,7,3,4,OUI,OUI,2025-03-13 15:02:04+00:00,"48.790379518724265, 2.3895226791501045",Vitry-sur-Seine,94081,0.3181818181818182,15
2108,Vivienne - Montmartre,OUI,37,6,31,17,14,OUI,OUI,2025-03-13 15:01:02+00:00,"48.871347597383, 2.3414588347077",Paris,75056,0.8378378378378378,15
17119,Toqueville - Cardinet,OUI,31,27,4,3,1,OUI,OUI,2025-03-13 15:01:25+00:00,"48.88490187110713, 2.3109393194317818",Paris,75056,0.12903225806451613,15
12101,Charenton - Prague,OUI,28,7,21,17,4,OUI,OUI,2025-03-13 15:00:50+00:00,"48.848175129981, 2.3763584494312",Paris,75056,0.75,15
15011,Cambronne - Villa Croix Nivert,OUI,60,43,17,13,4,OUI,OUI,2025-03-13 15:00:57+00:00,"48.845847561366, 2.3017574474216",Paris,75056,0.2833333333333333,15
51001,Gare d'Argenteuil,OUI,37,19,18,4,14,OUI,OUI,2025-03-13 14:58:58+00:00,"48.947022436806705, 2.256898172199726",Argenteuil,95018,0.4864864864864865,15
51002,Placette Grégoire Collas,OUI,25,15,10,4,6,OUI,OUI,2025-03-13 14:55:21+00:00,"48.94342014002797, 2.2487476095557213",Argenteuil,95018,0.4,15
8027,Mairie du 8ème,OUI,14,7,7,3,4,OUI,OUI,2025-03-13 15:01:53+00:00,"48.877932, 2.318264",Paris,75056,0.5,15
12026,Place Ginette Hamelin,OUI,50,22,28,23,5,OUI,OUI,2025-03-13 15:00:40+00:00,"48.837853, 2.382064",Paris,75056,0.56,15
15036,Croix Nivert - Square Saint-Lambert,OUI,47,47,0,0,0,NON,NON,2025-03-03 09:03:43+00:00,"48.843051521591, 2.2952004522085",Paris,75056,0.0,9
6012,Saint-Germain - Ciseaux,OUI,18,0,18,13,5,OUI,OUI,2025-03-13 14:59:54+00:00,"48.853305277595, 2.3344654618827",Paris,75056,1.0,15
15006,Cherche-Midi - Hôpital Necker,OUI,35,29,6,3,3,OUI,OUI,2025-03-13 15:02:04+00:00,"48.84461063309956, 2.317914068698883",Paris,75056,0.17142857142857143,15
15071,Suffren - Champ de Mars,OUI,23,13,10,8,2,OUI,OUI,2025-03-13 15:01:42+00:00,"48.8547194, 2.2952168",Paris,75056,0.43478260869565216,15
33014,Parc Eli Lotar,OUI,19,14,5,3,2,OUI,OUI,2025-03-13 15:01:02+00:00,"48.91844993053703, 2.3727085813879967",Aubervilliers,93001,0.2631578947368421,15
8201,Arsène Houssaye - Friedland,OUI,29,24,5,0,5,OUI,OUI,2025-03-13 14:57:03+00:00,"48.874510616163, 2.2994716674148",Paris,75056,0.1724137931034483,15
9007,Condorcet - Turgot,OUI,18,17,1,0,1,OUI,OUI,2025-03-13 14:57:55+00:00,"48.87985155789093, 2.345232367515564",Paris,75056,0.05555555555555555,15
8116,Champs-Elysees - Bassano,OUI,25,25,0,0,0,NON,NON,2021-02-21 19:09:18+00:00,"48.871811807816, 2.300238981843",Paris,75056,0.0,19
17024,Villiers - Batignolles,OUI,23,19,4,0,4,OUI,OUI,2025-03-13 14:59:34+00:00,"48.88125253846116, 2.31653843075037",Paris,75056,0.17391304347826086,15
18030,Joseph Dijon - Ornano,OUI,36,35,1,1,0,OUI,OUI,2025-03-13 15:01:16+00:00,"48.89374453351521, 2.3476678133010864",Paris,75056,0.027777777777777776,15
15127,Place Charles Michels,OUI,35,11,24,21,3,OUI,OUI,2025-03-13 14:57:59+00:00,"48.846401, 2.28502",Paris,75056,0.6857142857142857,15
92006,Place Nelson Mandela,OUI,30,17,13,2,11,OUI,OUI,2025-03-13 15:02:05+00:00,"48.897874318180556, 2.2182820737361912",Nanterre,92050,0.43333333333333335,15
20105,Benoît Frachon - République,OUI,28,26,2,0,2,OUI,OUI,2025-03-13 15:01:14+00:00,"48.85230729014318, 2.415605485439301",Paris,75056,0.07142857142857142,15
5024,Place Monge,OUI,21,16,5,3,2,OUI,OUI,2025-03-13 15:01:25+00:00,"48.842761803051, 2.3524079471827",Paris,75056,0.23809523809523808,15
14032,Mairie du 14ème,OUI,32,30,2,0,2,OUI,OUI,2025-03-13 15:01:06+00:00,"48.83254578123, 2.3254923149943",Paris,75056,0.0625,15
12155,Rottembourg - Général Michel Bizot,OUI,42,36,6,5,1,OUI,OUI,2025-03-13 15:00:12+00:00,"48.83787825992554, 2.4044052511453633",Paris,75056,0.14285714285714285,15
14011,Place des Droits de l'Enfant,OUI,39,36,3,2,1,OUI,OUI,2025-03-13 15:00:26+00:00,"48.8274804, 2.3319217",Paris,75056,0.07692307692307693,15
9011,Geoffroy - Marie,OUI,17,5,12,12,0,OUI,OUI,2025-03-13 15:00:04+00:00,"48.873781940593325, 2.344513876337893",Paris,75056,0.7058823529411765,15
6002,Saint-Benoît - Jacob,OUI,21,11,10,6,4,OUI,OUI,2025-03-13 15:00:18+00:00,"48.85545136013941, 2.3334722220897675",Paris,75056,0.47619047619047616,15
41211,Louis Xavier de Ricard - Ancienne Mairie,OUI,34,32,2,2,0,OUI,OUI,2025-03-13 14:59:54+00:00,"48.84629899065091, 2.472420372068882",Fontenay-sous-Bois,94033,0.058823529411764705,15
33012,Landy - Heurtault,OUI,29,27,2,1,1,OUI,OUI,2025-03-13 14:59:43+00:00,"48.915096534520316, 2.375951372087002",Aubervilliers,93001,0.06896551724137931,15
44011,Lebrun - Colonel Fabien,OUI,27,26,1,0,1,OUI,OUI,2025-03-13 14:52:47+00:00,"48.78266870733145, 2.381317801773548",Vitry-sur-Seine,94081,0.037037037037037035,15
2013,Favart - Italiens,OUI,17,4,13,1,12,OUI,OUI,2025-03-13 15:01:36+00:00,"48.871446353921, 2.3382901058508",Paris,75056,0.7647058823529411,15
21707,Square Etienne Jarousse,OUI,22,21,1,0,1,OUI,OUI,2025-03-13 15:01:18+00:00,"48.82485182597129, 2.2925933450460434",Vanves,92075,0.045454545454545456,15
3102,Bourg l'Abbé - Saint-Martin,OUI,36,2,34,22,12,OUI,OUI,2025-03-13 15:01:28+00:00,"48.86393331949257, 2.352406270802021",Paris,75056,0.9444444444444444,15
4019,Cloître Saint-Merri - Renard,OUI,31,3,28,21,7,OUI,OUI,2025-03-13 14:56:37+00:00,"48.858835448898, 2.3518279194832",Paris,75056,0.9032258064516129,15
10019,Paradis - Hauteville,OUI,31,16,15,13,2,OUI,OUI,2025-03-13 14:19:37+00:00,"48.874999954666755, 2.3522757401923404",Paris,75056,0.4838709677419355,14
5001,Harpe - Saint-Germain,OUI,43,17,26,22,4,OUI,OUI,2025-03-13 15:00:00+00:00,"48.851518815017, 2.3436703160405",Paris,75056,0.6046511627906976,15
41203,Stalingrad - Rigollots,OUI,50,48,2,0,2,OUI,OUI,2025-03-13 14:59:16+00:00,"48.84997403844251, 2.45557576417923",Fontenay-sous-Bois,94033,0.04,15
15129,Hôpital Necker,OUI,37,20,17,13,4,OUI,OUI,2025-03-13 14:58:43+00:00,"48.846043490118454, 2.313245013356209",Paris,75056,0.4594594594594595,15
18039,Jardins d'Eole,OUI,19,14,5,1,4,OUI,OUI,2025-03-13 14:57:05+00:00,"48.8869703, 2.3668488",Paris,75056,0.2631578947368421,15
15039,Abbé Groult - Convention,OUI,12,11,1,0,1,OUI,OUI,2025-03-13 14:59:49+00:00,"48.83596927866069, 2.302064039509349",Paris,75056,0.08333333333333333,15
21315,Jules Guesdes - Général de Gaulle,OUI,24,21,3,1,2,OUI,OUI,2025-03-13 14:59:59+00:00,"48.81930581291959, 2.278934195637703",Issy-les-Moulineaux,92040,0.125,15
20022,Porte de Bagnolet,OUI,33,32,1,0,1,OUI,OUI,2025-03-13 15:01:17+00:00,"48.864707139122984, 2.408344637349607",Paris,75056,0.030303030303030304,15
23102,Hôtel de Ville de Sèvres,OUI,31,15,16,12,4,OUI,OUI,2025-03-13 14:59:02+00:00,"48.824363561289, 2.2131047397852",Sèvres,92072,0.5161290322580645,15
12036,Reuilly - Place Felix Eboue,OUI,41,39,2,0,2,OUI,OUI,2025-03-13 15:00:54+00:00,"48.84030274499962, 2.394630398715453",Paris,75056,0.04878048780487805,15
6022,Marché Saint-Germain,OUI,19,1,18,12,6,OUI,OUI,2025-03-13 15:00:37+00:00,"48.85165625855281, 2.335500307381153",Paris,75056,0.9473684210526315,15
14026,Plantes - Moulin Vert,OUI,45,42,3,1,2,OUI,OUI,2025-03-13 15:00:25+00:00,"48.83005755305626, 2.3232302069664006",Paris,75056,0.06666666666666667,15
21402,Place Aimé Césaire,OUI,27,22,5,0,5,OUI,OUI,2025-03-13 14:56:00+00:00,"48.783194713067815, 2.2429127991199493",Clamart,92023,0.18518518518518517,15
10008,Cité Riverin - Château d'Eau,OUI,17,7,10,10,0,OUI,OUI,2025-03-13 15:00:35+00:00,"48.870702423554306, 2.358739863900845",Paris,75056,0.5882352941176471,15
41403,Gare RER - Malleret-Joinville,OUI,20,6,14,9,5,OUI,OUI,2025-03-13 15:00:05+00:00,"48.802936, 2.42531",Alfortville,94002,0.7,15
16012,Flandrin - Longchamp,OUI,40,6,34,12,22,OUI,OUI,2025-03-13 15:02:01+00:00,"48.86877849178477, 2.274354539176829",Paris,75056,0.85,15
13018,Bruant - Vincent Auriol,OUI,25,7,18,15,3,OUI,OUI,2025-03-13 15:01:33+00:00,"48.834848452929, 2.3668264996271",Paris,75056,0.72,15
16036,Porte Molitor,OUI,59,5,54,37,17,OUI,OUI,2025-03-13 15:02:01+00:00,"48.84524763511433, 2.2569015249609947",Paris,75056,0.9152542372881356,15
21303,Jean Monnet - Iles,OUI,32,3,29,27,2,OUI,OUI,2025-03-13 15:02:08+00:00,"48.823393984057304, 2.2497073194874866",Issy-les-Moulineaux,92040,0.90625,15
8117,Place de la Madeleine - Royale,OUI,43,0,43,29,14,OUI,OUI,2025-03-13 15:01:27+00:00,"48.869228052648, 2.324421107769",Paris,75056,1.0,15
13052,Leredde - Tolbiac,OUI,43,14,29,17,12,OUI,OUI,2025-03-13 14:59:12+00:00,"48.82887629664, 2.3744382709265",Paris,75056,0.6744186046511628,15
12015,Place de la Nation - Picpus,OUI,35,33,2,1,1,OUI,OUI,2025-03-13 15:01:30+00:00,"48.846821681548, 2.4001130461693",Paris,75056,0.05714285714285714,15
33103,Jean Jaurès - Jules Jacquemin,OUI,21,20,1,0,1,OUI,OUI,2025-03-13 14:57:09+00:00,"48.88433053604843, 2.4082902455152104",Le Pré-Saint-Gervais,93061,0.047619047619047616,15
26004,Gare RER les Grésillons,OUI,22,17,5,5,0,OUI,OUI,2025-03-13 14:59:47+00:00,"48.919898633572764, 2.31458459136273",Asnières-sur-Seine,92004,0.22727272727272727,15
41401,Marne - Charles de Gaulle,OUI,25,18,7,6,1,OUI,OUI,2025-03-13 15:00:43+00:00,"48.815071719544434, 2.4121668934822087",Alfortville,94002,0.28,15
16042,Murat - Porte de Saint-Cloud,OUI,38,5,33,30,3,OUI,OUI,2025-03-13 15:01:37+00:00,"48.83750862621299, 2.2577651962637906",Paris,75056,0.868421052631579,15
14031,Didot - Place de Moro-Giafferi,OUI,20,18,2,0,2,OUI,OUI,2025-03-13 14:53:01+00:00,"48.8337, 2.3215",Paris,75056,0.1,15
1006,Grande Truanderie - Saint-Denis,OUI,28,13,15,11,4,OUI,OUI,2025-03-13 15:01:38+00:00,"48.8626302, 2.3498075",Paris,75056,0.5357142857142857,15
20044,Davout - Volga,OUI,27,24,3,1,2,OUI,OUI,2025-03-13 15:00:13+00:00,"48.852919679957296, 2.410522909779111",Paris,75056,0.1111111111111111,15
19110,Square Claude Bernard,OUI,28,15,13,9,4,OUI,OUI,2025-03-13 14:59:29+00:00,"48.89876016219984, 2.375325746834278",Paris,75056,0.4642857142857143,15
16019,Porte de la Muette,OUI,34,17,17,3,14,OUI,OUI,2025-03-13 15:01:07+00:00,"48.86302317841182, 2.2687188170157406",Paris,75056,0.5,15
22201,Henri Ravera - Gabriel Péri,OUI,28,27,1,0,1,OUI,OUI,2025-03-13 14:58:31+00:00,"48.79722273833844, 2.302115857601166",Bagneux,92007,0.03571428571428571,15
11033,Bréguet - Sabin,OUI,29,5,24,18,6,OUI,OUI,2025-03-13 15:02:02+00:00,"48.856931678257, 2.3706749462105",Paris,75056,0.8275862068965517,15
11112,Jules Vallès - Charonne,OUI,23,14,9,6,3,OUI,OUI,2025-03-13 15:01:40+00:00,"48.854284379935, 2.3847674578428",Paris,75056,0.391304347826087,15
10033,Gare du Nord - Saint-Vincent de Paul,OUI,24,24,0,0,0,OUI,OUI,2025-03-13 14:53:40+00:00,"48.880955741648, 2.3524305148385",Paris,75056,0.0,15
5007,Ecoles - Carmes,OUI,34,5,29,16,13,OUI,OUI,2025-03-13 15:01:21+00:00,"48.848904447989405, 2.3473486304283147",Paris,75056,0.8529411764705882,15
16105,Crevaux - Bugeaud,OUI,31,25,6,0,6,OUI,OUI,2025-03-13 14:56:33+00:00,"48.87080942867, 2.2811490076919",Paris,75056,0.1935483870967742,15
42505,Charles Frérot - Albert Guilpin,OUI,29,26,3,1,2,OUI,OUI,2025-03-13 15:00:10+00:00,"48.8155839183714, 2.3505029082298283",Gentilly,94037,0.10344827586206896,15
18202,Diane Arbus,OUI,36,33,3,1,2,OUI,OUI,2025-03-13 14:55:01+00:00,"48.898800717199, 2.3524022474885",Paris,75056,0.08333333333333333,15
10032,Claude Vellefaux - Hôpital Saint-Louis,OUI,32,28,4,3,1,OUI,OUI,2025-03-13 14:54:27+00:00,"48.872859139003, 2.3700717069851",Paris,75056,0.125,15
3008,Perle - Vieille du Temple,OUI,35,9,26,22,4,OUI,OUI,2025-03-13 15:00:20+00:00,"48.8601346, 2.3611206",Paris,75056,0.7428571428571429,15
48004,Maxime Gorki - Louis Aragon,OUI,20,16,4,3,1,OUI,OUI,2025-03-13 14:53:06+00:00,"48.78909814728443, 2.368387877941132",Villejuif,94076,0.2,15
6010,Chevreuse - Montparnasse,OUI,15,8,7,0,7,OUI,OUI,2025-03-13 14:57:20+00:00,"48.841739161231, 2.3315522167367",Paris,75056,0.4666666666666667,15
14001,Edgar Quinet - Gaité,OUI,27,20,7,1,6,OUI,OUI,2025-03-13 14:57:05+00:00,"48.841160928966, 2.324595451355",Paris,75056,0.25925925925925924,15
5015,Epée de Bois - Mouffetard,OUI,62,51,11,9,2,OUI,OUI,2025-03-13 15:02:08+00:00,"48.841508690388835, 2.350066713988781",Paris,75056,0.1774193548387097,15
18139,Poissonniers - Championnet,OUI,28,26,2,0,2,OUI,OUI,2025-03-13 14:57:59+00:00,"48.89543299733937, 2.3530178144574165",Paris,75056,0.07142857142857142,15
45002,Roger Salengro - Général de Gaulle,OUI,27,16,11,4,7,OUI,OUI,2025-03-13 14:59:10+00:00,"48.820029010376956, 2.4846760556101803",Champigny-sur-Marne,94017,0.4074074074074074,15
15001,Gare Montparnasse - Arrivée,OUI,41,32,9,2,7,OUI,OUI,2025-03-13 15:01:55+00:00,"48.843827994315, 2.3225811123848",Paris,75056,0.21951219512195122,15
12037,Reuilly - Daumesnil,OUI,36,33,3,0,3,OUI,OUI,2025-03-13 15:01:19+00:00,"48.8395385, 2.3972516",Paris,75056,0.08333333333333333,15
15008,Sèvres - Lecourbe,OUI,60,34,26,22,4,OUI,OUI,2025-03-13 15:01:55+00:00,"48.8447677, 2.3110086",Paris,75056,0.43333333333333335,15
1007,Turbigo - Française,OUI,16,1,15,8,7,OUI,OUI,2025-03-13 15:01:59+00:00,"48.86358858111446, 2.3477794602513313",Paris,75056,0.9375,15
4006,Bourdon - Pont Morland,OUI,51,21,30,25,5,OUI,OUI,2025-03-13 15:01:57+00:00,"48.8478103, 2.3659356",Paris,75056,0.5882352941176471,15
18004,Place des Abbesses,OUI,12,11,1,0,1,OUI,OUI,2025-03-13 14:56:32+00:00,"48.884542726149725, 2.3386867716908455",Paris,75056,0.08333333333333333,15
15128,Cadix - Hameau,OUI,36,29,7,4,3,OUI,OUI,2025-03-13 15:00:48+00:00,"48.8340107632249, 2.289516180753708",Paris,75056,0.19444444444444445,15
20008,Pyrénées - Avron,OUI,31,30,1,0,1,OUI,OUI,2025-03-13 14:59:08+00:00,"48.853246898211985, 2.405871044529538",Paris,75056,0.03225806451612903,15
44014,Camille Risch - Paul Armangot,OUI,25,17,8,4,4,OUI,OUI,2025-03-13 14:54:54+00:00,"48.774703, 2.373685",Vitry-sur-Seine,94081,0.32,15
18034,Leibniz - Jean Dollfus,OUI,32,31,1,0,1,OUI,OUI,2025-03-13 15:01:19+00:00,"48.896328348515986, 2.333390423834684",Paris,75056,0.03125,15
47003,Charentonneau - Maisons Alfort,OUI,20,14,6,3,3,OUI,OUI,2025-03-13 14:59:55+00:00,"48.809932980484355, 2.443288456496946",Maisons-Alfort,94046,0.3,15
12019,Gare de Reuilly - Picpus,OUI,27,21,6,0,6,OUI,OUI,2025-03-13 15:02:03+00:00,"48.84267354116789, 2.3972943797707558",Paris,75056,0.2222222222222222,15
16013,Mairie du 16ème,OUI,35,32,3,0,3,OUI,OUI,2025-03-13 14:59:31+00:00,"48.863936848471994, 2.2765953093767166",Paris,75056,0.08571428571428572,15
3010,Beaubourg - Michel-le-Comte,OUI,15,0,15,10,5,OUI,OUI,2025-03-13 14:58:40+00:00,"48.862534941806, 2.3543103039265",Paris,75056,1.0,15
7012,Cité Vaneau,OUI,23,7,16,13,3,OUI,OUI,2025-03-13 14:59:43+00:00,"48.8542210666207, 2.319614924490452",Paris,75056,0.6956521739130435,15
10034,Louis Blanc - La Chapelle,OUI,21,20,1,0,1,OUI,OUI,2025-03-13 14:54:34+00:00,"48.884008964514, 2.3599335551262",Paris,75056,0.047619047619047616,15
20001,Place de la Nation - Charonne,OUI,35,33,2,1,1,OUI,OUI,2025-03-13 14:57:20+00:00,"48.848364667777, 2.3997623859813",Paris,75056,0.05714285714285714,15
6104,Herschel - Observatoire,OUI,35,11,24,0,24,OUI,OUI,2025-03-13 15:01:57+00:00,"48.84342376221923, 2.3376645147800446",Paris,75056,0.6857142857142857,15
20104,Louis Lumière.,OUI,22,21,1,1,0,OUI,OUI,2025-03-13 14:59:02+00:00,"48.86216198070008, 2.41112578185621",Paris,75056,0.045454545454545456,15
21309,Mairie d'Issy,OUI,39,23,16,8,8,OUI,OUI,2025-03-13 15:01:58+00:00,"48.823767792468, 2.2723111510277",Issy-les-Moulineaux,92040,0.41025641025641024,15
14135,Jourdan - Cité Universitaire,OUI,38,29,9,2,7,OUI,OUI,2025-03-13 15:00:27+00:00,"48.819897343156676, 2.3397007964124366",Paris,75056,0.23684210526315788,15
4021,Centre Georges Pompidou,OUI,26,2,24,20,4,OUI,OUI,2025-03-13 15:01:22+00:00,"48.861419, 2.352581",Paris,75056,0.9230769230769231,15
8110,Gare Saint-Lazare - Stockholm,OUI,31,17,14,3,11,OUI,OUI,2025-03-13 14:54:46+00:00,"48.877127316667654, 2.322417162358761",Paris,75056,0.45161290322580644,15
13005,Cordelières - Arago,OUI,45,13,32,28,4,OUI,OUI,2025-03-13 15:02:05+00:00,"48.83548071896613, 2.348572461702221",Paris,75056,0.7111111111111111,15
20024,Gambetta - Père Lachaise,OUI,27,26,1,0,1,OUI,OUI,2025-03-13 14:56:29+00:00,"48.864295696165875, 2.398228667282044",Paris,75056,0.037037037037037035,15
19002,Centquatre,OUI,38,21,17,4,13,NON,NON,2025-03-13 14:56:39+00:00,"48.889333538455, 2.3707854375243",Paris,75056,0.4473684210526316,15
12156,Niger - Soult,OUI,23,19,4,1,3,OUI,OUI,2025-03-13 15:00:45+00:00,"48.84369906369085, 2.410361237220498",Paris,75056,0.17391304347826086,15
17019,Phalsbourg - Villiers,OUI,18,7,11,6,5,OUI,OUI,2025-03-13 15:01:19+00:00,"48.88242307900951, 2.3090453445911407",Paris,75056,0.6111111111111112,15
18140,Porte de Clignancourt - Ney,OUI,38,36,2,1,1,OUI,OUI,2025-03-13 14:55:30+00:00,"48.899641123987095, 2.344321422278881",Paris,75056,0.05263157894736842,15
19201,Petit - Georges Thill,OUI,23,23,0,0,0,OUI,OUI,2025-03-13 14:53:31+00:00,"48.88603131999171, 2.3895753175020222",Paris,75056,0.0,15
19010,Emile Reynaud - Porte de la Villette,OUI,22,17,5,1,4,OUI,OUI,2025-03-13 14:59:35+00:00,"48.90098953630053, 2.3887022584676743",Paris,75056,0.22727272727272727,15
9009,Square Montholon,OUI,18,9,9,1,8,OUI,OUI,2025-03-13 14:58:03+00:00,"48.876620377545024, 2.3457641154527664",Paris,75056,0.5,15
10009,Mairie du 10ème,OUI,18,2,16,11,5,OUI,OUI,2025-03-13 14:57:38+00:00,"48.872089449907, 2.3575825989246",Paris,75056,0.8888888888888888,15
16102,Pergolèse - Marbeau,OUI,26,23,3,0,3,OUI,OUI,2025-03-13 14:55:46+00:00,"48.873568706869, 2.2815125225299",Paris,75056,0.11538461538461539,15
22301,Chausson - Gabriel Péri,OUI,20,12,8,7,1,OUI,OUI,2025-03-13 15:01:59+00:00,"48.921891003481115, 2.2952306270599365",Gennevilliers,92036,0.4,15
20034,Sorbier - Ménilmontant,OUI,24,23,1,0,1,OUI,OUI,2025-03-13 15:01:51+00:00,"48.868542395661, 2.3897721245885",Paris,75056,0.041666666666666664,15
8028,Arsène Houssaye - Champs-Elysées,OUI,28,9,19,0,19,OUI,OUI,2025-03-13 15:01:24+00:00,"48.873409276267, 2.2977904602885",Paris,75056,0.6785714285714286,15
15132,Bargue -  Dutot,OUI,21,16,5,2,3,OUI,OUI,2025-03-13 15:01:07+00:00,"48.837884, 2.308876",Paris,75056,0.23809523809523808,15
10011,Bourse du Travail,OUI,17,14,3,1,2,OUI,OUI,2025-03-13 14:57:18+00:00,"48.868976638826, 2.3623438552022",Paris,75056,0.17647058823529413,15
41405,Place de l'Europe - Alfortville,OUI,24,4,20,19,1,OUI,OUI,2025-03-13 14:58:36+00:00,"48.78913702405837, 2.4284800887107854",Alfortville,94002,0.8333333333333334,15
14137,Maurice d'Ocagne - General Maudhuy,OUI,29,24,5,2,3,OUI,OUI,2025-03-13 14:57:23+00:00,"48.82414282524159, 2.3158789426088333",Paris,75056,0.1724137931034483,15
20006,Pyrénées - Plaine,OUI,12,11,1,0,1,OUI,OUI,2025-03-13 14:58:55+00:00,"48.85026702458, 2.4062821269035",Paris,75056,0.08333333333333333,15
3011,Turbigo - Réaumur,OUI,31,12,19,18,1,OUI,OUI,2025-03-13 15:01:11+00:00,"48.865574047531, 2.3564198613167",Paris,75056,0.6129032258064516,15
21953,Gare de Bellevue,OUI,20,18,2,0,2,OUI,OUI,2025-03-13 14:58:15+00:00,"48.8192404685572, 2.2295309230685234",Meudon,92048,0.1,15
10027,Dunkerque - Alsace,OUI,20,18,2,1,1,OUI,OUI,2025-03-13 15:01:54+00:00,"48.879355, 2.358379",Paris,75056,0.1,15
14019,Sarrette - Général Leclerc,OUI,22,18,4,0,4,OUI,OUI,2025-03-13 15:01:11+00:00,"48.825030852925, 2.3264128693982",Paris,75056,0.18181818181818182,15
10006,Petites Ecuries - Faubourg Saint-Denis,OUI,27,23,4,1,3,OUI,OUI,2025-03-13 14:57:41+00:00,"48.87287120589831, 2.3542150855064397",Paris,75056,0.14814814814814814,15
31709,Place de la Fraternité,OUI,22,20,2,1,1,OUI,OUI,2025-03-13 15:02:05+00:00,"48.85716405838368, 2.422847449779511",Montreuil,93048,0.09090909090909091,15
12002,Lacuée - Lyon,OUI,16,0,16,9,7,OUI,OUI,2025-03-13 15:01:47+00:00,"48.849268481958, 2.3704585433006",Paris,75056,1.0,15
22401,Charles de Gaulle - Plateau de Vanves,OUI,32,30,2,0,2,OUI,OUI,2025-03-13 14:53:03+00:00,"48.82233088973263, 2.298571803412886",Malakoff,92046,0.0625,15
21506,Maurice Payret-Dortail,OUI,22,21,1,0,1,OUI,OUI,2025-03-13 14:53:43+00:00,"48.87811957063342, 2.2233625128865246",Suresnes,92073,0.045454545454545456,15
4103,Archives - Rivoli,OUI,21,3,18,13,5,OUI,OUI,2025-03-13 15:01:43+00:00,"48.857346707443, 2.3539767041802",Paris,75056,0.8571428571428571,15
14103,Maine - Liancourt,OUI,25,24,1,0,1,OUI,OUI,2025-03-13 14:53:33+00:00,"48.835064363954, 2.323731449974",Paris,75056,0.04,15
3001,Beaumarchais - Saint-Gilles,OUI,44,33,11,6,5,OUI,OUI,2025-03-13 15:00:42+00:00,"48.8580378, 2.3679352",Paris,75056,0.25,15
9037,Parme - Clichy,OUI,23,22,1,0,1,OUI,OUI,2025-03-13 14:58:11+00:00,"48.881266424227, 2.3281970934506",Paris,75056,0.043478260869565216,15
2015,Louis le Grand - Italiens,OUI,33,8,25,16,9,OUI,OUI,2025-03-13 15:01:04+00:00,"48.870508937204, 2.3340544619393",Paris,75056,0.7575757575757576,15
7021,Bosquet - Saint-Dominique,OUI,27,15,12,10,2,OUI,OUI,2025-03-13 15:00:39+00:00,"48.858651709526, 2.3037165802346",Paris,75056,0.4444444444444444,15
21026,Sèvres - Général Leclerc,OUI,29,10,19,16,3,OUI,OUI,2025-03-13 15:01:45+00:00,"48.830121559055, 2.2314262390137",Boulogne-Billancourt,92012,0.6551724137931034,15
19129,Solitaires - Place des Fêtes,OUI,29,29,0,0,0,NON,NON,2025-02-23 09:26:05+00:00,"48.876601, 2.391769",Paris,75056,0.0,9
32013,Saint-Denis - Université,OUI,18,7,11,6,5,OUI,OUI,2025-03-13 14:58:55+00:00,"48.94563430946964, 2.3638297989964485",Saint-Denis,93066,0.6111111111111112,15
22503,Joffre - Aigle,OUI,19,13,6,5,1,OUI,OUI,2025-03-13 15:00:44+00:00,"48.904033, 2.245096",La Garenne-Colombes,92035,0.3157894736842105,15
20029,Frères Flavien - Porte des Lilas,OUI,23,23,0,0,0,OUI,OUI,2025-03-13 14:56:45+00:00,"48.8780992764359, 2.41104629853209",Paris,75056,0.0,15
13017,Nationale - Vincent Auriol,OUI,33,26,7,1,6,OUI,OUI,2025-03-13 14:58:47+00:00,"48.83252708397293, 2.362354410392119",Paris,75056,0.21212121212121213,15
2003,Saint-Denis - Réaumur,OUI,31,12,19,10,9,OUI,OUI,2025-03-13 15:00:46+00:00,"48.8661116315789, 2.3507790675507594",Paris,75056,0.6129032258064516,15
15111,Olivier de Serres - Leriche,OUI,24,23,1,0,1,OUI,OUI,2025-03-13 15:01:28+00:00,"48.83460221715206, 2.2957482933998112",Paris,75056,0.041666666666666664,15
1102,Française - Etienne Marcel,OUI,36,8,28,19,9,OUI,OUI,2025-03-13 15:01:53+00:00,"48.864053304653766, 2.347587011754513",Paris,75056,0.7777777777777778,15
3009,Temple - Haudriettes,OUI,19,3,16,13,3,OUI,OUI,2025-03-13 14:59:59+00:00,"48.861636880212, 2.3566960206458",Paris,75056,0.8421052631578947,15
12020,Cours de Vincennes - Soult,OUI,44,38,6,2,4,OUI,OUI,2025-03-13 15:01:13+00:00,"48.846918761569, 2.4105220288038",Paris,75056,0.13636363636363635,15
14132,Bézout - Général Leclerc,OUI,28,24,4,0,4,OUI,OUI,2025-03-13 14:59:33+00:00,"48.82884804502439, 2.3285973072052",Paris,75056,0.14285714285714285,15
2021,Cléry - Montmartre,OUI,58,32,26,13,13,OUI,OUI,2025-03-13 15:01:06+00:00,"48.867458, 2.3445211",Paris,75056,0.4482758620689655,15
2005,Montmartre - Etienne Marcel,OUI,16,1,15,12,3,OUI,OUI,2025-03-13 14:59:28+00:00,"48.86502194581, 2.3450684401448",Paris,75056,0.9375,15
24006,Adolphe Lalyre - Armand Silvestre,OUI,38,38,0,0,0,OUI,OUI,2025-03-13 14:59:03+00:00,"48.90406266961591, 2.273416221141815",Courbevoie,92026,0.0,15
23702,Hôtel de Ville de Chaville,OUI,20,20,0,0,0,OUI,OUI,2025-03-13 14:58:52+00:00,"48.80887149094033, 2.188134044408798",Chaville,92022,0.0,15
4014,Blancs-Manteaux - Archives,OUI,29,2,27,24,3,OUI,OUI,2025-03-13 14:57:13+00:00,"48.85941800703, 2.3559471219778",Paris,75056,0.9310344827586207,15
21507,Gardenat-Lapostol - Velettes,OUI,20,12,8,2,6,OUI,OUI,2025-03-13 14:55:42+00:00,"48.87387, 2.224185",Suresnes,92073,0.4,15
3012,Square Emile - Chautemps,OUI,23,0,23,16,7,OUI,OUI,2025-03-13 14:58:46+00:00,"48.867433724231, 2.3536357283592",Paris,75056,1.0,15
14023,Adolphe Pinard - Victor Hugo,OUI,51,49,2,0,2,OUI,OUI,2025-03-13 14:54:35+00:00,"48.8236825874564, 2.3077843710780144",Malakoff,92046,0.0392156862745098,15
14022,Didot - Mariniers,OUI,35,34,1,0,1,OUI,OUI,2025-03-13 15:01:38+00:00,"48.82650543613106, 2.313136198271666",Paris,75056,0.02857142857142857,15
3006,Mairie du 3ème,OUI,24,2,22,20,2,OUI,OUI,2025-03-13 14:56:52+00:00,"48.86446178139141, 2.361762821674347",Paris,75056,0.9166666666666666,15
2002,Etienne Marcel - Montorgueil,OUI,25,1,24,18,6,OUI,OUI,2025-03-13 15:01:50+00:00,"48.86450567259199, 2.3461959511041637",Paris,75056,0.96,15
19012,Lally-Tollendal - Armand Carrel,OUI,27,24,3,1,2,OUI,OUI,2025-03-13 15:01:13+00:00,"48.88270066221072, 2.374717555940151",Paris,75056,0.1111111111111111,15
4015,Mairie du 4ème,OUI,41,3,38,33,5,OUI,OUI,2025-03-13 15:01:45+00:00,"48.855949910497, 2.3563823103905",Paris,75056,0.926829268292683,15
31001,Lagny - Auguste Blanqui,OUI,26,10,16,14,2,OUI,OUI,2025-03-13 15:00:20+00:00,"48.84922568052601, 2.4218603968620305",Montreuil,93048,0.6153846153846154,15
9111,Victoire - Laffitte,OUI,19,1,18,15,3,OUI,OUI,2025-03-13 15:00:16+00:00,"48.87514373494672, 2.338118505144376",Paris,75056,0.9473684210526315,15
22306,Place du 17 Octobre,OUI,16,7,9,5,4,OUI,OUI,2025-03-13 14:58:54+00:00,"48.91962690034779, 2.2978286134199792",Gennevilliers,92036,0.5625,15
21110,Parc Roger Salengro,OUI,30,8,22,21,1,OUI,OUI,2025-03-13 15:01:41+00:00,"48.905303858642, 2.31055945158",Clichy,92024,0.7333333333333333,15
22502,Kléber - National,OUI,20,16,4,3,1,OUI,OUI,2025-03-13 14:59:23+00:00,"48.906333898712234, 2.2393910586833954",La Garenne-Colombes,92035,0.2,15
8036,Lisbonne - Monceau,OUI,46,5,41,16,25,OUI,OUI,2025-03-13 14:59:51+00:00,"48.877455676814, 2.3096942214195",Paris,75056,0.8913043478260869,15
3003,Fille du Calvaire - Turenne,OUI,26,2,24,18,6,OUI,OUI,2025-03-13 15:01:25+00:00,"48.86210505412563, 2.3649600148200993",Paris,75056,0.9230769230769231,15
6031,Pierre Sarrazin - Saint-Michel,OUI,31,0,31,23,8,OUI,OUI,2025-03-13 15:01:36+00:00,"48.850908146398, 2.342130728066",Paris,75056,1.0,15
19111,Cesaria Evora - Rosa Parks,OUI,36,29,7,4,3,OUI,OUI,2025-03-13 15:02:00+00:00,"48.89717672825043, 2.3745173960924144",Paris,75056,0.19444444444444445,15
48005,Eugène Varlin - Place de la Paix,OUI,23,20,3,1,2,OUI,OUI,2025-03-13 15:00:32+00:00,"48.792862, 2.363093",Villejuif,94076,0.13043478260869565,15
5122,Saint-Michel - Luxembourg,OUI,28,9,19,6,13,OUI,OUI,2025-03-13 15:02:05+00:00,"48.84501507626, 2.3394941166043",Paris,75056,0.6785714285714286,15
14133,Froidevaux - Boulard,OUI,35,32,3,0,3,OUI,OUI,2025-03-13 15:01:12+00:00,"48.835147319625, 2.3294411972165",Paris,75056,0.08571428571428572,15
13125,Gare d'Austerlitz - Pont Charles de Gaulle,OUI,54,12,42,23,19,OUI,OUI,2025-03-13 15:01:53+00:00,"48.842319830109, 2.3670300096273",Paris,75056,0.7777777777777778,15
4012,Tiron - Rivoli,OUI,27,3,24,19,5,OUI,OUI,2025-03-13 15:00:41+00:00,"48.855692253233, 2.3579058051109",Paris,75056,0.8888888888888888,15
41208,Alouettes - Maréchal de Lattre de Tassigny,OUI,21,13,8,2,6,OUI,OUI,2025-03-13 15:01:35+00:00,"48.85511009293948, 2.4930700287222862",Fontenay-sous-Bois,94033,0.38095238095238093,15
21215,Verdier - Jean Jaurès,OUI,32,30,2,2,0,OUI,OUI,2025-03-13 15:00:06+00:00,"48.81614048711214, 2.3123561963438988",Montrouge,92049,0.0625,15
42704,Mairie du Kremlin-Bicêtre,OUI,25,24,1,0,1,OUI,OUI,2025-03-13 14:58:05+00:00,"48.81191981537702, 2.3570189997553825",Le Kremlin-Bicêtre,94043,0.04,15
4017,Place de l'Hôtel de Ville,OUI,12,2,10,7,3,OUI,OUI,2025-03-13 15:01:10+00:00,"48.8573314, 2.351458",Paris,75056,0.8333333333333334,15
21706,Jean Bleuzen - Square du 11 Novembre,OUI,45,42,3,1,2,OUI,OUI,2025-03-13 15:00:39+00:00,"48.8232579, 2.2965213",Vanves,92075,0.06666666666666667,15
26006,Bas - Gabriel Péri,OUI,30,13,17,15,2,OUI,OUI,2025-03-13 15:01:53+00:00,"48.91585580539625, 2.2948095202445984",Asnières-sur-Seine,92004,0.5666666666666667,15
1014,Rivoli - Musée du Louvre,OUI,22,1,21,10,11,OUI,OUI,2025-03-13 15:01:18+00:00,"48.86364636851945, 2.33409583568573",Paris,75056,0.9545454545454546,15
12163,Hippodrome Paris-Vincennes,OUI,42,40,2,1,1,OUI,OUI,2025-03-13 14:55:34+00:00,"48.82048387758518, 2.446271181106568",Paris,75056,0.047619047619047616,15
42211,Séminaire de Conflans - Liberté,OUI,24,5,19,11,8,OUI,OUI,2025-03-13 15:01:36+00:00,"48.823194, 2.404179",Charenton-le-Pont,94018,0.7916666666666666,15
3002,Saint-Gilles - Turenne,OUI,14,7,7,3,4,OUI,OUI,2025-03-13 15:00:08+00:00,"48.858158956779, 2.3647149920992",Paris,75056,0.5,15
42026,Barbès - Monique Maunoury,OUI,40,37,3,2,1,OUI,OUI,2025-03-13 14:59:16+00:00,"48.81552718820216, 2.3687169334905405",Ivry-sur-Seine,94041,0.075,15
1012,Jean-Jacques Rousseau - Deux Ecus,OUI,22,1,21,15,6,OUI,OUI,2025-03-13 14:59:50+00:00,"48.86297805972131, 2.3414635285735126",Paris,75056,0.9545454545454546,15
2012,Choiseul - Quatre Septembre,OUI,44,16,28,11,17,OUI,OUI,2025-03-13 15:01:42+00:00,"48.8699355331869, 2.3359975218772893",Paris,75056,0.6363636363636364,15
2004,Square Pierre Lazareff,OUI,17,8,9,5,4,OUI,OUI,2025-03-13 15:00:36+00:00,"48.867141720746, 2.3483933508396",Paris,75056,0.5294117647058824,15
21509,Gardenat Lapostol - Franklin Roosevelt,OUI,24,21,3,0,3,OUI,OUI,2025-03-13 14:57:48+00:00,"48.871839, 2.222505",Suresnes,92073,0.125,15
19130,Place Paul Delouvrier,OUI,26,24,2,1,1,OUI,OUI,2025-03-13 15:01:42+00:00,"48.89197621431365, 2.3851288855075836",Paris,75056,0.07692307692307693,15
13054,Pau Casals - Neuve Tolbiac,OUI,53,4,49,21,28,OUI,OUI,2025-03-13 15:02:06+00:00,"48.8311602, 2.3774395",Paris,75056,0.9245283018867925,15
35012,Candale - Mehul,OUI,25,22,3,0,3,OUI,OUI,2025-03-13 15:01:32+00:00,"48.8893935006175, 2.414379715919495",Pantin,93055,0.12,15
2016,Aboukir - Alexandrie,OUI,21,7,14,14,0,OUI,OUI,2025-03-13 15:01:39+00:00,"48.86868344444473, 2.3502043269474897",Paris,75056,0.6666666666666666,15
21505,Édouard Vaillant - Place Jean Jaurès,OUI,20,16,4,2,2,OUI,OUI,2025-03-13 14:57:15+00:00,"48.86265537999924, 2.2089037319128613",Suresnes,92073,0.2,15
16044,Porte de Saint Cloud - Parc des Princes,OUI,31,16,15,10,5,OUI,OUI,2025-03-13 15:00:34+00:00,"48.838662757066, 2.2525164484978",Paris,75056,0.4838709677419355,15
4018,Saint-Bon - Rivoli,OUI,14,2,12,9,3,OUI,OUI,2025-03-13 15:00:56+00:00,"48.857999643315, 2.3502172809763",Paris,75056,0.8571428571428571,15
5004,Saint-Jacques - Val de Grâce,OUI,19,5,14,0,14,OUI,OUI,2025-03-13 15:01:29+00:00,"48.8417514, 2.3413893",Paris,75056,0.7368421052631579,15
44001,Quai Jules Guesde - Saint-Simon,OUI,30,3,27,26,1,OUI,OUI,2025-03-13 15:01:14+00:00,"48.80391487219, 2.4089661620274",Vitry-sur-Seine,94081,0.9,15
4009,Village Saint-Paul,OUI,27,7,20,18,2,OUI,OUI,2025-03-13 15:02:02+00:00,"48.852639866625, 2.3607301712036",Paris,75056,0.7407407407407407,15
4007,Place de la Bastille - Bourdon,OUI,33,7,26,11,15,OUI,OUI,2025-03-13 15:02:06+00:00,"48.852364355271, 2.3681089282036",Paris,75056,0.7878787878787878,15
4101,Bastille - Beaumarchais,OUI,20,4,16,12,4,OUI,OUI,2025-03-13 15:00:41+00:00,"48.853833463852, 2.3685702681541",Paris,75056,0.8,15
10041,Gare du Nord - La Chapelle,OUI,18,16,2,0,2,OUI,OUI,2025-03-13 14:56:12+00:00,"48.884178287286, 2.3561057075858",Paris,75056,0.1111111111111111,15
33020,Waldeck Rochet - Germaine Tillon,OUI,30,2,28,18,10,OUI,OUI,2025-03-13 15:00:36+00:00,"48.91105960199651, 2.3676301538944244",Aubervilliers,93001,0.9333333333333333,15
32019,Place du 8 mai 1945.,OUI,28,17,11,5,6,OUI,OUI,2025-03-13 14:58:47+00:00,"48.938882272105, 2.3566243797541",Saint-Denis,93066,0.39285714285714285,15
1025,Oratoire - Rivoli,OUI,17,1,16,8,8,OUI,OUI,2025-03-13 14:55:34+00:00,"48.861342760889, 2.3400047421455",Paris,75056,0.9411764705882353,15
9039,Chaussée d'Antin - Haussmann,OUI,23,3,20,10,10,OUI,OUI,2025-03-13 15:01:29+00:00,"48.87243, 2.33359",Paris,75056,0.8695652173913043,15
1018,Alger - Rivoli,OUI,17,3,14,7,7,OUI,OUI,2025-03-13 14:58:07+00:00,"48.864773553495, 2.3294493936128",Paris,75056,0.8235294117647058,15
22506,Gare des Vallées,OUI,18,13,5,3,2,OUI,OUI,2025-03-13 14:59:05+00:00,"48.913179, 2.257726",La Garenne-Colombes,92035,0.2777777777777778,15
23101,Grande Rue - Europe,OUI,25,16,9,6,3,OUI,OUI,2025-03-13 15:01:40+00:00,"48.8218104687602, 2.205879874527455",Sèvres,92072,0.36,15
2008,Mairie du 2ème,OUI,28,5,23,14,9,OUI,OUI,2025-03-13 15:02:05+00:00,"48.8672190355135, 2.3404625437747044",Paris,75056,0.8214285714285714,15
15040,Saint-Amand - Labrouste,OUI,34,31,3,0,3,OUI,OUI,2025-03-13 14:59:36+00:00,"48.834097274832295, 2.3087677359581",Paris,75056,0.08823529411764706,15
1026,Place du Lieutenant Henri Karcher,OUI,29,1,28,22,6,OUI,OUI,2025-03-13 15:01:49+00:00,"48.863490871724466, 2.3400671035051346",Paris,75056,0.9655172413793104,15
23107,Gare de Sèvres - Ville d'Avray,OUI,22,21,1,1,0,OUI,OUI,2025-03-13 14:56:13+00:00,"48.826262366227, 2.2001516849313",Sèvres,92072,0.045454545454545456,15
18015,Custine - Ramey,OUI,40,37,3,0,3,OUI,OUI,2025-03-13 14:56:25+00:00,"48.888735896947, 2.3469526693225",Paris,75056,0.075,15
22601,Marx Dormoy - Château Sainte-Barbe,OUI,20,16,4,0,4,OUI,OUI,2025-03-13 14:56:06+00:00,"48.791782341055324, 2.297856844961643",Fontenay-aux-Roses,92032,0.2,15
17106,Berthier - Porte de Clichy,OUI,24,18,6,6,0,OUI,OUI,2025-03-13 15:00:33+00:00,"48.894222687781, 2.3125872006816",Paris,75056,0.25,15
42018,Amédée Huon - Fort d'Ivry,OUI,31,31,0,0,0,OUI,OUI,2025-03-13 14:59:26+00:00,"48.805131376899986, 2.388489693403244",Ivry-sur-Seine,94041,0.0,15
1116,Ventadour - Opéra,OUI,27,3,24,15,9,OUI,OUI,2025-03-13 14:59:56+00:00,"48.866810653323, 2.3343884482519",Paris,75056,0.8888888888888888,15
12164,Stade Pershing,OUI,26,26,0,0,0,NON,NON,2025-02-26 05:58:32+00:00,"48.829107826857, 2.4583535268903",Paris,75056,0.0,6
32024,Port - Confluence,OUI,23,11,12,5,7,OUI,OUI,2025-03-13 14:55:01+00:00,"48.936093926526, 2.3436167797955",Saint-Denis,93066,0.5217391304347826,15
1023,Saint-Honoré - Musée du Louvre,OUI,21,1,20,10,10,OUI,OUI,2025-03-13 15:01:40+00:00,"48.863443132848, 2.3348781846405",Paris,75056,0.9523809523809523,15
1017,Saint-Honoré - 29 juillet,OUI,20,7,13,10,3,OUI,OUI,2025-03-13 15:01:19+00:00,"48.86557114282421, 2.330567417577153",Paris,75056,0.65,15
48008,Guy Môquet - Parvis Georges Marchais,OUI,30,30,0,0,0,OUI,OUI,2025-03-13 15:02:07+00:00,"48.79518840095975, 2.35943466424942",Villejuif,94076,0.0,15
6201,Saint Pères - Saint Germain,OUI,22,19,3,2,1,OUI,OUI,2025-03-13 14:58:00+00:00,"48.853729675265, 2.3300181032703",Paris,75056,0.13636363636363635,15
19202,Marseillaise - Grenade,OUI,44,39,5,1,4,OUI,OUI,2025-03-13 14:57:50+00:00,"48.889371092747, 2.3979396821544",Paris,75056,0.11363636363636363,15
6026,Saint-Placide - Cherche Midi,OUI,66,42,24,15,9,OUI,OUI,2025-03-13 15:01:31+00:00,"48.8490535919234, 2.325317971408367",Paris,75056,0.36363636363636365,15
14201,Decrès - Alésia,OUI,30,26,4,1,3,OUI,OUI,2025-03-13 14:57:28+00:00,"48.832200060759, 2.3139070151575",Paris,75056,0.13333333333333333,15
27001,Square Victor Basch,OUI,19,7,12,11,1,OUI,OUI,2025-03-13 14:59:23+00:00,"48.914304862261, 2.2289156913757",Colombes,92025,0.631578947368421,15
5003,Le Goff - Gay-Lussac,OUI,34,2,32,11,21,OUI,OUI,2025-03-13 15:00:24+00:00,"48.846102400979, 2.3412207886577",Paris,75056,0.9411764705882353,15
17021,Jouffroy d'Abbans - Villiers,OUI,30,23,7,3,4,OUI,OUI,2025-03-13 15:00:19+00:00,"48.884215547037, 2.3056533560157",Paris,75056,0.23333333333333334,15
35005,Quai de l'Aisne - Général Leclerc,OUI,26,21,5,1,4,OUI,OUI,2025-03-13 15:01:53+00:00,"48.895713, 2.400571",Pantin,93055,0.19230769230769232,15
3007,Archives - Pastourelle,OUI,26,2,24,17,7,OUI,OUI,2025-03-13 15:01:11+00:00,"48.8623615, 2.3595041",Paris,75056,0.9230769230769231,15
18112,Arthur Ranc - Hôpital Bichat,OUI,23,16,7,3,4,OUI,OUI,2025-03-13 15:01:31+00:00,"48.8978712500682, 2.333521842956543",Paris,75056,0.30434782608695654,15
31020,Résistance - Parmentier,OUI,32,28,4,1,3,OUI,OUI,2025-03-13 15:00:05+00:00,"48.85965138131299, 2.436705082654953",Montreuil,93048,0.125,15
16139,Suresnes - Muette à Neuilly,OUI,29,22,7,4,3,OUI,OUI,2025-03-13 14:57:32+00:00,"48.868570404348, 2.266000919044",Paris,75056,0.2413793103448276,15
28005,Jean Jaurès - Paul Lafargue,OUI,27,2,25,5,20,OUI,OUI,2025-03-13 15:01:43+00:00,"48.884933177666, 2.2484488785267",Puteaux,92062,0.9259259259259259,15
6007,Bréa - Raspail,OUI,23,14,9,1,8,OUI,OUI,2025-03-13 15:01:50+00:00,"48.842738478258, 2.3297942217634",Paris,75056,0.391304347826087,15
22603,Place de la Division Leclerc,OUI,33,33,0,0,0,OUI,OUI,2025-03-13 15:01:21+00:00,"48.793824988636516, 2.2731140430551027",Fontenay-aux-Roses,92032,0.0,15
42028,Verdun - Carnot,OUI,28,27,1,0,1,OUI,OUI,2025-03-13 15:00:02+00:00,"48.808439376064946, 2.373795211315155",Ivry-sur-Seine,94041,0.03571428571428571,15
12113,Cardinal Lavigerie,OUI,46,8,38,29,9,OUI,OUI,2025-03-13 15:01:52+00:00,"48.832934193699835, 2.402636749399156",Paris,75056,0.8260869565217391,15
12166,Parc Floral du Bel Air,OUI,24,14,10,6,4,OUI,OUI,2025-03-13 15:00:47+00:00,"48.839285711865735, 2.438560165464878",Paris,75056,0.4166666666666667,15
21119,Belfort - Victor Hugo,OUI,21,3,18,11,7,OUI,OUI,2025-03-13 14:59:25+00:00,"48.9018492, 2.3172724",Clichy,92024,0.8571428571428571,15
16201,Porte Dauphine,OUI,60,46,14,1,13,OUI,OUI,2025-03-13 14:57:25+00:00,"48.871139344351, 2.2749781616017",Paris,75056,0.23333333333333334,15
16010,Belles Feuilles - Place de Mexico,OUI,22,16,6,3,3,OUI,OUI,2025-03-13 15:00:39+00:00,"48.865804746474, 2.2829206287861",Paris,75056,0.2727272727272727,15
23042,André Theuriet - Blagis,OUI,29,20,9,9,0,OUI,OUI,2025-03-13 15:01:41+00:00,"48.77977325745441, 2.3130525648593903",Bourg-la-Reine,92014,0.3103448275862069,15
42019,Lampes,OUI,43,4,39,39,0,OUI,OUI,2025-03-13 14:59:57+00:00,"48.81152481985875, 2.4017931148409843",Ivry-sur-Seine,94041,0.9069767441860465,15
32020,Jules Guesdes - Carnot,OUI,14,14,0,0,0,OUI,OUI,2025-03-13 14:56:11+00:00,"48.93828169931872, 2.3508992046117783",Saint-Denis,93066,0.0,15
27006,Victor Hugo - Gare,OUI,19,17,2,2,0,OUI,OUI,2025-03-13 14:55:45+00:00,"48.923133952658, 2.2600970417261",Colombes,92025,0.10526315789473684,15
1015,Place André Malraux,OUI,17,1,16,6,10,OUI,OUI,2025-03-13 15:01:15+00:00,"48.863925158727, 2.3356226831675",Paris,75056,0.9411764705882353,15
1008,Les Halles - Saint-Eustache,OUI,32,4,28,11,17,OUI,OUI,2025-03-13 15:01:40+00:00,"48.86362695901683, 2.342623919248581",Paris,75056,0.875,15
2006,Place des Victoires,OUI,23,1,22,13,9,OUI,OUI,2025-03-13 15:02:03+00:00,"48.8660354, 2.3420333",Paris,75056,0.9565217391304348,15
2102,Saint-Marc - Feydeau,OUI,37,6,31,14,17,OUI,OUI,2025-03-13 15:01:34+00:00,"48.870326843044, 2.3418715826353",Paris,75056,0.8378378378378378,15
9019,Victor Massé - Jean-Baptiste Pigalle,OUI,18,10,8,0,8,OUI,OUI,2025-03-13 15:01:34+00:00,"48.8811043724, 2.3366955667734",Paris,75056,0.4444444444444444,15
44004,Place de l'Eglise - Vitry-sur-Seine,OUI,28,6,22,22,0,OUI,OUI,2025-03-13 15:01:38+00:00,"48.791922819921815, 2.395057752728462",Vitry-sur-Seine,94081,0.7857142857142857,15
6029,Vaugirard - Monsieur le Prince,OUI,23,2,21,7,14,OUI,OUI,2025-03-13 15:02:07+00:00,"48.848951441614, 2.3411329463124",Paris,75056,0.9130434782608695,15
1024,Coquillière - Louvre,OUI,17,0,17,5,12,OUI,OUI,2025-03-13 15:01:39+00:00,"48.863795909662, 2.3425736278296",Paris,75056,1.0,15
12016,Saint-Mande - Picpus,OUI,33,24,9,3,6,OUI,OUI,2025-03-13 15:02:06+00:00,"48.845127728278, 2.4015686296482",Paris,75056,0.2727272727272727,15
19046,Porte de Pantin.,OUI,33,31,2,0,2,OUI,OUI,2025-03-13 14:53:37+00:00,"48.889199725577, 2.3950181901455",Paris,75056,0.06060606060606061,15
44008,Youri Gagarine - Commune de Paris,OUI,32,12,20,10,10,OUI,OUI,2025-03-13 14:59:02+00:00,"48.782427463041, 2.3939734697342",Vitry-sur-Seine,94081,0.625,15
2020,Danielle Casanova - Opéra,OUI,20,2,18,10,8,OUI,OUI,2025-03-13 15:01:42+00:00,"48.867643242297, 2.3333894088864",Paris,75056,0.9,15
23104,Quai de Sèvres - Manufacture Nationale,OUI,27,11,16,7,9,OUI,OUI,2025-03-13 15:01:11+00:00,"48.828688, 2.22499",Sèvres,92072,0.5925925925925926,15
10201,Magenta - Chabrol,OUI,23,20,3,0,3,OUI,OUI,2025-03-13 15:01:59+00:00,"48.876495350882, 2.3560990020633",Paris,75056,0.13043478260869565,15
21011,Silly - Louis Blériot,OUI,23,8,15,6,9,OUI,OUI,2025-03-13 15:01:28+00:00,"48.83219045374266, 2.2340199351310734",Boulogne-Billancourt,92012,0.6521739130434783,15
23301,Les Blagis,OUI,24,13,11,8,3,OUI,OUI,2025-03-13 15:01:34+00:00,"48.785205, 2.302526",Sceaux,92071,0.4583333333333333,15
20140,Paganini - Davout,OUI,21,19,2,0,2,OUI,OUI,2025-03-13 14:58:42+00:00,"48.85135, 2.412021",Paris,75056,0.09523809523809523,15
42210,Victor Hugo - Paul Eluard,OUI,31,3,28,25,3,OUI,OUI,2025-03-13 14:57:22+00:00,"48.819602554907, 2.4114319673051",Charenton-le-Pont,94018,0.9032258064516129,15
15018,Dutot - Place Alleray,OUI,56,50,6,0,6,OUI,OUI,2025-03-13 14:59:29+00:00,"48.836826091766, 2.3071701095578",Paris,75056,0.10714285714285714,15
34013,Blanqui - Docteur Bauer,OUI,20,9,11,7,4,OUI,OUI,2025-03-13 14:57:52+00:00,"48.907735489085, 2.3407192814591",Saint-Ouen-sur-Seine,93070,0.55,15
26012,Jardin Modèle - Pierre Boudou,OUI,15,10,5,2,3,OUI,OUI,2025-03-13 15:01:30+00:00,"48.914866710946, 2.3057010525935",Asnières-sur-Seine,92004,0.3333333333333333,15
48012,Stalingrad - Henri Luisette,OUI,26,25,1,0,1,OUI,OUI,2025-03-13 14:53:05+00:00,"48.78363092456589, 2.366935946761926",Villejuif,94076,0.038461538461538464,15
13049,Vincent Auriol - Louise Weiss,OUI,22,2,20,11,9,OUI,OUI,2025-03-13 15:01:04+00:00,"48.834001935501, 2.3703888058662",Paris,75056,0.9090909090909091,15
23303,Gare de Robinson,OUI,29,29,0,0,0,OUI,OUI,2025-03-13 14:55:15+00:00,"48.7799259211605, 2.281828634440899",Sceaux,92071,0.0,15
32605,Mairie,OUI,20,20,0,0,0,OUI,OUI,2025-03-13 14:57:26+00:00,"48.87914304162, 2.4163350908311",Les Lilas,93045,0.0,15
20010,Sorbier - Gasnier-Guy,OUI,34,31,3,1,2,OUI,OUI,2025-03-13 15:01:02+00:00,"48.865217631011, 2.3936596512794",Paris,75056,0.08823529411764706,15
17202,Mariotte - Batignolles,OUI,18,14,4,2,2,OUI,OUI,2025-03-13 14:57:06+00:00,"48.884571659595, 2.321469503475",Paris,75056,0.2222222222222222,15
42022,Gare RER - Maurice Grandcoing,OUI,37,7,30,28,2,OUI,OUI,2025-03-13 15:00:06+00:00,"48.813881, 2.392429",Ivry-sur-Seine,94041,0.8108108108108109,15
8202,Londres - Europe,OUI,27,17,10,3,7,OUI,OUI,2025-03-13 15:01:52+00:00,"48.878618556803, 2.3248164693922",Paris,75056,0.37037037037037035,15
20048,Bagnolet - Place Saint-Blaise,OUI,27,21,6,3,3,OUI,OUI,2025-03-13 15:02:04+00:00,"48.85973, 2.40334",Paris,75056,0.2222222222222222,15
32011,Stade de France - Francis de Pressensé,OUI,43,9,34,4,30,OUI,OUI,2025-03-13 15:01:37+00:00,"48.919141953558, 2.3620655760169",Saint-Denis,93066,0.7906976744186046,15
10166,Strasbourg - Saint-Denis,OUI,16,10,6,4,2,OUI,OUI,2025-03-13 15:02:05+00:00,"48.869601642433, 2.3542908579111",Paris,75056,0.375,15
12202,Charenton - Wattignies,OUI,40,35,5,3,2,OUI,OUI,2025-03-13 15:01:57+00:00,"48.836919119234, 2.3916775206425",Paris,75056,0.125,15
45004,République - Louis Loucheur,OUI,37,2,35,5,30,OUI,OUI,2025-03-13 15:01:34+00:00,"48.823549261189, 2.5101865455508",Champigny-sur-Marne,94017,0.9459459459459459,15
23206,Béranger - Félix Faure,OUI,26,25,1,0,1,OUI,OUI,2025-03-13 14:56:12+00:00,"48.80404828621485, 2.2848263373723436",Châtillon,92020,0.038461538461538464,15
23202,Henri Barbusse - Gabriel Péri,OUI,17,15,2,0,2,OUI,OUI,2025-03-13 14:58:44+00:00,"48.801773795836, 2.2874166362216",Châtillon,92020,0.11764705882352941,15
8040,Pierre Charron - Champs-Elysées,OUI,30,7,23,8,15,OUI,OUI,2025-03-13 14:59:12+00:00,"48.870103359864, 2.3043501377106",Paris,75056,0.7666666666666667,15
6015,André Mazet - Saint-André des Arts,OUI,55,0,55,44,11,OUI,OUI,2025-03-13 15:01:10+00:00,"48.85375581057431, 2.3390958085656166",Paris,75056,1.0,15
10202,Bichat - Grange aux Belles,OUI,29,26,3,2,1,OUI,OUI,2025-03-13 15:01:33+00:00,"48.873688, 2.365015",Paris,75056,0.10344827586206896,15
17020,Jouffroy d'Abbans - Malesherbes,OUI,26,17,9,2,7,OUI,OUI,2025-03-13 14:58:12+00:00,"48.8850134, 2.3070717",Paris,75056,0.34615384615384615,15
42030,Stéphanie Bouvard - Gambetta,OUI,30,24,6,5,1,OUI,OUI,2025-03-13 15:01:26+00:00,"48.814548138856, 2.4024386957288",Ivry-sur-Seine,94041,0.2,15
48001,Chastenet de Géry - Marcel Paul,OUI,25,22,3,0,3,OUI,OUI,2025-03-13 15:00:32+00:00,"48.800123, 2.3567359",Villejuif,94076,0.12,15
8018,Saint-Augustin,OUI,31,4,27,14,13,OUI,OUI,2025-03-13 15:01:38+00:00,"48.8762009747008, 2.319786250591278",Paris,75056,0.8709677419354839,15
51008,Martyrs de Châteaubriant - Jean Grandel,OUI,38,27,11,1,10,OUI,OUI,2025-03-13 14:58:45+00:00,"48.951432, 2.211214",Argenteuil,95018,0.2894736842105263,15
20142,Mûriers - Père Lachaise,OUI,19,17,2,0,2,OUI,OUI,2025-03-13 14:58:31+00:00,"48.864130509668044, 2.39164982067019",Paris,75056,0.10526315789473684,15
34011,Clef des Champs - Albert Dhalenne,OUI,25,4,21,12,9,OUI,OUI,2025-03-13 15:00:31+00:00,"48.914938, 2.330665",Saint-Ouen-sur-Seine,93070,0.84,15
21329,Gare - Aristide Briand,OUI,28,8,20,17,3,OUI,OUI,2025-03-13 14:59:56+00:00,"48.821410564722, 2.2555950104387",Issy-les-Moulineaux,92040,0.7142857142857143,15
18135,Ney - Porte de Montmartre,OUI,23,21,2,1,1,OUI,OUI,2025-03-13 15:01:53+00:00,"48.897918, 2.3364872",Paris,75056,0.08695652173913043,15
21704,Place du Maréchal de Lattre de Tassigny,OUI,27,24,3,2,1,OUI,OUI,2025-03-13 15:00:52+00:00,"48.821707715257055, 2.2853431485432423",Vanves,92075,0.1111111111111111,15
24101,Place Charles de Gaulle,OUI,24,20,4,0,4,OUI,OUI,2025-03-13 15:00:20+00:00,"48.826073335699, 2.1894485725692",Ville-d'Avray,92077,0.16666666666666666,15
25007,Bons Raisins - Voltaire,OUI,24,23,1,1,0,OUI,OUI,2025-03-13 15:01:55+00:00,"48.87282451461399, 2.1947155570850896",Rueil-Malmaison,92063,0.041666666666666664,15
19121,Belleville -  Pré Saint-Gervais,OUI,21,20,1,0,1,OUI,OUI,2025-03-13 14:58:58+00:00,"48.875565910073, 2.3930460959673",Paris,75056,0.047619047619047616,15
5027,Gobelins - Port-Royal,OUI,36,6,30,26,4,OUI,OUI,2025-03-13 15:01:50+00:00,"48.837135900263, 2.3515201359987",Paris,75056,0.8333333333333334,15
13015,Chevaleret - Louise Weiss,OUI,35,7,28,18,10,OUI,OUI,2025-03-13 15:01:20+00:00,"48.832586513351, 2.37121138812",Paris,75056,0.8,15
13116,Place du Docteur Yersin,OUI,50,44,6,1,5,OUI,OUI,2025-03-13 14:52:20+00:00,"48.82010494991975, 2.3725583776831627",Paris,75056,0.12,15
19114,Manin - Secrétan,OUI,20,18,2,0,2,OUI,OUI,2025-03-13 14:54:52+00:00,"48.8791665, 2.3787959",Paris,75056,0.1,15
18016,Francoeur - Caulaincourt,OUI,33,28,5,0,5,OUI,OUI,2025-03-13 15:00:34+00:00,"48.8899944409612, 2.342529706656933",Paris,75056,0.15151515151515152,15
12123,Château de Vincennes,OUI,49,46,3,0,3,OUI,OUI,2025-03-13 14:59:04+00:00,"48.84423193255657, 2.439209537709179",Paris,75056,0.061224489795918366,15
20003,Pyrénées - Cours de Vincennes,OUI,19,15,4,0,4,OUI,OUI,2025-03-13 15:01:50+00:00,"48.847796779935, 2.4061721563339",Paris,75056,0.21052631578947367,15
21002,Place Denfert-Rochereau,OUI,20,13,7,6,1,OUI,OUI,2025-03-13 15:01:27+00:00,"48.843252536286684, 2.245987951755524",Boulogne-Billancourt,92012,0.35,15
10003,Hauteville - Bonne Nouvelle,OUI,16,2,14,12,2,OUI,OUI,2025-03-13 14:58:50+00:00,"48.87077436024, 2.3496496368327",Paris,75056,0.875,15
13024,Bobillot - Tolbiac,OUI,33,23,10,4,6,OUI,OUI,2025-03-13 15:02:02+00:00,"48.8255961335041, 2.350204177200794",Paris,75056,0.30303030303030304,15
11022,Roquette - Auguste Laurent,OUI,16,11,5,2,3,OUI,OUI,2025-03-13 15:02:06+00:00,"48.858001906023354, 2.381797702650783",Paris,75056,0.3125,15
24004,Paix - Verdun,OUI,33,21,12,8,4,OUI,OUI,2025-03-13 14:58:44+00:00,"48.900504, 2.261173",Courbevoie,92026,0.36363636363636365,15
41602,Place Charles Digeon,OUI,31,31,0,0,0,OUI,OUI,2025-03-13 15:01:58+00:00,"48.84354203133597, 2.418427169322968",Saint-Mandé,94067,0.0,15
23041,Général Leclerc - Bièvre,OUI,24,20,4,3,1,OUI,OUI,2025-03-13 15:01:24+00:00,"48.782414428747316, 2.3166695237159733",Bourg-la-Reine,92014,0.16666666666666666,15
15069,Félix Faure - Convention,OUI,44,28,16,13,3,OUI,OUI,2025-03-13 15:02:01+00:00,"48.841249336041, 2.2883866008495",Paris,75056,0.36363636363636365,15
24005,Edith Cavell - Volta,OUI,32,28,4,2,2,OUI,OUI,2025-03-13 15:01:12+00:00,"48.901616564286975, 2.269354350864887",Courbevoie,92026,0.125,15
14027,Gergovie - Alésia,OUI,54,51,3,2,1,OUI,OUI,2025-03-13 15:01:22+00:00,"48.83088717455243, 2.318882101207347",Paris,75056,0.05555555555555555,15
31104,Mairie de Rosny-sous-Bois,OUI,26,12,14,10,4,OUI,OUI,2025-03-13 15:00:03+00:00,"48.871256519012, 2.4865807592869",Rosny-sous-Bois,93064,0.5384615384615384,15
42303,Place Eustache Deschamps,OUI,20,12,8,4,4,OUI,OUI,2025-03-13 15:00:11+00:00,"48.793855, 2.336637",Cachan,94016,0.4,15
42024,Danielle Casanova - Ledru-Rollin,OUI,28,5,23,21,2,OUI,OUI,2025-03-13 14:59:17+00:00,"48.815783497876815, 2.383259721100331",Ivry-sur-Seine,94041,0.8214285714285714,15
41605,Général De Gaulle - Vivien,OUI,21,17,4,1,3,OUI,OUI,2025-03-13 14:58:33+00:00,"48.83607420090204, 2.4189166724681854",Saint-Mandé,94067,0.19047619047619047,15
15203,Porte de Versailles,OUI,27,16,11,3,8,OUI,OUI,2025-03-13 14:56:50+00:00,"48.832324016657, 2.2875617349045",Paris,75056,0.4074074074074074,15
20020,Pyrénées - Charles Renouvier,OUI,29,28,1,0,1,OUI,OUI,2025-03-13 14:59:10+00:00,"48.86095933229224, 2.400421852042113",Paris,75056,0.034482758620689655,15
11111,Léon Frot - Charonne,OUI,18,10,8,5,3,OUI,OUI,2025-03-13 15:01:51+00:00,"48.854963800335234, 2.387217085372007",Paris,75056,0.4444444444444444,15
15024,Suffren - La Motte-Piquet,OUI,23,8,15,11,4,OUI,OUI,2025-03-13 15:00:42+00:00,"48.850881230919, 2.3012199997902",Paris,75056,0.6521739130434783,15
48006,Maxime Gorki - Paul Vaillant-Couturier,OUI,19,19,0,0,0,OUI,OUI,2025-03-13 14:52:23+00:00,"48.79673508795443, 2.3683342337608337",Villejuif,94076,0.0,15
15050,Dominique Pado - Croix Nivert,OUI,22,14,8,4,4,OUI,OUI,2025-03-13 14:57:43+00:00,"48.83648798164934, 2.2897250577807426",Paris,75056,0.36363636363636365,15
15012,Cambronne - Mademoiselle,OUI,66,63,3,2,1,OUI,OUI,2025-03-13 14:59:11+00:00,"48.843277330035214, 2.30230766886348",Paris,75056,0.045454545454545456,15
13036,Olympiades,OUI,36,29,7,1,6,OUI,OUI,2025-03-13 15:01:37+00:00,"48.826764665199, 2.3650860786438",Paris,75056,0.19444444444444445,15
19117,Euryale Dehaynin - Loire,OUI,30,22,8,1,7,OUI,OUI,2025-03-13 15:00:54+00:00,"48.886248917304805, 2.3774591088294987",Paris,75056,0.26666666666666666,15
43004,Montreuil - République,OUI,23,15,8,4,4,OUI,OUI,2025-03-13 15:02:06+00:00,"48.85026349463687, 2.4345204234123234",Vincennes,94080,0.34782608695652173,15
15053,Lecourbe - Convention,OUI,44,24,20,17,3,OUI,OUI,2025-03-13 15:01:42+00:00,"48.83923319241899, 2.2915197908878326",Paris,75056,0.45454545454545453,15
14009,Tombe Issoire - René Coty,OUI,35,34,1,0,1,OUI,OUI,2025-03-13 14:57:32+00:00,"48.830512876709, 2.3343613743782",Paris,75056,0.02857142857142857,15
21022,Dôme - République,OUI,24,2,22,21,1,OUI,OUI,2025-03-13 14:58:48+00:00,"48.832681, 2.250257",Boulogne-Billancourt,92012,0.9166666666666666,15
17117,Pereire - Saussure,OUI,31,26,5,4,1,OUI,OUI,2025-03-13 14:58:20+00:00,"48.888229075478, 2.3101296275854",Paris,75056,0.16129032258064516,15
15041,Franquet - Labrouste,OUI,37,35,2,2,0,OUI,OUI,2025-03-13 15:00:54+00:00,"48.83287705011431, 2.306762784719467",Paris,75056,0.05405405405405406,15
20013,Alexandre Dumas - Place de la Réunion,OUI,45,42,3,1,2,OUI,OUI,2025-03-13 15:01:08+00:00,"48.85533710742046, 2.3997703687646292",Paris,75056,0.06666666666666667,15
41103,Place de la vache noire,OUI,23,21,2,0,2,OUI,OUI,2025-03-13 15:02:07+00:00,"48.81040517059777, 2.327060401439667",Arcueil,94003,0.08695652173913043,15
15045,Porte de la Plaine,OUI,35,35,0,0,0,OUI,OUI,2025-03-13 14:59:24+00:00,"48.82805169605981, 2.2924277186393742",Paris,75056,0.0,15
13028,Gouthière - Poterne des Peupliers,OUI,32,25,7,1,6,OUI,OUI,2025-03-13 14:59:13+00:00,"48.820507, 2.351342",Paris,75056,0.21875,15
42205,Place Aristide Briand,OUI,35,22,13,12,1,OUI,OUI,2025-03-13 15:00:30+00:00,"48.82189236575831, 2.413003742694855",Charenton-le-Pont,94018,0.37142857142857144,15
20012,Buzenval - Vignoles,OUI,17,16,1,0,1,OUI,OUI,2025-03-13 14:58:41+00:00,"48.853858171688, 2.4000040814281",Paris,75056,0.058823529411764705,15
17110,Legendre - Nollet,OUI,29,24,5,0,5,OUI,OUI,2025-03-13 15:00:43+00:00,"48.887742186754224, 2.320293079881375",Paris,75056,0.1724137931034483,15
14004,Port Royal - Hôpital Cochin,OUI,22,16,6,3,3,OUI,OUI,2025-03-13 15:00:06+00:00,"48.838608030238, 2.3406994164846",Paris,75056,0.2727272727272727,15
31701,Mairie de Bagnolet,OUI,28,27,1,0,1,OUI,OUI,2025-03-13 14:58:17+00:00,"48.868421318555, 2.4179587885737",Bagnolet,93006,0.03571428571428571,15
48002,LCL Campus - Place Oscar Niemeyer,OUI,37,35,2,0,2,OUI,OUI,2025-03-13 15:00:21+00:00,"48.805342480621576, 2.363983690738678",Villejuif,94076,0.05405405405405406,15
20032,Square des Amandiers,OUI,26,21,5,1,4,OUI,OUI,2025-03-13 14:58:58+00:00,"48.86615630668046, 2.3891324177384377",Paris,75056,0.19230769230769232,15
30003,Moscou - Edouard Vaillant,OUI,29,21,8,4,4,OUI,OUI,2025-03-13 15:00:04+00:00,"48.90755810177, 2.4689837335263",Bobigny,93008,0.27586206896551724,15
30004,Jean Jaurès - Place de la Libération,OUI,28,5,23,10,13,OUI,OUI,2025-03-13 14:57:37+00:00,"48.90617751921, 2.4391458057475",Bobigny,93008,0.8214285714285714,15
35013,Guillaume Tell - Parc Henri Barbusse,OUI,19,17,2,1,1,OUI,OUI,2025-03-13 14:58:04+00:00,"48.88958925894009, 2.4198862910270695",Pantin,93055,0.10526315789473684,15
20110,Gambetta - Tourelles,OUI,20,20,0,0,0,OUI,OUI,2025-03-13 14:54:40+00:00,"48.875337902264, 2.4059921130538",Paris,75056,0.0,15
12008,Hector Malot - Daumesnil,OUI,52,2,50,47,3,OUI,OUI,2025-03-13 15:01:37+00:00,"48.84693552991762, 2.3770876228809357",Paris,75056,0.9615384615384616,15
14005,René Coty - Place Denfert-Rochereau,OUI,36,30,6,0,6,OUI,OUI,2025-03-13 15:00:17+00:00,"48.833056477316, 2.3329411447048",Paris,75056,0.16666666666666666,15
12102,Bercy - Traversiére,OUI,30,1,29,28,1,OUI,OUI,2025-03-13 15:01:13+00:00,"48.846192642574, 2.3703800886869",Paris,75056,0.9666666666666667,15
8007,Rome - Provence,OUI,29,5,24,19,5,OUI,OUI,2025-03-13 14:58:27+00:00,"48.874230055580306, 2.325570111724113",Paris,75056,0.8275862068965517,15
13120,Pierre Joseph Desault,OUI,18,9,9,8,1,OUI,OUI,2025-03-13 15:00:24+00:00,"48.82110230800372, 2.378775402903557",Paris,75056,0.5,15
21207,Verdier - République,OUI,29,25,4,2,2,OUI,OUI,2025-03-13 15:00:38+00:00,"48.815403766277, 2.31739372015",Montrouge,92049,0.13793103448275862,15
12119,Dom-Pérignon - Gravelle,OUI,47,30,17,13,4,OUI,OUI,2025-03-13 15:01:47+00:00,"48.825481574435, 2.409880310297",Paris,75056,0.3617021276595745,15
15120,Colonel Pierre Avia,OUI,28,9,19,14,5,OUI,OUI,2025-03-13 14:59:29+00:00,"48.8296843300915, 2.275342586850291",Paris,75056,0.6785714285714286,15
13006,Duméril - Jeanne d'Arc,OUI,40,30,10,9,1,OUI,OUI,2025-03-13 15:00:40+00:00,"48.838151608087, 2.3571084495564",Paris,75056,0.25,15
16033,Marché d'Auteuil,OUI,31,10,21,19,2,OUI,OUI,2025-03-13 15:00:20+00:00,"48.84842761367387, 2.265253821160005",Paris,75056,0.6774193548387096,15
43007,Hôtel de Ville de Vincennes,OUI,26,13,13,9,4,OUI,OUI,2025-03-13 14:55:41+00:00,"48.84827609706963, 2.4398955702781677",Vincennes,94080,0.5,15
24007,Jean-Baptiste Charcot - Sainte-Geneviève,OUI,21,19,2,0,2,OUI,OUI,2025-03-13 14:52:22+00:00,"48.90310883721567, 2.278892956674099",Courbevoie,92026,0.09523809523809523,15
16025,Jean de la Fontaine - Boulainvilliers,OUI,66,12,54,43,11,OUI,OUI,2025-03-13 15:01:46+00:00,"48.85264791461651, 2.2758664190769196",Paris,75056,0.8181818181818182,15
6004,Regard - Rennes,OUI,46,26,20,13,7,OUI,OUI,2025-03-13 14:59:39+00:00,"48.847385404956, 2.3268555477262",Paris,75056,0.43478260869565216,15
16017,Siam - La Pompe,OUI,16,13,3,0,3,OUI,OUI,2025-03-13 14:54:00+00:00,"48.861720329027264, 2.275346568555312",Paris,75056,0.1875,15
11029,Ménilmontant - Oberkampf,OUI,39,24,15,3,12,OUI,OUI,2025-03-13 15:01:38+00:00,"48.866617658681, 2.3830134404158",Paris,75056,0.38461538461538464,15
18021,Marcadet - Ramey,OUI,21,19,2,0,2,OUI,OUI,2025-03-13 15:01:12+00:00,"48.890875, 2.3449019",Paris,75056,0.09523809523809523,15
19014,Lorraine - Jean Jaurès,OUI,19,18,1,0,1,OUI,OUI,2025-03-13 15:00:33+00:00,"48.8863865, 2.3825772",Paris,75056,0.05263157894736842,15
16116,George Sand - Jean de La Fontaine,OUI,28,16,12,7,5,OUI,OUI,2025-03-13 15:02:03+00:00,"48.84986918764119, 2.268257387525699",Paris,75056,0.42857142857142855,15
11028,Guillaume Bertrand - République,OUI,38,27,11,3,8,OUI,OUI,2025-03-13 15:00:49+00:00,"48.863825174341, 2.380906377155",Paris,75056,0.2894736842105263,15
5033,Saint-Séverin - Saint-Michel,OUI,30,2,28,23,5,OUI,OUI,2025-03-13 14:55:49+00:00,"48.852731305488, 2.3440927639604",Paris,75056,0.9333333333333333,15
21027,Fief - République,OUI,25,2,23,20,3,OUI,OUI,2025-03-13 15:02:08+00:00,"48.83170888166024, 2.255771979689598",Boulogne-Billancourt,92012,0.92,15
25004,Marcel Pourtout - Édouard Manet,OUI,24,6,18,18,0,OUI,OUI,2025-03-13 14:59:56+00:00,"48.87555620763429, 2.1655967831611638",Rueil-Malmaison,92063,0.75,15
15044,Dantzig - Lefebvre,OUI,33,28,5,0,5,OUI,OUI,2025-03-13 14:59:11+00:00,"48.83013921586756, 2.295934036374092",Paris,75056,0.15151515151515152,15
12022,Sahel - Général Michel Bizot,OUI,30,24,6,2,4,OUI,OUI,2025-03-13 15:01:08+00:00,"48.840872964793355, 2.4044444784522057",Paris,75056,0.2,15
15113,Arsonval - Falguière,OUI,24,23,1,1,0,OUI,OUI,2025-03-13 14:58:28+00:00,"48.84040040365445, 2.313117867297474",Paris,75056,0.041666666666666664,15
15027,Duhamel - André Gide,OUI,20,20,0,0,0,OUI,OUI,2025-03-13 14:55:13+00:00,"48.8365662244334, 2.312707121097412",Paris,75056,0.0,15
16022,Jean Bologne - Passy,OUI,19,15,4,0,4,OUI,OUI,2025-03-13 14:59:28+00:00,"48.857566889784465, 2.280027395306772",Paris,75056,0.21052631578947367,15
21023,Ancienne Mairie - André Morizet,OUI,25,9,16,9,7,OUI,OUI,2025-03-13 15:01:13+00:00,"48.838311, 2.234077",Boulogne-Billancourt,92012,0.64,15
20011,Pyrénées - Dagorno,OUI,20,18,2,0,2,OUI,OUI,2025-03-13 15:01:45+00:00,"48.855425770695085, 2.4051643162965775",Paris,75056,0.1,15
31105,Lavoisier - Missak Manouchian,OUI,14,9,5,1,4,OUI,OUI,2025-03-13 14:58:51+00:00,"48.86286468896063, 2.495676465332508",Rosny-sous-Bois,93064,0.35714285714285715,15
22701,Général Leclerc - République,OUI,28,9,19,17,2,OUI,OUI,2025-03-13 15:00:04+00:00,"48.915885074177, 2.2682306702811",Bois-Colombes,92009,0.6785714285714286,15
13023,Bobillot - Moulin des Prés,OUI,28,27,1,1,0,OUI,OUI,2025-03-13 14:59:40+00:00,"48.828657346203, 2.353020646317",Paris,75056,0.03571428571428571,15
22404,Pierre Brossolette - 12 Février 1934,OUI,24,21,3,1,2,OUI,OUI,2025-03-13 14:57:52+00:00,"48.8176962416867, 2.3076123744249344",Malakoff,92046,0.125,15
21007,Rond-Point Rhin et Danube,OUI,53,47,6,5,1,OUI,OUI,2025-03-13 15:00:16+00:00,"48.840452820991764, 2.2280225157737736",Boulogne-Billancourt,92012,0.11320754716981132,15
20014,Charonne - Alexandre Dumas,OUI,34,33,1,0,1,OUI,OUI,2025-03-13 14:59:42+00:00,"48.856077415056, 2.3948693275452",Paris,75056,0.029411764705882353,15
19007,Flandre - Ourcq,OUI,29,21,8,4,4,OUI,OUI,2025-03-13 15:01:20+00:00,"48.89260159189023, 2.3790915682911873",Paris,75056,0.27586206896551724,15
14035,Maine - Jean Zay,OUI,47,42,5,0,5,OUI,OUI,2025-03-13 15:01:12+00:00,"48.837925263898, 2.3225428909063",Paris,75056,0.10638297872340426,15
21016,Point du Jour - Jean Jaurès,OUI,39,27,12,12,0,OUI,OUI,2025-03-13 14:59:18+00:00,"48.828753141436465, 2.245911467014621",Boulogne-Billancourt,92012,0.3076923076923077,15
8046,Marceau - Président Wilson,OUI,30,2,28,23,5,OUI,OUI,2025-03-13 14:59:27+00:00,"48.8652359, 2.3002513",Paris,75056,0.9333333333333333,15
5105,Geoffroy-Saint-Hilaire - Saint-Marcel,OUI,17,11,6,5,1,OUI,OUI,2025-03-13 15:00:41+00:00,"48.83907826424974, 2.356877340669728",Paris,75056,0.35294117647058826,15
21218,Gabriel Péri - Place de la Libération,OUI,17,15,2,1,1,OUI,OUI,2025-03-13 15:01:42+00:00,"48.819828421929, 2.3117361743705",Montrouge,92049,0.11764705882352941,15
22007,Commandant Charcot - Bretteville,OUI,31,11,20,12,8,OUI,OUI,2025-03-13 15:01:21+00:00,"48.87530570765423, 2.2558460757136345",Neuilly-sur-Seine,92051,0.6451612903225806,15
17006,Guy Môquet - Compoint,OUI,34,32,2,0,2,OUI,OUI,2025-03-13 14:59:59+00:00,"48.89213559044868, 2.32321947813034",Paris,75056,0.058823529411764705,15
13037,Ivry - Baudricourt,OUI,20,18,2,1,1,OUI,OUI,2025-03-13 14:58:58+00:00,"48.824695995415006, 2.363106073577468",Paris,75056,0.1,15
18101,Championnet.,OUI,21,18,3,1,2,OUI,OUI,2025-03-13 15:01:25+00:00,"48.8953643, 2.3498166",Paris,75056,0.14285714285714285,15
5031,Lacépède - Linné,OUI,49,12,37,25,12,OUI,OUI,2025-03-13 15:01:00+00:00,"48.8437035476636, 2.354651279747486",Paris,75056,0.7551020408163265,15
6028,Quatre Vents - Carrefour de l'Odéon,OUI,37,0,37,20,17,OUI,OUI,2025-03-13 15:00:01+00:00,"48.851751374458864, 2.338161695134053",Paris,75056,1.0,15
20033,Etienne Dolet - Place Maurice Chevalier,OUI,47,40,7,3,4,OUI,OUI,2025-03-13 14:59:48+00:00,"48.86798303359366, 2.3851405311143026",Paris,75056,0.14893617021276595,15
20005,Reynaldo Hahn - Lagny,OUI,19,17,2,0,2,OUI,OUI,2025-03-13 14:59:28+00:00,"48.849266043601794, 2.412330328844772",Paris,75056,0.10526315789473684,15
11016,Philippe-Auguste,OUI,48,44,4,1,3,OUI,OUI,2025-03-13 15:00:54+00:00,"48.851853488265, 2.3932945355773",Paris,75056,0.08333333333333333,15
17050,Batignolles - Abel Truchet,OUI,26,22,4,1,3,OUI,OUI,2025-03-13 15:00:28+00:00,"48.883103904582, 2.3238347490884",Paris,75056,0.15384615384615385,15
12122,Bois de Vincennes - Polygone,OUI,51,44,7,2,5,OUI,OUI,2025-03-13 15:00:30+00:00,"48.83544491617421, 2.431421081436563",Paris,75056,0.13725490196078433,15
13013,Saint-Marcel - Hôpital,OUI,20,2,18,12,6,OUI,OUI,2025-03-13 15:01:54+00:00,"48.839504424583, 2.3609894170229",Paris,75056,0.9,15
21205,Arthur Auger - Jean Jaurès,OUI,23,23,0,0,0,OUI,OUI,2025-03-13 15:02:04+00:00,"48.813736445585235, 2.3069277405738835",Montrouge,92049,0.0,15
1201,Perrault - Place du Louvre,OUI,28,11,17,10,7,OUI,OUI,2025-03-13 15:00:04+00:00,"48.860273568996, 2.3412468419093",Paris,75056,0.6071428571428571,15
16023,Passy - Place du Costa Rica,OUI,29,26,3,0,3,OUI,OUI,2025-03-13 14:58:53+00:00,"48.8584893, 2.2839655",Paris,75056,0.10344827586206896,15
21510,Fontaine du Tertre - Calvaire,OUI,23,22,1,0,1,OUI,OUI,2025-03-13 14:55:03+00:00,"48.8702539, 2.2187778",Suresnes,92073,0.043478260869565216,15
15114,Pasteur - Cotentin,OUI,9,9,0,0,0,OUI,OUI,2025-03-13 14:57:50+00:00,"48.8389284, 2.316356",Paris,75056,0.0,15
17036,Place Tristan Bernard,OUI,28,26,2,0,2,OUI,OUI,2025-03-13 15:01:13+00:00,"48.8794936, 2.2915423",Paris,75056,0.07142857142857142,15
15014,Volontaires - Vaugirard,OUI,33,28,5,1,4,OUI,OUI,2025-03-13 15:00:50+00:00,"48.84132050184004, 2.30808901725357",Paris,75056,0.15151515151515152,15
11038,Temple - Charlot,OUI,42,2,40,35,5,OUI,OUI,2025-03-13 15:00:40+00:00,"48.865709343796, 2.3652737250724",Paris,75056,0.9523809523809523,15
13055,M.- A. Lagroua Weill-Hallé -  F. Dolto,OUI,59,9,50,28,22,OUI,OUI,2025-03-13 15:01:43+00:00,"48.828595283857425, 2.380220606266108",Paris,75056,0.847457627118644,15
21511,Marcel Monge - Marcel Dassault,OUI,46,8,38,31,7,OUI,OUI,2025-03-13 15:01:38+00:00,"48.86096384533371, 2.2246733296048142",Suresnes,92073,0.8260869565217391,15
22014,Victor Hugo - Bineau,OUI,24,21,3,2,1,OUI,OUI,2025-03-13 15:01:16+00:00,"48.88758225888669, 2.2783890366554265",Neuilly-sur-Seine,92051,0.125,15
21112,Claude Debussy - Marc Bloch,OUI,52,35,17,14,3,OUI,OUI,2025-03-13 15:00:49+00:00,"48.910388180512, 2.3117771744728",Clichy,92024,0.3269230769230769,15
25002,Hôtel de Ville de Rueil-Malmaison,OUI,19,2,17,11,6,OUI,OUI,2025-03-13 15:01:01+00:00,"48.878194, 2.181724",Rueil-Malmaison,92063,0.8947368421052632,15
22703,Place Jean Mermoz,OUI,30,22,8,4,4,OUI,OUI,2025-03-13 15:01:56+00:00,"48.9220937, 2.2718348",Bois-Colombes,92009,0.26666666666666666,15
6005,Montparnasse -  Square Ozanam,OUI,49,34,15,13,2,OUI,OUI,2025-03-13 15:01:58+00:00,"48.843310567822, 2.3265242949128",Paris,75056,0.30612244897959184,15
26010,Louis Armand - Bernard Palissy,OUI,17,9,8,5,3,OUI,OUI,2025-03-13 14:56:33+00:00,"48.916974, 2.313384",Asnières-sur-Seine,92004,0.47058823529411764,15
19001,Crimée - Ourcq,OUI,56,50,6,5,1,OUI,OUI,2025-03-13 14:59:16+00:00,"48.894104140316, 2.3729460884673",Paris,75056,0.10714285714285714,15
20030,Ménilmontant - Père Lachaise,OUI,40,29,11,0,11,OUI,OUI,2025-03-13 14:57:05+00:00,"48.863287291502, 2.3869940266013",Paris,75056,0.275,15
12040,Porte de Charenton,OUI,66,58,8,4,4,OUI,OUI,2025-03-13 14:55:59+00:00,"48.831240105856, 2.3989107459784",Paris,75056,0.12121212121212122,15
20035,Pyrénées - Ménilmontant,OUI,24,23,1,0,1,OUI,OUI,2025-03-13 14:54:47+00:00,"48.8693268535238, 2.395084574818611",Paris,75056,0.041666666666666664,15
20106,Mairie du 20ème,OUI,27,25,2,0,2,OUI,OUI,2025-03-13 15:00:21+00:00,"48.865302324275, 2.3990669846535",Paris,75056,0.07407407407407407,15
23106,Pavé des Gardes - Charles Vaillant,OUI,20,15,5,5,0,OUI,OUI,2025-03-13 14:57:42+00:00,"48.81168551728, 2.2111820107205",Sèvres,92072,0.25,15
6020,Place Saint-André des Arts,OUI,33,1,32,23,9,OUI,OUI,2025-03-13 15:00:49+00:00,"48.852886173881, 2.3426544293761",Paris,75056,0.9696969696969697,15
21508,Georges Pompidou - Verdun,OUI,24,9,15,10,5,OUI,OUI,2025-03-13 14:57:41+00:00,"48.875481, 2.232443",Suresnes,92073,0.625,15
11018,Saint-Maur - République,OUI,36,29,7,3,4,OUI,OUI,2025-03-13 15:01:54+00:00,"48.864185861455, 2.3783174157143",Paris,75056,0.19444444444444445,15
15032,Félix Faure - Lourmel,OUI,54,38,16,11,5,OUI,OUI,2025-03-13 15:01:53+00:00,"48.83868901709515, 2.2818081825971603",Paris,75056,0.2962962962962963,15
19123,Metz - Marne,OUI,29,24,5,2,3,OUI,OUI,2025-03-13 15:02:06+00:00,"48.891163, 2.3865705",Paris,75056,0.1724137931034483,15
19045,Macdonald - Césaria Evora,OUI,66,51,15,8,7,OUI,OUI,2025-03-13 14:59:09+00:00,"48.89883, 2.37933",Paris,75056,0.22727272727272727,15
21107,Bertrand Sincholle - Henri Barbusse,OUI,18,6,12,8,4,OUI,OUI,2025-03-13 15:00:57+00:00,"48.89925982394349, 2.3042294383049016",Clichy,92024,0.6666666666666666,15
13053,Chevaleret - Tolbiac,OUI,21,9,12,11,1,OUI,OUI,2025-03-13 14:58:51+00:00,"48.82941, 2.375934",Paris,75056,0.5714285714285714,15
12039,Général Michel Bizot - Claude Decaen,OUI,38,27,11,8,3,OUI,OUI,2025-03-13 14:59:54+00:00,"48.83481262982544, 2.400927788127704",Paris,75056,0.2894736842105263,15
9029,Saint-Lazare - Place d'Estienne d'Orves,OUI,39,8,31,21,10,OUI,OUI,2025-03-13 14:59:10+00:00,"48.8768345, 2.3329067",Paris,75056,0.7948717948717948,15
12017,Saint-Mandé - Docteur Arnold Netter,OUI,36,29,7,5,2,OUI,OUI,2025-03-13 15:02:00+00:00,"48.84462585769668, 2.404946386814118",Paris,75056,0.19444444444444445,15
48011,Epi d'Or - Chevilly,OUI,20,17,3,0,3,OUI,OUI,2025-03-13 14:55:12+00:00,"48.781109786782, 2.3549050362061",Villejuif,94076,0.15,15
14025,Jacquier - Didot,OUI,30,30,0,0,0,OUI,OUI,2025-03-13 14:53:31+00:00,"48.82953336292279, 2.318179272115231",Paris,75056,0.0,15
41212,Nungesser - Santé,OUI,22,22,0,0,0,OUI,OUI,2025-03-13 14:55:15+00:00,"48.852335, 2.448967",Fontenay-sous-Bois,94033,0.0,15
6009,Guynemer - Jardin du Luxembourg,OUI,34,14,20,14,6,OUI,OUI,2025-03-13 15:01:49+00:00,"48.8466127, 2.3325478",Paris,75056,0.5882352941176471,15
34009,Dora Maar - Nadia Guendouz,OUI,28,10,18,16,2,OUI,OUI,2025-03-13 15:01:09+00:00,"48.905452421305, 2.3220406472683",Saint-Ouen-sur-Seine,93070,0.6428571428571429,15
42027,Verdun - Pierre et Marie Curie,OUI,26,23,3,0,3,OUI,OUI,2025-03-13 15:01:37+00:00,"48.812822398263286, 2.3707106709480286",Ivry-sur-Seine,94041,0.11538461538461539,15
22208,Stalingrad - Barbara,OUI,19,16,3,0,3,OUI,OUI,2025-03-13 14:53:43+00:00,"48.809223658808, 2.3175904558822",Bagneux,92007,0.15789473684210525,15
16104,Paul Valery - Victor Hugo,OUI,34,21,13,0,13,OUI,OUI,2025-03-13 15:00:54+00:00,"48.87137406080164, 2.2887128591537476",Paris,75056,0.38235294117647056,15
35021,Cartier Bresson - Denis Papin,OUI,31,25,6,4,2,OUI,OUI,2025-03-13 14:58:39+00:00,"48.902616, 2.397814",Pantin,93055,0.1935483870967742,15
30005,Convention - Campus de Bobigny,OUI,30,17,13,3,10,OUI,OUI,2025-03-13 14:58:16+00:00,"48.914920058264, 2.4172238067445",Bobigny,93008,0.43333333333333335,15
18045,Pierre Ginier - Clichy,OUI,15,15,0,0,0,OUI,OUI,2025-03-13 15:00:04+00:00,"48.8867667, 2.326228",Paris,75056,0.0,15
8044,Alfred de Vigny - Place du Général Brocard,OUI,32,18,14,5,9,OUI,OUI,2025-03-13 14:56:56+00:00,"48.87836138361425, 2.305254448220567",Paris,75056,0.4375,15
18018,Carpeaux - Place Jacques Froment,OUI,17,17,0,0,0,OUI,OUI,2025-03-13 15:01:28+00:00,"48.8906542, 2.3309428",Paris,75056,0.0,15
51007,Résistance - Romain Rolland,OUI,28,27,1,0,1,OUI,OUI,2025-03-13 14:59:39+00:00,"48.950873482371, 2.2310190077797",Argenteuil,95018,0.03571428571428571,15
10025,Jemmapes - Ecluses Saint-Martin,OUI,13,12,1,0,1,OUI,OUI,2025-03-13 14:55:42+00:00,"48.87748519186726, 2.3660067468881607",Paris,75056,0.07692307692307693,15
11040,Temple - Jean-Pierre Timbaud,OUI,32,7,25,20,5,OUI,OUI,2025-03-13 14:59:53+00:00,"48.86446597201, 2.3660597205162",Paris,75056,0.78125,15
22305,Jean Jaurès - Place du Dr Roux,OUI,34,25,9,8,1,OUI,OUI,2025-03-13 14:58:19+00:00,"48.927567032796, 2.2947337017374",Gennevilliers,92036,0.2647058823529412,15
13008,Place d'Italie - Soeur Rosalie,OUI,51,44,7,2,5,OUI,OUI,2025-03-13 15:01:33+00:00,"48.831908520394, 2.3546943448098",Paris,75056,0.13725490196078433,15
22507,Châteaudun - Place de la Liberté,OUI,25,21,4,2,2,OUI,OUI,2025-03-13 14:54:34+00:00,"48.90970830301211, 2.2454486480600626",La Garenne-Colombes,92035,0.16,15
21033,Sèvres - Maréchal Juin,OUI,18,5,13,10,3,OUI,OUI,2025-03-13 15:01:01+00:00,"48.8324305, 2.2292812",Boulogne-Billancourt,92012,0.7222222222222222,15
11201,Faubourg St-Antoine - Place de la Nation,OUI,16,13,3,2,1,OUI,OUI,2025-03-13 14:56:08+00:00,"48.8487726, 2.393606",Paris,75056,0.1875,15
8003,Galilée - Vernet,OUI,47,25,22,8,14,OUI,OUI,2025-03-13 15:02:04+00:00,"48.871715878697, 2.2985444962978",Paris,75056,0.46808510638297873,15
23205,Parc des Pierrettes,OUI,22,21,1,0,1,OUI,OUI,2025-03-13 14:59:42+00:00,"48.7973062, 2.2909969",Châtillon,92020,0.045454545454545456,15
24010,Charles de Gaulle - Rue de l'Alma,OUI,27,5,22,5,17,OUI,OUI,2025-03-13 15:00:52+00:00,"48.896620592993, 2.252313240191",Courbevoie,92026,0.8148148148148148,15
21320,Président Roosevelt - Rouget de Lisle,OUI,40,0,40,24,16,OUI,OUI,2025-03-13 14:57:19+00:00,"48.83047518749, 2.2616135525345",Issy-les-Moulineaux,92040,1.0,15
25009,Place des Arts - Jean Mermoz,OUI,20,6,14,14,0,OUI,OUI,2025-03-13 14:58:50+00:00,"48.880391139734, 2.1832160452221",Rueil-Malmaison,92063,0.7,15
21327,Jean Bouin - Gouverneur Général Eboué,OUI,31,1,30,29,1,OUI,OUI,2025-03-13 15:01:28+00:00,"48.824792734266, 2.2651904328524",Issy-les-Moulineaux,92040,0.967741935483871,15
41101,Paul Doumer - Stalingrad,OUI,24,20,4,3,1,OUI,OUI,2025-03-13 14:57:07+00:00,"48.806518992199, 2.3368880152702",Arcueil,94003,0.16666666666666666,15
23203,Division Leclerc - Kléber,OUI,25,22,3,1,2,OUI,OUI,2025-03-13 15:01:22+00:00,"48.798666226364, 2.2833752789972",Châtillon,92020,0.12,15
16140,Hippodrome de Longchamp,OUI,24,4,20,15,5,OUI,OUI,2025-03-13 14:58:39+00:00,"48.86413226532, 2.239905372262",Paris,75056,0.8333333333333334,15
34005,Adrien Lesesne - Docteur Bauer,OUI,29,28,1,0,1,OUI,OUI,2025-03-13 14:56:12+00:00,"48.90263867304635, 2.348248063431511",Saint-Ouen-sur-Seine,93070,0.034482758620689655,15
3201,Payenne - Square George Caïn,OUI,22,1,21,18,3,OUI,OUI,2025-03-13 15:00:47+00:00,"48.8578329, 2.3622643",Paris,75056,0.9545454545454546,15
34008,Garibaldi - Gabriel Péri,OUI,28,20,8,4,4,OUI,OUI,2025-03-13 15:01:35+00:00,"48.905741911394, 2.3316044208059",Saint-Ouen-sur-Seine,93070,0.2857142857142857,15
20037,Gambetta - Saint Fargeau,OUI,24,22,2,0,2,OUI,OUI,2025-03-13 15:01:37+00:00,"48.871244610447015, 2.4039056897163396",Paris,75056,0.08333333333333333,15
34012,Bateliers - Quai de Seine,OUI,22,16,6,2,4,OUI,OUI,2025-03-13 14:57:16+00:00,"48.915817585516, 2.3239533298594",Saint-Ouen-sur-Seine,93070,0.2727272727272727,15
22302,Gare RER - Général de Gaulle,OUI,38,18,20,13,7,OUI,OUI,2025-03-13 15:01:27+00:00,"48.933548439566, 2.3064726536317",Gennevilliers,92036,0.5263157894736842,15
23204,Roland Garros - Jean Bouin,OUI,28,27,1,0,1,OUI,OUI,2025-03-13 14:53:26+00:00,"48.809460857173, 2.2853198638301",Châtillon,92020,0.03571428571428571,15
21514,Place de la Paix - Abbé Saint-Pierre,OUI,24,22,2,1,1,OUI,OUI,2025-03-13 14:58:59+00:00,"48.86462724459225, 2.2047570338469806",Suresnes,92073,0.08333333333333333,15
41304,Port - Maurice Chevalier,OUI,30,4,26,23,3,OUI,OUI,2025-03-13 15:01:35+00:00,"48.832474421632, 2.490257616467",Nogent-sur-Marne,94052,0.8666666666666667,15
31303,Simone Signoret - Paris,OUI,26,16,10,5,5,OUI,OUI,2025-03-13 14:58:48+00:00,"48.903600624712865, 2.465406596265139",Noisy-le-Sec,93053,0.38461538461538464,15
10151,Gare du Nord - Faubourg Saint-Denis,OUI,28,27,1,0,1,OUI,OUI,2025-03-13 15:00:37+00:00,"48.879612765504, 2.3568402975798",Paris,75056,0.03571428571428571,15
10026,Gare de l'Est - Chateau Landon,OUI,54,50,4,1,3,OUI,OUI,2025-03-13 15:01:12+00:00,"48.879305, 2.362424",Paris,75056,0.07407407407407407,15
7007,Musée d'Orsay,OUI,63,4,59,41,18,OUI,OUI,2025-03-13 15:01:54+00:00,"48.859726157909, 2.3258604481816",Paris,75056,0.9365079365079365,15
17010,Jonquière - Docteur Paul Brousse,OUI,37,27,10,5,5,OUI,OUI,2025-03-13 15:01:58+00:00,"48.894799816683985, 2.318705212173216",Paris,75056,0.2702702702702703,15
8031,Jean Mermoz - Champs-Elysées,OUI,46,8,38,14,24,OUI,OUI,2025-03-13 15:01:09+00:00,"48.869689856852, 2.3107324540615",Paris,75056,0.8260869565217391,15
18024,Clignancourt - Ordener,OUI,35,35,0,0,0,OUI,OUI,2025-03-13 14:59:41+00:00,"48.891457726153774, 2.348636478060487",Paris,75056,0.0,15
26011,Ménil - Argenteuil,OUI,18,14,4,2,2,OUI,OUI,2025-03-13 14:56:56+00:00,"48.925901818305, 2.2741496502338",Asnières-sur-Seine,92004,0.2222222222222222,15
19018,Cité de la Musique,OUI,54,31,23,13,10,OUI,OUI,2025-03-13 15:00:06+00:00,"48.888796556487, 2.3925811931922",Paris,75056,0.42592592592592593,15
22209,Verdun - Henri Barbusse,OUI,23,21,2,0,2,OUI,OUI,2025-03-13 15:00:05+00:00,"48.802056061754, 2.3159965061736",Bagneux,92007,0.08695652173913043,15
16006,Lauriston - Copernic,OUI,19,15,4,1,3,OUI,OUI,2025-03-13 15:02:07+00:00,"48.86926, 2.289918",Paris,75056,0.21052631578947367,15
45005,Stalingrad - Général de Gaulle,OUI,26,11,15,4,11,OUI,OUI,2025-03-13 15:01:43+00:00,"48.823450589614, 2.4965062363218",Champigny-sur-Marne,94017,0.5769230769230769,15
8008,Joseph Sansboeuf - Saint Lazare,OUI,32,15,17,11,6,OUI,OUI,2025-03-13 15:01:30+00:00,"48.875315630653, 2.3229019716382",Paris,75056,0.53125,15
14110,Abbé Carton - Plantes,OUI,25,23,2,1,1,OUI,OUI,2025-03-13 15:01:26+00:00,"48.827673823166, 2.3209181427956",Paris,75056,0.08,15
13205,Choisy - Pointe d'Ivry,OUI,24,21,3,1,2,OUI,OUI,2025-03-13 15:01:24+00:00,"48.822154170359, 2.3633708034878",Paris,75056,0.125,15
32305,Saint-Germain - Verdun,OUI,29,29,0,0,0,OUI,OUI,2025-03-13 14:58:10+00:00,"48.882877330093, 2.4331868384644",Romainville,93063,0.0,15
7201,Place De Fontenoy - Saxe,OUI,18,3,15,10,5,OUI,OUI,2025-03-13 15:02:02+00:00,"48.850270554523, 2.3069813815839",Paris,75056,0.8333333333333334,15
21954,Val-Fleury,OUI,23,20,3,2,1,OUI,OUI,2025-03-13 14:59:34+00:00,"48.807671407991, 2.2407217696309",Meudon,92048,0.13043478260869565,15
22602,Place Henri Dunant - Gare RER,OUI,30,29,1,0,1,OUI,OUI,2025-03-13 14:59:05+00:00,"48.788093281931, 2.2909234046643",Fontenay-aux-Roses,92032,0.03333333333333333,15
13204,Tolbiac - Boussingault,OUI,41,37,4,2,2,OUI,OUI,2025-03-13 14:59:22+00:00,"48.826177754027, 2.3420378552202",Paris,75056,0.0975609756097561,15
12106,Gare de Lyon - Roland Barthes,OUI,68,9,59,57,2,OUI,OUI,2025-03-13 15:02:07+00:00,"48.84395729494058, 2.3790882155299187",Paris,75056,0.8676470588235294,15
13035,Choisy - Tolbiac,OUI,20,17,3,1,2,OUI,OUI,2025-03-13 14:54:40+00:00,"48.82591155587, 2.3602393269539",Paris,75056,0.15,15
32023,Guy Môquet - Jean Moulin,OUI,27,11,16,9,7,OUI,OUI,2025-03-13 14:57:54+00:00,"48.940931521020836, 2.363948999931771",Saint-Denis,93066,0.5925925925925926,15
18042,Place Pigalle,OUI,20,19,1,0,1,OUI,OUI,2025-03-13 15:02:03+00:00,"48.8827555, 2.3361566",Paris,75056,0.05,15
23201,Avenir,OUI,41,34,7,7,0,OUI,OUI,2025-03-13 14:57:02+00:00,"48.8103438, 2.3003776",Châtillon,92020,0.17073170731707318,15
11037,Faubourg Du Temple - Republique,OUI,37,18,19,18,1,OUI,OUI,2025-03-13 15:01:25+00:00,"48.867872484749, 2.3648982158072",Paris,75056,0.5135135135135135,15
25010,Maréchal Leclerc de Hauteclocque - Marché Buzenval,OUI,29,25,4,2,2,OUI,OUI,2025-03-13 14:55:30+00:00,"48.858446, 2.192077",Rueil-Malmaison,92063,0.13793103448275862,15
11014,Place de la Nation - Taillebourg,OUI,46,45,1,1,0,OUI,OUI,2025-03-13 14:59:20+00:00,"48.8488408, 2.3973043",Paris,75056,0.021739130434782608,15
12165,Champs de Manoeuvre - Cartoucherie,OUI,32,2,30,14,16,OUI,OUI,2025-03-13 15:01:02+00:00,"48.835261, 2.447974",Paris,75056,0.9375,15
35002,Jean Jaurès - Presles,OUI,31,27,4,4,0,OUI,OUI,2025-03-13 14:52:30+00:00,"48.907134414988, 2.3960057280531",Pantin,93055,0.12903225806451613,15
12001,Bastille - Biscornet,OUI,59,2,57,45,12,OUI,OUI,2025-03-13 15:01:28+00:00,"48.851355779579, 2.369220033288",Paris,75056,0.9661016949152542,15
8039,Colisée - Champs-Elysées,OUI,16,2,14,4,10,OUI,OUI,2025-03-13 14:55:32+00:00,"48.870475399387, 2.3076190799475",Paris,75056,0.875,15
22018,Charles de Gaulle - Les Sablons,OUI,35,15,20,11,9,OUI,OUI,2025-03-13 15:01:41+00:00,"48.880987514929, 2.2715748726513",Neuilly-sur-Seine,92051,0.5714285714285714,15
11102,Alexandre Dumas - Voltaire,OUI,58,53,5,0,5,OUI,OUI,2025-03-13 14:59:46+00:00,"48.852888670365, 2.3891476408096",Paris,75056,0.08620689655172414,15
11001,Richard Lenoir - Place de la Bastille,OUI,46,16,30,25,5,OUI,OUI,2025-03-13 15:01:42+00:00,"48.8538327, 2.3697222",Paris,75056,0.6521739130434783,15
12157,Fabre d'Eglantine - Place de la Nation,OUI,66,65,1,0,1,OUI,OUI,2025-03-13 14:53:46+00:00,"48.8471116, 2.3956204",Paris,75056,0.015151515151515152,15
9035,Gare Saint-Lazare - Place de Budapest,OUI,43,15,28,16,12,OUI,OUI,2025-03-13 14:59:35+00:00,"48.877753, 2.327339",Paris,75056,0.6511627906976745,15
16103,Traktir - Foch,OUI,20,1,19,3,16,OUI,OUI,2025-03-13 14:59:33+00:00,"48.872755334614, 2.2915497802487",Paris,75056,0.95,15
17126,Hélène et François Missoffe - Emile Borel,OUI,28,10,18,15,3,OUI,OUI,2025-03-13 15:00:17+00:00,"48.89990653843488, 2.321543991674844",Paris,75056,0.6428571428571429,15
21213,Vanne - Général de Gaulle,OUI,24,23,1,0,1,OUI,OUI,2025-03-13 15:02:06+00:00,"48.815007, 2.328318",Montrouge,92049,0.041666666666666664,15
17127,Porte de Clichy - Place des Nations Unies,OUI,37,5,32,32,0,OUI,OUI,2025-03-13 15:01:11+00:00,"48.896737263309504, 2.310542999196392",Paris,75056,0.8648648648648649,15
35001,Jean Jaurès - Ouvrières Pivéreuses,OUI,21,17,4,0,4,OUI,OUI,2025-03-13 15:00:14+00:00,"48.910423437526, 2.3995766043663",Pantin,93055,0.19047619047619047,15
26008,Henri Barbusse - Bourguignons,OUI,32,26,6,1,5,OUI,OUI,2025-03-13 14:54:19+00:00,"48.91301722799713, 2.2734212270774417",Asnières-sur-Seine,92004,0.1875,15
11011,Richard Lenoir - Voltaire,OUI,25,11,14,10,4,OUI,OUI,2025-03-13 15:01:20+00:00,"48.86164273878, 2.3727491497993",Paris,75056,0.56,15
26009,Marceau Delorme - Pierre Brossolette,OUI,26,21,5,1,4,OUI,OUI,2025-03-13 14:57:41+00:00,"48.91206062860357, 2.295897423568745",Asnières-sur-Seine,92004,0.19230769230769232,15
15105,Fédération - Suffren,OUI,25,14,11,7,4,OUI,OUI,2025-03-13 15:00:41+00:00,"48.852828153442, 2.2978776320815",Paris,75056,0.44,15
31301,Gare RER,OUI,27,21,6,0,6,OUI,OUI,2025-03-13 15:01:00+00:00,"48.896280181078, 2.4581568985227",Noisy-le-Sec,93053,0.2222222222222222,15
7109,Place Joffre - Frédéric le Play,OUI,37,28,9,6,3,OUI,OUI,2025-03-13 15:01:52+00:00,"48.853754486938, 2.3044242337346",Paris,75056,0.24324324324324326,15
5107,Pontoise - La Tournelle,OUI,22,3,19,14,5,OUI,OUI,2025-03-13 15:02:07+00:00,"48.850458009188, 2.3524542754922",Paris,75056,0.8636363636363636,15
7025,Octave Gréard - Tour Eiffel,OUI,32,10,22,10,12,OUI,OUI,2025-03-13 15:00:21+00:00,"48.856502977696, 2.2931787543289",Paris,75056,0.6875,15
18023,Ordener - Poissonniers,OUI,35,33,2,0,2,OUI,OUI,2025-03-13 14:58:14+00:00,"48.891213890844654, 2.351288666219873",Paris,75056,0.05714285714285714,15
40010,Haut du Mont-Mesly,OUI,21,18,3,2,1,OUI,OUI,2025-03-13 14:56:30+00:00,"48.780191921646, 2.4685737495183",Créteil,94028,0.14285714285714285,15
18026,Ruisseau - Ordener,OUI,33,29,4,0,4,OUI,OUI,2025-03-13 15:00:21+00:00,"48.89299462568024, 2.340144887566567",Paris,75056,0.12121212121212122,15
40013,Hôtel de Ville de Créteil,OUI,36,15,21,14,7,OUI,OUI,2025-03-13 14:59:53+00:00,"48.77699496201, 2.4552552404284",Créteil,94028,0.5833333333333334,15
31202,Gabriel Péri - Jules Ferry,OUI,27,9,18,15,3,OUI,OUI,2025-03-13 15:01:37+00:00,"48.926182814311, 2.3912295762525",La Courneuve,93027,0.6666666666666666,15
40014,Créteil Pointe du Lac,OUI,28,2,26,9,17,OUI,OUI,2025-03-13 15:01:53+00:00,"48.769807356177, 2.4623027310281",Créteil,94028,0.9285714285714286,15
31201,Suzanne Masson,OUI,33,11,22,13,9,OUI,OUI,2025-03-13 15:01:53+00:00,"48.923306888013, 2.3847292397611",La Courneuve,93027,0.6666666666666666,15
23011,Bineau - Louise Michel,OUI,26,13,13,8,5,OUI,OUI,2025-03-13 15:01:48+00:00,"48.88666162207, 2.2843274474144",Levallois-Perret,92044,0.5,15
15013,Volontaires - Lecourbe,OUI,29,26,3,3,0,OUI,OUI,2025-03-13 15:01:51+00:00,"48.84351378799, 2.3065522313118",Paris,75056,0.10344827586206896,15
12201,Dugommier,OUI,53,50,3,2,1,OUI,OUI,2025-03-13 14:59:55+00:00,"48.838811048815, 2.3896577954292",Paris,75056,0.05660377358490566,15
12105,Bercy - Villot,OUI,36,6,30,24,6,OUI,OUI,2025-03-13 15:01:56+00:00,"48.841795009027, 2.3767850184816",Paris,75056,0.8333333333333334,15
15062,Convention - Lourmel,OUI,35,16,19,16,3,OUI,OUI,2025-03-13 15:00:11+00:00,"48.842055041656, 2.2859910875559",Paris,75056,0.5428571428571428,15
14021,Place de la Porte de Châtillon,OUI,59,57,2,0,2,OUI,OUI,2025-03-13 15:01:05+00:00,"48.8242469, 2.3186306",Paris,75056,0.03389830508474576,15
10114,Granges aux Belles - Hôpital Saint-Louis,OUI,59,58,1,1,0,OUI,OUI,2025-03-13 15:01:19+00:00,"48.874794994841, 2.366669436985",Paris,75056,0.01694915254237288,15
13106,Bobillot - Paulin Mery,OUI,21,20,1,1,0,OUI,OUI,2025-03-13 15:00:21+00:00,"48.829899841747, 2.3543356766749",Paris,75056,0.047619047619047616,15
18134,Ney - Porte de Clignancourt,OUI,24,24,0,0,0,OUI,OUI,2025-03-13 14:56:39+00:00,"48.8978867, 2.3458001",Paris,75056,0.0,15
13203,Square de Choisy - Eastman,OUI,23,17,6,1,5,OUI,OUI,2025-03-13 14:57:41+00:00,"48.828543456283, 2.3583075090494",Paris,75056,0.2608695652173913,15
40015,Iles de Loisirs de Créteil,OUI,24,5,19,10,9,OUI,OUI,2025-03-13 15:01:23+00:00,"48.780258200618, 2.4455094301232",Créteil,94028,0.7916666666666666,15
47007,Liberté - Vert-de-Maisons,OUI,20,3,17,15,2,OUI,OUI,2025-03-13 15:00:22+00:00,"48.790147809608, 2.4328628182411",Maisons-Alfort,94046,0.85,15
51005,Yves Farges - Route d'Enghien,OUI,33,16,17,6,11,OUI,OUI,2025-03-13 14:59:26+00:00,"48.95756799268, 2.2834496977978",Argenteuil,95018,0.5151515151515151,15
13202,Place Farhat Hached,OUI,28,4,24,11,13,OUI,OUI,2025-03-13 15:02:08+00:00,"48.825487045602, 2.3816306985827",Paris,75056,0.8571428571428571,15
13051,Halle Freyssinet - Parvis Alan Turing,OUI,23,6,17,7,10,OUI,OUI,2025-03-13 15:00:42+00:00,"48.832846814471, 2.3711421713233",Paris,75056,0.7391304347826086,15
10031,Louis Blanc - Aqueduc,OUI,36,35,1,1,0,OUI,OUI,2025-03-13 15:01:18+00:00,"48.882030182599, 2.363561578095",Paris,75056,0.027777777777777776,15
8038,François 1er - Montaigne,OUI,52,14,38,25,13,OUI,OUI,2025-03-13 15:00:34+00:00,"48.866887649978, 2.3066755757207",Paris,75056,0.7307692307692307,15
31708,Noisy le Sec - Jean-Baptiste Clément,OUI,21,19,2,0,2,OUI,OUI,2025-03-13 14:52:51+00:00,"48.874515389637, 2.4152836203575",Bagnolet,93006,0.09523809523809523,15
21501,Pont de Suresnes,OUI,15,12,3,2,1,OUI,OUI,2025-03-13 14:57:34+00:00,"48.867415092322, 2.2258946679617",Suresnes,92073,0.2,15
15026,Bir Hakeim,OUI,32,6,26,17,9,OUI,OUI,2025-03-13 15:01:11+00:00,"48.853844054334, 2.289705348222",Paris,75056,0.8125,15
19204,Rampal - Belleville,OUI,19,17,2,0,2,OUI,OUI,2025-03-13 15:02:07+00:00,"48.873114661405, 2.3798409114805",Paris,75056,0.10526315789473684,15
18043,Clichy - Place Blanche,OUI,18,11,7,4,3,OUI,OUI,2025-03-13 15:01:34+00:00,"48.883601088297, 2.3332237824798",Paris,75056,0.3888888888888889,15
5201,Saint-Jacques - Soufflot,OUI,16,2,14,3,11,OUI,OUI,2025-03-13 14:59:55+00:00,"48.846280383395, 2.3430785379567",Paris,75056,0.875,15
32012,Carrefour Pleyel,OUI,65,31,34,17,17,OUI,OUI,2025-03-13 15:01:34+00:00,"48.92034156960326, 2.3438543826341625",Saint-Denis,93066,0.5230769230769231,15
18041,Rochechouart - Martyrs,OUI,17,17,0,0,0,OUI,OUI,2025-03-13 14:59:19+00:00,"48.882193779572, 2.3405495658517",Paris,75056,0.0,15
34014,Michelet - Dr Bauer,OUI,30,28,2,0,2,OUI,OUI,2025-03-13 14:57:02+00:00,"48.906125424194, 2.3440374449846",Saint-Ouen-sur-Seine,93070,0.06666666666666667,15
11020,Belfort - Voltaire,OUI,39,30,9,3,6,OUI,OUI,2025-03-13 14:59:21+00:00,"48.8563358, 2.3829901",Paris,75056,0.23076923076923078,15
21404,Jean Jaurès - Gare de Clamart,OUI,20,19,1,1,0,OUI,OUI,2025-03-13 15:00:05+00:00,"48.81321981219, 2.2716768079163",Clamart,92023,0.05,15
18044,Clichy - Douai,OUI,32,29,3,1,2,OUI,OUI,2025-03-13 15:02:02+00:00,"48.883687771522, 2.328063700029",Paris,75056,0.09375,15
6001,Institut de France,OUI,17,2,15,8,7,OUI,OUI,2025-03-13 15:00:43+00:00,"48.857615678565, 2.3358313530377",Paris,75056,0.8823529411764706,15
3004,Place de la République - Temple,OUI,17,2,15,9,6,OUI,OUI,2025-03-13 15:01:14+00:00,"48.867211201859, 2.3635464370545",Paris,75056,0.8823529411764706,15
17038,Grande Armée - Brunel,OUI,60,26,34,10,24,OUI,OUI,2025-03-13 15:02:06+00:00,"48.876116, 2.288124",Paris,75056,0.5666666666666667,15
11046,Place de la République - Voltaire,OUI,16,1,15,14,1,OUI,OUI,2025-03-13 15:00:44+00:00,"48.866830968942, 2.3654810339212",Paris,75056,0.9375,15
4104,Sebastopol - Rambuteau,OUI,15,2,13,8,5,OUI,OUI,2025-03-13 15:01:59+00:00,"48.86181809267, 2.3501381278038",Paris,75056,0.8666666666666667,15
11009,Boulets - Voltaire,OUI,24,19,5,2,3,OUI,OUI,2025-03-13 15:01:39+00:00,"48.85218705621, 2.3890301585197",Paris,75056,0.20833333333333334,15
40002,Bleuets - Bordières,OUI,21,17,4,2,2,OUI,OUI,2025-03-13 14:53:28+00:00,"48.802117531472, 2.4543687905029",Créteil,94028,0.19047619047619047,15
15060,Place de la Montagne du Goulet,OUI,20,9,11,10,1,OUI,OUI,2025-03-13 15:01:42+00:00,"48.8443415, 2.2773844",Paris,75056,0.55,15
8002,Gare Saint-Lazare - Cour du Havre,OUI,43,14,29,10,19,OUI,OUI,2025-03-13 15:00:27+00:00,"48.875674400851, 2.3265598341823",Paris,75056,0.6744186046511628,15
7111,Ecole Militaire - Place Joffre,OUI,25,8,17,13,4,OUI,OUI,2025-03-13 15:00:43+00:00,"48.852060203583, 2.3017993569374",Paris,75056,0.68,15
21021,Enfants du Paradis - Peupliers,OUI,60,0,60,33,27,OUI,OUI,2025-03-13 15:02:00+00:00,"48.833122686454, 2.2571459412575",Boulogne-Billancourt,92012,1.0,15
11012,Montreuil - Voltaire,OUI,32,27,5,1,4,OUI,OUI,2025-03-13 14:59:14+00:00,"48.850507011842, 2.3930755582745",Paris,75056,0.15625,15
12127,Tremblay - Lac des Minimes,OUI,53,9,44,15,29,OUI,OUI,2025-03-13 15:01:08+00:00,"48.834131261494, 2.4547516554594",Paris,75056,0.8301886792452831,15
18205,Mauroy - Cheminots,OUI,30,22,8,2,6,OUI,OUI,2025-03-13 14:58:43+00:00,"48.897715198403, 2.357895075822",Paris,75056,0.26666666666666666,15
15056,Place Balard,OUI,27,4,23,19,4,OUI,OUI,2025-03-13 15:01:38+00:00,"48.836395736424, 2.2784192115068",Paris,75056,0.8518518518518519,15
8057,Hoche - Tilsitt,OUI,31,28,3,2,1,OUI,OUI,2025-03-13 14:52:20+00:00,"48.874836457837, 2.2971323132515",Paris,75056,0.0967741935483871,15
8004,Malesherbes - Place de la Madeleine,OUI,78,6,72,31,41,OUI,OUI,2025-03-13 15:01:23+00:00,"48.870406028483, 2.323243509808",Paris,75056,0.9230769230769231,15
7023,Bourdonnais - Tour Eiffel,OUI,57,1,56,42,14,OUI,OUI,2025-03-13 14:59:44+00:00,"48.860897797941, 2.295599598447",Paris,75056,0.9824561403508771,15
9025,Taitbout - Châteaudun,OUI,53,4,49,47,2,OUI,OUI,2025-03-13 15:02:03+00:00,"48.876383969379, 2.3353566779335",Paris,75056,0.9245283018867925,15
4108,Quai de Béthune - Pont de la Tournelle,OUI,25,2,23,17,6,OUI,OUI,2025-03-13 15:01:25+00:00,"48.85097433194, 2.3563072085381",Paris,75056,0.92,15
40007,Préfecture de Créteil,OUI,27,7,20,14,6,OUI,OUI,2025-03-13 15:01:36+00:00,"48.783680285918, 2.4544713672215",Créteil,94028,0.7407407407407407,15
40012,Stade de la Habette,OUI,16,14,2,0,2,OUI,OUI,2025-03-13 14:56:43+00:00,"48.774397033806, 2.4668785263921",Créteil,94028,0.125,15
12107,Diderot - Pierre Bourdan,OUI,21,6,15,6,9,OUI,OUI,2025-03-13 15:00:34+00:00,"48.847648620797, 2.3902582749724",Paris,75056,0.7142857142857143,15
16005,Raymond Poincaré - Place Victor Hugo,OUI,22,11,11,1,10,OUI,OUI,2025-03-13 14:59:35+00:00,"48.87030612437, 2.2850745414202",Paris,75056,0.5,15
26005,Hôtel de Ville d'Asnières sur Seine,OUI,25,19,6,2,4,OUI,OUI,2025-03-13 15:01:31+00:00,"48.90999330025577, 2.288238108158112",Asnières-sur-Seine,92004,0.24,15
40003,Centre Hospitalier Intercommunal de Créteil,OUI,17,17,0,0,0,OUI,OUI,2025-03-13 15:01:14+00:00,"48.797078298909, 2.463801423807",Créteil,94028,0.0,15
23801,Place de la Gare,OUI,20,16,4,1,3,OUI,OUI,2025-03-13 14:55:54+00:00,"48.838513582184, 2.1866139007512",Garches,92033,0.2,15
40004,Créteil Village,OUI,25,4,21,7,14,OUI,OUI,2025-03-13 15:00:42+00:00,"48.79122395576, 2.4642198533952",Créteil,94028,0.84,15
23703,Gare de Chaville Rive Gauche,OUI,18,17,1,1,0,OUI,OUI,2025-03-13 14:58:02+00:00,"48.805160304345, 2.188277207315",Chaville,92022,0.05555555555555555,15
40008,Créteil Pompadour,OUI,44,16,28,11,17,OUI,OUI,2025-03-13 15:01:26+00:00,"48.773011623355, 2.435166164893",Créteil,94028,0.6363636363636364,15
32004,Wilson - Landy,OUI,38,19,19,16,3,OUI,OUI,2025-03-13 15:01:40+00:00,"48.91516726221354, 2.357633225619793",Saint-Denis,93066,0.5,15
20137,Borrégo - Gambetta,OUI,25,24,1,0,1,OUI,OUI,2025-03-13 14:55:52+00:00,"48.87330497045532, 2.4014145880937576",Paris,75056,0.04,15
35014,Charles de Gaulle - Jean Lolive,OUI,26,24,2,2,0,OUI,OUI,2025-03-13 15:01:05+00:00,"48.8932644350857, 2.4126765131950383",Pantin,93055,0.07692307692307693,15
1003,Saint-Denis - Rivoli,OUI,43,2,41,27,14,OUI,OUI,2025-03-13 15:01:33+00:00,"48.859059340842, 2.3476943001151",Paris,75056,0.9534883720930233,15
10013,Alibert - Jemmapes,OUI,59,51,8,3,5,OUI,OUI,2025-03-13 15:01:28+00:00,"48.871044051984, 2.3661044619878",Paris,75056,0.13559322033898305,15
15103,Cauchy - Cévennes,OUI,50,7,43,40,3,OUI,OUI,2025-03-13 15:01:47+00:00,"48.843372571022, 2.2751328349113",Paris,75056,0.86,15
1022,Danielle Casanova - Place Vendôme,OUI,37,5,32,20,12,OUI,OUI,2025-03-13 15:02:02+00:00,"48.868266498223, 2.3304839059711",Paris,75056,0.8648648648648649,15
41301,Bois de Vincennes - Gare,OUI,50,46,4,2,2,OUI,OUI,2025-03-13 15:00:34+00:00,"48.836022242887, 2.470833995083",Nogent-sur-Marne,94052,0.08,15
19203,Pailleron - Bouret,OUI,27,24,3,2,1,OUI,OUI,2025-03-13 15:00:46+00:00,"48.880516995482, 2.3763902374411",Paris,75056,0.1111111111111111,15
27004,Gare de la Garenne-Colombes,OUI,27,15,12,7,5,OUI,OUI,2025-03-13 15:01:37+00:00,"48.909752, 2.239145",Colombes,92025,0.4444444444444444,15
17123,Mstislav Rostropovitch - Berthier,OUI,18,9,9,3,6,OUI,OUI,2025-03-13 14:58:33+00:00,"48.892120821173975, 2.309234105050564",Paris,75056,0.5,15
1002,Victoria - Place du Chatelet,OUI,19,1,18,10,8,OUI,OUI,2025-03-13 15:01:23+00:00,"48.857992591527, 2.3469167947769",Paris,75056,0.9473684210526315,15
8052,Balzac - Champs Elysées,OUI,30,7,23,11,12,OUI,OUI,2025-03-13 15:02:04+00:00,"48.872699639621, 2.3001953959465",Paris,75056,0.7666666666666667,15
12010,Daumesnil - Picpus,OUI,21,17,4,3,1,OUI,OUI,2025-03-13 15:01:09+00:00,"48.8374688, 2.401765",Paris,75056,0.19047619047619047,15
13123,BNF - Bibliothèque Nationale de France,OUI,46,1,45,28,17,OUI,OUI,2025-03-13 15:01:59+00:00,"48.8350268238, 2.3760157451034",Paris,75056,0.9782608695652174,15
32001,Proudhon - Président Wilson,OUI,29,13,16,12,4,OUI,OUI,2025-03-13 15:02:03+00:00,"48.906442763495, 2.3584905266762",Saint-Denis,93066,0.5517241379310345,15
33019,Madeleine Vionnet,OUI,42,12,30,9,21,OUI,OUI,2025-03-13 15:01:39+00:00,"48.902519074064, 2.3740895837545",Aubervilliers,93001,0.7142857142857143,15
21302,Aristide Briand - Place de la Résistance,OUI,37,5,32,31,1,OUI,OUI,2025-03-13 14:59:18+00:00,"48.82124248401006, 2.2511002421379094",Issy-les-Moulineaux,92040,0.8648648648648649,15
9104,Caumartin - Provence,OUI,22,6,16,13,3,OUI,OUI,2025-03-13 15:01:41+00:00,"48.874422773426545, 2.3284685611724854",Paris,75056,0.7272727272727273,15
16107,Benjamin Godard - Victor Hugo,OUI,32,29,3,2,1,OUI,OUI,2025-03-13 16:02:10+00:00,"48.865983, 2.275725",Paris,75056,0.09375,16
9020,Toudouze - Clauzel,OUI,21,20,1,0,1,OUI,OUI,2025-03-13 15:59:54+00:00,"48.87929591733507, 2.3373600840568547",Paris,75056,0.047619047619047616,16
40001,Hôpital Mondor,OUI,28,9,19,11,8,OUI,OUI,2025-03-13 16:01:10+00:00,"48.798922410229, 2.4537451531298",Créteil,94028,0.6785714285714286,16
14014,Jourdan - Stade Charléty,OUI,57,53,4,2,2,OUI,OUI,2025-03-13 16:02:12+00:00,"48.819428333369, 2.3433353751898",Paris,75056,0.07017543859649122,16
44015,Rouget de L'isle - Watteau,OUI,20,9,11,1,10,OUI,OUI,2025-03-13 15:59:55+00:00,"48.778192750803, 2.3963020229163",Vitry-sur-Seine,94081,0.55,16
32017,Basilique,OUI,19,14,5,0,5,OUI,OUI,2025-03-13 16:00:53+00:00,"48.93626891059109, 2.3588666820200914",Saint-Denis,93066,0.2631578947368421,16
14111,Cassini - Denfert-Rochereau,OUI,23,20,3,2,1,OUI,OUI,2025-03-13 16:01:33+00:00,"48.837525839067, 2.3360354080796",Paris,75056,0.13043478260869565,16
7002,Vaneau - Sèvres,OUI,35,11,24,19,5,OUI,OUI,2025-03-13 16:02:10+00:00,"48.848563233059, 2.3204218259346",Paris,75056,0.6857142857142857,16
11104,Charonne - Robert et Sonia Delaunay,OUI,20,20,0,0,0,OUI,OUI,2025-03-13 15:56:32+00:00,"48.855907555969, 2.3925706744194",Paris,75056,0.0,16
5110,Lacépède - Monge,OUI,23,13,10,0,10,OUI,OUI,2025-03-13 15:59:59+00:00,"48.84389286531899, 2.3519663885235786",Paris,75056,0.43478260869565216,16
8026,Messine - Place Du Pérou,OUI,12,2,10,5,5,OUI,OUI,2025-03-13 15:57:06+00:00,"48.875448033960744, 2.315508019010038",Paris,75056,0.8333333333333334,16
42016,Pierre et Marie Curie - Maurice Thorez,OUI,26,18,8,4,4,OUI,OUI,2025-03-13 15:59:37+00:00,"48.81580226360801, 2.376804985105991",Ivry-sur-Seine,94041,0.3076923076923077,16
13007,Le Brun - Gobelins,OUI,48,36,12,11,1,OUI,OUI,2025-03-13 15:57:18+00:00,"48.835092787824, 2.3534681351338",Paris,75056,0.25,16
40011,Bas du Mont-Mesly,OUI,26,17,9,6,3,OUI,OUI,2025-03-13 16:02:16+00:00,"48.779035118572, 2.4609763908985",Créteil,94028,0.34615384615384615,16
6003,Saint-Sulpice,OUI,21,9,12,12,0,OUI,OUI,2025-03-13 16:02:11+00:00,"48.85165383178419, 2.3308077827095985",Paris,75056,0.5714285714285714,16
21010,Silly - Galliéni,OUI,25,8,17,12,5,OUI,OUI,2025-03-13 16:00:58+00:00,"48.835583838706, 2.2325500845909",Boulogne-Billancourt,92012,0.68,16
6108,Saint-Romain - Cherche-Midi,OUI,16,3,13,11,2,OUI,OUI,2025-03-13 16:01:55+00:00,"48.84708159081946, 2.321374788880348",Paris,75056,0.8125,16
32304,Charcot - Benfleet,OUI,28,27,1,0,1,NON,NON,2025-03-13 15:55:01+00:00,"48.878370277021, 2.440523876268",Romainville,93063,0.03571428571428571,16
33006,André Karman - République,OUI,30,27,3,0,3,OUI,OUI,2025-03-13 15:58:18+00:00,"48.91039875761846, 2.3851355910301213",Aubervilliers,93001,0.1,16
7003,Square Boucicaut,OUI,58,30,28,23,5,OUI,OUI,2025-03-13 16:00:58+00:00,"48.851296433665276, 2.325061820447445",Paris,75056,0.4827586206896552,16
25006,Place Nelson Mandela,OUI,22,21,1,0,1,OUI,OUI,2025-03-13 16:02:06+00:00,"48.862453313908, 2.1961666225454",Rueil-Malmaison,92063,0.045454545454545456,16
17041,Guersant - Gouvion-Saint-Cyr,OUI,33,13,20,9,11,OUI,OUI,2025-03-13 15:58:46+00:00,"48.88287775178599, 2.287667370814871",Paris,75056,0.6060606060606061,16
30002,Jean Rostand - Paul Vaillant Couturier,OUI,39,30,9,7,2,OUI,OUI,2025-03-13 15:56:55+00:00,"48.908168131015, 2.4530601033354",Bobigny,93008,0.23076923076923078,16
5016,Thouin - Cardinal Lemoine,OUI,16,11,5,0,5,OUI,OUI,2025-03-13 16:00:36+00:00,"48.84504716661511, 2.3494647851273465",Paris,75056,0.3125,16
15047,Morillons - Dantzig,OUI,51,49,2,0,2,OUI,OUI,2025-03-13 15:56:12+00:00,"48.83310149953933, 2.299380004405976",Paris,75056,0.0392156862745098,16
11025,Froment - Bréguet,OUI,43,14,29,23,6,OUI,OUI,2025-03-13 15:57:36+00:00,"48.8570414504784, 2.37289470306807",Paris,75056,0.6744186046511628,16
6021,Beaux-Arts - Bonaparte,OUI,19,3,16,14,2,OUI,OUI,2025-03-13 15:57:49+00:00,"48.856451985396, 2.3348518833518",Paris,75056,0.8421052631578947,16
17026,Jouffroy d'Abbans - Wagram,OUI,39,20,19,10,9,OUI,OUI,2025-03-13 15:59:11+00:00,"48.881973298352, 2.301132157445",Paris,75056,0.48717948717948717,16
15202,Bracion - Périphérique,OUI,30,30,0,0,0,OUI,OUI,2025-03-13 15:58:26+00:00,"48.826103771275, 2.3004549373748",Paris,75056,0.0,16
12109,Mairie du 12ème,OUI,30,24,6,5,1,OUI,OUI,2025-03-13 15:56:07+00:00,"48.840855311763, 2.3875549435616",Paris,75056,0.2,16
13101,Croulebarde - Corvisart,OUI,32,24,8,7,1,OUI,OUI,2025-03-13 16:01:10+00:00,"48.830981659316855, 2.3481646925210953",Paris,75056,0.25,16
8050,Boétie - Ponthieu,OUI,43,6,37,16,21,OUI,OUI,2025-03-13 16:02:00+00:00,"48.871417284355, 2.3076787590981",Paris,75056,0.8604651162790697,16
14108,Le Brix et Mesmin - Jourdan,OUI,20,16,4,1,3,OUI,OUI,2025-03-13 15:58:26+00:00,"48.82234096593411, 2.327861653302471",Paris,75056,0.2,16
31024,Romainville - Vaillant-Couturier,OUI,36,35,1,0,1,OUI,OUI,2025-03-13 16:01:00+00:00,"48.86785, 2.446748",Montreuil,93048,0.027777777777777776,16
2022,Saint-Fiacre - Poissonière,OUI,33,6,27,14,13,OUI,OUI,2025-03-13 16:01:24+00:00,"48.870828911558, 2.3459213599563",Paris,75056,0.8181818181818182,16
17044,Porte de Saint-Ouen - Bessières,OUI,41,29,12,9,3,OUI,OUI,2025-03-13 15:57:31+00:00,"48.89792240854517, 2.32851451022192",Paris,75056,0.2926829268292683,16
17025,Chazelles - Courcelles,OUI,32,25,7,2,5,OUI,OUI,2025-03-13 16:01:30+00:00,"48.879406604954, 2.3034455627202988",Paris,75056,0.21875,16
19033,Cambrai - Benjamin Constant,OUI,41,38,3,2,1,OUI,OUI,2025-03-13 16:01:55+00:00,"48.89594736851349, 2.381133802246315",Paris,75056,0.07317073170731707,16
21326,Moulin de Pierre - Abbé Grégoire,OUI,20,15,5,0,5,OUI,OUI,2025-03-13 16:01:25+00:00,"48.822036188382, 2.2754641655975",Issy-les-Moulineaux,92040,0.25,16
20143,Ramponeau - Belleville,OUI,44,41,3,0,3,OUI,OUI,2025-03-13 16:01:01+00:00,"48.871031137596, 2.379056852114",Paris,75056,0.06818181818181818,16
43002,Lagny - Victor Basch,OUI,24,21,3,2,1,OUI,OUI,2025-03-13 16:01:24+00:00,"48.84884147189881, 2.426325418925233",Vincennes,94080,0.125,16
16138,Saint-Cloud - Hippodrome,OUI,30,23,7,3,4,OUI,OUI,2025-03-13 15:58:59+00:00,"48.85772148887421, 2.2549109905958176",Paris,75056,0.23333333333333334,16
21216,Louis Lejeune - Barbès,OUI,24,23,1,0,1,OUI,OUI,2025-03-13 15:58:52+00:00,"48.81807418981508, 2.3267009854316716",Montrouge,92049,0.041666666666666664,16
22207,Rond-point du Dr Albert Schweitzer,OUI,22,17,5,2,3,OUI,OUI,2025-03-13 15:59:40+00:00,"48.78980918988166, 2.3143940046429634",Bagneux,92007,0.22727272727272727,16
15068,Général Martial Valin - Pont du Garigliano,OUI,14,9,5,1,4,OUI,OUI,2025-03-13 15:57:09+00:00,"48.83823094269141, 2.270506024360657",Paris,75056,0.35714285714285715,16
44017,Jules Guesde - Pont du Port à l'Anglais,OUI,26,2,24,24,0,OUI,OUI,2025-03-13 16:01:51+00:00,"48.79628807093802, 2.417212128639221",Vitry-sur-Seine,94081,0.9230769230769231,16
92002,Théâtre des Amandiers - Palais des sports,OUI,23,8,15,9,6,OUI,OUI,2025-03-13 15:53:17+00:00,"48.892648526839, 2.2136941552162",Nanterre,92050,0.6521739130434783,16
2017,Caire - Dussoubs,OUI,39,13,26,24,2,OUI,OUI,2025-03-13 16:02:01+00:00,"48.86785342111862, 2.349364310503006",Paris,75056,0.6666666666666666,16
19027,Serrurier,OUI,18,14,4,0,4,OUI,OUI,2025-03-13 16:00:48+00:00,"48.880493403246, 2.398064173758",Paris,75056,0.2222222222222222,16
9008,Tour d'Auvergne - Rodier,OUI,16,10,6,2,4,OUI,OUI,2025-03-13 16:00:33+00:00,"48.879161, 2.343698",Paris,75056,0.375,16
31028,Raspail Barbès,OUI,28,27,1,1,0,OUI,OUI,2025-03-13 15:56:00+00:00,"48.8529945, 2.4247387",Montreuil,93048,0.03571428571428571,16
14013,Liard - Amiral Mouchez,OUI,26,24,2,0,2,OUI,OUI,2025-03-13 16:01:08+00:00,"48.8214169, 2.342167",Paris,75056,0.07692307692307693,16
17048,De Toqueville - Terrasse,OUI,30,26,4,2,2,OUI,OUI,2025-03-13 16:01:48+00:00,"48.882428, 2.314002",Paris,75056,0.13333333333333333,16
13118,Regnault - Patay,OUI,63,18,45,40,5,OUI,OUI,2025-03-13 16:02:10+00:00,"48.82435782216384, 2.377065159380436",Paris,75056,0.7142857142857143,16
15112,Vigée-Lebrun - Anselme Payen,OUI,23,18,5,2,3,OUI,OUI,2025-03-13 15:58:41+00:00,"48.838683941628375, 2.3110422492027287",Paris,75056,0.21739130434782608,16
16118,Michel-Ange - Parent de Rosan,OUI,23,19,4,1,3,OUI,OUI,2025-03-13 15:50:47+00:00,"48.840579923690115, 2.2584119439125065",Paris,75056,0.17391304347826086,16
18111,Félix Ziem - Armand Gauthier,OUI,23,23,0,0,0,OUI,OUI,2025-03-13 15:59:56+00:00,"48.88949630486821, 2.333393658804396",Paris,75056,0.0,16
8103,Artois - Berri,OUI,22,3,19,12,7,OUI,OUI,2025-03-13 16:01:43+00:00,"48.87393521240818, 2.3064258322119713",Paris,75056,0.8636363636363636,16
9002,Abbeville - Faubourg Poissonnière,OUI,14,10,4,1,3,OUI,OUI,2025-03-13 15:58:17+00:00,"48.879223, 2.349147",Paris,75056,0.2857142857142857,16
8048,Marceau - Chaillot,OUI,21,8,13,1,12,OUI,OUI,2025-03-13 15:56:21+00:00,"48.868834023334, 2.2986030816809",Paris,75056,0.6190476190476191,16
9001,Bellefond - Poissonnière,OUI,15,9,6,1,5,OUI,OUI,2025-03-13 15:59:32+00:00,"48.87759897050706, 2.348463758826256",Paris,75056,0.4,16
13030,Italie - Tolbiac,OUI,21,17,4,0,4,OUI,OUI,2025-03-13 16:00:03+00:00,"48.82557229464416, 2.3576171323657036",Paris,75056,0.19047619047619047,16
17032,Jean Oestreicher - Porte de Champerret,OUI,21,10,11,6,5,OUI,OUI,2025-03-13 16:01:31+00:00,"48.88655580065981, 2.288640439510346",Paris,75056,0.5238095238095238,16
48003,Youri Gagarine - Karl Marx,OUI,22,20,2,1,1,OUI,OUI,2025-03-13 15:58:27+00:00,"48.78448485079149, 2.35908430069685",Villejuif,94076,0.09090909090909091,16
10115,Granges aux Belles,OUI,27,25,2,1,1,OUI,OUI,2025-03-13 15:58:15+00:00,"48.8761373390584, 2.3680844979417",Paris,75056,0.07407407407407407,16
16110,Octave Feuillet - Albéric Magnard,OUI,21,17,4,0,4,OUI,OUI,2025-03-13 16:00:01+00:00,"48.86106902949534, 2.2730283066630363",Paris,75056,0.19047619047619047,16
41303,Gare de Nogent-le-Perreux,OUI,31,15,16,11,5,OUI,OUI,2025-03-13 15:56:51+00:00,"48.83842553348809, 2.493693307042122",Nogent-sur-Marne,94052,0.5161290322580645,16
43009,Place Jean-Spire-Lemaître,OUI,47,39,8,1,7,OUI,OUI,2025-03-13 15:59:59+00:00,"48.8468428626593, 2.452062070369721",Vincennes,94080,0.1702127659574468,16
13104,Gare d'Austerlitz - Quai Saint-Bernard,OUI,26,1,25,15,10,OUI,OUI,2025-03-13 15:55:44+00:00,"48.84369030864, 2.3657163977623",Paris,75056,0.9615384615384616,16
8016,Square Louis XVI,OUI,29,7,22,14,8,OUI,OUI,2025-03-13 16:02:15+00:00,"48.87320440102894, 2.323658830743138",Paris,75056,0.7586206896551724,16
9038,Douai - Bruxelles,OUI,26,22,4,0,4,OUI,OUI,2025-03-13 15:57:12+00:00,"48.88320784122797, 2.3308449949028507",Paris,75056,0.15384615384615385,16
10029,Dunkerque - Rocroy,OUI,24,20,4,0,4,OUI,OUI,2025-03-13 16:00:28+00:00,"48.880726, 2.351464",Paris,75056,0.16666666666666666,16
8009,Gare Saint-Lazare - Isly,OUI,23,17,6,1,5,OUI,OUI,2025-03-13 16:02:12+00:00,"48.874777677621296, 2.326515804784655",Paris,75056,0.2608695652173913,16
10161,Gare de l'Est - Faubourg-Saint-Martin,OUI,32,29,3,1,2,OUI,OUI,2025-03-13 16:00:12+00:00,"48.875642647477, 2.3594588041306",Paris,75056,0.09375,16
31103,Gare Rosny-Bois-Perrier,OUI,32,12,20,0,20,OUI,OUI,2025-03-13 15:59:21+00:00,"48.88115023337061, 2.480436824262142",Rosny-sous-Bois,93064,0.625,16
12031,Gabriel Lamé,OUI,34,23,11,7,4,OUI,OUI,2025-03-13 16:00:16+00:00,"48.8351212784276, 2.385534569621086",Paris,75056,0.3235294117647059,16
17008,Porte Pouchet-Bessières,OUI,23,10,13,8,5,OUI,OUI,2025-03-13 16:00:26+00:00,"48.8978765, 2.3230632",Paris,75056,0.5652173913043478,16
1001,Quai de l'Horloge - Pont Neuf,OUI,16,3,13,8,5,OUI,OUI,2025-03-13 15:58:17+00:00,"48.857058739111, 2.3417982839439",Paris,75056,0.8125,16
21323,Charlot - Stade Gabriel Voisin,OUI,31,0,31,28,3,OUI,OUI,2025-03-13 16:02:16+00:00,"48.827228120536, 2.268122527474",Issy-les-Moulineaux,92040,1.0,16
5022,Boulangers - Cardinal Lemoine,OUI,18,15,3,2,1,OUI,OUI,2025-03-13 15:58:58+00:00,"48.8462904, 2.3521495",Paris,75056,0.16666666666666666,16
8053,Place Georges Guillaumin,OUI,27,17,10,5,5,OUI,OUI,2025-03-13 15:57:30+00:00,"48.874750203957, 2.301771435326",Paris,75056,0.37037037037037035,16
21328,Verger - Colonel Guichard,OUI,29,25,4,0,4,OUI,OUI,2025-03-13 15:57:43+00:00,"48.816376985087, 2.2670380088932",Issy-les-Moulineaux,92040,0.13793103448275862,16
19105,Ambroise Rendu - Porte Brunet,OUI,17,15,2,1,1,OUI,OUI,2025-03-13 15:58:02+00:00,"48.883667, 2.395733",Paris,75056,0.11764705882352941,16
17040,Pereire - Ternes,OUI,48,37,11,4,7,OUI,OUI,2025-03-13 16:01:20+00:00,"48.87973954830735, 2.288012132048607",Paris,75056,0.22916666666666666,16
19015,Thionville - Ourcq,OUI,23,19,4,2,2,OUI,OUI,2025-03-13 15:59:14+00:00,"48.88917613743794, 2.3833653330802917",Paris,75056,0.17391304347826086,16
7018,Ségur - d'Estrées,OUI,19,6,13,5,8,OUI,OUI,2025-03-13 16:01:47+00:00,"48.851419978983, 2.3097044974566",Paris,75056,0.6842105263157895,16
9022,Rossini - Laffitte,OUI,33,5,28,19,9,OUI,OUI,2025-03-13 16:01:43+00:00,"48.87334627510507, 2.337980867701675",Paris,75056,0.8484848484848485,16
18203,Lamarck - Saint-Ouen,OUI,40,40,0,0,0,NON,NON,2025-03-13 16:00:06+00:00,"48.891334555236, 2.3272445342326",Paris,75056,0.0,16
26003,Argenteuil - Voltaire,OUI,16,4,12,3,9,OUI,OUI,2025-03-13 16:00:22+00:00,"48.91864865955558, 2.2814112156629562",Asnières-sur-Seine,92004,0.75,16
5005,Gay Lussac - Saint-Jacques,OUI,23,13,10,2,8,OUI,OUI,2025-03-13 15:57:44+00:00,"48.844730256132, 2.3419239448664",Paris,75056,0.43478260869565216,16
12151,Gare de Lyon - Place Louis Armand,OUI,58,5,53,38,15,OUI,OUI,2025-03-13 16:00:45+00:00,"48.845515089794, 2.3726498446286",Paris,75056,0.9137931034482759,16
9014,Faubourg Montmartre - La Fayette,OUI,33,7,26,17,9,OUI,OUI,2025-03-13 16:00:14+00:00,"48.875254549053, 2.3408536612988",Paris,75056,0.7878787878787878,16
5020,Institut du Monde Arabe - Saint-Germain,OUI,37,2,35,32,3,OUI,OUI,2025-03-13 16:01:58+00:00,"48.849063299501, 2.3558086529374",Paris,75056,0.9459459459459459,16
9106,Boudreau - Auber,OUI,27,6,21,10,11,OUI,OUI,2025-03-13 16:00:24+00:00,"48.87219, 2.329423",Paris,75056,0.7777777777777778,16
16026,Ranelagh - Mozart,OUI,7,5,2,1,1,OUI,OUI,2025-03-13 16:00:00+00:00,"48.8554439, 2.2704418",Paris,75056,0.2857142857142857,16
31706,Château - République,OUI,24,21,3,0,3,OUI,OUI,2025-03-13 15:59:07+00:00,"48.862923800596, 2.4155035614967",Bagnolet,93006,0.125,16
9028,Moncey - Blanche,OUI,17,9,8,3,5,OUI,OUI,2025-03-13 15:58:34+00:00,"48.88006587474148, 2.3310810327529907",Paris,75056,0.47058823529411764,16
22409,Henri Barbusse - Stalingrad,OUI,16,10,6,2,4,OUI,OUI,2025-03-13 15:55:48+00:00,"48.814183748660554, 2.2872862592339516",Malakoff,92046,0.375,16
10107,Gare du Nord - Hôpital Lariboisière,OUI,49,49,0,0,0,OUI,OUI,2025-03-13 16:01:40+00:00,"48.881949, 2.352339",Paris,75056,0.0,16
17004,Legendre - Clichy,OUI,38,37,1,0,1,OUI,OUI,2025-03-13 16:02:15+00:00,"48.88896161855884, 2.322528975094376",Paris,75056,0.02631578947368421,16
26002,Redoute - Les Courtilles,OUI,37,16,21,18,3,OUI,OUI,2025-03-13 16:02:11+00:00,"48.929867194519, 2.2836696356535",Asnières-sur-Seine,92004,0.5675675675675675,16
19003,Quai de la Seine,OUI,24,20,4,3,1,OUI,OUI,2025-03-13 16:01:36+00:00,"48.884492238407525, 2.3703941702842717",Paris,75056,0.16666666666666666,16
17043,Belidor - Gouvion-Saint-Cyr,OUI,38,26,12,11,1,OUI,OUI,2025-03-13 15:55:24+00:00,"48.88022154052015, 2.2854680567979813",Paris,75056,0.3157894736842105,16
92007,Pesaro - Préfecture,OUI,21,14,7,2,5,OUI,OUI,2025-03-13 15:54:43+00:00,"48.89577046284005, 2.223908342421055",Nanterre,92050,0.3333333333333333,16
11023,Saint-Maur - Roquette,OUI,46,40,6,3,3,OUI,OUI,2025-03-13 16:00:21+00:00,"48.858688774062955, 2.383553994571467",Paris,75056,0.13043478260869565,16
19026,Place de Rhin et Danube,OUI,14,14,0,0,0,OUI,OUI,2025-03-13 15:56:09+00:00,"48.88192765861766, 2.392586767673493",Paris,75056,0.0,16
45003,11 Novembre 1918 - 8 Mai 1945,OUI,36,13,23,14,9,OUI,OUI,2025-03-13 15:58:03+00:00,"48.80889533774377, 2.5382421165704727",Champigny-sur-Marne,94017,0.6388888888888888,16
16039,Exelmans - Versailles,OUI,48,15,33,25,8,OUI,OUI,2025-03-13 16:01:27+00:00,"48.84097491091973, 2.264390252530575",Paris,75056,0.6875,16
11002,Roquette - Thiéré,OUI,21,0,21,13,8,OUI,OUI,2025-03-13 15:58:24+00:00,"48.85507930579506, 2.3733686318721463",Paris,75056,1.0,16
12111,Claude Decaen - Cannebière,OUI,27,26,1,1,0,OUI,OUI,2025-03-13 15:53:00+00:00,"48.83761417037952, 2.397253782195704",Paris,75056,0.037037037037037035,16
8034,Berri - Haussmann,OUI,34,5,29,15,14,OUI,OUI,2025-03-13 16:00:46+00:00,"48.874746047357135, 2.3082953318953514",Paris,75056,0.8529411764705882,16
5032,Panthéon - Valette,OUI,39,32,7,1,6,OUI,OUI,2025-03-13 16:01:43+00:00,"48.847020571652, 2.3464982619671",Paris,75056,0.1794871794871795,16
11047,Amelot - Saint-Sébastien,OUI,29,7,22,18,4,OUI,OUI,2025-03-13 16:02:12+00:00,"48.861142162761, 2.3677996181077",Paris,75056,0.7586206896551724,16
18107,Chartres - La Charbonnière,OUI,34,33,1,0,1,OUI,OUI,2025-03-13 16:00:20+00:00,"48.8847601, 2.3534657",Paris,75056,0.029411764705882353,16
19043,Delphine Seyrig - Général Leclerc,OUI,52,49,3,2,1,OUI,OUI,2025-03-13 16:00:01+00:00,"48.893923963057865, 2.39790290594101",Pantin,93055,0.057692307692307696,16
15067,Desaix - Edgar Faure,OUI,11,0,11,7,4,OUI,OUI,2025-03-13 16:01:08+00:00,"48.852804604940296, 2.293077029857222",Paris,75056,1.0,16
20042,Pyrénées - Emmery,OUI,39,36,3,0,3,OUI,OUI,2025-03-13 15:59:18+00:00,"48.872010281270974, 2.392039597034455",Paris,75056,0.07692307692307693,16
17030,Pereire - Rennequin,OUI,22,18,4,0,4,OUI,OUI,2025-03-13 16:01:42+00:00,"48.88364782887555, 2.2952447086572647",Paris,75056,0.18181818181818182,16
6006,Notre-Dame-des-Champs - Stanislas,OUI,18,17,1,0,1,OUI,OUI,2025-03-13 16:00:03+00:00,"48.84479928858768, 2.329337755887181",Paris,75056,0.05555555555555555,16
12128,Pyramide - Ecole du Breuil,OUI,33,32,1,1,0,OUI,OUI,2025-03-13 15:55:21+00:00,"48.82237977153955, 2.4586871266365056",Paris,75056,0.030303030303030304,16
11027,Saint-Ambroise - Parmentier,OUI,35,30,5,4,1,OUI,OUI,2025-03-13 16:01:47+00:00,"48.862147844548, 2.3772348091006",Paris,75056,0.14285714285714285,16
46002,Rouget de Lisle,OUI,35,4,31,16,15,OUI,OUI,2025-03-13 15:58:13+00:00,"48.764615483395254, 2.4071189761161804",Choisy-le-Roi,94022,0.8857142857142857,16
8010,Liège - Moscou,OUI,15,14,1,0,1,OUI,OUI,2025-03-13 16:01:13+00:00,"48.8795431, 2.3264628",Paris,75056,0.06666666666666667,16
10016,Récollets - Square Villemin,OUI,16,15,1,0,1,OUI,OUI,2025-03-13 15:58:55+00:00,"48.875034655883944, 2.359801238597928",Paris,75056,0.0625,16
31022,Mairie de Montreuil,OUI,51,49,2,2,0,OUI,OUI,2025-03-13 16:01:18+00:00,"48.86131452758348, 2.440614402294159",Montreuil,93048,0.0392156862745098,16
31009,Place Du Général De Gaulle,OUI,25,25,0,0,0,OUI,OUI,2025-03-13 16:01:16+00:00,"48.8687591, 2.4329931",Montreuil,93048,0.0,16
41302,Charles de Gaulle - Beauté,OUI,48,46,2,0,2,OUI,OUI,2025-03-13 15:56:34+00:00,"48.83649602312711, 2.479562651149885",Nogent-sur-Marne,94052,0.041666666666666664,16
15042,Henry Farman,OUI,16,3,13,8,5,OUI,OUI,2025-03-13 15:57:09+00:00,"48.83372430280548, 2.2713854536414146",Paris,75056,0.8125,16
14020,Cimetière de Montrouge,OUI,58,54,4,2,2,OUI,OUI,2025-03-13 15:55:51+00:00,"48.821466904768, 2.3215785772007",Paris,75056,0.06896551724137931,16
18011,Pajol - Place Herbert,OUI,39,35,4,0,4,OUI,OUI,2025-03-13 16:02:16+00:00,"48.8927825, 2.3635598",Paris,75056,0.10256410256410256,16
33017,Anatole France - President Roosevelt,OUI,25,22,3,1,2,OUI,OUI,2025-03-13 16:01:44+00:00,"48.9155156, 2.3814103",Aubervilliers,93001,0.12,16
11113,Richard Lenoir - Republique,OUI,57,29,28,27,1,OUI,OUI,2025-03-13 16:01:51+00:00,"48.8667175, 2.3692541",Paris,75056,0.49122807017543857,16
33102,Gabriel Péri - Francisco Ferrer,OUI,18,13,5,0,5,OUI,OUI,2025-03-13 15:59:07+00:00,"48.88633710236977, 2.407338917255402",Le Pré-Saint-Gervais,93061,0.2777777777777778,16
43008,Fontenay - Libération,OUI,25,19,6,5,1,OUI,OUI,2025-03-13 16:00:31+00:00,"48.847803063647, 2.4451419711113",Vincennes,94080,0.24,16
42706,Roger Salengro - Fontainebleau,OUI,25,19,6,3,3,OUI,OUI,2025-03-13 16:01:48+00:00,"48.814548697325, 2.3611663654447",Le Kremlin-Bicêtre,94043,0.24,16
5018,Mutualité,OUI,37,9,28,27,1,OUI,OUI,2025-03-13 16:00:27+00:00,"48.848225572724, 2.3502873256803",Paris,75056,0.7567567567567568,16
21212,Marne - Germain Dardan,OUI,20,19,1,0,1,OUI,OUI,2025-03-13 15:55:53+00:00,"48.81217465201, 2.3035024699104",Montrouge,92049,0.05,16
19103,Manin - Carrières d'Amérique,OUI,17,14,3,1,2,OUI,OUI,2025-03-13 16:00:13+00:00,"48.88467214209463, 2.3919698596000676",Paris,75056,0.17647058823529413,16
44006,Concorde - Stalingrad,OUI,35,26,9,2,7,OUI,OUI,2025-03-13 15:59:50+00:00,"48.7985844, 2.3821302",Vitry-sur-Seine,94081,0.2571428571428571,16
12114,Victor Hugo - Jeanne Jugan,OUI,28,25,3,0,3,OUI,OUI,2025-03-13 15:56:59+00:00,"48.843949064031825, 2.415081394834419",Paris,75056,0.10714285714285714,16
19120,Carducci - Place Hannah Arendt,OUI,27,26,1,0,1,OUI,OUI,2025-03-13 15:59:11+00:00,"48.877436681515796, 2.3860743641853337",Paris,75056,0.037037037037037035,16
46003,Conservatoire de Musique,OUI,24,3,21,19,2,OUI,OUI,2025-03-13 16:02:02+00:00,"48.77093586667601, 2.4034014344215398",Choisy-le-Roi,94022,0.875,16
18003,Cimetière de Montmartre,OUI,43,41,2,0,2,OUI,OUI,2025-03-13 15:56:41+00:00,"48.886472466142, 2.3328901827335",Paris,75056,0.046511627906976744,16
21312,Lucie Aubrac - Fort,OUI,30,23,7,0,7,OUI,OUI,2025-03-13 15:58:22+00:00,"48.818144834008976, 2.271184623241425",Issy-les-Moulineaux,92040,0.23333333333333334,16
15104,Hôpital Européen Georges Pompidou,OUI,64,12,52,49,3,OUI,OUI,2025-03-13 16:01:31+00:00,"48.837695319163, 2.2753742337227",Paris,75056,0.8125,16
14008,Mouton Duvernet - Général Leclerc,OUI,26,16,10,0,10,OUI,OUI,2025-03-13 15:57:35+00:00,"48.831632518293, 2.3293121159077",Paris,75056,0.38461538461538464,16
14003,Schoelcher - Raspail,OUI,47,41,6,1,5,OUI,OUI,2025-03-13 16:01:13+00:00,"48.83681733526843, 2.3312794080411474",Paris,75056,0.1276595744680851,16
18028,Championnet - Vauvenargues,OUI,31,24,7,0,7,OUI,OUI,2025-03-13 15:57:22+00:00,"48.89401874744574, 2.3319872841238976",Paris,75056,0.22580645161290322,16
19101,Square Simon Bolivar,OUI,22,15,7,1,6,OUI,OUI,2025-03-13 16:01:32+00:00,"48.875089888322, 2.3826304078102",Paris,75056,0.3181818181818182,16
15054,Lecourbe - Jean Maridor,OUI,18,10,8,7,1,OUI,OUI,2025-03-13 16:00:09+00:00,"48.83796366147599, 2.2877392172813416",Paris,75056,0.4444444444444444,16
14138,Porte de Vanves,OUI,30,29,1,1,0,OUI,OUI,2025-03-13 16:01:22+00:00,"48.828012849445, 2.3056878894567",Paris,75056,0.03333333333333333,16
15106,Grenelle - Violet,OUI,34,12,22,21,1,OUI,OUI,2025-03-13 16:02:12+00:00,"48.84993035512154, 2.294612042605877",Paris,75056,0.6470588235294118,16
41209,Cimetière de Fontenay-sous-Bois,OUI,15,13,2,0,2,OUI,OUI,2025-03-13 16:01:15+00:00,"48.84706173362218, 2.4787822365760808",Fontenay-sous-Bois,94033,0.13333333333333333,16
14106,Marc Sangnier - Porte de Vanves,OUI,20,20,0,0,0,OUI,OUI,2025-03-13 16:01:44+00:00,"48.825218683556734, 2.3107116669416428",Paris,75056,0.0,16
13001,Port-Royal - Hôpital du Val-de-Grâce,OUI,17,10,7,3,4,OUI,OUI,2025-03-13 16:01:39+00:00,"48.837668272811, 2.3448138346607",Paris,75056,0.4117647058823529,16
18046,Etienne Jodelle - Saint Ouen,OUI,32,32,0,0,0,OUI,OUI,2025-03-13 16:00:10+00:00,"48.88794016394694, 2.326124420314341",Paris,75056,0.0,16
8017,Rocher - Laborde,OUI,64,59,5,4,1,OUI,OUI,2025-03-13 16:01:39+00:00,"48.87590240712654, 2.322616316378116",Paris,75056,0.078125,16
8054,Bertie Albrecht - Hoche,OUI,32,25,7,3,4,OUI,OUI,2025-03-13 16:02:15+00:00,"48.87614039826388, 2.301303138307601",Paris,75056,0.21875,16
5124,Erasme - Ulm,OUI,21,18,3,1,2,OUI,OUI,2025-03-13 16:00:22+00:00,"48.84264375274712, 2.3445946723222733",Paris,75056,0.14285714285714285,16
15109,Cevennes - Bergers,OUI,28,12,16,6,10,OUI,OUI,2025-03-13 16:00:16+00:00,"48.84240765130395, 2.281037718057633",Paris,75056,0.5714285714285714,16
22406,Guy Môquet - Etienne Dolet,OUI,22,17,5,1,4,OUI,OUI,2025-03-13 16:01:08+00:00,"48.81527009991819, 2.298078276995073",Malakoff,92046,0.22727272727272727,16
21209,Molière - République,OUI,30,27,3,0,3,OUI,OUI,2025-03-13 15:56:59+00:00,"48.81111581390707, 2.3145738624448158",Montrouge,92049,0.1,16
31102,Boissière - Etienne Dolet,OUI,20,16,4,1,3,OUI,OUI,2025-03-13 16:01:03+00:00,"48.876111, 2.4677312",Montreuil,93048,0.2,16
14012,Sibelle - Alésia,OUI,37,36,1,0,1,OUI,OUI,2025-03-13 15:55:50+00:00,"48.826701758539215, 2.3384983465075493",Paris,75056,0.02702702702702703,16
2111,Chabanais - Petits Champs,OUI,30,6,24,19,5,OUI,OUI,2025-03-13 16:01:14+00:00,"48.86703740186721, 2.336716018617153",Paris,75056,0.8,16
21005,Hôtel de Ville de Boulogne Billancourt,OUI,26,9,17,9,8,OUI,OUI,2025-03-13 16:01:15+00:00,"48.83495885166784, 2.2416803240776066",Boulogne-Billancourt,92012,0.6538461538461539,16
18022,Marcadet - Barbès,OUI,34,26,8,0,8,OUI,OUI,2025-03-13 15:57:25+00:00,"48.890451120965, 2.3490573929687",Paris,75056,0.23529411764705882,16
17203,Place de la Porte de Champeret,OUI,28,10,18,14,4,OUI,OUI,2025-03-13 15:56:07+00:00,"48.886062068226, 2.2917001576821",Paris,75056,0.6428571428571429,16
35010,Hoche - Jean Lolive,OUI,20,17,3,1,2,OUI,OUI,2025-03-13 16:02:14+00:00,"48.89110239200789, 2.402843534946442",Pantin,93055,0.15,16
42014,Place Marcel Cachin,OUI,32,8,24,21,3,OUI,OUI,2025-03-13 15:59:36+00:00,"48.81411442356866, 2.39090770483017",Ivry-sur-Seine,94041,0.75,16
10042,Enghien - Faubourg Poissonnière,OUI,31,21,10,7,3,OUI,OUI,2025-03-13 16:01:45+00:00,"48.872420063053, 2.3483952362828",Paris,75056,0.3225806451612903,16
4016,Lobau - Hôtel de Ville,OUI,59,2,57,49,8,OUI,OUI,2025-03-13 16:01:15+00:00,"48.8562118, 2.3532536",Paris,75056,0.9661016949152542,16
8045,Place de la Reine Astrid,OUI,57,18,39,29,10,OUI,OUI,2025-03-13 15:58:33+00:00,"48.864920982538, 2.3025491823859",Paris,75056,0.6842105263157895,16
14124,David Weill - Parc Montsouris,OUI,22,18,4,0,4,OUI,OUI,2025-03-13 16:01:42+00:00,"48.821092374256104, 2.333725690841675",Paris,75056,0.18181818181818182,16
15133,Saint Lambert - Blomet,OUI,27,18,9,5,4,OUI,OUI,2025-03-13 16:01:45+00:00,"48.83659148147257, 2.2930556908249855",Paris,75056,0.3333333333333333,16
44013,Edouard Tremblay - Julian Grimaux,OUI,30,30,0,0,0,OUI,OUI,2025-03-13 15:57:22+00:00,"48.781383825117, 2.3723508417606",Vitry-sur-Seine,94081,0.0,16
15110,Place Robert Guillemard,OUI,22,2,20,16,4,OUI,OUI,2025-03-13 15:59:39+00:00,"48.836191728066666, 2.2811267160086417",Paris,75056,0.9090909090909091,16
6025,Assas - Rennes,OUI,31,7,24,14,10,OUI,OUI,2025-03-13 16:01:14+00:00,"48.8492084999386, 2.32851454623001",Paris,75056,0.7741935483870968,16
21006,Marcelin Berthelot,OUI,27,22,5,3,2,OUI,OUI,2025-03-13 15:53:57+00:00,"48.8415473058801, 2.233161628246308",Boulogne-Billancourt,92012,0.18518518518518517,16
44003,Gabriel Péri - Danielle Casanova,OUI,20,9,11,9,2,OUI,OUI,2025-03-13 16:00:57+00:00,"48.790114, 2.4025777",Vitry-sur-Seine,94081,0.55,16
48010,Karl Marx,OUI,16,7,9,1,8,OUI,OUI,2025-03-13 15:56:22+00:00,"48.784527937293184, 2.3646667979455587",Villejuif,94076,0.5625,16
20131,Repos - Cimetière du Père Lachaise,OUI,33,32,1,1,0,OUI,OUI,2025-03-13 15:56:39+00:00,"48.859358523593, 2.3896131366845",Paris,75056,0.030303030303030304,16
22203,Tertres - Fontaine,OUI,27,23,4,0,4,OUI,OUI,2025-03-13 15:59:53+00:00,"48.787553654715644, 2.306235730648041",Bagneux,92007,0.14814814814814814,16
21015,Nationale - Place Jules Guesde,OUI,23,12,11,8,3,OUI,OUI,2025-03-13 16:02:16+00:00,"48.82753962462998, 2.2416052222251897",Boulogne-Billancourt,92012,0.4782608695652174,16
42021,Raspail - Manufacture des Oeillets,OUI,31,10,21,20,1,OUI,OUI,2025-03-13 16:00:19+00:00,"48.8094458, 2.3903009",Ivry-sur-Seine,94041,0.6774193548387096,16
15034,Lakanal - Commerce,OUI,48,15,33,30,3,OUI,OUI,2025-03-13 16:01:04+00:00,"48.84442462786544, 2.294059172272682",Paris,75056,0.6875,16
1119,Cossonnerie - Sébastopol,OUI,23,6,17,12,5,OUI,OUI,2025-03-13 15:59:56+00:00,"48.86132665908402, 2.349419631063938",Paris,75056,0.7391304347826086,16
5028,Censier - Jardin des Plantes,OUI,28,5,23,16,7,OUI,OUI,2025-03-13 16:01:27+00:00,"48.84107178161383, 2.355475388467312",Paris,75056,0.8214285714285714,16
25003,Henri Ste-Claire Déville - Paul Héroult,OUI,20,8,12,6,6,OUI,OUI,2025-03-13 16:02:14+00:00,"48.892663, 2.172411",Rueil-Malmaison,92063,0.6,16
41202,Gare Rer de Fontenay sous Bois,OUI,60,56,4,1,3,OUI,OUI,2025-03-13 15:56:08+00:00,"48.8436279, 2.4630465",Fontenay-sous-Bois,94033,0.06666666666666667,16
20115,Louis Lumière - Porte de Bagnolet,OUI,20,20,0,0,0,OUI,OUI,2025-03-13 15:56:16+00:00,"48.86431136000005, 2.4105210229754443",Paris,75056,0.0,16
35020,Marcelle - Thalie,OUI,20,19,1,0,1,OUI,OUI,2025-03-13 16:01:54+00:00,"48.8835462, 2.4137883",Pantin,93055,0.05,16
9116,Victoire - Chaussée d'Antin,OUI,24,6,18,8,10,OUI,OUI,2025-03-13 16:01:29+00:00,"48.875065791004396, 2.3316738009452824",Paris,75056,0.75,16
1020,Cambon - Rivoli,OUI,35,23,12,3,9,OUI,OUI,2025-03-13 16:01:39+00:00,"48.866143390992, 2.3251800647137",Paris,75056,0.34285714285714286,16
11030,Oberkampf - République,OUI,20,13,7,4,3,OUI,OUI,2025-03-13 15:59:52+00:00,"48.86531608707, 2.37611478491",Paris,75056,0.35,16
31003,Paris - Emile Zola,OUI,29,27,2,1,1,OUI,OUI,2025-03-13 16:02:16+00:00,"48.854898095789295, 2.4186685681343083",Montreuil,93048,0.06896551724137931,16
11039,Richard Lenoir - Jean-Pierre Timbaud,OUI,35,12,23,17,6,OUI,OUI,2025-03-13 16:01:27+00:00,"48.865804276686, 2.3693370749669",Paris,75056,0.6571428571428571,16
22402,Jean Jaurès - Salvador Allende,OUI,42,38,4,3,1,OUI,OUI,2025-03-13 16:01:10+00:00,"48.821475594736775, 2.3026576638221745",Malakoff,92046,0.09523809523809523,16
11026,Chemin Vert - Saint-Maur,OUI,44,40,4,1,3,OUI,OUI,2025-03-13 16:00:47+00:00,"48.86112461407359, 2.381299026310444",Paris,75056,0.09090909090909091,16
17013,Legendre - Dulong,OUI,23,20,3,1,2,OUI,OUI,2025-03-13 16:01:49+00:00,"48.885325169402904, 2.316423766314984",Paris,75056,0.13043478260869565,16
41601,Général De Gaulle - Alouette,OUI,25,18,7,4,3,OUI,OUI,2025-03-13 15:59:31+00:00,"48.839109, 2.4175664",Saint-Mandé,94067,0.28,16
32604,Square du Théâtre du Garde-Chasse,OUI,50,49,1,1,0,OUI,OUI,2025-03-13 15:56:19+00:00,"48.881287375060616, 2.420119643211365",Les Lilas,93045,0.02,16
9010,Rochechouart lamartine,OUI,24,15,9,0,9,OUI,OUI,2025-03-13 16:02:07+00:00,"48.876719895109, 2.344393021854",Paris,75056,0.375,16
19024,Botzaris - Parc des Buttes Chaumont,OUI,20,19,1,0,1,OUI,OUI,2025-03-13 15:57:59+00:00,"48.877951, 2.381464",Paris,75056,0.05,16
19032,Villette - Belleville,OUI,39,32,7,3,4,OUI,OUI,2025-03-13 16:01:27+00:00,"48.8726877314, 2.376461327076",Paris,75056,0.1794871794871795,16
23006,Jules Guesde - Alsace,OUI,24,9,15,8,7,OUI,OUI,2025-03-13 16:01:35+00:00,"48.890566275506, 2.2950777411461",Levallois-Perret,92044,0.625,16
19022,Marché Secrétan,OUI,25,18,7,2,5,OUI,OUI,2025-03-13 15:59:36+00:00,"48.88125496379482, 2.373463287949562",Paris,75056,0.28,16
15021,Joseph Liouville - Croix Nivert,OUI,62,42,20,20,0,OUI,OUI,2025-03-13 16:00:29+00:00,"48.844835471244416, 2.297508493065834",Paris,75056,0.3225806451612903,16
21701,Larmeroux - Baudelaire,OUI,28,22,6,1,5,OUI,OUI,2025-03-13 16:01:28+00:00,"48.816939911292, 2.2809894804846",Vanves,92075,0.21428571428571427,16
17105,Place Madeleine Daniélou,OUI,42,28,14,13,1,OUI,OUI,2025-03-13 16:01:34+00:00,"48.883498, 2.282015",Paris,75056,0.3333333333333333,16
22003,Beffroy,OUI,26,12,14,7,7,OUI,OUI,2025-03-13 16:01:09+00:00,"48.886591074488, 2.2613945603371",Neuilly-sur-Seine,92051,0.5384615384615384,16
18009,Jean-François Lépine - Stephenson,OUI,20,16,4,0,4,OUI,OUI,2025-03-13 15:56:23+00:00,"48.88611466796807, 2.356855627529275",Paris,75056,0.2,16
11024,Mairie du 11ème,OUI,50,37,13,10,3,OUI,OUI,2025-03-13 16:02:16+00:00,"48.858925, 2.3789759",Paris,75056,0.26,16
11105,Parmentier - République,OUI,20,15,5,2,3,OUI,OUI,2025-03-13 16:01:28+00:00,"48.8644954, 2.3750124",Paris,75056,0.25,16
13050,Quai Panhard et Levassor,OUI,56,18,38,29,9,OUI,OUI,2025-03-13 16:01:01+00:00,"48.828374828097, 2.3842737458056",Paris,75056,0.6785714285714286,16
16108,Sablons - Georges Mandel,OUI,38,36,2,1,1,OUI,OUI,2025-03-13 15:57:04+00:00,"48.863875, 2.28189",Paris,75056,0.05263157894736842,16
20134,Lieutenant Chauré - Etienne Marey,OUI,19,18,1,0,1,OUI,OUI,2025-03-13 16:02:13+00:00,"48.86746195408435, 2.405970990657807",Paris,75056,0.05263157894736842,16
17125,Marie-Georges Picquart - Pereire,OUI,31,29,2,2,0,OUI,OUI,2025-03-13 16:01:32+00:00,"48.88863669349711, 2.3111706599593163",Paris,75056,0.06451612903225806,16
14136,Auguste Cain - Jean Moulin,OUI,40,38,2,1,1,OUI,OUI,2025-03-13 16:00:27+00:00,"48.82577028927573, 2.3210415244102482",Paris,75056,0.05,16
43005,Gare RER de Vincennes,OUI,48,43,5,0,5,OUI,OUI,2025-03-13 16:01:51+00:00,"48.847563015126106, 2.433383166790009",Vincennes,94080,0.10416666666666667,16
10014,Marseille - Beaurepaire,OUI,46,10,36,35,1,OUI,OUI,2025-03-13 16:00:56+00:00,"48.871624306962985, 2.3639265082738348",Paris,75056,0.782608695652174,16
16136,Théophile Gautier - François Millet,OUI,27,5,22,17,5,OUI,OUI,2025-03-13 16:02:03+00:00,"48.85034821320644, 2.273029983043671",Paris,75056,0.8148148148148148,16
11035,Parmentier - Abel Rabaud,OUI,49,44,5,4,1,OUI,OUI,2025-03-13 15:58:41+00:00,"48.86921273836114, 2.371688821240712",Paris,75056,0.10204081632653061,16
16008,Galilée - Kléber,OUI,29,25,4,0,4,OUI,OUI,2025-03-13 15:59:11+00:00,"48.867411865714, 2.2907813801148",Paris,75056,0.13793103448275862,16
46001,Place Paul Eluard,OUI,19,3,16,9,7,OUI,OUI,2025-03-13 16:00:13+00:00,"48.7672039733195, 2.4144977331161503",Choisy-le-Roi,94022,0.8421052631578947,16
17028,Reims - Raymond Pitet,OUI,36,16,20,17,3,OUI,OUI,2025-03-13 16:01:26+00:00,"48.8888, 2.296319",Paris,75056,0.5555555555555556,16
21008,Victor Hugo - Galliéni,OUI,33,16,17,14,3,OUI,OUI,2025-03-13 15:58:39+00:00,"48.838020154411, 2.2460845112801",Boulogne-Billancourt,92012,0.5151515151515151,16
21301,Saint-Vincent - Verdun,OUI,33,24,9,6,3,OUI,OUI,2025-03-13 15:56:18+00:00,"48.819211549234495, 2.254007756710053",Issy-les-Moulineaux,92040,0.2727272727272727,16
24001,Arche - Léonard de Vinci,OUI,27,22,5,2,3,OUI,OUI,2025-03-13 16:01:53+00:00,"48.89790972494496, 2.2383723043644914",Courbevoie,92026,0.18518518518518517,16
9032,Mathurins - Auber,OUI,35,11,24,22,2,OUI,OUI,2025-03-13 16:01:28+00:00,"48.872988840744, 2.3294984212276",Paris,75056,0.6857142857142857,16
22016,Charles de Gaulle - Sablonville,OUI,26,14,12,5,7,OUI,OUI,2025-03-13 15:59:58+00:00,"48.87991924860035, 2.2763770446181297",Neuilly-sur-Seine,92051,0.46153846153846156,16
19016,Hautpoul - Jean Jaurès,OUI,30,28,2,0,2,OUI,OUI,2025-03-13 16:00:44+00:00,"48.886393679436, 2.3865414544355",Paris,75056,0.06666666666666667,16
32302,Chemin Vert - Fraternité,OUI,20,18,2,0,2,OUI,OUI,2025-03-13 16:01:14+00:00,"48.877141208359035, 2.4461565166711807",Romainville,93063,0.1,16
32003,Wilson - Métallurgie,OUI,28,13,15,9,6,OUI,OUI,2025-03-13 15:53:52+00:00,"48.909423010092326, 2.3584435880184174",Saint-Denis,93066,0.5357142857142857,16
42010,Mairie d'Ivry-sur-Seine,OUI,51,26,25,22,3,OUI,OUI,2025-03-13 16:00:48+00:00,"48.81057120969284, 2.3842826485633855",Ivry-sur-Seine,94041,0.49019607843137253,16
21104,Madame de Sanzillon - Mozart,OUI,22,7,15,15,0,OUI,OUI,2025-03-13 16:01:49+00:00,"48.90379820774301, 2.3187401890754704",Clichy,92024,0.6818181818181818,16
15046,Parc Georges Brassens - Brancion,OUI,28,27,1,0,1,OUI,OUI,2025-03-13 15:59:01+00:00,"48.83227829269761, 2.3022570088505745",Paris,75056,0.03571428571428571,16
11042,Grand Prieuré - Crussol,OUI,46,24,22,19,3,OUI,OUI,2025-03-13 16:00:37+00:00,"48.864660627935, 2.3692265531829",Paris,75056,0.4782608695652174,16
16040,Exelmans - Michel-Ange,OUI,31,17,14,12,2,OUI,OUI,2025-03-13 15:58:47+00:00,"48.84309486651855, 2.2597770800669053",Paris,75056,0.45161290322580644,16
32026,Leroy des Barres - Médiathèque,OUI,27,1,26,11,15,OUI,OUI,2025-03-13 16:01:50+00:00,"48.928253687082, 2.3681719727966",Saint-Denis,93066,0.9629629629629629,16
22006,Pierret - Madrid,OUI,27,16,11,9,2,OUI,OUI,2025-03-13 16:00:42+00:00,"48.882976576876565, 2.260125767248034",Neuilly-sur-Seine,92051,0.4074074074074074,16
1013,Place du Palais Royal,OUI,65,6,59,40,19,OUI,OUI,2025-03-13 15:59:08+00:00,"48.862382970647, 2.3384822532535",Paris,75056,0.9076923076923077,16
42302,Aristide Briand - Gare de Bagneux,OUI,20,14,6,2,4,OUI,OUI,2025-03-13 16:00:10+00:00,"48.79387269664978, 2.321148812770844",Cachan,94016,0.3,16
8025,Miromesnil - La Boétie,OUI,32,19,13,11,2,OUI,OUI,2025-03-13 16:02:04+00:00,"48.873722412917, 2.3158480972052",Paris,75056,0.40625,16
19029,Seine - Flandre,OUI,19,15,4,0,4,OUI,OUI,2025-03-13 16:00:07+00:00,"48.886785741479684, 2.3746193200349808",Paris,75056,0.21052631578947367,16
7102,Mairie du 7ème,OUI,48,10,38,26,12,OUI,OUI,2025-03-13 16:02:02+00:00,"48.8577967, 2.3192664",Paris,75056,0.7916666666666666,16
9005,Square d'Anvers,OUI,32,30,2,0,2,OUI,OUI,2025-03-13 16:01:09+00:00,"48.882633484311, 2.3448844062122",Paris,75056,0.0625,16
13002,Arago - Glacière,OUI,26,18,8,4,4,OUI,OUI,2025-03-13 16:02:16+00:00,"48.83486054775774, 2.3445770524322067",Paris,75056,0.3076923076923077,16
19013,Laumière - Petit,OUI,31,28,3,0,3,OUI,OUI,2025-03-13 16:01:49+00:00,"48.88467368538326, 2.380039058625698",Paris,75056,0.0967741935483871,16
20121,Boyer - Ménilmontant,OUI,19,17,2,0,2,OUI,OUI,2025-03-13 15:56:45+00:00,"48.868895162679, 2.3919824145635",Paris,75056,0.10526315789473684,16
26013,Quai du docteur Dervaux,OUI,26,19,7,7,0,OUI,OUI,2025-03-13 16:00:34+00:00,"48.910482, 2.297998",Asnières-sur-Seine,92004,0.2692307692307692,16
42301,Gare Arcueil - Cachan,OUI,25,22,3,0,3,OUI,OUI,2025-03-13 15:59:47+00:00,"48.799824, 2.328171",Arcueil,94003,0.12,16
42015,Place Jean Ferrat,OUI,23,21,2,0,2,OUI,OUI,2025-03-13 16:01:45+00:00,"48.8184945213025, 2.3744174838066106",Ivry-sur-Seine,94041,0.08695652173913043,16
42504,Gare RER de Gentilly,OUI,30,24,6,2,4,OUI,OUI,2025-03-13 15:57:33+00:00,"48.814280450380224, 2.3410347104072575",Gentilly,94037,0.2,16
32016,Place de la Porte de Paris,OUI,33,22,11,5,6,OUI,OUI,2025-03-13 16:01:56+00:00,"48.93009363207303, 2.3564037680625916",Saint-Denis,93066,0.3333333333333333,16
20111,Villiers de l'Isle Adam - Pyrénées,OUI,20,20,0,0,0,OUI,OUI,2025-03-13 16:01:24+00:00,"48.867362, 2.396222",Paris,75056,0.0,16
19008,Flandre - Alphonse Karr,OUI,26,24,2,0,2,OUI,OUI,2025-03-13 16:02:16+00:00,"48.89465, 2.381868",Paris,75056,0.07692307692307693,16
20043,Charonne - Avron,OUI,25,24,1,0,1,OUI,OUI,2025-03-13 16:00:41+00:00,"48.851602665222, 2.3984030470379",Paris,75056,0.04,16
11004,Charonne - Faubourg Saint-Antoine,OUI,31,16,15,13,2,OUI,OUI,2025-03-13 16:02:02+00:00,"48.852191909696, 2.3740932717919",Paris,75056,0.4838709677419355,16
15201,Place Amédée Gordini - Lefebvre,OUI,37,29,8,2,6,OUI,OUI,2025-03-13 16:01:50+00:00,"48.83061737745, 2.2920634208276",Paris,75056,0.21621621621621623,16
18201,Tristan Tzara -  Tchaïkovski,OUI,33,31,2,1,1,OUI,OUI,2025-03-13 16:02:02+00:00,"48.89490221746837, 2.3648490384221077",Paris,75056,0.06060606060606061,16
31010,Stalingrad - Désiré Chevalier,OUI,42,37,5,2,3,OUI,OUI,2025-03-13 16:01:28+00:00,"48.85670169739857, 2.445072233676911",Montreuil,93048,0.11904761904761904,16
92008,Hôtel de Ville de Nanterre,OUI,35,16,19,10,9,OUI,OUI,2025-03-13 16:02:07+00:00,"48.892371898250424, 2.205548956990242",Nanterre,92050,0.5428571428571428,16
12009,Charenton - Diderot,OUI,18,7,11,9,2,OUI,OUI,2025-03-13 16:01:19+00:00,"48.846171461187, 2.3793068155646",Paris,75056,0.6111111111111112,16
41402,Victor Hugo - Ecoles,OUI,22,4,18,9,9,OUI,OUI,2025-03-13 15:59:56+00:00,"48.80476007936134, 2.4180373930262093",Alfortville,94002,0.8181818181818182,16
19125,Place de l'Édit de Nantes,OUI,27,21,6,3,3,OUI,OUI,2025-03-13 16:02:15+00:00,"48.88879, 2.3785",Paris,75056,0.2222222222222222,16
51004,Général Delambre - Prebuard,OUI,28,18,10,3,7,OUI,OUI,2025-03-13 15:57:48+00:00,"48.93870344444, 2.2234171606307",Argenteuil,95018,0.35714285714285715,16
14036,Boulard - Daguerre,OUI,43,40,3,0,3,OUI,OUI,2025-03-13 16:00:10+00:00,"48.83446472680611, 2.3293386027216907",Paris,75056,0.06976744186046512,16
18012,Stephenson - Doudeauville,OUI,35,34,1,0,1,OUI,OUI,2025-03-13 16:01:30+00:00,"48.888537048944826, 2.3561610281467438",Paris,75056,0.02857142857142857,16
5123,Saint-Germain - Thenard,OUI,29,0,29,10,19,OUI,OUI,2025-03-13 16:01:41+00:00,"48.850571, 2.3471015",Paris,75056,1.0,16
43003,Hôpital Bégin,OUI,26,26,0,0,0,NON,NON,2025-03-13 16:00:42+00:00,"48.84571672113, 2.4272462725639",Vincennes,94080,0.0,16
19205,Simon Bolivar - Henri Turot,OUI,23,20,3,0,3,OUI,OUI,2025-03-13 15:58:35+00:00,"48.877475489801, 2.3739709492211",Paris,75056,0.13043478260869565,16
23009,Anatole France - Louise Michel,OUI,47,41,6,4,2,OUI,OUI,2025-03-13 16:00:44+00:00,"48.88873214926474, 2.2881576418876652",Levallois-Perret,92044,0.1276595744680851,16
11036,Jules Ferry - Faubourg du Temple Paris,OUI,57,30,27,26,1,OUI,OUI,2025-03-13 16:01:20+00:00,"48.868397, 2.3678933",Paris,75056,0.47368421052631576,16
42029,Stalingrad - Germaine Tailleferre,OUI,28,24,4,1,3,OUI,OUI,2025-03-13 16:00:43+00:00,"48.80257200481316, 2.3786691203713417",Ivry-sur-Seine,94041,0.14285714285714285,16
9021,Saint Georges - d'Aumale,OUI,23,20,3,1,2,OUI,OUI,2025-03-13 16:00:20+00:00,"48.87778639599673, 2.337429821491241",Paris,75056,0.13043478260869565,16
8035,Bienfaisance - Place de Narvik,OUI,34,11,23,14,9,OUI,OUI,2025-03-13 16:01:33+00:00,"48.87660163459077, 2.3129771277308464",Paris,75056,0.6764705882352942,16
12027,Montgallet - Charenton,OUI,15,2,13,13,0,OUI,OUI,2025-03-13 15:57:27+00:00,"48.842647778701, 2.3861649278137",Paris,75056,0.8666666666666667,16
17102,Alfred Roll - Berthier,OUI,26,24,2,1,1,OUI,OUI,2025-03-13 15:55:48+00:00,"48.887808570529, 2.3000952981763",Paris,75056,0.07692307692307693,16
21313,Guynemer - Séverine,OUI,24,7,17,13,4,OUI,OUI,2025-03-13 16:00:40+00:00,"48.83091743371036, 2.2790706530213356",Issy-les-Moulineaux,92040,0.7083333333333334,16
28001,Richard Wallace - Place du 8 Mai 1945,OUI,29,4,25,14,11,OUI,OUI,2025-03-13 16:02:06+00:00,"48.87866794788021, 2.2420343756675725",Puteaux,92062,0.8620689655172413,16
26007,Square Gilbert Thomain,OUI,19,17,2,1,1,OUI,OUI,2025-03-13 15:55:55+00:00,"48.90717373809284, 2.2695400938391685",Asnières-sur-Seine,92004,0.10526315789473684,16
11007,Jean Macé - Faidherbe,OUI,56,52,4,2,2,OUI,OUI,2025-03-13 16:02:05+00:00,"48.85337548426, 2.3828620836139",Paris,75056,0.07142857142857142,16
16111,Faustin Hélie - Desbordes-Valmore,OUI,27,23,4,2,2,OUI,OUI,2025-03-13 16:02:15+00:00,"48.859403, 2.276522",Paris,75056,0.14814814814814814,16
35018,Ancien Canal - Hélène Brion,OUI,23,22,1,0,1,OUI,OUI,2025-03-13 15:58:55+00:00,"48.89484799296163, 2.4188338592648506",Pantin,93055,0.043478260869565216,16
15025,Dupleix - du Guesclin,OUI,45,18,27,25,2,OUI,OUI,2025-03-13 16:01:27+00:00,"48.85147910413369, 2.296709530055523",Paris,75056,0.6,16
19005,Flandre - Riquet,OUI,20,13,7,4,3,OUI,OUI,2025-03-13 15:56:46+00:00,"48.888013281448, 2.3737595955229",Paris,75056,0.35,16
18110,Departement - Pajol,OUI,16,15,1,0,1,OUI,OUI,2025-03-13 16:01:59+00:00,"48.886674849730184, 2.3613611608743668",Paris,75056,0.0625,16
10113,Parmentier - Hôpital Saint-Louis,OUI,40,38,2,1,1,OUI,OUI,2025-03-13 15:54:20+00:00,"48.871379874257, 2.3698963836667",Paris,75056,0.05,16
41606,Pasteur - Gambetta,OUI,18,14,4,4,0,OUI,OUI,2025-03-13 16:02:12+00:00,"48.84572797384512, 2.4236011505126953",Saint-Mandé,94067,0.2222222222222222,16
17011,Fragonard - Porte de Clichy,OUI,55,29,26,20,6,OUI,OUI,2025-03-13 16:00:15+00:00,"48.894155633419, 2.3143893107772",Paris,75056,0.4727272727272727,16
17045,Place des Ternes.,OUI,44,42,2,0,2,OUI,OUI,2025-03-13 15:58:21+00:00,"48.878438631226516, 2.297727763652802",Paris,75056,0.045454545454545456,16
43402,Place de Verdun,OUI,40,19,21,19,2,OUI,OUI,2025-03-13 16:01:01+00:00,"48.8202823, 2.473775",Joinville-le-Pont,94042,0.525,16
33018,Edouard Poisson - Victor Hugo,OUI,27,22,5,1,4,OUI,OUI,2025-03-13 16:01:52+00:00,"48.91118557052621, 2.379864752692811",Aubervilliers,93001,0.18518518518518517,16
12013,Montgallet - Reuilly,OUI,14,12,2,1,1,OUI,OUI,2025-03-13 15:58:34+00:00,"48.844291, 2.3896481",Paris,75056,0.14285714285714285,16
7015,Varenne,OUI,43,16,27,20,7,OUI,OUI,2025-03-13 16:02:11+00:00,"48.857202661803, 2.3152771219611",Paris,75056,0.627906976744186,16
21305,Place Jacques Madaule,OUI,23,4,19,18,1,OUI,OUI,2025-03-13 16:02:04+00:00,"48.823933787309, 2.2606918215752",Issy-les-Moulineaux,92040,0.8260869565217391,16
5021,Jussieu - Fossés Saint-Bernard,OUI,37,12,25,21,4,OUI,OUI,2025-03-13 16:01:57+00:00,"48.847185510023, 2.3534858599305",Paris,75056,0.6756756756756757,16
11115,Montreuil - Gonnet,OUI,24,22,2,0,2,OUI,OUI,2025-03-13 16:00:42+00:00,"48.850500564921, 2.3890856287864",Paris,75056,0.08333333333333333,16
16121,Jardin d'Acclimatation,OUI,30,25,5,3,2,OUI,OUI,2025-03-13 15:58:24+00:00,"48.878772242510465, 2.270772233605385",Paris,75056,0.16666666666666666,16
15010,Square Cambronne,OUI,59,3,56,53,3,OUI,OUI,2025-03-13 16:01:15+00:00,"48.84756654526, 2.3025691509247",Paris,75056,0.9491525423728814,16
6013,Jacques Callot - Mazarine,OUI,27,4,23,23,0,OUI,OUI,2025-03-13 15:55:45+00:00,"48.855280175332, 2.3375743255019",Paris,75056,0.8518518518518519,16
41102,Gare de Laplace,OUI,43,43,0,0,0,OUI,OUI,2025-03-13 15:57:35+00:00,"48.80893199114179, 2.3349460959434514",Arcueil,94003,0.0,16
12115,Porte de Vincennes,OUI,32,29,3,2,1,OUI,OUI,2025-03-13 16:01:57+00:00,"48.846454, 2.415514",Paris,75056,0.09375,16
16124,Route de Sèvres - Porte de Bagatelle,OUI,66,7,59,52,7,OUI,OUI,2025-03-13 16:00:26+00:00,"48.87525984132485, 2.249415814876557",Paris,75056,0.8939393939393939,16
8033,Commandant Rivière,OUI,39,3,36,20,16,OUI,OUI,2025-03-13 16:01:50+00:00,"48.872933, 2.309796",Paris,75056,0.9230769230769231,16
33003,Bordier - Félix Faure,OUI,45,34,11,6,5,OUI,OUI,2025-03-13 15:59:37+00:00,"48.90390751882016, 2.3830059170722966",Aubervilliers,93001,0.24444444444444444,16
23001,Paul Vaillant Couturier - Chaptal,OUI,34,9,25,23,2,OUI,OUI,2025-03-13 16:02:09+00:00,"48.893479576183, 2.2775253653526",Levallois-Perret,92044,0.7352941176470589,16
22505,Mairie de La Garenne Colombes,OUI,22,18,4,4,0,OUI,OUI,2025-03-13 16:01:56+00:00,"48.90663823468682, 2.24679596722126",La Garenne-Colombes,92035,0.18181818181818182,16
17037,Bayen - Pereire,OUI,21,11,10,10,0,OUI,OUI,2025-03-13 15:59:11+00:00,"48.881804409079656, 2.2921088710427284",Paris,75056,0.47619047619047616,16
13045,Jean Colly - Tolbiac,OUI,35,33,2,2,0,OUI,OUI,2025-03-13 16:00:28+00:00,"48.827817291597846, 2.3705490678548813",Paris,75056,0.05714285714285714,16
18141,Clignancourt - Sofia,OUI,19,15,4,0,4,OUI,OUI,2025-03-13 15:54:12+00:00,"48.88511992309783, 2.34719488842051",Paris,75056,0.21052631578947367,16
16018,Flandrin - Henri Martin,OUI,17,13,4,0,4,OUI,OUI,2025-03-13 15:55:54+00:00,"48.8643275, 2.2724174",Paris,75056,0.23529411764705882,16
33009,Félix Faure - Sadi Carnot,OUI,33,27,6,2,4,OUI,OUI,2025-03-13 15:59:27+00:00,"48.90812110228388, 2.378623187541962",Aubervilliers,93001,0.18181818181818182,16
25008,Place du 8 Mai 1945,OUI,18,14,4,4,0,OUI,OUI,2025-03-13 16:00:02+00:00,"48.871552174017, 2.2025031970585",Rueil-Malmaison,92063,0.2222222222222222,16
5106,Cujas - Saint-Michel,OUI,18,7,11,0,11,OUI,OUI,2025-03-13 16:02:12+00:00,"48.848191348584, 2.341831654854",Paris,75056,0.6111111111111112,16
33001,Victor Hugo - Magasins Généraux,OUI,34,24,10,4,6,OUI,OUI,2025-03-13 15:59:41+00:00,"48.903281401126755, 2.368072383105755",Aubervilliers,93001,0.29411764705882354,16
25005,18 juin 1940 - Buzenval,OUI,25,20,5,3,2,OUI,OUI,2025-03-13 15:58:54+00:00,"48.868807, 2.185428",Rueil-Malmaison,92063,0.2,16
7009,Assemblée Nationale,OUI,75,9,66,29,37,OUI,OUI,2025-03-13 16:00:16+00:00,"48.861411014652, 2.3201214185208",Paris,75056,0.88,16
19115,Porte de la Villette,OUI,26,25,1,0,1,OUI,OUI,2025-03-13 15:59:27+00:00,"48.89835196548483, 2.386150136590004",Paris,75056,0.038461538461538464,16
42707,Place Jean-Baptiste Clément,OUI,24,24,0,0,0,OUI,OUI,2025-03-13 15:54:25+00:00,"48.81240466867336, 2.3617091774940495",Le Kremlin-Bicêtre,94043,0.0,16
14034,Ouest - Château,OUI,23,23,0,0,0,OUI,OUI,2025-03-13 16:01:02+00:00,"48.83617286014242, 2.319392143923804",Paris,75056,0.0,16
5119,Jussieu - Guy de la Brosse,OUI,38,25,13,11,2,OUI,OUI,2025-03-13 16:02:09+00:00,"48.845665, 2.355653",Paris,75056,0.34210526315789475,16
32010,Place aux Étoiles,OUI,37,13,24,5,19,OUI,OUI,2025-03-13 16:01:37+00:00,"48.91835629408464, 2.3523425683379173",Saint-Denis,93066,0.6486486486486487,16
35009,Jean Lolive - Parc Stalingrad,OUI,21,20,1,0,1,OUI,OUI,2025-03-13 15:59:23+00:00,"48.89206174403158, 2.4091735482215886",Pantin,93055,0.047619047619047616,16
12034,Pirogues de Bercy - Libourne,OUI,48,32,16,9,7,OUI,OUI,2025-03-13 16:00:18+00:00,"48.832308, 2.38637",Paris,75056,0.3333333333333333,16
8055,Courcelles - Place des Ternes,OUI,29,21,8,5,3,OUI,OUI,2025-03-13 15:57:36+00:00,"48.878199928923124, 2.2992860188665043",Paris,75056,0.27586206896551724,16
15033,Place Violet,OUI,29,20,9,7,2,OUI,OUI,2025-03-13 16:02:03+00:00,"48.84487893836502, 2.2905756533145905",Paris,75056,0.3103448275862069,16
27002,Parc Pierre Lagravère,OUI,30,10,20,9,11,OUI,OUI,2025-03-13 16:00:55+00:00,"48.92650488131725, 2.239069678491417",Colombes,92025,0.6666666666666666,16
19044,Grands Moulins de Pantin,OUI,50,43,7,4,3,OUI,OUI,2025-03-13 15:59:36+00:00,"48.89738369720229, 2.3959985375404362",Paris,75056,0.14,16
23701,Parvis Robert Schuman - Roger Salengro,OUI,24,17,7,2,5,OUI,OUI,2025-03-13 16:00:30+00:00,"48.812657470558754, 2.1921751275658607",Chaville,92022,0.2916666666666667,16
24002,Gare de Courbevoie,OUI,32,20,12,3,9,OUI,OUI,2025-03-13 15:58:55+00:00,"48.8993867, 2.2506506",Courbevoie,92026,0.375,16
21502,Verdun - Place Henri IV,OUI,26,8,18,13,5,OUI,OUI,2025-03-13 16:00:37+00:00,"48.870797375639214, 2.2277003154158592",Suresnes,92073,0.6923076923076923,16
16034,Porte d'Auteuil,OUI,32,24,8,3,5,OUI,OUI,2025-03-13 15:59:43+00:00,"48.8479394142243, 2.2608396783471107",Paris,75056,0.25,16
31012,Place Carnot,OUI,23,19,4,0,4,OUI,OUI,2025-03-13 15:58:37+00:00,"48.85593932186797, 2.441531717777252",Montreuil,93048,0.17391304347826086,16
41404,Carnot - Pâquerettes,OUI,23,3,20,18,2,OUI,OUI,2025-03-13 16:01:49+00:00,"48.79592939432515, 2.4261841177940373",Alfortville,94002,0.8695652173913043,16
16129,Ceinture du Lac Inferieure - Saint-Cloud,OUI,40,40,0,0,0,OUI,OUI,2025-03-13 15:59:49+00:00,"48.86218070933143, 2.2617871686816216",Paris,75056,0.0,16
20132,Réunion - Avron,OUI,26,26,0,0,0,OUI,OUI,2025-03-13 16:01:03+00:00,"48.852566752033766, 2.403928068708116",Paris,75056,0.0,16
14104,Boyer-Barret - Raymond Losserand,OUI,22,21,1,0,1,OUI,OUI,2025-03-13 15:53:19+00:00,"48.83329880233322, 2.3173383995890617",Paris,75056,0.045454545454545456,16
92003,Chanzy - Sud-Est,OUI,25,22,3,0,3,OUI,OUI,2025-03-13 16:01:58+00:00,"48.888912037698766, 2.195632159709931",Nanterre,92050,0.12,16
6030,Assas - Vaugirard,OUI,34,23,11,7,4,OUI,OUI,2025-03-13 16:01:45+00:00,"48.848274111398, 2.3292413726449",Paris,75056,0.3235294117647059,16
19019,Petit - Manin,OUI,22,22,0,0,0,NON,NON,2025-03-13 15:57:41+00:00,"48.886506875343, 2.3938155401308",Paris,75056,0.0,16
15122,Place Charles Vallin,OUI,26,11,15,7,8,OUI,OUI,2025-03-13 16:01:55+00:00,"48.835523812041, 2.3025986552238",Paris,75056,0.5769230769230769,16
21109,Guichet - Jean Jaurès,OUI,23,20,3,2,1,OUI,OUI,2025-03-13 15:56:33+00:00,"48.905169868129036, 2.3023840785026555",Clichy,92024,0.13043478260869565,16
15017,Place Falguière,OUI,23,21,2,1,1,OUI,OUI,2025-03-13 15:53:25+00:00,"48.83629973941847, 2.3104464635252953",Paris,75056,0.08695652173913043,16
17007,Navier - Epinettes,OUI,36,30,6,3,3,OUI,OUI,2025-03-13 15:54:36+00:00,"48.89587780769155, 2.3226776719093327",Paris,75056,0.16666666666666666,16
17018,Parc Monceau,OUI,18,4,14,8,6,OUI,OUI,2025-03-13 16:01:32+00:00,"48.881077914129, 2.3095492646098",Paris,75056,0.7777777777777778,16
12024,Gare de Bercy,OUI,35,12,23,21,2,OUI,OUI,2025-03-13 16:01:29+00:00,"48.839794573906, 2.3826066032052",Paris,75056,0.6571428571428571,16
18005,Tardieu - Chappe,OUI,16,14,2,0,2,OUI,OUI,2025-03-13 15:57:30+00:00,"48.884146759782, 2.341845408082",Paris,75056,0.125,16
35019,Anatole France - Jean Lolive,OUI,28,25,3,1,2,OUI,OUI,2025-03-13 16:01:40+00:00,"48.8949922, 2.4253764",Pantin,93055,0.10714285714285714,16
92004,Nanterre - Université,OUI,19,9,10,8,2,OUI,OUI,2025-03-13 16:00:38+00:00,"48.901365, 2.212693",Nanterre,92050,0.5263157894736842,16
20113,Piat - Parc de Belleville,OUI,21,17,4,0,4,OUI,OUI,2025-03-13 16:01:11+00:00,"48.87195626635528, 2.384981390278095",Paris,75056,0.19047619047619047,16
5026,Pascal - Claude Bernard,OUI,48,27,21,20,1,OUI,OUI,2025-03-13 16:00:27+00:00,"48.839061952159746, 2.3499782010912895",Paris,75056,0.4375,16
20119,Square des Saint-Simoniens,OUI,25,24,1,0,1,OUI,OUI,2025-03-13 15:59:36+00:00,"48.8701796, 2.3967273",Paris,75056,0.04,16
15028,Grenelle - Dr Finlay,OUI,71,4,67,67,0,OUI,OUI,2025-03-13 16:01:32+00:00,"48.851315406715976, 2.2919502854347233",Paris,75056,0.9436619718309859,16
31705,Champeaux - Gallieni,OUI,47,43,4,0,4,OUI,OUI,2025-03-13 15:58:26+00:00,"48.864459134684644, 2.4161778017878532",Bagnolet,93006,0.0851063829787234,16
14018,Porte d'Orléans,OUI,45,38,7,2,5,OUI,OUI,2025-03-13 15:59:19+00:00,"48.8227639, 2.3249313",Paris,75056,0.15555555555555556,16
23802,Raymond Poincaré - Allée de la Marche,OUI,22,16,6,6,0,OUI,OUI,2025-03-13 16:00:17+00:00,"48.838634069623, 2.1724102640451",Garches,92033,0.2727272727272727,16
42503,Vladimir Ilitch Lénine - Andrée Chedid,OUI,31,31,0,0,0,OUI,OUI,2025-03-13 16:01:29+00:00,"48.813240124373, 2.3319716067039",Gentilly,94037,0.0,16
12126,Gravelle - Route du Bac,OUI,49,44,5,3,2,OUI,OUI,2025-03-13 16:02:04+00:00,"48.824407, 2.418455",Paris,75056,0.10204081632653061,16
21111,Professeur René Leriche - Général Leclerc,OUI,50,42,8,8,0,OUI,OUI,2025-03-13 16:01:36+00:00,"48.90782845483013, 2.307887971401215",Clichy,92024,0.16,16
20036,Ménilmontant - Pelleport,OUI,31,30,1,0,1,OUI,OUI,2025-03-13 16:00:36+00:00,"48.870682633845, 2.3989596023316",Paris,75056,0.03225806451612903,16
2010,Uzès - Montmartre,OUI,26,4,22,11,11,OUI,OUI,2025-03-13 16:02:06+00:00,"48.870790980240706, 2.3431010171771054",Paris,75056,0.8461538461538461,16
41604,Lagny - Joffre,OUI,30,30,0,0,0,OUI,OUI,2025-03-13 16:01:00+00:00,"48.84930687084088, 2.417949736118317",Saint-Mandé,94067,0.0,16
11114,Ledru-Rollin - Charonne,OUI,32,10,22,19,3,OUI,OUI,2025-03-13 16:01:06+00:00,"48.85345855607243, 2.3772463581947094",Paris,75056,0.6875,16
15029,Emeriau - Place de Brazzaville,OUI,51,24,27,26,1,OUI,OUI,2025-03-13 16:01:48+00:00,"48.850785261674964, 2.2871585190296173",Paris,75056,0.5294117647058824,16
5116,Place Valhubert,OUI,51,4,47,42,5,OUI,OUI,2025-03-13 16:01:10+00:00,"48.844182577315, 2.3640366643667",Paris,75056,0.9215686274509803,16
10005,Petites Ecuries - Faubourg Poissonnière,OUI,16,4,12,12,0,OUI,OUI,2025-03-13 16:01:59+00:00,"48.87397217237368, 2.348388757504776",Paris,75056,0.75,16
7014,Saint-François-Xavier,OUI,41,23,18,14,4,OUI,OUI,2025-03-13 16:02:04+00:00,"48.85154484769, 2.3146149516106",Paris,75056,0.43902439024390244,16
26001,Gare d'Asnières sur Seine,OUI,21,12,9,9,0,OUI,OUI,2025-03-13 15:59:15+00:00,"48.90636459217474, 2.2835066914558415",Asnières-sur-Seine,92004,0.42857142857142855,16
20040,Parc de Belleville - Julien Lacroix,OUI,26,25,1,0,1,OUI,OUI,2025-03-13 16:02:12+00:00,"48.8703459, 2.3842214",Paris,75056,0.038461538461538464,16
18020,Francoeur - Marcadet,OUI,20,17,3,0,3,OUI,OUI,2025-03-13 16:01:31+00:00,"48.89104123261663, 2.340014585442034",Paris,75056,0.15,16
34002,Capitaine Glarner - Gabriel Péri,OUI,24,15,9,6,3,OUI,OUI,2025-03-13 15:59:34+00:00,"48.902449900418745, 2.3304807533425724",Saint-Ouen-sur-Seine,93070,0.375,16
20136,Henri Chevreau - Couronnes,OUI,26,24,2,2,0,OUI,OUI,2025-03-13 15:57:54+00:00,"48.87033205312931, 2.388777695596218",Paris,75056,0.07692307692307693,16
13026,Place Jean Delay,OUI,33,20,13,6,7,OUI,OUI,2025-03-13 16:02:07+00:00,"48.823316, 2.354336",Paris,75056,0.3939393939393939,16
43006,Vignerons - Minimes,OUI,29,25,4,2,2,OUI,OUI,2025-03-13 16:01:36+00:00,"48.841486, 2.430793",Vincennes,94080,0.13793103448275862,16
11101,Charles Delescluze,OUI,48,18,30,27,3,OUI,OUI,2025-03-13 16:01:14+00:00,"48.85242200848887, 2.380632497370243",Paris,75056,0.625,16
5002,Sommerard - Saint-Jacques,OUI,34,4,30,25,5,OUI,OUI,2025-03-13 15:57:35+00:00,"48.850310432924466, 2.345015835298588",Paris,75056,0.8823529411764706,16
14130,Jonquoy - Didot,OUI,30,23,7,2,5,OUI,OUI,2025-03-13 15:59:19+00:00,"48.82890454823947, 2.31648076325655",Paris,75056,0.23333333333333334,16
8102,Lamennais - Washington,OUI,25,5,20,10,10,OUI,OUI,2025-03-13 16:02:06+00:00,"48.87352990026496, 2.303444892168045",Paris,75056,0.8,16
10015,Lucien Sampaix - Récollets,OUI,41,37,4,2,2,OUI,OUI,2025-03-13 16:00:56+00:00,"48.874330377560476, 2.3621229082345963",Paris,75056,0.0975609756097561,16
31702,Pierre et Marie Curie - Julien Grimau,OUI,18,16,2,0,2,OUI,OUI,2025-03-13 15:57:35+00:00,"48.870714014863225, 2.424097023904324",Bagnolet,93006,0.1111111111111111,16
12032,Porte Dorée,OUI,35,18,17,12,5,OUI,OUI,2025-03-13 16:02:12+00:00,"48.8354337, 2.4077132",Paris,75056,0.4857142857142857,16
7004,Raspail - Varenne,OUI,17,16,1,0,1,OUI,OUI,2025-03-13 16:01:18+00:00,"48.853147816545, 2.3263905197382",Paris,75056,0.058823529411764705,16
19037,Belleville - Porte des Lilas,OUI,29,27,2,0,2,OUI,OUI,2025-03-13 15:58:04+00:00,"48.87660391892763, 2.404769691129476",Paris,75056,0.06896551724137931,16
21013,Pierre Grenier - Pont de Billancourt,OUI,21,12,9,4,5,OUI,OUI,2025-03-13 15:58:24+00:00,"48.8258020742942, 2.2487989068031315",Boulogne-Billancourt,92012,0.42857142857142855,16
6103,Mézières - Rennes,OUI,53,42,11,6,5,OUI,OUI,2025-03-13 16:02:16+00:00,"48.85023459321703, 2.3303819820284843",Paris,75056,0.20754716981132076,16
7006,Quai Voltaire,OUI,31,5,26,20,6,OUI,OUI,2025-03-13 16:02:00+00:00,"48.858942986179, 2.3314182047146",Paris,75056,0.8387096774193549,16
15038,Place Adolphe Cherioux - Vaugirard,OUI,62,59,3,1,2,OUI,OUI,2025-03-13 16:00:18+00:00,"48.83959442800459, 2.3010657727718353",Paris,75056,0.04838709677419355,16
8012,Batignolles - Place de Clichy,OUI,47,45,2,1,1,OUI,OUI,2025-03-13 16:01:08+00:00,"48.883474535757, 2.326493114233",Paris,75056,0.0425531914893617,16
21032,Sèvres-Gallieni,OUI,24,3,21,18,3,OUI,OUI,2025-03-13 16:02:13+00:00,"48.837809408957, 2.2281519323587",Boulogne-Billancourt,92012,0.875,16
17017,Gare de Pont-Cardinet,OUI,30,28,2,1,1,OUI,OUI,2025-03-13 15:59:18+00:00,"48.88713901475306, 2.314494143994255",Paris,75056,0.06666666666666667,16
20021,Indre - Prairies,OUI,38,30,8,0,8,OUI,OUI,2025-03-13 15:59:33+00:00,"48.86254398506782, 2.403290458023548",Paris,75056,0.21052631578947367,16
10023,Gare de l'Est - Verdun,OUI,13,10,3,3,0,OUI,OUI,2025-03-13 16:00:41+00:00,"48.876156054271, 2.3609149083206",Paris,75056,0.23076923076923078,16
7005,Raspail - Bac,OUI,50,29,21,19,2,OUI,OUI,2025-03-13 16:00:33+00:00,"48.855628721101, 2.3256602883339",Paris,75056,0.42,16
23002,Pont de Levallois-bécon,OUI,49,43,6,4,2,OUI,OUI,2025-03-13 16:01:55+00:00,"48.8984179, 2.2791311",Levallois-Perret,92044,0.12244897959183673,16
21019,Edouard Vaillant - Paul-Adolphe Souriau,OUI,26,1,25,20,5,OUI,OUI,2025-03-13 16:00:31+00:00,"48.834845858829, 2.2479459643364",Boulogne-Billancourt,92012,0.9615384615384616,16
14139,Pierre Larousse - Raymond Losserand,OUI,30,29,1,0,1,OUI,OUI,2025-03-13 16:01:01+00:00,"48.83059564231877, 2.3119183257222176",Paris,75056,0.03333333333333333,16
21105,Morice - Général Leclerc,OUI,25,15,10,7,3,OUI,OUI,2025-03-13 16:00:43+00:00,"48.90245471981591, 2.3128929734230046",Clichy,92024,0.4,16
13102,Pitié-Salpêtrière,OUI,49,29,20,12,8,OUI,OUI,2025-03-13 16:01:56+00:00,"48.83748810318667, 2.365213818848133",Paris,75056,0.40816326530612246,16
19109,Tanger - Place du Maroc,OUI,19,16,3,3,0,OUI,OUI,2025-03-13 16:01:10+00:00,"48.8862524447104, 2.3689296841621403",Paris,75056,0.15789473684210525,16
15055,Vasco de Gama,OUI,54,27,27,23,4,OUI,OUI,2025-03-13 16:01:06+00:00,"48.83671783466264, 2.283664085650799",Paris,75056,0.5,16
17124,Porte de Saint-Ouen - Henri Huchard,OUI,26,9,17,16,1,OUI,OUI,2025-03-13 15:55:20+00:00,"48.898708366365064, 2.3295360803604126",Paris,75056,0.6538461538461539,16
41207,Place du Général de Gaulle,OUI,28,25,3,0,3,OUI,OUI,2025-03-13 15:57:21+00:00,"48.8525288, 2.4877332",Fontenay-sous-Bois,94033,0.10714285714285714,16
44012,Génie - Mozart,OUI,18,15,3,1,2,OUI,OUI,2025-03-13 15:54:59+00:00,"48.794902381218904, 2.3734183609485626",Vitry-sur-Seine,94081,0.16666666666666666,16
12011,Charenton - Place du Col Bourgoin,OUI,35,23,12,11,1,OUI,OUI,2025-03-13 16:01:59+00:00,"48.844867319554, 2.3825789350545",Paris,75056,0.34285714285714286,16
31016,Lucie Aubrac - Franklin,OUI,35,35,0,0,0,OUI,OUI,2025-03-13 15:57:50+00:00,"48.86223916006812, 2.4435862898826604",Montreuil,93048,0.0,16
21308,Bara - Henri Farman,OUI,58,12,46,35,11,OUI,OUI,2025-03-13 16:00:35+00:00,"48.833218027457846, 2.2677567601203923",Issy-les-Moulineaux,92040,0.7931034482758621,16
22101,Gare Routière de Saint Cloud,OUI,30,9,21,14,7,OUI,OUI,2025-03-13 16:01:00+00:00,"48.84288183896324, 2.222245037555695",Saint-Cloud,92064,0.7,16
6018,Michelet - Assas,OUI,17,14,3,0,3,OUI,OUI,2025-03-13 16:02:02+00:00,"48.842741502832, 2.3350211977959",Paris,75056,0.17647058823529413,16
13043,Dunois - Clisson,OUI,50,40,10,5,5,OUI,OUI,2025-03-13 15:58:51+00:00,"48.832294, 2.3674523",Paris,75056,0.2,16
31019,Vincennes - Douy-Delcupe,OUI,37,35,2,1,1,OUI,OUI,2025-03-13 16:00:08+00:00,"48.85493692155721, 2.436049282550812",Montreuil,93048,0.05405405405405406,16
2009,Filles Saint-Thomas - Place de la Bourse,OUI,58,14,44,23,21,OUI,OUI,2025-03-13 16:02:16+00:00,"48.868899890853, 2.3397543845203",Paris,75056,0.7586206896551724,16
32014,Place du Cornillon - Stade de France,OUI,33,3,30,19,11,OUI,OUI,2025-03-13 16:01:49+00:00,"48.92540695835961, 2.3644426837563515",Saint-Denis,93066,0.9090909090909091,16
44102,Verdun - Adrien Damalix,OUI,26,24,2,2,0,OUI,OUI,2025-03-13 16:01:10+00:00,"48.8222334178559, 2.4215328320860863",Saint-Maurice,94069,0.07692307692307693,16
18032,Porte de Clignancourt.,OUI,55,50,5,1,4,OUI,OUI,2025-03-13 16:02:13+00:00,"48.897488, 2.343996",Paris,75056,0.09090909090909091,16
9115,Milton - Manuel,OUI,21,16,5,0,5,OUI,OUI,2025-03-13 15:56:16+00:00,"48.878249, 2.341181",Paris,75056,0.23809523809523808,16
17027,Place du Maréchal Juin - Péreire,OUI,44,19,25,21,4,OUI,OUI,2025-03-13 16:01:29+00:00,"48.885263, 2.298286",Paris,75056,0.5681818181818182,16
21003,Jean Jaurès - Jean Baptiste Clément,OUI,39,38,1,0,1,OUI,OUI,2025-03-13 15:58:31+00:00,"48.84576261454011, 2.2369650006294255",Boulogne-Billancourt,92012,0.02564102564102564,16
51003,Hôtel de Ville d'Argenteuil,OUI,29,13,16,11,5,OUI,OUI,2025-03-13 15:54:21+00:00,"48.946504, 2.2496396",Argenteuil,95018,0.5517241379310345,16
18025,Mairie du 18ème,OUI,40,37,3,0,3,OUI,OUI,2025-03-13 15:56:35+00:00,"48.892939296937605, 2.3445510864257812",Paris,75056,0.075,16
13016,Primo Levi - Frigos,OUI,33,3,30,26,4,OUI,OUI,2025-03-13 16:01:41+00:00,"48.83094844846017, 2.37965351592796",Paris,75056,0.9090909090909091,16
17122,Bridaine - Lamandé,OUI,28,27,1,0,1,OUI,OUI,2025-03-13 16:02:15+00:00,"48.8862074, 2.3206239",Paris,75056,0.03571428571428571,16
8051,Batignolles - Rome,OUI,12,9,3,1,2,OUI,OUI,2025-03-13 16:00:33+00:00,"48.881823370566806, 2.3202589899301524",Paris,75056,0.25,16
9023,Laffitte - Italiens,OUI,31,10,21,15,6,OUI,OUI,2025-03-13 15:59:59+00:00,"48.871815737396, 2.3372015478451",Paris,75056,0.6774193548387096,16
19039,Edouard Pailleron - Simon Bolivar,OUI,23,22,1,0,1,OUI,OUI,2025-03-13 16:00:38+00:00,"48.87979886049996, 2.374839261174202",Paris,75056,0.043478260869565216,16
14122,Colonel Monteil - Brune,OUI,19,17,2,1,1,OUI,OUI,2025-03-13 15:59:38+00:00,"48.82650293311, 2.3092747998272",Paris,75056,0.10526315789473684,16
16032,Eglise d'Auteuil,OUI,21,18,3,0,3,OUI,OUI,2025-03-13 16:01:46+00:00,"48.84749841771691, 2.26848387135299",Paris,75056,0.14285714285714285,16
6016,Danton - Serpente,OUI,21,1,20,18,2,OUI,OUI,2025-03-13 15:59:32+00:00,"48.852297362582, 2.3414132371545",Paris,75056,0.9523809523809523,16
22001,Château - Bineau,OUI,20,3,17,14,3,OUI,OUI,2025-03-13 16:01:54+00:00,"48.890404028589806, 2.270106375217438",Neuilly-sur-Seine,92051,0.85,16
17046,Mac-Mahon - Brey,OUI,24,16,8,3,5,OUI,OUI,2025-03-13 15:59:46+00:00,"48.877532084130166, 2.294512536052928",Paris,75056,0.3333333333333333,16
20027,Porte de Ménilmontant,OUI,15,14,1,0,1,OUI,OUI,2025-03-13 16:00:22+00:00,"48.8691543609174, 2.40932246879487",Paris,75056,0.06666666666666667,16
18029,Emile Blemont - Poteau,OUI,39,32,7,1,6,OUI,OUI,2025-03-13 16:02:06+00:00,"48.8943782, 2.3415122",Paris,75056,0.1794871794871795,16
16123,Mahatma Gandhi,OUI,24,8,16,12,4,OUI,OUI,2025-03-13 16:02:12+00:00,"48.876356, 2.264205",Paris,75056,0.6666666666666666,16
21703,Square du Carrefour de l'Insurrection,OUI,20,14,6,1,5,OUI,OUI,2025-03-13 15:59:25+00:00,"48.820864559770676, 2.291113436222077",Vanves,92075,0.3,16
31007,Paris - Désiré Préaux,OUI,44,36,8,2,6,OUI,OUI,2025-03-13 16:01:21+00:00,"48.85742876694898, 2.4323049187660217",Montreuil,93048,0.18181818181818182,16
20118,Orteaux - Mouraud,OUI,24,24,0,0,0,OUI,OUI,2025-03-13 15:54:53+00:00,"48.85558642847872, 2.408762907764669",Paris,75056,0.0,16
15108,Lourmel - Marie Skobtsov,OUI,22,12,10,6,4,OUI,OUI,2025-03-13 16:01:48+00:00,"48.844974, 2.287283",Paris,75056,0.45454545454545453,16
20023,Pelleport - Belgrand,OUI,14,12,2,1,1,OUI,OUI,2025-03-13 16:00:48+00:00,"48.86500081847653, 2.403980836377493",Paris,75056,0.14285714285714285,16
19040,Belleville - Télégraphe,OUI,40,40,0,0,0,OUI,OUI,2025-03-13 15:56:14+00:00,"48.8756045, 2.3995549",Paris,75056,0.0,16
14002,Edgar Quinet - Raspail,OUI,44,41,3,0,3,OUI,OUI,2025-03-13 16:01:18+00:00,"48.83940266673835, 2.32971478253603",Paris,75056,0.06818181818181818,16
17047,Courcelles - Pierre Demours,OUI,26,1,25,11,14,OUI,OUI,2025-03-13 16:01:48+00:00,"48.883769733273496, 2.29858466343129",Paris,75056,0.9615384615384616,16
18049,Porte d'Aubervilliers,OUI,53,46,7,6,1,OUI,OUI,2025-03-13 15:59:18+00:00,"48.89859661942376, 2.3689722642302513",Paris,75056,0.1320754716981132,16
41204,République - Danton,OUI,19,19,0,0,0,OUI,OUI,2025-03-13 15:54:18+00:00,"48.85249172181667, 2.462034523487091",Fontenay-sous-Bois,94033,0.0,16
10020,Chabrol - d'Hauteville,OUI,11,10,1,0,1,OUI,OUI,2025-03-13 16:01:12+00:00,"48.877018388033, 2.3513179644942",Paris,75056,0.09090909090909091,16
17121,Square des Epinettes,OUI,20,20,0,0,0,OUI,OUI,2025-03-13 16:02:09+00:00,"48.89383909781389, 2.325953990221024",Paris,75056,0.0,16
19009,Cité des Sciences et de l'Industrie,OUI,28,21,7,2,5,OUI,OUI,2025-03-13 16:01:29+00:00,"48.89659571178903, 2.384599149227142",Paris,75056,0.25,16
11041,Square Saint-Ambroise,OUI,38,22,16,14,2,OUI,OUI,2025-03-13 16:00:25+00:00,"48.860934, 2.375841",Paris,75056,0.42105263157894735,16
18109,Pajol - Riquet,OUI,45,41,4,3,1,OUI,OUI,2025-03-13 16:01:31+00:00,"48.88960028134536, 2.3628534749150276",Paris,75056,0.08888888888888889,16
31703,Sadi Carnot - François Mitterrand,OUI,25,23,2,0,2,OUI,OUI,2025-03-13 15:57:45+00:00,"48.87532687671517, 2.4241617321968083",Bagnolet,93006,0.08,16
19038,Lassus - Delouvain,OUI,19,17,2,0,2,OUI,OUI,2025-03-13 16:00:28+00:00,"48.8755044846, 2.3890327325519",Paris,75056,0.10526315789473684,16
15031,Théâtre - Lourmel,OUI,52,17,35,35,0,OUI,OUI,2025-03-13 16:01:53+00:00,"48.8482070397636, 2.2898658737540245",Paris,75056,0.6730769230769231,16
35017,Toffier Decaux - Cartier Bresson,OUI,18,15,3,3,0,OUI,OUI,2025-03-13 15:59:06+00:00,"48.90165072551549, 2.4017545580863957",Pantin,93055,0.16666666666666666,16
21014,Hameau Fleuri - Marché,OUI,22,7,15,9,6,OUI,OUI,2025-03-13 16:01:56+00:00,"48.831448892608314, 2.2412404417991643",Boulogne-Billancourt,92012,0.6818181818181818,16
16021,François Ponsard - La Muette,OUI,23,22,1,0,1,OUI,OUI,2025-03-13 15:58:45+00:00,"48.8583666, 2.2744515",Paris,75056,0.043478260869565216,16
47005,Ecole Vétérinaire,OUI,35,18,17,13,4,OUI,OUI,2025-03-13 16:02:03+00:00,"48.81488859822486, 2.4224362157778994",Maisons-Alfort,94046,0.4857142857142857,16
9031,Provence - Chaussée d'Antin,OUI,24,9,15,11,4,OUI,OUI,2025-03-13 15:56:47+00:00,"48.87428447542072, 2.332976511564311",Paris,75056,0.625,16
15070,Balard - Montagne de la Fage,OUI,34,2,32,28,4,OUI,OUI,2025-03-13 16:01:10+00:00,"48.83850740333351, 2.2782871127128606",Paris,75056,0.9411764705882353,16
9117,Bellefond - Maubeuge,OUI,28,27,1,1,0,OUI,OUI,2025-03-13 16:01:11+00:00,"48.878255397645, 2.3452642187476",Paris,75056,0.03571428571428571,16
9026,Jean-Baptiste Pigalle - La Bruyere,OUI,17,14,3,0,3,OUI,OUI,2025-03-13 15:55:59+00:00,"48.87939826447722, 2.333709173337285",Paris,75056,0.17647058823529413,16
15035,Place Etienne Pernet,OUI,43,4,39,33,6,OUI,OUI,2025-03-13 16:01:34+00:00,"48.84243457133779, 2.2921819612383847",Paris,75056,0.9069767441860465,16
18033,Belliard - Damrémont,OUI,34,31,3,1,2,OUI,OUI,2025-03-13 16:02:14+00:00,"48.89669238777841, 2.338023450388167",Paris,75056,0.08823529411764706,16
18113,Lepic - Armée d'Orient,OUI,24,22,2,0,2,OUI,OUI,2025-03-13 15:55:38+00:00,"48.887536403814, 2.3343077301979",Paris,75056,0.08333333333333333,16
11010,Boulets - Faubourg Saint-Antoine,OUI,42,38,4,4,0,OUI,OUI,2025-03-13 16:01:06+00:00,"48.849259262115, 2.3917546141943",Paris,75056,0.09523809523809523,16
35003,Gabrielle Josserand - Edouard Vaillant,OUI,24,19,5,1,4,OUI,OUI,2025-03-13 15:58:51+00:00,"48.90271566255436, 2.3933270573616032",Pantin,93055,0.20833333333333334,16
15002,Maine - Antoine Bourdelle,OUI,17,9,8,5,3,OUI,OUI,2025-03-13 16:02:16+00:00,"48.84308531746595, 2.320263946784738",Paris,75056,0.47058823529411764,16
5121,Square René Viviani - Montebello,OUI,33,4,29,26,3,OUI,OUI,2025-03-13 16:01:56+00:00,"48.851904891406, 2.3478421568871",Paris,75056,0.8787878787878788,16
21310,Kléber - Gouverneur Général Eboué,OUI,22,3,19,15,4,OUI,OUI,2025-03-13 15:58:06+00:00,"48.826885843069796, 2.2723413258790965",Issy-les-Moulineaux,92040,0.8636363636363636,16
11006,Ledru-Rollin - Place du Père Chaillet,OUI,37,2,35,23,12,OUI,OUI,2025-03-13 16:01:17+00:00,"48.856433706943704, 2.379020587761426",Paris,75056,0.9459459459459459,16
23007,Président Wilson - Jean Jaures,OUI,25,6,19,7,12,OUI,OUI,2025-03-13 16:01:42+00:00,"48.89034054052266, 2.2920683026313786",Levallois-Perret,92044,0.76,16
19127,Aubervilliers - Curial,OUI,23,20,3,0,3,OUI,OUI,2025-03-13 16:01:06+00:00,"48.89088305227546, 2.3688579350709915",Paris,75056,0.13043478260869565,16
20016,Pyrénées - Maraîchers,OUI,32,30,2,2,0,OUI,OUI,2025-03-13 15:59:51+00:00,"48.85714001395299, 2.4043509364128113",Paris,75056,0.0625,16
16015,Bassano -  Iéna,OUI,15,11,4,0,4,OUI,OUI,2025-03-13 15:58:45+00:00,"48.868144510482075, 2.296149600985935",Paris,75056,0.26666666666666666,16
32015,Gare RER de Saint-Denis,OUI,36,22,14,9,5,OUI,OUI,2025-03-13 16:01:09+00:00,"48.93554324248177, 2.3471488058567047",Saint-Denis,93066,0.3888888888888889,16
1120,Lavandieres Sainte Opportune - Rivoli,OUI,26,1,25,17,8,OUI,OUI,2025-03-13 16:01:43+00:00,"48.859279702476, 2.3466217517853",Paris,75056,0.9615384615384616,16
20116,Haies - Réunion,OUI,20,18,2,2,0,OUI,OUI,2025-03-13 16:01:18+00:00,"48.85386896766491, 2.402426162238911",Paris,75056,0.1,16
14112,Méchain - Faubourg Saint-Jacques,OUI,14,12,2,1,1,OUI,OUI,2025-03-13 16:00:24+00:00,"48.83586772099485, 2.33798034198275",Paris,75056,0.14285714285714285,16
6107,Place Alphonse Deville,OUI,22,3,19,15,4,OUI,OUI,2025-03-13 16:01:12+00:00,"48.850188262662, 2.3275961726904",Paris,75056,0.8636363636363636,16
47004,Stade Auguste Delaune,OUI,21,0,21,20,1,OUI,OUI,2025-03-13 15:59:51+00:00,"48.80896378683884, 2.4345204234123234",Maisons-Alfort,94046,1.0,16
16029,Maison de Radio - France,OUI,42,5,37,36,1,OUI,OUI,2025-03-13 16:02:13+00:00,"48.85132886434057, 2.277785539627075",Paris,75056,0.8809523809523809,16
21001,Transvaal - Charles de Gaulle,OUI,27,21,6,5,1,OUI,OUI,2025-03-13 15:59:42+00:00,"48.848280403628806, 2.2373420120857195",Boulogne-Billancourt,92012,0.2222222222222222,16
18008,Square Léon,OUI,33,33,0,0,0,OUI,OUI,2025-03-13 15:59:51+00:00,"48.88667396788626, 2.353205569088459",Paris,75056,0.0,16
16122,Route de la Muette - Porte de Neuilly,OUI,49,39,10,5,5,OUI,OUI,2025-03-13 16:01:59+00:00,"48.8798926, 2.2587671",Paris,75056,0.20408163265306123,16
7008,Villersexel - Saint-Germain,OUI,16,9,7,5,2,OUI,OUI,2025-03-13 15:59:59+00:00,"48.858297001218, 2.3237934708595",Paris,75056,0.4375,16
10010,Place Jacques Bonsergent,OUI,34,7,27,19,8,OUI,OUI,2025-03-13 16:02:10+00:00,"48.870948218595, 2.3612049221992",Paris,75056,0.7941176470588235,16
14030,Pernety - Raymond Losserand,OUI,32,31,1,0,1,OUI,OUI,2025-03-13 16:01:42+00:00,"48.834254627953, 2.317609339387",Paris,75056,0.03125,16
16043,Place de Passy,OUI,12,8,4,1,3,OUI,OUI,2025-03-13 16:00:24+00:00,"48.85780291711202, 2.277500546942199",Paris,75056,0.3333333333333333,16
20201,Eugène Reisz - Davout,OUI,20,19,1,0,1,OUI,OUI,2025-03-13 15:55:55+00:00,"48.85631874632638, 2.410396970808506",Paris,75056,0.05,16
16027,Mozart - Jasmin,OUI,62,57,5,3,2,OUI,OUI,2025-03-13 15:58:06+00:00,"48.85286124871689, 2.268483570651513",Paris,75056,0.08064516129032258,16
13046,Eugène Oudiné - Dessous Des Berges,OUI,44,20,24,18,6,OUI,OUI,2025-03-13 16:01:43+00:00,"48.8256423, 2.3750226",Paris,75056,0.5454545454545454,16
8019,Naples - Rome,OUI,25,21,4,0,4,OUI,OUI,2025-03-13 16:01:57+00:00,"48.879960700846226, 2.321358695626259",Paris,75056,0.16,16
22102,Mont Valérien - Michel Salles,OUI,24,7,17,12,5,OUI,OUI,2025-03-13 16:00:24+00:00,"48.8561915, 2.2152966",Saint-Cloud,92064,0.7083333333333334,16
9017,Lallier - Trudaine,OUI,28,25,3,1,2,OUI,OUI,2025-03-13 16:00:41+00:00,"48.88109246617963, 2.3408224806189537",Paris,75056,0.10714285714285714,16
4110,Neuve Saint-Pierre - Beautreillis,OUI,20,8,12,8,4,OUI,OUI,2025-03-13 16:02:04+00:00,"48.85355351439652, 2.3639122769236565",Paris,75056,0.6,16
16112,Chernoviz - Raynouard,OUI,36,28,8,1,7,OUI,OUI,2025-03-13 16:01:25+00:00,"48.8569864146289, 2.282173218142987",Paris,75056,0.2222222222222222,16
17022,Pereire - Place de Wagram,OUI,45,40,5,3,2,OUI,OUI,2025-03-13 16:00:30+00:00,"48.887070607581215, 2.304111124531457",Paris,75056,0.1111111111111111,16
42703,Fontainebleau - Edmond Michelet,OUI,45,43,2,0,2,OUI,OUI,2025-03-13 15:58:19+00:00,"48.80956436844049, 2.3626908659935",Le Kremlin-Bicêtre,94043,0.044444444444444446,16
7020,Champ de Mars - Cler,OUI,39,20,19,19,0,OUI,OUI,2025-03-13 16:01:23+00:00,"48.856691550115315, 2.306646779179573",Paris,75056,0.48717948717948717,16
15003,Gare Montparnasse - Vaugirard,OUI,65,40,25,4,21,OUI,OUI,2025-03-13 16:01:12+00:00,"48.8418071798797, 2.31951002690117",Paris,75056,0.38461538461538464,16
10036,Aqueduc - Villette,OUI,24,23,1,0,1,OUI,OUI,2025-03-13 15:59:25+00:00,"48.883886063895, 2.367198803315",Paris,75056,0.041666666666666664,16
6032,Sabot - Rennes,OUI,25,6,19,15,4,OUI,OUI,2025-03-13 16:02:12+00:00,"48.852575112948415, 2.331552766263485",Paris,75056,0.76,16
6017,Sénat - Condé,OUI,31,2,29,19,10,OUI,OUI,2025-03-13 16:01:33+00:00,"48.84954227788459, 2.337939441204071",Paris,75056,0.9354838709677419,16
23304,Mairie de Sceaux,OUI,33,31,2,1,1,OUI,OUI,2025-03-13 16:02:11+00:00,"48.778916905132, 2.2887361764861",Sceaux,92071,0.06060606060606061,16
13103,Hôpital Pitié Salpêtrière,OUI,48,43,5,0,5,OUI,OUI,2025-03-13 15:58:29+00:00,"48.8377016, 2.3604946",Paris,75056,0.10416666666666667,16
12161,Diderot - Reuilly,OUI,44,9,35,34,1,OUI,OUI,2025-03-13 16:02:07+00:00,"48.847208456061, 2.3861273378134",Paris,75056,0.7954545454545454,16
18017,Caulaincourt - Place Constantin Pecqueur,OUI,42,41,1,0,1,OUI,OUI,2025-03-13 16:00:47+00:00,"48.889677905028, 2.3381787144261",Paris,75056,0.023809523809523808,16
15107,Palais des Sports,OUI,20,2,18,17,1,OUI,OUI,2025-03-13 16:01:20+00:00,"48.833468517426, 2.2858720645308",Paris,75056,0.9,16
11043,Place Pasdeloup,OUI,20,8,12,11,1,OUI,OUI,2025-03-13 16:00:48+00:00,"48.862654215631, 2.3670325062844",Paris,75056,0.6,16
9101,Cadet - La Fayette,OUI,18,6,12,10,2,OUI,OUI,2025-03-13 16:02:02+00:00,"48.875601632672, 2.3435704037547",Paris,75056,0.6666666666666666,16
1117,Pont Neuf - Rivoli,OUI,25,2,23,14,9,OUI,OUI,2025-03-13 15:57:43+00:00,"48.860089892617, 2.344057559967",Paris,75056,0.92,16
19041,Belleville - Pyrénées,OUI,38,35,3,0,3,OUI,OUI,2025-03-13 15:59:23+00:00,"48.8741908, 2.3860039",Paris,75056,0.07894736842105263,16
13010,Place d'Italie - Vincent Auriol,OUI,39,34,5,1,4,OUI,OUI,2025-03-13 16:02:05+00:00,"48.831481874467, 2.3567550292319",Paris,75056,0.1282051282051282,16
23903,Stade Gaston Bouillant,OUI,29,24,5,3,2,OUI,OUI,2025-03-13 15:59:55+00:00,"48.939958667023, 2.3279571813836",Villeneuve-la-Garenne,92078,0.1724137931034483,16
31704,Jeanne Hornet - Girardot,OUI,28,28,0,0,0,OUI,OUI,2025-03-13 15:53:41+00:00,"48.873802681432146, 2.427820265293122",Bagnolet,93006,0.0,16
23403,Chateau,OUI,21,18,3,2,1,OUI,OUI,2025-03-13 16:02:00+00:00,"48.774661399959, 2.3135878035462",Bourg-la-Reine,92014,0.14285714285714285,16
32603,Calmette,OUI,31,30,1,1,0,OUI,OUI,2025-03-13 16:02:08+00:00,"48.88104925098552, 2.424993216991425",Les Lilas,93045,0.03225806451612903,16
4013,Vieille du Temple - Francs Bourgeois,OUI,28,2,26,24,2,OUI,OUI,2025-03-13 16:01:56+00:00,"48.858256413365815, 2.35821794718504",Paris,75056,0.9285714285714286,16
17201,Porte Maillot - Perreire,OUI,50,25,25,9,16,OUI,OUI,2025-03-13 16:01:17+00:00,"48.878021154637, 2.2842371277102",Paris,75056,0.5,16
21024,Billancourt - Général Leclerc,OUI,22,22,0,0,0,OUI,OUI,2025-03-13 16:01:53+00:00,"48.8322649, 2.2380413",Boulogne-Billancourt,92012,0.0,16
21311,Parvis Corentin Celton,OUI,52,15,37,36,1,OUI,OUI,2025-03-13 15:58:34+00:00,"48.82747252522725, 2.2784319519996648",Issy-les-Moulineaux,92040,0.7115384615384616,16
2001,Greneta - Sebastopol,OUI,32,1,31,28,3,OUI,OUI,2025-03-13 16:01:04+00:00,"48.865242333228, 2.3516669869423",Paris,75056,0.96875,16
15059,Parc André Citroën,OUI,64,6,58,53,5,OUI,OUI,2025-03-13 16:02:07+00:00,"48.840639944296655, 2.2780618071556096",Paris,75056,0.90625,16
20019,Place du Maquis du Vercors,OUI,30,30,0,0,0,OUI,OUI,2025-03-13 16:01:10+00:00,"48.877321579493575, 2.4083782732486725",Paris,75056,0.0,16
45001,Hôtel de Ville de Champigny sur Marne,OUI,21,4,17,9,8,OUI,OUI,2025-03-13 16:02:09+00:00,"48.813810628405, 2.5096759200096",Champigny-sur-Marne,94017,0.8095238095238095,16
18137,Poissonniers - Nord,OUI,27,26,1,1,0,OUI,OUI,2025-03-13 16:02:07+00:00,"48.892511213520656, 2.3522228747606277",Paris,75056,0.037037037037037035,16
31023,Place François Mitterand,OUI,34,32,2,0,2,OUI,OUI,2025-03-13 15:58:17+00:00,"48.86492782016328, 2.442958317697048",Montreuil,93048,0.058823529411764705,16
8056,Beaujon - Wagram,OUI,28,27,1,0,1,OUI,OUI,2025-03-13 15:55:49+00:00,"48.875352455985, 2.2964416444302",Paris,75056,0.03571428571428571,16
9118,Faubourg Poissonniere - Delta,OUI,36,35,1,0,1,OUI,OUI,2025-03-13 16:00:46+00:00,"48.882555807626765, 2.3497482016682625",Paris,75056,0.027777777777777776,16
13041,Porte d'Ivry,OUI,50,45,5,1,4,OUI,OUI,2025-03-13 16:00:28+00:00,"48.821768747596, 2.3688706755638",Paris,75056,0.1,16
10163,Gare du Nord - Demarquay,OUI,28,21,7,1,6,OUI,OUI,2025-03-13 16:00:18+00:00,"48.881154, 2.358411",Paris,75056,0.25,16
7016,Surcouf - Université,OUI,56,19,37,31,6,OUI,OUI,2025-03-13 16:02:15+00:00,"48.861273016278, 2.3094535509142",Paris,75056,0.6607142857142857,16
19023,Manin - Simon Bolivar,OUI,24,22,2,0,2,OUI,OUI,2025-03-13 15:59:14+00:00,"48.876499654127, 2.3794073625991",Paris,75056,0.08333333333333333,16
12108,Bercy.,OUI,63,13,50,43,7,OUI,OUI,2025-03-13 16:00:07+00:00,"48.839966914994, 2.3788625746965",Paris,75056,0.7936507936507936,16
7101,Raspail - Chomel,OUI,49,13,36,27,9,OUI,OUI,2025-03-13 16:01:50+00:00,"48.852233164303, 2.3266580700874",Paris,75056,0.7346938775510204,16
18019,Square Raymond Souplex,OUI,51,49,2,0,2,OUI,OUI,2025-03-13 15:59:52+00:00,"48.89183721478911, 2.335426103165901",Paris,75056,0.0392156862745098,16
17116,Reims - Porte d'Asnières,OUI,26,22,4,3,1,OUI,OUI,2025-03-13 15:58:26+00:00,"48.891834448210986, 2.300144659954865",Paris,75056,0.15384615384615385,16
41206,Place des Larris,OUI,34,29,5,1,4,OUI,OUI,2025-03-13 15:59:37+00:00,"48.8568363, 2.4780236",Fontenay-sous-Bois,94033,0.14705882352941177,16
18138,Station Paris Basketball - Ney - Charles Hermite,OUI,20,15,5,3,2,OUI,OUI,2025-03-13 16:01:28+00:00,"48.898748039775, 2.3645754531026",Paris,75056,0.25,16
13113,Vistule - Choisy,OUI,33,29,4,3,1,OUI,OUI,2025-03-13 16:00:41+00:00,"48.82365543660611, 2.3615723848342896",Paris,75056,0.12121212121212122,16
4011,Hôtel de Ville - Pont-Marie,OUI,33,1,32,28,4,OUI,OUI,2025-03-13 16:01:52+00:00,"48.853899645527, 2.3569472506642",Paris,75056,0.9696969696969697,16
19031,Manin - Crimée,OUI,21,21,0,0,0,OUI,OUI,2025-03-13 15:55:09+00:00,"48.8831217743719, 2.3863670602440834",Paris,75056,0.0,16
12041,Bois de Vincennes.,OUI,58,47,11,5,6,OUI,OUI,2025-03-13 15:52:58+00:00,"48.8338064, 2.4132221",Saint-Mandé,94067,0.1896551724137931,16
13114,Nationale - Marcel Duchamp,OUI,23,20,3,1,2,OUI,OUI,2025-03-13 15:57:13+00:00,"48.82463749337136, 2.3678014799952507",Paris,75056,0.13043478260869565,16
14006,Saint-Jacques - Tombe Issoire,OUI,20,16,4,1,3,OUI,OUI,2025-03-13 16:00:02+00:00,"48.833206330538864, 2.3369108140468597",Paris,75056,0.2,16
15061,Square Desnouettes,OUI,21,8,13,10,3,OUI,OUI,2025-03-13 16:01:58+00:00,"48.83476837934194, 2.284142297394666",Paris,75056,0.6190476190476191,16
7013,Duroc - Place de Breteuil,OUI,46,21,25,22,3,OUI,OUI,2025-03-13 16:01:56+00:00,"48.847460641142, 2.3126140236855",Paris,75056,0.5434782608695652,16
20017,Saint-Blaise - Mouraud,OUI,27,26,1,0,1,OUI,OUI,2025-03-13 15:57:08+00:00,"48.85696177597818, 2.40869477391243",Paris,75056,0.037037037037037035,16
21114,Gustave Eiffel - Parc des Impressionnistes,OUI,30,22,8,6,2,OUI,OUI,2025-03-13 15:57:46+00:00,"48.90390619651018, 2.2946908324956894",Clichy,92024,0.26666666666666666,16
11019,Charonne - Philippe-Auguste,OUI,30,27,3,1,2,OUI,OUI,2025-03-13 15:58:34+00:00,"48.855603162026, 2.39054639062",Paris,75056,0.1,16
31013,Centenaire - Sorins,OUI,42,39,3,0,3,OUI,OUI,2025-03-13 15:59:07+00:00,"48.85853523359734, 2.4273508787155156",Montreuil,93048,0.07142857142857142,16
21108,Mairie de Clichy,OUI,44,37,7,5,2,OUI,OUI,2025-03-13 16:02:15+00:00,"48.903653634661, 2.3059353232384",Clichy,92024,0.1590909090909091,16
32018,Franciade - Gabriel Péri,OUI,26,19,7,6,1,OUI,OUI,2025-03-13 15:58:06+00:00,"48.93261499331498, 2.355954498052597",Saint-Denis,93066,0.2692307692307692,16
14116,Romain Rolland,OUI,25,22,3,1,2,OUI,OUI,2025-03-13 16:00:03+00:00,"48.820215229662765, 2.3234144234418346",Montrouge,92049,0.12,16
17016,Brochant - Square des Batignolles,OUI,31,28,3,2,1,OUI,OUI,2025-03-13 15:59:51+00:00,"48.88818698581028, 2.316861143151153",Paris,75056,0.0967741935483871,16
47002,Les Juilliottes,OUI,21,7,14,9,5,OUI,OUI,2025-03-13 15:54:14+00:00,"48.8043072, 2.4437362",Maisons-Alfort,94046,0.6666666666666666,16
20202,Dupont de l'Eure - Gambetta,OUI,29,27,2,0,2,OUI,OUI,2025-03-13 16:01:45+00:00,"48.8679385, 2.4003649",Paris,75056,0.06896551724137931,16
33005,République - Henri Barbusse,OUI,32,18,14,9,5,OUI,OUI,2025-03-13 16:01:27+00:00,"48.90661553626751, 2.389432489871979",Aubervilliers,93001,0.4375,16
2110,Jeûneurs - Mulhouse,OUI,27,17,10,7,3,OUI,OUI,2025-03-13 16:01:16+00:00,"48.868997, 2.346925",Paris,75056,0.37037037037037035,16
11003,Keller - La Roquette,OUI,34,22,12,9,3,OUI,OUI,2025-03-13 16:00:53+00:00,"48.8555508, 2.3752778",Paris,75056,0.35294117647058826,16
7026,Place de Finlande,OUI,24,3,21,16,5,OUI,OUI,2025-03-13 15:57:05+00:00,"48.862408335967, 2.3113624379039",Paris,75056,0.875,16
11034,Parmentier - Fontaine au Roi,OUI,45,35,10,6,4,OUI,OUI,2025-03-13 16:00:16+00:00,"48.86787670551736, 2.372705978671471",Paris,75056,0.2222222222222222,16
1016,Thérèse - Opéra,OUI,24,1,23,21,2,OUI,OUI,2025-03-13 16:01:49+00:00,"48.866483514509, 2.3344334212238",Paris,75056,0.9583333333333334,16
9012,Rougemont - Poissonnière,OUI,30,4,26,16,10,OUI,OUI,2025-03-13 16:02:07+00:00,"48.871611569354755, 2.345873080193996",Paris,75056,0.8666666666666667,16
17033,Carnot - Général Lanrezac,OUI,29,24,5,2,3,OUI,OUI,2025-03-13 15:58:17+00:00,"48.875443870736, 2.2938242935036",Paris,75056,0.1724137931034483,16
15020,Mairie du 15ème,OUI,31,30,1,1,0,OUI,OUI,2025-03-13 15:58:52+00:00,"48.8417762, 2.2986539",Paris,75056,0.03225806451612903,16
14007,Ferrus - Saint-Jacques,OUI,33,30,3,2,1,OUI,OUI,2025-03-13 16:02:15+00:00,"48.8313878, 2.3408563",Paris,75056,0.09090909090909091,16
23008,Hôtel de Ville de Levallois Perret,OUI,25,10,15,14,1,OUI,OUI,2025-03-13 15:58:12+00:00,"48.89314451997415, 2.2888818383216862",Levallois-Perret,92044,0.6,16
11107,Faidherbe - Dahomey,OUI,41,21,20,17,3,OUI,OUI,2025-03-13 16:00:42+00:00,"48.851358329771806, 2.383823134795429",Paris,75056,0.4878048780487805,16
8015,Roquépine - Malesherbes,OUI,52,12,40,27,13,OUI,OUI,2025-03-13 16:02:16+00:00,"48.87345073390807, 2.320404499769211",Paris,75056,0.7692307692307693,16
9113,Bleue - Trévise,OUI,27,10,17,10,7,OUI,OUI,2025-03-13 16:01:20+00:00,"48.87578906564573, 2.347289621829987",Paris,75056,0.6296296296296297,16
6014,Pont de Lodi - Dauphine,OUI,21,3,18,12,6,OUI,OUI,2025-03-13 16:00:49+00:00,"48.855296898603285, 2.339947307565249",Paris,75056,0.8571428571428571,16
11048,Place Mireille Havet,OUI,40,8,32,28,4,OUI,OUI,2025-03-13 16:01:56+00:00,"48.850533, 2.383756",Paris,75056,0.8,16
31018,Gambetta - Michelet,OUI,30,28,2,1,1,OUI,OUI,2025-03-13 16:01:51+00:00,"48.85273792380526, 2.429966032505036",Montreuil,93048,0.06666666666666667,16
12154,Square Georges Melies,OUI,38,25,13,7,6,OUI,OUI,2025-03-13 15:58:30+00:00,"48.84070239213081, 2.409667745232582",Paris,75056,0.34210526315789475,16
5019,Poissy - Saint-Germain,OUI,24,8,16,15,1,OUI,OUI,2025-03-13 15:59:21+00:00,"48.84969649427, 2.3529685288668",Paris,75056,0.6666666666666666,16
22017,Charles de Gaulle - Louis Philippe,OUI,26,20,6,3,3,OUI,OUI,2025-03-13 16:01:36+00:00,"48.881742142181, 2.2710045335353",Neuilly-sur-Seine,92051,0.23076923076923078,16
10164,Claude Vellefaux - Sambre et Meuse,OUI,32,30,2,1,1,OUI,OUI,2025-03-13 15:57:40+00:00,"48.875022, 2.370478",Paris,75056,0.0625,16
19021,Mairie du 19ème,OUI,24,20,4,2,2,OUI,OUI,2025-03-13 16:01:26+00:00,"48.88256264247959, 2.3812624812126164",Paris,75056,0.16666666666666666,16
20103,Le Vau - Maurice Bertaux,OUI,23,23,0,0,0,OUI,OUI,2025-03-13 15:55:34+00:00,"48.86803439043193, 2.411030612453627",Paris,75056,0.0,16
17104,Jardin Marguerite Long,OUI,21,13,8,2,6,OUI,OUI,2025-03-13 16:01:43+00:00,"48.8816985773914, 2.2836575657129288",Paris,75056,0.38095238095238093,16
2014,Daunou - Louis le Grand,OUI,30,10,20,7,13,OUI,OUI,2025-03-13 16:01:48+00:00,"48.869113, 2.332515",Paris,75056,0.6666666666666666,16
19030,Melun - Jean Jaurès,OUI,27,24,3,2,1,OUI,OUI,2025-03-13 16:01:23+00:00,"48.8837796723475, 2.376477420330048",Paris,75056,0.1111111111111111,16
4109,Mornay - Sully,OUI,13,9,4,3,1,OUI,OUI,2025-03-13 15:57:01+00:00,"48.84970399548416, 2.364460788667202",Paris,75056,0.3076923076923077,16
21004,Jean Jaurès - Reine,OUI,31,6,25,22,3,OUI,OUI,2025-03-13 15:59:26+00:00,"48.84009622558849, 2.239872515201569",Boulogne-Billancourt,92012,0.8064516129032258,16
3101,Porte Saint-Martin,OUI,30,7,23,20,3,OUI,OUI,2025-03-13 16:01:30+00:00,"48.86860172112996, 2.35570102930069",Paris,75056,0.7666666666666667,16
35008,Place de l'Eglise - Pantin,OUI,28,28,0,0,0,OUI,OUI,2025-03-13 16:00:57+00:00,"48.892809461520265, 2.4124351143836975",Pantin,93055,0.0,16
8105,François 1er - Lincoln,OUI,29,7,22,0,22,OUI,OUI,2025-03-13 16:02:11+00:00,"48.869517979344, 2.3024262188416",Paris,75056,0.7586206896551724,16
13022,Butte aux Cailles - Esperance,OUI,30,25,5,2,3,OUI,OUI,2025-03-13 15:59:56+00:00,"48.82758774190948, 2.3492151126265526",Paris,75056,0.16666666666666666,16
15058,Place du Moulin de Javel,OUI,53,15,38,34,4,OUI,OUI,2025-03-13 16:01:22+00:00,"48.84021670922, 2.2716060653329",Paris,75056,0.7169811320754716,16
20045,Louis Ganne - Davout,OUI,30,30,0,0,0,OUI,OUI,2025-03-13 15:59:36+00:00,"48.86338720692607, 2.409725748002529",Paris,75056,0.0,16
2101,Bachaumont - Montmartre,OUI,33,7,26,26,0,OUI,OUI,2025-03-13 15:58:47+00:00,"48.86617395079137, 2.3449775576591496",Paris,75056,0.7878787878787878,16
11044,Square du Bataclan,OUI,18,3,15,12,3,OUI,OUI,2025-03-13 16:00:00+00:00,"48.8633762, 2.3711327",Paris,75056,0.8333333333333334,16
8049,Georges V - François 1er,OUI,21,8,13,4,9,OUI,OUI,2025-03-13 16:02:12+00:00,"48.87034, 2.30082",Paris,75056,0.6190476190476191,16
5030,Sorbonne - Ecoles,OUI,47,26,21,2,19,OUI,OUI,2025-03-13 16:01:58+00:00,"48.849686566191, 2.3434996604919",Paris,75056,0.44680851063829785,16
22002,Argenson - Château,OUI,24,6,18,15,3,OUI,OUI,2025-03-13 16:01:54+00:00,"48.888559314669514, 2.2642001509666447",Neuilly-sur-Seine,92051,0.75,16
21952,Place Tony de Graaff,OUI,42,18,24,20,4,OUI,OUI,2025-03-13 15:59:09+00:00,"48.8181645, 2.2458109",Meudon,92048,0.5714285714285714,16
13019,Fernand Braudel - Vincent Auriol,OUI,36,9,27,22,5,OUI,OUI,2025-03-13 16:01:29+00:00,"48.83637852318147, 2.3723404482007027",Paris,75056,0.75,16
9015,Lamartine - Faubourg Montmartre,OUI,30,21,9,6,3,OUI,OUI,2025-03-13 16:02:12+00:00,"48.876613982891, 2.3397656902671",Paris,75056,0.3,16
16041,Versailles - Claude Terrasse,OUI,44,17,27,25,2,OUI,OUI,2025-03-13 16:00:50+00:00,"48.840219338074, 2.263834191153",Paris,75056,0.6136363636363636,16
8029,Place du Canada,OUI,56,10,46,26,20,OUI,OUI,2025-03-13 16:01:44+00:00,"48.865346269363, 2.3101937879648",Paris,75056,0.8214285714285714,16
12120,Lac Daumesnil - Saint-Maurice,OUI,49,38,11,8,3,OUI,OUI,2025-03-13 15:57:20+00:00,"48.82774555743318, 2.4183654785156246",Paris,75056,0.22448979591836735,16
11110,Roquette - Folie Regnault,OUI,50,40,10,0,10,OUI,OUI,2025-03-13 16:00:47+00:00,"48.859246959155485, 2.386553623578705",Paris,75056,0.2,16
22012,Madeleine Michelis - Roule,OUI,23,12,11,8,3,OUI,OUI,2025-03-13 15:57:14+00:00,"48.88260431301364, 2.2773634269833565",Neuilly-sur-Seine,92051,0.4782608695652174,16
16031,Vignes - Boulainvilliers,OUI,20,19,1,0,1,OUI,OUI,2025-03-13 15:56:37+00:00,"48.856399483950504, 2.275240458548069",Paris,75056,0.05,16
18142,Jessaint - Marx Dormoy,OUI,29,29,0,0,0,OUI,OUI,2025-03-13 16:02:10+00:00,"48.88484543106364, 2.358930408954621",Paris,75056,0.0,16
12153,Terroirs de France - Lheureux,OUI,55,22,33,19,14,OUI,OUI,2025-03-13 16:02:01+00:00,"48.83212027074841, 2.388618104159832",Paris,75056,0.6,16
18035,René Binet - Porte de Montmartre,OUI,36,33,3,0,3,OUI,OUI,2025-03-13 16:01:02+00:00,"48.89905109950848, 2.3365534096956253",Paris,75056,0.08333333333333333,16
17005,Brochant - Clichy,OUI,52,45,7,1,6,OUI,OUI,2025-03-13 15:59:57+00:00,"48.89032998912038, 2.319730559929781",Paris,75056,0.1346153846153846,16
23005,Gare de Clichy-Levallois,OUI,25,5,20,17,3,OUI,OUI,2025-03-13 16:01:54+00:00,"48.89679827481989, 2.2984680533409123",Levallois-Perret,92044,0.8,16
21017,Place Marcel Sembat,OUI,55,6,49,43,6,OUI,OUI,2025-03-13 16:01:26+00:00,"48.83328865030686, 2.2441747784614567",Boulogne-Billancourt,92012,0.8909090909090909,16
21120,Docteur Calmette - Martre,OUI,30,27,3,2,1,OUI,OUI,2025-03-13 15:56:38+00:00,"48.898969358483, 2.3086513252383",Clichy,92024,0.1,16
14127,Odessa - Départ,OUI,39,30,9,4,5,OUI,OUI,2025-03-13 16:00:10+00:00,"48.842885590081, 2.3244281485677",Paris,75056,0.23076923076923078,16
21009,Le Corbusier - Jean Jaurès,OUI,45,16,29,21,8,OUI,OUI,2025-03-13 15:59:28+00:00,"48.83780830557548, 2.2408381104469304",Boulogne-Billancourt,92012,0.6444444444444445,16
14016,René Coty - Parc Montsouris,OUI,54,48,6,2,4,OUI,OUI,2025-03-13 15:56:27+00:00,"48.82479134498032, 2.336124926805496",Paris,75056,0.1111111111111111,16
13047,Boutroux - Porte de Vitry,OUI,49,27,22,19,3,OUI,OUI,2025-03-13 16:02:15+00:00,"48.822632, 2.377738",Paris,75056,0.4489795918367347,16
12033,François Truffaut - Saint Emilion,OUI,66,13,53,49,4,OUI,OUI,2025-03-13 16:01:31+00:00,"48.83372354344807, 2.386601903271428",Paris,75056,0.803030303030303,16
44103,Pont De Charenton,OUI,18,5,13,13,0,OUI,OUI,2025-03-13 15:54:43+00:00,"48.8179685, 2.4199531",Saint-Maurice,94069,0.7222222222222222,16
13110,Moulin de la Pointe,OUI,21,18,3,0,3,OUI,OUI,2025-03-13 15:59:48+00:00,"48.82092946051445, 2.3563179373741145",Paris,75056,0.14285714285714285,16
42004,Westermeyer - Paul Vaillant-Couturier,OUI,27,12,15,13,2,OUI,OUI,2025-03-13 16:01:59+00:00,"48.819116181578764, 2.3966637253761296",Ivry-sur-Seine,94041,0.5555555555555556,16
23105,Sèvres Rive Gauche,OUI,33,21,12,12,0,OUI,OUI,2025-03-13 15:56:24+00:00,"48.821443218278, 2.2150785306885",Sèvres,92072,0.36363636363636365,16
19113,Pré Saint-Gervais - Lilas,OUI,27,22,5,0,5,OUI,OUI,2025-03-13 15:58:56+00:00,"48.877870626988, 2.3959073424339",Paris,75056,0.18518518518518517,16
15009,Suffren - Pérignon,OUI,45,6,39,29,10,OUI,OUI,2025-03-13 16:01:44+00:00,"48.84717561492764, 2.307052147596786",Paris,75056,0.8666666666666667,16
10039,Sambre et Meuse - Villette,OUI,24,18,6,0,6,OUI,OUI,2025-03-13 16:00:01+00:00,"48.874405666217, 2.3738072379951",Paris,75056,0.25,16
20117,Saint-Fargeau - Mortier,OUI,31,31,0,0,0,OUI,OUI,2025-03-13 15:54:42+00:00,"48.87266656122256, 2.407912909984589",Paris,75056,0.0,16
31101,Jules Guesde - Laennec,OUI,19,15,4,0,4,OUI,OUI,2025-03-13 15:57:25+00:00,"48.87628983900398, 2.5006942078471184",Rosny-sous-Bois,93064,0.21052631578947367,16
48009,République - Auguste Perret,OUI,30,29,1,1,0,OUI,OUI,2025-03-13 15:58:05+00:00,"48.78695280952244, 2.3518594354391094",Villejuif,94076,0.03333333333333333,16
12129,Bois de Vincennes - Porte Jaune,OUI,35,30,5,3,2,OUI,OUI,2025-03-13 16:00:56+00:00,"48.838751246689455, 2.4605489149689674",Paris,75056,0.14285714285714285,16
14125,Dareau - Broussais,OUI,21,19,2,1,1,OUI,OUI,2025-03-13 16:00:08+00:00,"48.8307758, 2.3361804",Paris,75056,0.09523809523809523,16
31707,Edouard Vaillant - Galliéni,OUI,48,47,1,0,1,OUI,OUI,2025-03-13 15:56:56+00:00,"48.858462881661, 2.4147954583168",Bagnolet,93006,0.020833333333333332,16
31017,Jean Moulin - Paul Doumer,OUI,17,15,2,0,2,OUI,OUI,2025-03-13 15:59:44+00:00,"48.8622179854695, 2.45533436536789",Montreuil,93048,0.11764705882352941,16
13020,Paul Klee - Place Augusta Holmes,OUI,43,20,23,5,18,OUI,OUI,2025-03-13 16:01:17+00:00,"48.838946417408025, 2.3704235663952966",Paris,75056,0.5348837209302325,16
18114,Véron - Lepic,OUI,23,23,0,0,0,OUI,OUI,2025-03-13 16:01:51+00:00,"48.88526123395252, 2.334559857845307",Paris,75056,0.0,16
7010,Constantine - Université,OUI,59,13,46,43,3,OUI,OUI,2025-03-13 16:01:24+00:00,"48.860680473738, 2.3148481955842",Paris,75056,0.7796610169491526,16
4107,Beaumarchais - Pas de la Mule,OUI,16,8,8,4,4,OUI,OUI,2025-03-13 16:00:30+00:00,"48.855580507049, 2.3684333673431",Paris,75056,0.5,16
14113,Santé - Arago,OUI,36,33,3,1,2,OUI,OUI,2025-03-13 15:56:15+00:00,"48.83507657562064, 2.3415737262044938",Paris,75056,0.08333333333333333,16
22403,Pierre Brossolette - Adolphe Pinard,OUI,23,21,2,2,0,OUI,OUI,2025-03-13 16:01:32+00:00,"48.821772279548, 2.3131558299065",Malakoff,92046,0.08695652173913043,16
35015,Averroès - Aimé Césaire,OUI,18,15,3,1,2,OUI,OUI,2025-03-13 15:55:50+00:00,"48.91405323432864, 2.412636950612068",Pantin,93055,0.16666666666666666,16
42011,Quai Marcel Boyer - Victor Hugo,OUI,29,11,18,15,3,OUI,OUI,2025-03-13 16:01:16+00:00,"48.822556366667, 2.3920395970345",Ivry-sur-Seine,94041,0.6206896551724138,16
15019,Paul Barruel - Vaugirard,OUI,36,33,3,1,2,OUI,OUI,2025-03-13 16:02:01+00:00,"48.84014918546239, 2.3044332861900334",Paris,75056,0.08333333333333333,16
20047,Cours de Vincennes - Davout,OUI,48,45,3,1,2,OUI,OUI,2025-03-13 15:57:38+00:00,"48.847238029966, 2.4107042336225",Paris,75056,0.0625,16
13515,Auguste Blanqui - Glacière,OUI,59,55,4,1,3,OUI,OUI,2025-03-13 16:01:21+00:00,"48.831151602964, 2.343822196126",Paris,75056,0.06779661016949153,16
9013,Mairie du 9ème,OUI,24,3,21,12,9,OUI,OUI,2025-03-13 16:01:49+00:00,"48.873267137583, 2.3407534480528",Paris,75056,0.875,16
10152,Gare du Nord - Place de Valenciennes,OUI,23,12,11,7,4,OUI,OUI,2025-03-13 16:02:13+00:00,"48.879089, 2.354235",Paris,75056,0.4782608695652174,16
21951,Place Centrale,OUI,22,20,2,1,1,OUI,OUI,2025-03-13 15:54:34+00:00,"48.78740167690531, 2.2278830409049992",Meudon,92048,0.09090909090909091,16
9036,Athènes - Clichy,OUI,18,10,8,4,4,OUI,OUI,2025-03-13 15:58:49+00:00,"48.878113787876, 2.32956021945824",Paris,75056,0.4444444444444444,16
92005,Gare de Nanterre Ville,OUI,42,20,22,18,4,OUI,OUI,2025-03-13 16:01:25+00:00,"48.8950295, 2.1957932",Nanterre,92050,0.5238095238095238,16
15125,Parc Suzanne Lenglen,OUI,51,3,48,47,1,OUI,OUI,2025-03-13 16:01:53+00:00,"48.833250690537874, 2.2765403240919113",Paris,75056,0.9411764705882353,16
22103,Senard - Charles Blum,OUI,24,5,19,6,13,OUI,OUI,2025-03-13 15:59:50+00:00,"48.857315824799, 2.221091687679291",Saint-Cloud,92064,0.7916666666666666,16
13027,Mazagran - Pierre de Coubertin,OUI,15,9,6,3,3,OUI,OUI,2025-03-13 15:59:37+00:00,"48.816218640260445, 2.344226874411106",Paris,75056,0.4,16
14128,Gergovie - Vercingétorix,OUI,29,24,5,1,4,OUI,OUI,2025-03-13 16:02:09+00:00,"48.83453413883994, 2.313154547426182",Paris,75056,0.1724137931034483,16
11103,Pelée - Alphonse Baudin,OUI,35,22,13,7,6,OUI,OUI,2025-03-13 16:01:08+00:00,"48.8600265, 2.3710541",Paris,75056,0.37142857142857144,16
19036,Hôpital Robert Debré,OUI,33,31,2,0,2,OUI,OUI,2025-03-13 16:00:15+00:00,"48.88005222200894, 2.4008650346327003",Paris,75056,0.06060606060606061,16
20039,Belleville - Couronnes,OUI,48,41,7,1,6,OUI,OUI,2025-03-13 15:56:30+00:00,"48.868831082877, 2.3809862136841",Paris,75056,0.14583333333333334,16
31026,Demi-Lune - Aristide Briand,OUI,20,18,2,0,2,OUI,OUI,2025-03-13 16:00:50+00:00,"48.87626381919953, 2.4562818557024",Montreuil,93048,0.1,16
5034,Censier - Santeuil,OUI,65,27,38,35,3,OUI,OUI,2025-03-13 16:00:02+00:00,"48.840658921385234, 2.3537524044513702",Paris,75056,0.5846153846153846,16
17001,Guy Môquet - Saint-Ouen,OUI,44,40,4,2,2,OUI,OUI,2025-03-13 16:01:00+00:00,"48.892777719023975, 2.3270335793495183",Paris,75056,0.09090909090909091,16
16007,Longchamp - Place d'Iéna,OUI,24,14,10,1,9,OUI,OUI,2025-03-13 16:02:08+00:00,"48.864917233434, 2.2926748171449",Paris,75056,0.4166666666666667,16
35004,Place du Président Salvador Allende,OUI,58,54,4,0,4,OUI,OUI,2025-03-13 15:58:36+00:00,"48.897307310356055, 2.40079153681279",Pantin,93055,0.06896551724137931,16
10110,Louis Blanc - Jemmapes,OUI,31,21,10,2,8,OUI,OUI,2025-03-13 15:56:29+00:00,"48.879330755297, 2.3684485629201",Paris,75056,0.3225806451612903,16
8011,Clapeyron - Moscou,OUI,15,13,2,2,0,OUI,OUI,2025-03-13 15:59:11+00:00,"48.88078819514121, 2.324815057218075",Paris,75056,0.13333333333333333,16
21115,Chancé Milly - Cimetière Communal Sud,OUI,32,16,16,14,2,OUI,OUI,2025-03-13 16:00:55+00:00,"48.89687189382465, 2.303922325372696",Clichy,92024,0.5,16
19124,Alexander Fleming - Belvédère,OUI,31,30,1,0,1,OUI,OUI,2025-03-13 16:00:41+00:00,"48.88179064200294, 2.4030599377642674",Paris,75056,0.03225806451612903,16
21708,Marcel Yol - Jullien,OUI,28,28,0,0,0,OUI,OUI,2025-03-13 15:59:06+00:00,"48.82537611802588, 2.287235018058929",Vanves,92075,0.0,16
32021,Place du Front Populaire - George Sand,OUI,64,41,23,16,7,OUI,OUI,2025-03-13 16:01:26+00:00,"48.90680713698062, 2.364541214992642",Saint-Denis,93066,0.359375,16
41210,Hôtel de ville de Fontenay-sous-Bois,OUI,19,16,3,0,3,OUI,OUI,2025-03-13 15:55:24+00:00,"48.84949749106274, 2.4750164151191716",Fontenay-sous-Bois,94033,0.15789473684210525,16
20203,Evariste Galois,OUI,20,20,0,0,0,OUI,OUI,2025-03-13 15:53:47+00:00,"48.873341356228, 2.4133544409574",Paris,75056,0.0,16
42304,Marc Sangnier - Division Leclerc,OUI,21,6,15,13,2,OUI,OUI,2025-03-13 16:01:58+00:00,"48.78599652305309, 2.329955510795116",Cachan,94016,0.7142857142857143,16
7024,Rapp - Place du Général Gouraud,OUI,29,25,4,3,1,OUI,OUI,2025-03-13 16:00:46+00:00,"48.858102885107, 2.3004072904587",Paris,75056,0.13793103448275862,16
11109,Pierre Levée - Fontaine Timbaud,OUI,21,13,8,4,4,OUI,OUI,2025-03-13 16:01:44+00:00,"48.86632723374305, 2.3711163550615306",Paris,75056,0.38095238095238093,16
20004,Commandant l'Herminier - Gallieni,OUI,17,16,1,1,0,OUI,OUI,2025-03-13 16:01:57+00:00,"48.847040552603, 2.4160453677177",Paris,75056,0.058823529411764705,16
16115,Raffet - Montmorency,OUI,40,37,3,0,3,OUI,OUI,2025-03-13 16:01:53+00:00,"48.85258670812, 2.2629252456151954",Paris,75056,0.075,16
12150,Bastille - Quai de la Rapée,OUI,27,3,24,20,4,OUI,OUI,2025-03-13 15:59:51+00:00,"48.84682410855, 2.3669364675879",Paris,75056,0.8888888888888888,16
13039,Ivry - Simone Weil,OUI,18,8,10,3,7,OUI,OUI,2025-03-13 16:01:05+00:00,"48.823283932030755, 2.3659095168113713",Paris,75056,0.5555555555555556,16
11031,Jacquard - Ternaux,OUI,39,15,24,16,8,OUI,OUI,2025-03-13 16:01:33+00:00,"48.8646605, 2.373162",Paris,75056,0.6153846153846154,16
21031,Cimetière de Boulogne-Billancourt,OUI,40,11,29,23,6,OUI,OUI,2025-03-13 16:00:23+00:00,"48.830764, 2.252024",Boulogne-Billancourt,92012,0.725,16
12125,Pyramide - Parc Floral,OUI,50,48,2,1,1,OUI,OUI,2025-03-13 15:59:15+00:00,"48.837442, 2.440452",Paris,75056,0.04,16
16024,Ranelagh - Maison de la Radio,OUI,20,5,15,15,0,OUI,OUI,2025-03-13 15:59:31+00:00,"48.85293603169479, 2.280449643731117",Paris,75056,0.75,16
9016,Choron - Martyrs,OUI,17,12,5,1,4,OUI,OUI,2025-03-13 16:02:15+00:00,"48.877851443503, 2.3396701365709",Paris,75056,0.29411764705882354,16
17039,Place Saint-Ferdinand,OUI,38,21,17,3,14,OUI,OUI,2025-03-13 16:00:56+00:00,"48.87815529789739, 2.288518047864942",Paris,75056,0.4473684210526316,16
15131,Charles Lecocq - Lecourbe,OUI,28,20,8,3,5,OUI,OUI,2025-03-13 16:00:37+00:00,"48.84044, 2.294867",Paris,75056,0.2857142857142857,16
22604,Hôtel de Ville de Fontenay-aux-Roses,OUI,32,30,2,0,2,OUI,OUI,2025-03-13 15:53:55+00:00,"48.790844603480856, 2.2871455930319455",Fontenay-aux-Roses,92032,0.0625,16
10037,Quai de Valmy,OUI,26,21,5,2,3,OUI,OUI,2025-03-13 16:01:08+00:00,"48.88126951579429, 2.368186041712761",Paris,75056,0.19230769230769232,16
42305,Vanne - Saussaies,OUI,20,18,2,0,2,OUI,OUI,2025-03-13 15:53:49+00:00,"48.786404, 2.338848",Cachan,94016,0.1,16
13117,Stade Georges Carpentier,OUI,40,36,4,3,1,OUI,OUI,2025-03-13 15:57:53+00:00,"48.820482438381, 2.3668321967125",Paris,75056,0.1,16
10012,Vinaigriers - Magenta,OUI,24,14,10,9,1,OUI,OUI,2025-03-13 16:00:49+00:00,"48.8731167, 2.3593052",Paris,75056,0.4166666666666667,16
17029,Pierre Demours - Laugier,OUI,36,27,9,2,7,OUI,OUI,2025-03-13 16:00:41+00:00,"48.8813072, 2.294846",Paris,75056,0.25,16
21028,Pierre Lefaucheux - Traversière,OUI,34,9,25,17,8,OUI,OUI,2025-03-13 16:01:48+00:00,"48.82435208303827, 2.2417913004755974",Boulogne-Billancourt,92012,0.7352941176470589,16
10004,Metz - Faubourg Saint-Denis,OUI,44,14,30,27,3,OUI,OUI,2025-03-13 16:00:53+00:00,"48.870893, 2.353521",Paris,75056,0.6818181818181818,16
4003,Quai aux Fleurs - Pont Saint-Louis,OUI,21,7,14,13,1,OUI,OUI,2025-03-13 15:56:55+00:00,"48.852915956209, 2.3521957173944",Paris,75056,0.6666666666666666,16
21118,Neuilly - Petit,OUI,14,8,6,5,1,OUI,OUI,2025-03-13 15:57:51+00:00,"48.898965361341254, 2.29627937078476",Clichy,92024,0.42857142857142855,16
32301,Mairie de Romainville,OUI,17,17,0,0,0,OUI,OUI,2025-03-13 15:56:11+00:00,"48.885109, 2.435679",Romainville,93063,0.0,16
21203,Place Jules Ferry,OUI,28,27,1,0,1,OUI,OUI,2025-03-13 15:58:30+00:00,"48.812107928414775, 2.325837314128876",Montrouge,92049,0.03571428571428571,16
21219,Amaury Duval - Gabriel Péri,OUI,36,35,1,0,1,OUI,OUI,2025-03-13 15:56:24+00:00,"48.81718759671675, 2.323841750621796",Montrouge,92049,0.027777777777777776,16
10017,Gare de l'Est - Fidélité,OUI,11,1,10,8,2,OUI,OUI,2025-03-13 16:01:56+00:00,"48.874575, 2.356796",Paris,75056,0.9090909090909091,16
13011,Hôpital - Campo-Formio,OUI,11,9,2,0,2,OUI,OUI,2025-03-13 16:01:59+00:00,"48.835405, 2.358218",Paris,75056,0.18181818181818182,16
22013,Mairie de Neuilly sur Seine,OUI,30,23,7,5,2,OUI,OUI,2025-03-13 16:01:31+00:00,"48.88494728765838, 2.2677031159400944",Neuilly-sur-Seine,92051,0.23333333333333334,16
31025,Paul Signac - Aristide Briand,OUI,33,31,2,0,2,OUI,OUI,2025-03-13 15:55:19+00:00,"48.86950262156371, 2.4502260982990265",Montreuil,93048,0.06060606060606061,16
21316,Cimetière d'Issy-les-Moulineaux,OUI,23,23,0,0,0,OUI,OUI,2025-03-13 15:53:41+00:00,"48.817699773925, 2.2609312087297",Issy-les-Moulineaux,92040,0.0,16
5014,Jean Calvin - Tournefort,OUI,28,25,3,2,1,OUI,OUI,2025-03-13 16:02:06+00:00,"48.84158856925782, 2.348489575088024",Paris,75056,0.10714285714285714,16
19025,Botzaris - Crimée,OUI,20,17,3,0,3,OUI,OUI,2025-03-13 16:00:13+00:00,"48.87959698690176, 2.3887913337477067",Paris,75056,0.15,16
8549,George V - Christophe Colomb,OUI,24,5,19,4,15,OUI,OUI,2025-03-13 16:01:26+00:00,"48.87046, 2.30104",Paris,75056,0.7916666666666666,16
16009,Saint-Didier - Raymond Poincaré,OUI,17,13,4,2,2,OUI,OUI,2025-03-13 16:00:35+00:00,"48.86642312020962, 2.285863497192411",Paris,75056,0.23529411764705882,16
23902,Gallieni - Lycée Charles Petitet,OUI,44,20,24,17,7,OUI,OUI,2025-03-13 16:01:06+00:00,"48.927640283627, 2.3308986340524",Villeneuve-la-Garenne,92078,0.5454545454545454,16
21029,Cours de l'Ile Seguin - Parc Billancourt,OUI,28,5,23,18,5,OUI,OUI,2025-03-13 16:00:49+00:00,"48.82714055843935, 2.234234511852265",Boulogne-Billancourt,92012,0.8214285714285714,16
16020,Place de la Porte de Passy,OUI,34,34,0,0,0,OUI,OUI,2025-03-13 16:00:25+00:00,"48.857341095470794, 2.2644165538827115",Paris,75056,0.0,16
10153,Gare du Nord - Denain,OUI,20,15,5,0,5,OUI,OUI,2025-03-13 16:01:42+00:00,"48.879595787608, 2.3544725775719",Paris,75056,0.25,16
13126,Place Nationale - Château-des-Rentiers,OUI,18,15,3,0,3,OUI,OUI,2025-03-13 16:01:10+00:00,"48.829268, 2.365212",Paris,75056,0.16666666666666666,16
16003,André Maurois - Joseph et Marie Hackin,OUI,27,13,14,11,3,OUI,OUI,2025-03-13 16:02:07+00:00,"48.8778983, 2.2789591",Paris,75056,0.5185185185185185,16
14101,Gare Montparnasse - Edgar Quinet,OUI,33,28,5,0,5,OUI,OUI,2025-03-13 16:00:13+00:00,"48.841487851079, 2.3233232282801",Paris,75056,0.15151515151515152,16
15072,Place Fernand Forest,OUI,27,1,26,21,5,OUI,OUI,2025-03-13 16:00:41+00:00,"48.849269143836, 2.281863167882",Paris,75056,0.9629629629629629,16
15023,La Motte-Picquet - Grenelle,OUI,34,7,27,22,5,OUI,OUI,2025-03-13 15:57:23+00:00,"48.84858321339195, 2.299347817897797",Paris,75056,0.7941176470588235,16
12006,Gare de Lyon - Van Gogh,OUI,41,4,37,28,9,OUI,OUI,2025-03-13 15:59:26+00:00,"48.843839785643, 2.3704450240357",Paris,75056,0.9024390243902439,16
42003,Place de l'Insurrection d'Août 1944,OUI,29,7,22,20,2,OUI,OUI,2025-03-13 16:01:29+00:00,"48.81477852751594, 2.398074567317963",Ivry-sur-Seine,94041,0.7586206896551724,16
16014,Eylau - Trocadéro,OUI,22,21,1,0,1,OUI,OUI,2025-03-13 16:00:53+00:00,"48.863354122371, 2.2864209115505",Paris,75056,0.045454545454545456,16
12043,Daumesnil - Hébrard,OUI,39,11,28,22,6,OUI,OUI,2025-03-13 16:01:56+00:00,"48.8429, 2.38474",Paris,75056,0.717948717948718,16
13048,Wurtz - Tolbiac,OUI,28,28,0,0,0,NON,NON,2025-03-13 12:52:17+00:00,"48.82631195621, 2.344585955143",Paris,75056,0.0,13
23003,Président Wilson - Baudin,OUI,27,9,18,16,2,OUI,OUI,2025-03-13 16:01:12+00:00,"48.89826887103676, 2.2849336266517644",Levallois-Perret,92044,0.6666666666666666,16
21702,Gare SNCF Vanves-Malakoff,OUI,49,45,4,1,3,OUI,OUI,2025-03-13 15:52:53+00:00,"48.819002163836444, 2.292150005103606",Vanves,92075,0.08163265306122448,16
17023,Porte d'Asnières,OUI,33,24,9,6,3,OUI,OUI,2025-03-13 15:59:15+00:00,"48.89035817610495, 2.3036286234855656",Paris,75056,0.2727272727272727,16
15052,Convention - Vaugirard,OUI,45,26,19,10,9,OUI,OUI,2025-03-13 16:02:14+00:00,"48.83767682233156, 2.295586926020252",Paris,75056,0.4222222222222222,16
19108,Gaston Tessier - Rosa Parks RER,OUI,37,33,4,2,2,OUI,OUI,2025-03-13 16:01:19+00:00,"48.8963765, 2.3743692",Paris,75056,0.10810810810810811,16
31021,Résistance - Hoche,OUI,28,25,3,0,3,OUI,OUI,2025-03-13 15:55:54+00:00,"48.864273423741956, 2.435784414410591",Montreuil,93048,0.10714285714285714,16
4002,Marché aux fleurs,OUI,20,10,10,9,1,OUI,OUI,2025-03-13 16:01:23+00:00,"48.855258115391, 2.3473754525185",Paris,75056,0.5,16
44002,Paul Vaillant-Couturier - Gare RER,OUI,25,8,17,17,0,OUI,OUI,2025-03-13 16:01:15+00:00,"48.80108159069614, 2.402097210288048",Vitry-sur-Seine,94081,0.68,16
42501,Raspail - Albert Schweitzer,OUI,27,6,21,18,3,OUI,OUI,2025-03-13 16:01:36+00:00,"48.81031545, 2.34395871",Gentilly,94037,0.7777777777777778,16
15123,Commerce - Letellier,OUI,42,27,15,8,7,OUI,OUI,2025-03-13 16:00:49+00:00,"48.84797660373612, 2.2966245196598805",Paris,75056,0.35714285714285715,16
13109,Brillat-Savarin - Küss,OUI,21,16,5,5,0,OUI,OUI,2025-03-13 16:01:01+00:00,"48.822203, 2.350422",Paris,75056,0.23809523809523808,16
21030,Fessart - Château,OUI,20,6,14,9,5,OUI,OUI,2025-03-13 16:02:06+00:00,"48.84245, 2.23989",Boulogne-Billancourt,92012,0.7,16
21204,Estienne d'Orves - Henri Ginoux,OUI,30,26,4,1,3,OUI,OUI,2025-03-13 16:00:34+00:00,"48.815388220397274, 2.320886790760933",Montrouge,92049,0.13333333333333333,16
15043,Brancion - Lefebvre,OUI,9,6,3,1,2,OUI,OUI,2025-03-13 16:02:01+00:00,"48.82900222785569, 2.301431038163409",Paris,75056,0.3333333333333333,16
43001,Paris - Laitières,OUI,22,15,7,4,3,OUI,OUI,2025-03-13 16:01:31+00:00,"48.84630274151258, 2.4207553267478947",Vincennes,94080,0.3181818181818182,16
20009,Docteurs Déjérine - Pte de Montreuil,OUI,19,19,0,0,0,OUI,OUI,2025-03-13 15:57:59+00:00,"48.85398448133697, 2.41208288897222",Paris,75056,0.0,16
21217,Louis Rolland - République,OUI,26,26,0,0,0,OUI,OUI,2025-03-13 16:00:16+00:00,"48.81710889740748, 2.3193106434955717",Montrouge,92049,0.0,16
11032,Jean-Pierre Timbaud - Vaucouleurs,OUI,45,29,16,2,14,OUI,OUI,2025-03-13 16:02:11+00:00,"48.867937, 2.377885",Paris,75056,0.35555555555555557,16
9114,Faubourg Poissonnière - Dunkerque,OUI,29,27,2,1,1,OUI,OUI,2025-03-13 16:02:12+00:00,"48.880883445404436, 2.349934279918671",Paris,75056,0.06896551724137931,16
21955,Vaugirard - Verrerie,OUI,24,2,22,18,4,OUI,OUI,2025-03-13 16:01:48+00:00,"48.820881336842, 2.2367222622987",Meudon,92048,0.9166666666666666,16
16011,Victor Hugo - La Pompe,OUI,40,39,1,0,1,OUI,OUI,2025-03-13 16:01:43+00:00,"48.86795222470859, 2.28146318346262",Paris,75056,0.025,16
16101,Malakoff - Place de la Porte Maillot,OUI,26,11,15,3,12,OUI,OUI,2025-03-13 15:56:17+00:00,"48.876733496638, 2.2834577411413",Paris,75056,0.5769230769230769,16
25001,Colmar - Victor Hugo,OUI,31,8,23,11,12,OUI,OUI,2025-03-13 15:59:38+00:00,"48.88652251096166, 2.173960916697979",Rueil-Malmaison,92063,0.7419354838709677,16
8001,Petit Palais,OUI,45,10,35,23,12,OUI,OUI,2025-03-13 16:01:18+00:00,"48.8667692, 2.3157655",Paris,75056,0.7777777777777778,16
13032,Italie - Jardin Joan Miro,OUI,24,17,7,3,4,OUI,OUI,2025-03-13 16:02:16+00:00,"48.81990914045756, 2.3592948541045193",Paris,75056,0.2916666666666667,16
13121,Bruneseau - Quai d'Ivry,OUI,46,1,45,45,0,OUI,OUI,2025-03-13 16:02:02+00:00,"48.824945637583, 2.3885661363602",Ivry-sur-Seine,94041,0.9782608695652174,16
10165,Gare de l'Est - Place du 11 Novembre 1918,OUI,39,33,6,3,3,OUI,OUI,2025-03-13 16:01:46+00:00,"48.876327, 2.3585464",Paris,75056,0.15384615384615385,16
21307,Victor Cresson - Telles de la Poterie,OUI,29,16,13,12,1,OUI,OUI,2025-03-13 15:52:59+00:00,"48.822698842979, 2.2686498274964",Issy-les-Moulineaux,92040,0.4482758620689655,16
15064,Javel - André Citroën,OUI,44,6,38,34,4,OUI,OUI,2025-03-13 16:01:52+00:00,"48.846276485475, 2.2786368057132",Paris,75056,0.8636363636363636,16
4010,Saint-Antoine Sévigné,OUI,25,7,18,13,5,OUI,OUI,2025-03-13 16:02:16+00:00,"48.8550222, 2.3612322",Paris,75056,0.72,16
13128,Quai de la Gare - Pont de Bercy,OUI,29,1,28,22,6,OUI,OUI,2025-03-13 15:56:45+00:00,"48.83730787972, 2.3740861260598",Paris,75056,0.9655172413793104,16
10018,Square Alban Satragne,OUI,29,21,8,2,6,OUI,OUI,2025-03-13 16:01:05+00:00,"48.875388227727, 2.3559567333359",Paris,75056,0.27586206896551724,16
22303,Lucien Lanternier - Le Luth,OUI,25,9,16,12,4,OUI,OUI,2025-03-13 16:00:51+00:00,"48.93159430558871, 2.2889783978462224",Gennevilliers,92036,0.64,16
20108,Jardin de l'Hospice Debrousse,OUI,23,22,1,0,1,OUI,OUI,2025-03-13 16:01:17+00:00,"48.861451061938, 2.40568600595",Paris,75056,0.043478260869565216,16
43010,La Jarry - Place Diderot,OUI,25,20,5,0,5,OUI,OUI,2025-03-13 15:59:10+00:00,"48.849726940367326, 2.452013790607453",Vincennes,94080,0.2,16
20007,Buzenval - Avron,OUI,49,48,1,1,0,OUI,OUI,2025-03-13 16:00:33+00:00,"48.851617204999, 2.4015135973077",Paris,75056,0.02040816326530612,16
17107,Berthier - Place Stuart Merril,OUI,34,23,11,9,2,OUI,OUI,2025-03-13 16:00:43+00:00,"48.885927922355044, 2.2933450341224675",Paris,75056,0.3235294117647059,16
13033,Porte d'Italie,OUI,13,10,3,1,2,OUI,OUI,2025-03-13 16:02:13+00:00,"48.817161987718954, 2.360236309468746",Paris,75056,0.23076923076923078,16
15057,Lucien Bossoutrot - Général Martial Vallin,OUI,38,20,18,17,1,OUI,OUI,2025-03-13 16:00:28+00:00,"48.836956046311, 2.2741072252393",Paris,75056,0.47368421052631576,16
42701,Charles Gide - Fort de Bicêtre,OUI,29,24,5,0,5,OUI,OUI,2025-03-13 15:58:50+00:00,"48.8071937956922, 2.353984415531159",Le Kremlin-Bicêtre,94043,0.1724137931034483,16
15004,Vaugirard - Pasteur,OUI,21,20,1,0,1,OUI,OUI,2025-03-13 15:58:31+00:00,"48.84040868803496, 2.3154367133975033",Paris,75056,0.047619047619047616,16
20122,Vitruve - Davout,OUI,23,20,3,0,3,OUI,OUI,2025-03-13 16:00:06+00:00,"48.86053161154489, 2.4091592812626543",Paris,75056,0.13043478260869565,16
23010,Voltaire - Anatole France,OUI,26,9,17,10,7,OUI,OUI,2025-03-13 16:00:21+00:00,"48.891999360256904, 2.284262739121914",Levallois-Perret,92044,0.6538461538461539,16
8020,Batignolles - Beudant,OUI,43,41,2,1,1,OUI,OUI,2025-03-13 15:58:13+00:00,"48.88216401466375, 2.319852970540523",Paris,75056,0.046511627906976744,16
18007,Goutte d'or - Barbès,OUI,20,19,1,0,1,OUI,OUI,2025-03-13 16:00:08+00:00,"48.885124323627, 2.3496962338686",Paris,75056,0.05,16
17015,Place de Lévis,OUI,48,46,2,2,0,OUI,OUI,2025-03-13 16:00:29+00:00,"48.883546851533254, 2.3131933808326726",Paris,75056,0.041666666666666664,16
18006,Square Louise Michel,OUI,35,35,0,0,0,OUI,OUI,2025-03-13 15:53:54+00:00,"48.884687354509, 2.3441386967897",Paris,75056,0.0,16
22501,Théâtre de La Garenne,OUI,20,13,7,0,7,OUI,OUI,2025-03-13 16:01:53+00:00,"48.905658361454, 2.2345951981176",La Garenne-Colombes,92035,0.35,16
21401,Mairie de Clamart,OUI,31,25,6,0,6,OUI,OUI,2025-03-13 15:55:00+00:00,"48.800612, 2.262151",Clamart,92023,0.1935483870967742,16
4001,Arcole - Notre-Dame,OUI,28,17,11,4,7,OUI,OUI,2025-03-13 16:01:02+00:00,"48.853883541328, 2.3493797332048",Paris,75056,0.39285714285714285,16
13044,Place Jeanne d'Arc,OUI,35,28,7,0,7,OUI,OUI,2025-03-13 16:00:02+00:00,"48.829575, 2.369126",Paris,75056,0.2,16
40009,Lycée Saint Exupéry - Juliette Savar,OUI,29,18,11,8,3,OUI,OUI,2025-03-13 16:01:57+00:00,"48.783021513972, 2.4637357216879",Créteil,94028,0.3793103448275862,16
17108,Bessières - Porte de Clichy,OUI,30,19,11,8,3,OUI,OUI,2025-03-13 15:58:56+00:00,"48.89611762451474, 2.31790903955698",Paris,75056,0.36666666666666664,16
14131,Jourdan - Monticelli,OUI,30,18,12,4,8,OUI,OUI,2025-03-13 16:02:04+00:00,"48.822032, 2.329095",Paris,75056,0.4,16
15022,Emile Zola - Fondary,OUI,42,12,30,29,1,OUI,OUI,2025-03-13 16:01:55+00:00,"48.847051143113745, 2.2953405976295476",Paris,75056,0.7142857142857143,16
44007,Camille Groult - Guy Môquet,OUI,21,3,18,12,6,OUI,OUI,2025-03-13 15:59:59+00:00,"48.787482746521306, 2.3976725712418556",Vitry-sur-Seine,94081,0.8571428571428571,16
23004,Paul Vaillant-Couturier - Victor Hugo,OUI,33,2,31,29,2,OUI,OUI,2025-03-13 16:00:13+00:00,"48.89819702263572, 2.293848017974069",Levallois-Perret,92044,0.9393939393939394,16
10105,Mazagran - Bonne Nouvelle,OUI,25,13,12,10,2,OUI,OUI,2025-03-13 15:59:48+00:00,"48.870047123655, 2.3511248454452",Paris,75056,0.48,16
22408,Place du 14 Juillet,OUI,22,21,1,1,0,OUI,OUI,2025-03-13 15:54:22+00:00,"48.819266959525, 2.3011998832226",Malakoff,92046,0.045454545454545456,16
17003,Jacques Kellner - Saint-Ouen,OUI,43,38,5,1,4,OUI,OUI,2025-03-13 16:01:11+00:00,"48.895809485802886, 2.327897409164145",Paris,75056,0.11627906976744186,16
11017,Charonne - Bureau,OUI,44,42,2,0,2,OUI,OUI,2025-03-13 16:00:52+00:00,"48.854176, 2.396093",Paris,75056,0.045454545454545456,16
6008,Assas - Luxembourg,OUI,32,29,3,1,2,OUI,OUI,2025-03-13 16:00:44+00:00,"48.843734468779, 2.3334283818759",Paris,75056,0.09375,16
21306,Place Lafayette,OUI,61,7,54,52,2,OUI,OUI,2025-03-13 16:02:06+00:00,"48.829654975522, 2.2638675570488",Issy-les-Moulineaux,92040,0.8852459016393442,16
42209,Place de l'Europe - Quai de Bercy,OUI,15,3,12,12,0,OUI,OUI,2025-03-13 16:01:11+00:00,"48.82529858840266, 2.3945679143071175",Charenton-le-Pont,94018,0.8,16
1021,Halles - Bourdonnais,OUI,18,3,15,8,7,OUI,OUI,2025-03-13 16:01:21+00:00,"48.860448992575, 2.3460162431002",Paris,75056,0.8333333333333334,16
22206,Louis Pasteur - Albert Petit,OUI,30,27,3,0,3,OUI,OUI,2025-03-13 16:01:31+00:00,"48.796261, 2.317289",Bagneux,92007,0.1,16
33015,Charles Tillon - Cimetière Communal,OUI,26,1,25,6,19,OUI,OUI,2025-03-13 16:01:02+00:00,"48.91844023641836, 2.3935630917549138",Aubervilliers,93001,0.9615384615384616,16
11021,Charonne - Pierre Bayle,OUI,23,23,0,0,0,OUI,OUI,2025-03-13 16:01:02+00:00,"48.858445054262, 2.3903981223891",Paris,75056,0.0,16
15311,Quai du Président Roosevelt - Pont Aval,OUI,30,0,30,20,10,OUI,OUI,2025-03-13 16:00:40+00:00,"48.8343883676388, 2.2656820714473724",Paris,75056,1.0,16
15030,Emeriau - Beaugrenelle,OUI,73,15,58,49,9,OUI,OUI,2025-03-13 16:02:16+00:00,"48.84791249714942, 2.2843059897422795",Paris,75056,0.7945205479452054,16
12018,Saint-Mandé - Fabre d'Eglantine,OUI,32,29,3,0,3,OUI,OUI,2025-03-13 16:01:14+00:00,"48.8453579, 2.3965022",Paris,75056,0.09375,16
12007,Gare de Lyon - Chalon,OUI,45,1,44,23,21,OUI,OUI,2025-03-13 16:02:02+00:00,"48.845666194202, 2.3741452395916",Paris,75056,0.9777777777777777,16
44005,Place Saint-Just,OUI,22,12,10,5,5,OUI,OUI,2025-03-13 16:02:13+00:00,"48.790379518724265, 2.3895226791501045",Vitry-sur-Seine,94081,0.45454545454545453,16
35007,Benjamin Delessert - Jean Lolive,OUI,21,20,1,1,0,OUI,OUI,2025-03-13 16:01:42+00:00,"48.89392043619345, 2.417981922626496",Pantin,93055,0.047619047619047616,16
15011,Cambronne - Villa Croix Nivert,OUI,60,44,16,15,1,OUI,OUI,2025-03-13 16:01:05+00:00,"48.845847561366, 2.3017574474216",Paris,75056,0.26666666666666666,16
47001,Place de la Gare,OUI,45,2,43,39,4,OUI,OUI,2025-03-13 16:01:26+00:00,"48.80253358011283, 2.4275037646293645",Maisons-Alfort,94046,0.9555555555555556,16
32601,Porte des Lilas - Faidherbe,OUI,39,37,2,1,1,OUI,OUI,2025-03-13 15:56:15+00:00,"48.87861855668978, 2.4120327830314636",Les Lilas,93045,0.05128205128205128,16
44101,Place Mongolfier,OUI,37,16,21,12,9,OUI,OUI,2025-03-13 16:00:51+00:00,"48.815160030060376, 2.4592879414558415",Saint-Maurice,94069,0.5675675675675675,16
12026,Place Ginette Hamelin,OUI,50,24,26,20,6,OUI,OUI,2025-03-13 16:01:32+00:00,"48.837853, 2.382064",Paris,75056,0.52,16
14010,Jean Moulin - Place Victor et Hélène Basch,OUI,38,34,4,0,4,OUI,OUI,2025-03-13 16:02:06+00:00,"48.82764910241, 2.3261967301369",Paris,75056,0.10526315789473684,16
13009,Auguste Blanqui - Corvisart,OUI,25,23,2,1,1,OUI,OUI,2025-03-13 16:02:15+00:00,"48.8300989, 2.3502726",Paris,75056,0.08,16
92001,Mairie de quartier du Plateau - Mont-Valérien,OUI,20,14,6,5,1,OUI,OUI,2025-03-13 15:55:47+00:00,"48.8799933, 2.2072437",Nanterre,92050,0.3,16
27005,Gare du Stade,OUI,18,12,6,2,4,OUI,OUI,2025-03-13 15:56:48+00:00,"48.9312676, 2.2603778",Colombes,92025,0.3333333333333333,16
16002,Pergolèse - Malakoff,OUI,37,31,6,1,5,OUI,OUI,2025-03-13 15:59:00+00:00,"48.87521088779225, 2.2842781618237495",Paris,75056,0.16216216216216217,16
9024,Taitbout - La Fayette,OUI,51,11,40,25,15,OUI,OUI,2025-03-13 16:02:08+00:00,"48.8733298892, 2.3352625966072",Paris,75056,0.7843137254901961,16
6027,Blaise-Desgoffe - Vaugirard,OUI,32,30,2,1,1,OUI,OUI,2025-03-13 15:58:45+00:00,"48.846128877747, 2.3242672160268",Paris,75056,0.0625,16
8201,Arsène Houssaye - Friedland,OUI,29,25,4,0,4,OUI,OUI,2025-03-13 15:57:29+00:00,"48.874510616163, 2.2994716674148",Paris,75056,0.13793103448275862,16
19128,Quai de l'Oise - Aisne,OUI,28,23,5,3,2,OUI,OUI,2025-03-13 16:01:46+00:00,"48.8906231, 2.3833701",Paris,75056,0.17857142857142858,16
17111,Lemercier - Cardinet,OUI,24,13,11,5,6,OUI,OUI,2025-03-13 16:00:09+00:00,"48.890097168851746, 2.317377626895905",Paris,75056,0.4583333333333333,16
15005,Place Jacques et Thérèse Tréfouël,OUI,42,40,2,1,1,OUI,OUI,2025-03-13 16:02:08+00:00,"48.842726498317, 2.3125657439232",Paris,75056,0.047619047619047616,16
21319,Esplanade du Foncet - Camille Desmoulins,OUI,27,2,25,20,5,OUI,OUI,2025-03-13 16:01:54+00:00,"48.827090233494964, 2.2606857866048813",Issy-les-Moulineaux,92040,0.9259259259259259,16
9027,Douai - Pierre Fontaine,OUI,23,17,6,0,6,OUI,OUI,2025-03-13 15:54:49+00:00,"48.88229101148092, 2.33324121683836",Paris,75056,0.2608695652173913,16
18030,Joseph Dijon - Ornano,OUI,36,32,4,1,3,OUI,OUI,2025-03-13 16:01:56+00:00,"48.89374453351521, 2.3476678133010864",Paris,75056,0.1111111111111111,16
4020,Place Edmond Michelet,OUI,23,5,18,16,2,OUI,OUI,2025-03-13 16:01:04+00:00,"48.860134890542, 2.3500636965036",Paris,75056,0.782608695652174,16
92006,Place Nelson Mandela,OUI,30,17,13,3,10,OUI,OUI,2025-03-13 16:00:48+00:00,"48.897874318180556, 2.2182820737361912",Nanterre,92050,0.43333333333333335,16
5012,Estrapade - Ulm,OUI,16,11,5,2,3,OUI,OUI,2025-03-13 16:01:42+00:00,"48.84512772828, 2.3454568170362",Paris,75056,0.3125,16
5024,Place Monge,OUI,20,13,7,4,3,OUI,OUI,2025-03-13 16:01:53+00:00,"48.842761803051, 2.3524079471827",Paris,75056,0.35,16
8037,Monceau - Malesherbes,OUI,37,29,8,5,3,OUI,OUI,2025-03-13 15:58:05+00:00,"48.8795079, 2.3145456",Paris,75056,0.21621621621621623,16
31005,Square Denise Buisson,OUI,45,41,4,0,4,OUI,OUI,2025-03-13 16:01:23+00:00,"48.8562322730982, 2.426436245441437",Montreuil,93048,0.08888888888888889,16
7017,La Motte-Picquet - La Tour Maubourg,OUI,40,22,18,9,9,OUI,OUI,2025-03-13 15:59:24+00:00,"48.856926701847, 2.3096215831203",Paris,75056,0.45,16
12005,Crozatier - Faubourg Saint-Antoine,OUI,39,1,38,27,11,OUI,OUI,2025-03-13 16:01:58+00:00,"48.850440013405, 2.378901366211",Paris,75056,0.9743589743589743,16
35006,Delizy - Louis Nadot,OUI,21,18,3,0,3,OUI,OUI,2025-03-13 15:57:20+00:00,"48.896212845581346, 2.4094578623771667",Pantin,93055,0.14285714285714285,16
12155,Rottembourg - Général Michel Bizot,OUI,42,33,9,4,5,OUI,OUI,2025-03-13 16:00:39+00:00,"48.83787825992554, 2.4044052511453633",Paris,75056,0.21428571428571427,16
41205,Maréchal Joffre - Verdun,OUI,20,19,1,0,1,OUI,OUI,2025-03-13 15:55:22+00:00,"48.85385, 2.470307",Fontenay-sous-Bois,94033,0.05,16
9011,Geoffroy - Marie,OUI,17,6,11,10,1,OUI,OUI,2025-03-13 16:00:30+00:00,"48.873781940593325, 2.344513876337893",Paris,75056,0.6470588235294118,16
22015,Île de la Jatte,OUI,23,7,16,4,12,OUI,OUI,2025-03-13 16:00:34+00:00,"48.894036161302104, 2.2666339203715324",Neuilly-sur-Seine,92051,0.6956521739130435,16
9034,Godot de Mauroy - Madeleine,OUI,21,4,17,3,14,OUI,OUI,2025-03-13 16:02:00+00:00,"48.869789, 2.326347",Paris,75056,0.8095238095238095,16
44016,Balzac - Olympes de Gouges,OUI,28,9,19,9,10,OUI,OUI,2025-03-13 16:01:20+00:00,"48.77850332486751, 2.4006786569952965",Vitry-sur-Seine,94081,0.6785714285714286,16
12035,Madagascar - Meuniers,OUI,32,25,7,4,3,OUI,OUI,2025-03-13 15:56:47+00:00,"48.83460464474706, 2.3970650508999825",Paris,75056,0.21875,16
17119,Toqueville - Cardinet,OUI,32,25,7,6,1,OUI,OUI,2025-03-13 16:02:13+00:00,"48.88490187110713, 2.3109393194317818",Paris,75056,0.21875,16
10021,Marché Saint-Quentin,OUI,14,12,2,0,2,OUI,OUI,2025-03-13 15:53:09+00:00,"48.877356057652, 2.3545114456374",Paris,75056,0.14285714285714285,16
9004,Gérando - Rochechouart,OUI,21,19,2,1,1,OUI,OUI,2025-03-13 16:01:47+00:00,"48.88294340845, 2.3464846238494",Paris,75056,0.09523809523809523,16
21707,Square Etienne Jarousse,OUI,22,21,1,0,1,OUI,OUI,2025-03-13 16:01:39+00:00,"48.82485182597129, 2.2925933450460434",Vanves,92075,0.045454545454545456,16
51002,Placette Grégoire Collas,OUI,25,14,11,4,7,OUI,OUI,2025-03-13 15:56:20+00:00,"48.94342014002797, 2.2487476095557213",Argenteuil,95018,0.44,16
5001,Harpe - Saint-Germain,OUI,43,17,26,19,7,OUI,OUI,2025-03-13 16:00:00+00:00,"48.851518815017, 2.3436703160405",Paris,75056,0.6046511627906976,16
33016,Fort d'Aubervilliers,OUI,22,14,8,7,1,OUI,OUI,2025-03-13 15:58:20+00:00,"48.91502382370325, 2.4035281687974925",Aubervilliers,93001,0.36363636363636365,16
21315,Jules Guesdes - Général de Gaulle,OUI,24,19,5,1,4,OUI,OUI,2025-03-13 16:00:28+00:00,"48.81930581291959, 2.278934195637703",Issy-les-Moulineaux,92040,0.20833333333333334,16
10162,Alexandre Parodi - Quai de Valmy,OUI,24,24,0,0,0,OUI,OUI,2025-03-13 15:52:06+00:00,"48.879359419425, 2.3665961623192",Paris,75056,0.0,16
15036,Croix Nivert - Square Saint-Lambert,OUI,47,47,0,0,0,NON,NON,2025-03-03 09:03:43+00:00,"48.843051521591, 2.2952004522085",Paris,75056,0.0,9
6012,Saint-Germain - Ciseaux,OUI,18,7,11,10,1,OUI,OUI,2025-03-13 16:00:24+00:00,"48.853305277595, 2.3344654618827",Paris,75056,0.6111111111111112,16
15006,Cherche-Midi - Hôpital Necker,OUI,35,27,8,7,1,OUI,OUI,2025-03-13 16:01:50+00:00,"48.84461063309956, 2.317914068698883",Paris,75056,0.22857142857142856,16
15071,Suffren - Champ de Mars,OUI,23,11,12,9,3,OUI,OUI,2025-03-13 16:01:48+00:00,"48.8547194, 2.2952168",Paris,75056,0.5217391304347826,16
21402,Place Aimé Césaire,OUI,27,25,2,0,2,OUI,OUI,2025-03-13 15:54:55+00:00,"48.783194713067815, 2.2429127991199493",Clamart,92023,0.07407407407407407,16
9102,Londres - Place d'Estienne d'Orves,OUI,24,4,20,14,6,OUI,OUI,2025-03-13 15:58:57+00:00,"48.876693805756986, 2.3305362090468407",Paris,75056,0.8333333333333334,16
41403,Gare RER - Malleret-Joinville,OUI,20,6,14,8,6,OUI,OUI,2025-03-13 16:00:32+00:00,"48.802936, 2.42531",Alfortville,94002,0.7,16
9006,Dunkerque - Trudaine,OUI,16,15,1,1,0,OUI,OUI,2025-03-13 16:00:59+00:00,"48.88215166773376, 2.3463253676891327",Paris,75056,0.0625,16
13052,Leredde - Tolbiac,OUI,43,13,30,20,10,OUI,OUI,2025-03-13 15:59:21+00:00,"48.82887629664, 2.3744382709265",Paris,75056,0.6976744186046512,16
8116,Champs-Elysees - Bassano,OUI,25,25,0,0,0,NON,NON,2021-02-21 19:09:18+00:00,"48.871811807816, 2.300238981843",Paris,75056,0.0,19
17024,Villiers - Batignolles,OUI,23,20,3,1,2,OUI,OUI,2025-03-13 16:01:44+00:00,"48.88125253846116, 2.31653843075037",Paris,75056,0.13043478260869565,16
21314,Chemin de Bretagne,OUI,28,3,25,20,5,OUI,OUI,2025-03-13 16:02:15+00:00,"48.824753068884, 2.2588385956052",Issy-les-Moulineaux,92040,0.8928571428571429,16
20105,Benoît Frachon - République,OUI,28,27,1,0,1,OUI,OUI,2025-03-13 16:02:09+00:00,"48.85230729014318, 2.415605485439301",Paris,75056,0.03571428571428571,16
12038,Picpus - Louis Braille,OUI,43,41,2,1,1,OUI,OUI,2025-03-13 15:59:27+00:00,"48.839988788912, 2.4005256685521",Paris,75056,0.046511627906976744,16
14011,Place des Droits de l'Enfant,OUI,38,36,2,1,1,OUI,OUI,2025-03-13 16:01:42+00:00,"48.8274804, 2.3319217",Paris,75056,0.05263157894736842,16
13516,Glacière - Soeur Catherine Marie,OUI,40,38,2,0,2,OUI,OUI,2025-03-13 15:58:36+00:00,"48.829522989420596, 2.343570403754711",Paris,75056,0.05,16
41401,Marne - Charles de Gaulle,OUI,25,16,9,7,2,OUI,OUI,2025-03-13 16:00:35+00:00,"48.815071719544434, 2.4121668934822087",Alfortville,94002,0.36,16
12028,Vivaldi - Antoine-Julien Hénard,OUI,27,27,0,0,0,OUI,OUI,2025-03-13 16:00:29+00:00,"48.841923663276546, 2.389728979467376",Paris,75056,0.0,16
6002,Saint-Benoît - Jacob,OUI,21,7,14,10,4,OUI,OUI,2025-03-13 16:00:49+00:00,"48.85545136013941, 2.3334722220897675",Paris,75056,0.6666666666666666,16
5115,Buffon - Jardin des Plantes,OUI,30,4,26,17,9,OUI,OUI,2025-03-13 16:01:25+00:00,"48.842668466104875, 2.3618587106466293",Paris,75056,0.8666666666666667,16
14031,Didot - Place de Moro-Giafferi,OUI,20,16,4,0,4,OUI,OUI,2025-03-13 16:01:46+00:00,"48.8337, 2.3215",Paris,75056,0.2,16
41211,Louis Xavier de Ricard - Ancienne Mairie,OUI,34,32,2,2,0,OUI,OUI,2025-03-13 16:00:20+00:00,"48.84629899065091, 2.472420372068882",Fontenay-sous-Bois,94033,0.058823529411764705,16
16019,Porte de la Muette,OUI,34,22,12,3,9,OUI,OUI,2025-03-13 16:01:36+00:00,"48.86302317841182, 2.2687188170157406",Paris,75056,0.35294117647058826,16
44011,Lebrun - Colonel Fabien,OUI,27,26,1,0,1,OUI,OUI,2025-03-13 15:53:12+00:00,"48.78266870733145, 2.381317801773548",Vitry-sur-Seine,94081,0.037037037037037035,16
2013,Favart - Italiens,OUI,17,7,10,2,8,OUI,OUI,2025-03-13 16:01:46+00:00,"48.871446353921, 2.3382901058508",Paris,75056,0.5882352941176471,16
2108,Vivienne - Montmartre,OUI,37,6,31,20,11,OUI,OUI,2025-03-13 16:01:25+00:00,"48.871347597383, 2.3414588347077",Paris,75056,0.8378378378378378,16
10019,Paradis - Hauteville,OUI,31,16,15,12,3,OUI,OUI,2025-03-13 16:02:14+00:00,"48.874999954666755, 2.3522757401923404",Paris,75056,0.4838709677419355,16
12101,Charenton - Prague,OUI,28,1,27,21,6,OUI,OUI,2025-03-13 16:01:10+00:00,"48.848175129981, 2.3763584494312",Paris,75056,0.9642857142857143,16
41203,Stalingrad - Rigollots,OUI,50,44,6,0,6,OUI,OUI,2025-03-13 15:59:42+00:00,"48.84997403844251, 2.45557576417923",Fontenay-sous-Bois,94033,0.12,16
4019,Cloître Saint-Merri - Renard,OUI,31,1,30,25,5,OUI,OUI,2025-03-13 16:01:24+00:00,"48.858835448898, 2.3518279194832",Paris,75056,0.967741935483871,16
10033,Gare du Nord - Saint-Vincent de Paul,OUI,24,23,1,1,0,OUI,OUI,2025-03-13 15:54:10+00:00,"48.880955741648, 2.3524305148385",Paris,75056,0.041666666666666664,16
15129,Hôpital Necker,OUI,37,23,14,8,6,OUI,OUI,2025-03-13 15:59:10+00:00,"48.846043490118454, 2.313245013356209",Paris,75056,0.3783783783783784,16
51001,Gare d'Argenteuil,OUI,37,17,20,4,16,OUI,OUI,2025-03-13 15:59:24+00:00,"48.947022436806705, 2.256898172199726",Argenteuil,95018,0.5405405405405406,16
16036,Porte Molitor,OUI,59,16,43,32,11,OUI,OUI,2025-03-13 16:01:43+00:00,"48.84524763511433, 2.2569015249609947",Paris,75056,0.7288135593220338,16
8027,Mairie du 8ème,OUI,14,10,4,2,2,OUI,OUI,2025-03-13 15:52:47+00:00,"48.877932, 2.318264",Paris,75056,0.2857142857142857,16
8117,Place de la Madeleine - Royale,OUI,42,10,32,23,9,OUI,OUI,2025-03-13 16:02:14+00:00,"48.869228052648, 2.324421107769",Paris,75056,0.7619047619047619,16
15039,Abbé Groult - Convention,OUI,12,9,3,0,3,OUI,OUI,2025-03-13 16:01:31+00:00,"48.83596927866069, 2.302064039509349",Paris,75056,0.25,16
48004,Maxime Gorki - Louis Aragon,OUI,20,19,1,1,0,OUI,OUI,2025-03-13 15:58:21+00:00,"48.78909814728443, 2.368387877941132",Villejuif,94076,0.05,16
23102,Hôtel de Ville de Sèvres,OUI,31,18,13,12,1,OUI,OUI,2025-03-13 16:02:11+00:00,"48.824363561289, 2.2131047397852",Sèvres,92072,0.41935483870967744,16
26004,Gare RER les Grésillons,OUI,22,18,4,4,0,OUI,OUI,2025-03-13 16:00:12+00:00,"48.919898633572764, 2.31458459136273",Asnières-sur-Seine,92004,0.18181818181818182,16
6022,Marché Saint-Germain,OUI,19,7,12,9,3,OUI,OUI,2025-03-13 16:00:49+00:00,"48.85165625855281, 2.335500307381153",Paris,75056,0.631578947368421,16
18139,Poissonniers - Championnet,OUI,28,26,2,1,1,OUI,OUI,2025-03-13 15:58:45+00:00,"48.89543299733937, 2.3530178144574165",Paris,75056,0.07142857142857142,16
13018,Bruant - Vincent Auriol,OUI,25,10,15,13,2,OUI,OUI,2025-03-13 16:02:15+00:00,"48.834848452929, 2.3668264996271",Paris,75056,0.6,16
1006,Grande Truanderie - Saint-Denis,OUI,28,6,22,16,6,OUI,OUI,2025-03-13 16:01:27+00:00,"48.8626302, 2.3498075",Paris,75056,0.7857142857142857,16
21303,Jean Monnet - Iles,OUI,32,3,29,26,3,OUI,OUI,2025-03-13 16:02:13+00:00,"48.823393984057304, 2.2497073194874866",Issy-les-Moulineaux,92040,0.90625,16
15001,Gare Montparnasse - Arrivée,OUI,41,27,14,7,7,OUI,OUI,2025-03-13 16:02:06+00:00,"48.843827994315, 2.3225811123848",Paris,75056,0.34146341463414637,16
33014,Parc Eli Lotar,OUI,19,14,5,4,1,OUI,OUI,2025-03-13 16:01:30+00:00,"48.91844993053703, 2.3727085813879967",Aubervilliers,93001,0.2631578947368421,16
15008,Sèvres - Lecourbe,OUI,60,44,16,16,0,OUI,OUI,2025-03-13 15:59:46+00:00,"48.8447677, 2.3110086",Paris,75056,0.26666666666666666,16
9007,Condorcet - Turgot,OUI,19,13,6,4,2,OUI,OUI,2025-03-13 15:58:25+00:00,"48.87985155789093, 2.345232367515564",Paris,75056,0.3157894736842105,16
19110,Square Claude Bernard,OUI,29,19,10,7,3,OUI,OUI,2025-03-13 15:59:59+00:00,"48.89876016219984, 2.375325746834278",Paris,75056,0.3448275862068966,16
15127,Place Charles Michels,OUI,35,10,25,21,4,OUI,OUI,2025-03-13 15:58:08+00:00,"48.846401, 2.28502",Paris,75056,0.7142857142857143,16
3008,Perle - Vieille du Temple,OUI,35,7,28,23,5,OUI,OUI,2025-03-13 16:01:53+00:00,"48.8601346, 2.3611206",Paris,75056,0.8,16
33103,Jean Jaurès - Jules Jacquemin,OUI,22,20,2,0,2,OUI,OUI,2025-03-13 16:01:10+00:00,"48.88433053604843, 2.4082902455152104",Le Pré-Saint-Gervais,93061,0.09090909090909091,16
6010,Chevreuse - Montparnasse,OUI,15,15,0,0,0,OUI,OUI,2025-03-13 16:01:42+00:00,"48.841739161231, 2.3315522167367",Paris,75056,0.0,16
14032,Mairie du 14ème,OUI,32,31,1,0,1,OUI,OUI,2025-03-13 15:59:20+00:00,"48.83254578123, 2.3254923149943",Paris,75056,0.03125,16
45002,Roger Salengro - Général de Gaulle,OUI,27,16,11,4,7,OUI,OUI,2025-03-13 15:59:20+00:00,"48.820029010376956, 2.4846760556101803",Champigny-sur-Marne,94017,0.4074074074074074,16
20044,Davout - Volga,OUI,27,27,0,0,0,OUI,OUI,2025-03-13 15:56:45+00:00,"48.852919679957296, 2.410522909779111",Paris,75056,0.0,16
15128,Cadix - Hameau,OUI,36,34,2,1,1,OUI,OUI,2025-03-13 15:59:50+00:00,"48.8340107632249, 2.289516180753708",Paris,75056,0.05555555555555555,16
33012,Landy - Heurtault,OUI,29,25,4,1,3,OUI,OUI,2025-03-13 16:00:09+00:00,"48.915096534520316, 2.375951372087002",Aubervilliers,93001,0.13793103448275862,16
44014,Camille Risch - Paul Armangot,OUI,25,18,7,4,3,OUI,OUI,2025-03-13 15:55:19+00:00,"48.774703, 2.373685",Vitry-sur-Seine,94081,0.28,16
3102,Bourg l'Abbé - Saint-Martin,OUI,36,0,36,22,14,OUI,OUI,2025-03-13 16:01:48+00:00,"48.86393331949257, 2.352406270802021",Paris,75056,1.0,16
12037,Reuilly - Daumesnil,OUI,35,33,2,0,2,OUI,OUI,2025-03-13 15:54:12+00:00,"48.8395385, 2.3972516",Paris,75056,0.05714285714285714,16
11033,Bréguet - Sabin,OUI,29,6,23,15,8,OUI,OUI,2025-03-13 15:58:19+00:00,"48.856931678257, 2.3706749462105",Paris,75056,0.7931034482758621,16
18004,Place des Abbesses,OUI,12,10,2,0,2,OUI,OUI,2025-03-13 15:58:54+00:00,"48.884542726149725, 2.3386867716908455",Paris,75056,0.16666666666666666,16
18039,Jardins d'Eole,OUI,19,18,1,0,1,OUI,OUI,2025-03-13 15:59:06+00:00,"48.8869703, 2.3668488",Paris,75056,0.05263157894736842,16
20001,Place de la Nation - Charonne,OUI,35,34,1,0,1,OUI,OUI,2025-03-13 15:57:49+00:00,"48.848364667777, 2.3997623859813",Paris,75056,0.02857142857142857,16
20008,Pyrénées - Avron,OUI,31,29,2,1,1,OUI,OUI,2025-03-13 15:59:51+00:00,"48.853246898211985, 2.405871044529538",Paris,75056,0.06451612903225806,16
20022,Porte de Bagnolet,OUI,33,32,1,0,1,OUI,OUI,2025-03-13 16:01:44+00:00,"48.864707139122984, 2.408344637349607",Paris,75056,0.030303030303030304,16
18034,Leibniz - Jean Dollfus,OUI,32,32,0,0,0,OUI,OUI,2025-03-13 16:01:40+00:00,"48.896328348515986, 2.333390423834684",Paris,75056,0.0,16
12036,Reuilly - Place Felix Eboue,OUI,41,41,0,0,0,OUI,OUI,2025-03-13 16:00:21+00:00,"48.84030274499962, 2.394630398715453",Paris,75056,0.0,16
12019,Gare de Reuilly - Picpus,OUI,27,26,1,0,1,OUI,OUI,2025-03-13 15:54:10+00:00,"48.84267354116789, 2.3972943797707558",Paris,75056,0.037037037037037035,16
14026,Plantes - Moulin Vert,OUI,45,42,3,0,3,OUI,OUI,2025-03-13 16:00:53+00:00,"48.83005755305626, 2.3232302069664006",Paris,75056,0.06666666666666667,16
8110,Gare Saint-Lazare - Stockholm,OUI,31,21,10,1,9,OUI,OUI,2025-03-13 15:55:19+00:00,"48.877127316667654, 2.322417162358761",Paris,75056,0.3225806451612903,16
10008,Cité Riverin - Château d'Eau,OUI,17,7,10,9,1,OUI,OUI,2025-03-13 16:01:14+00:00,"48.870702423554306, 2.358739863900845",Paris,75056,0.5882352941176471,16
20024,Gambetta - Père Lachaise,OUI,27,26,1,0,1,OUI,OUI,2025-03-13 15:56:57+00:00,"48.864295696165875, 2.398228667282044",Paris,75056,0.037037037037037035,16
16012,Flandrin - Longchamp,OUI,40,13,27,10,17,OUI,OUI,2025-03-13 16:00:30+00:00,"48.86877849178477, 2.274354539176829",Paris,75056,0.675,16
12156,Niger - Soult,OUI,23,19,4,1,3,OUI,OUI,2025-03-13 16:00:56+00:00,"48.84369906369085, 2.410361237220498",Paris,75056,0.17391304347826086,16
42505,Charles Frérot - Albert Guilpin,OUI,29,25,4,3,1,OUI,OUI,2025-03-13 16:01:14+00:00,"48.8155839183714, 2.3505029082298283",Gentilly,94037,0.13793103448275862,16
9009,Square Montholon,OUI,17,6,11,1,10,OUI,OUI,2025-03-13 15:58:29+00:00,"48.876620377545024, 2.3457641154527664",Paris,75056,0.6470588235294118,16
10032,Claude Vellefaux - Hôpital Saint-Louis,OUI,32,28,4,3,1,OUI,OUI,2025-03-13 15:59:30+00:00,"48.872859139003, 2.3700717069851",Paris,75056,0.125,16
6104,Herschel - Observatoire,OUI,34,32,2,0,2,OUI,OUI,2025-03-13 16:00:57+00:00,"48.84342376221923, 2.3376645147800446",Paris,75056,0.058823529411764705,16
12015,Place de la Nation - Picpus,OUI,35,34,1,0,1,OUI,OUI,2025-03-13 16:02:01+00:00,"48.846821681548, 2.4001130461693",Paris,75056,0.02857142857142857,16
21309,Mairie d'Issy,OUI,39,24,15,13,2,OUI,OUI,2025-03-13 16:01:36+00:00,"48.823767792468, 2.2723111510277",Issy-les-Moulineaux,92040,0.38461538461538464,16
14001,Edgar Quinet - Gaité,OUI,27,18,9,0,9,OUI,OUI,2025-03-13 15:57:37+00:00,"48.841160928966, 2.324595451355",Paris,75056,0.3333333333333333,16
4021,Centre Georges Pompidou,OUI,26,2,24,22,2,OUI,OUI,2025-03-13 16:01:41+00:00,"48.861419, 2.352581",Paris,75056,0.9230769230769231,16
16042,Murat - Porte de Saint-Cloud,OUI,38,2,36,33,3,OUI,OUI,2025-03-13 15:59:23+00:00,"48.83750862621299, 2.2577651962637906",Paris,75056,0.9473684210526315,16
20034,Sorbier - Ménilmontant,OUI,24,23,1,0,1,OUI,OUI,2025-03-13 16:02:16+00:00,"48.868542395661, 2.3897721245885",Paris,75056,0.041666666666666664,16
22201,Henri Ravera - Gabriel Péri,OUI,28,24,4,0,4,OUI,OUI,2025-03-13 16:02:14+00:00,"48.79722273833844, 2.302115857601166",Bagneux,92007,0.14285714285714285,16
13005,Cordelières - Arago,OUI,45,18,27,26,1,OUI,OUI,2025-03-13 16:00:38+00:00,"48.83548071896613, 2.348572461702221",Paris,75056,0.6,16
11112,Jules Vallès - Charonne,OUI,23,9,14,8,6,OUI,OUI,2025-03-13 16:01:47+00:00,"48.854284379935, 2.3847674578428",Paris,75056,0.6086956521739131,16
19002,Centquatre,OUI,38,27,11,6,5,NON,NON,2025-03-13 15:56:49+00:00,"48.889333538455, 2.3707854375243",Paris,75056,0.2894736842105263,16
5007,Ecoles - Carmes,OUI,34,3,31,18,13,OUI,OUI,2025-03-13 16:00:25+00:00,"48.848904447989405, 2.3473486304283147",Paris,75056,0.9117647058823529,16
17019,Phalsbourg - Villiers,OUI,19,10,9,7,2,OUI,OUI,2025-03-13 16:02:14+00:00,"48.88242307900951, 2.3090453445911407",Paris,75056,0.47368421052631576,16
16105,Crevaux - Bugeaud,OUI,31,27,4,0,4,OUI,OUI,2025-03-13 15:57:07+00:00,"48.87080942867, 2.2811490076919",Paris,75056,0.12903225806451613,16
19201,Petit - Georges Thill,OUI,23,19,4,1,3,OUI,OUI,2025-03-13 16:01:19+00:00,"48.88603131999171, 2.3895753175020222",Paris,75056,0.17391304347826086,16
4006,Bourdon - Pont Morland,OUI,51,21,30,26,4,OUI,OUI,2025-03-13 16:02:05+00:00,"48.8478103, 2.3659356",Paris,75056,0.5882352941176471,16
10009,Mairie du 10ème,OUI,18,2,16,11,5,OUI,OUI,2025-03-13 16:00:23+00:00,"48.872089449907, 2.3575825989246",Paris,75056,0.8888888888888888,16
18202,Diane Arbus,OUI,37,34,3,1,2,OUI,OUI,2025-03-13 16:00:08+00:00,"48.898800717199, 2.3524022474885",Paris,75056,0.08108108108108109,16
22301,Chausson - Gabriel Péri,OUI,20,12,8,7,1,OUI,OUI,2025-03-13 16:02:09+00:00,"48.921891003481115, 2.2952306270599365",Gennevilliers,92036,0.4,16
5015,Epée de Bois - Mouffetard,OUI,63,54,9,8,1,OUI,OUI,2025-03-13 15:59:44+00:00,"48.841508690388835, 2.350066713988781",Paris,75056,0.14285714285714285,16
41405,Place de l'Europe - Alfortville,OUI,24,3,21,18,3,OUI,OUI,2025-03-13 15:58:45+00:00,"48.78913702405837, 2.4284800887107854",Alfortville,94002,0.875,16
1007,Turbigo - Française,OUI,16,5,11,7,4,OUI,OUI,2025-03-13 16:01:28+00:00,"48.86358858111446, 2.3477794602513313",Paris,75056,0.6875,16
8028,Arsène Houssaye - Champs-Elysées,OUI,28,11,17,0,17,OUI,OUI,2025-03-13 16:02:05+00:00,"48.873409276267, 2.2977904602885",Paris,75056,0.6071428571428571,16
47003,Charentonneau - Maisons Alfort,OUI,20,14,6,3,3,OUI,OUI,2025-03-13 16:00:51+00:00,"48.809932980484355, 2.443288456496946",Maisons-Alfort,94046,0.3,16
10011,Bourse du Travail,OUI,17,15,2,2,0,OUI,OUI,2025-03-13 16:00:28+00:00,"48.868976638826, 2.3623438552022",Paris,75056,0.11764705882352941,16
16013,Mairie du 16ème,OUI,35,34,1,1,0,OUI,OUI,2025-03-13 16:00:19+00:00,"48.863936848471994, 2.2765953093767166",Paris,75056,0.02857142857142857,16
21953,Gare de Bellevue,OUI,20,18,2,0,2,OUI,OUI,2025-03-13 16:02:12+00:00,"48.8192404685572, 2.2295309230685234",Meudon,92048,0.1,16
7012,Cité Vaneau,OUI,23,11,12,11,1,OUI,OUI,2025-03-13 15:58:31+00:00,"48.8542210666207, 2.319614924490452",Paris,75056,0.5217391304347826,16
14019,Sarrette - Général Leclerc,OUI,22,19,3,0,3,OUI,OUI,2025-03-13 16:00:40+00:00,"48.825030852925, 2.3264128693982",Paris,75056,0.13636363636363635,16
20104,Louis Lumière.,OUI,22,21,1,1,0,OUI,OUI,2025-03-13 15:58:49+00:00,"48.86216198070008, 2.41112578185621",Paris,75056,0.045454545454545456,16
31709,Place de la Fraternité,OUI,22,21,1,1,0,OUI,OUI,2025-03-13 15:57:57+00:00,"48.85716405838368, 2.422847449779511",Montreuil,93048,0.045454545454545456,16
14135,Jourdan - Cité Universitaire,OUI,38,34,4,2,2,OUI,OUI,2025-03-13 15:56:42+00:00,"48.819897343156676, 2.3397007964124366",Paris,75056,0.10526315789473684,16
10006,Petites Ecuries - Faubourg Saint-Denis,OUI,27,21,6,3,3,OUI,OUI,2025-03-13 16:01:13+00:00,"48.87287120589831, 2.3542150855064397",Paris,75056,0.2222222222222222,16
3010,Beaubourg - Michel-le-Comte,OUI,15,0,15,11,4,OUI,OUI,2025-03-13 15:59:30+00:00,"48.862534941806, 2.3543103039265",Paris,75056,1.0,16
12002,Lacuée - Lyon,OUI,16,2,14,11,3,OUI,OUI,2025-03-13 16:01:57+00:00,"48.849268481958, 2.3704585433006",Paris,75056,0.875,16
18140,Porte de Clignancourt - Ney,OUI,38,36,2,1,1,OUI,OUI,2025-03-13 15:59:43+00:00,"48.899641123987095, 2.344321422278881",Paris,75056,0.05263157894736842,16
21506,Maurice Payret-Dortail,OUI,22,21,1,0,1,OUI,OUI,2025-03-13 15:54:13+00:00,"48.87811957063342, 2.2233625128865246",Suresnes,92073,0.045454545454545456,16
4103,Archives - Rivoli,OUI,21,2,19,11,8,OUI,OUI,2025-03-13 16:01:48+00:00,"48.857346707443, 2.3539767041802",Paris,75056,0.9047619047619048,16
10034,Louis Blanc - La Chapelle,OUI,21,21,0,0,0,OUI,OUI,2025-03-13 15:55:23+00:00,"48.884008964514, 2.3599335551262",Paris,75056,0.0,16
14103,Maine - Liancourt,OUI,25,19,6,0,6,OUI,OUI,2025-03-13 15:56:26+00:00,"48.835064363954, 2.323731449974",Paris,75056,0.24,16
16102,Pergolèse - Marbeau,OUI,26,21,5,0,5,OUI,OUI,2025-03-13 15:56:12+00:00,"48.873568706869, 2.2815125225299",Paris,75056,0.19230769230769232,16
9037,Parme - Clichy,OUI,23,20,3,1,2,OUI,OUI,2025-03-13 15:53:46+00:00,"48.881266424227, 2.3281970934506",Paris,75056,0.13043478260869565,16
19010,Emile Reynaud - Porte de la Villette,OUI,22,15,7,3,4,OUI,OUI,2025-03-13 16:01:08+00:00,"48.90098953630053, 2.3887022584676743",Paris,75056,0.3181818181818182,16
7021,Bosquet - Saint-Dominique,OUI,27,22,5,4,1,OUI,OUI,2025-03-13 15:55:19+00:00,"48.858651709526, 2.3037165802346",Paris,75056,0.18518518518518517,16
15132,Bargue -  Dutot,OUI,21,16,5,4,1,OUI,OUI,2025-03-13 15:59:37+00:00,"48.837884, 2.308876",Paris,75056,0.23809523809523808,16
2015,Louis le Grand - Italiens,OUI,33,11,22,16,6,OUI,OUI,2025-03-13 16:01:33+00:00,"48.870508937204, 2.3340544619393",Paris,75056,0.6666666666666666,16
20006,Pyrénées - Plaine,OUI,12,12,0,0,0,OUI,OUI,2025-03-13 16:01:49+00:00,"48.85026702458, 2.4062821269035",Paris,75056,0.0,16
19129,Solitaires - Place des Fêtes,OUI,29,29,0,0,0,NON,NON,2025-02-23 09:26:05+00:00,"48.876601, 2.391769",Paris,75056,0.0,9
14137,Maurice d'Ocagne - General Maudhuy,OUI,29,25,4,1,3,OUI,OUI,2025-03-13 15:58:06+00:00,"48.82414282524159, 2.3158789426088333",Paris,75056,0.13793103448275862,16
20029,Frères Flavien - Porte des Lilas,OUI,23,23,0,0,0,OUI,OUI,2025-03-13 15:57:11+00:00,"48.8780992764359, 2.41104629853209",Paris,75056,0.0,16
3011,Turbigo - Réaumur,OUI,31,7,24,22,2,OUI,OUI,2025-03-13 16:02:03+00:00,"48.865574047531, 2.3564198613167",Paris,75056,0.7741935483870968,16
1102,Française - Etienne Marcel,OUI,36,2,34,23,11,OUI,OUI,2025-03-13 16:01:56+00:00,"48.864053304653766, 2.347587011754513",Paris,75056,0.9444444444444444,16
10027,Dunkerque - Alsace,OUI,20,20,0,0,0,OUI,OUI,2025-03-13 16:00:28+00:00,"48.879355, 2.358379",Paris,75056,0.0,16
13017,Nationale - Vincent Auriol,OUI,33,26,7,2,5,OUI,OUI,2025-03-13 16:02:16+00:00,"48.83252708397293, 2.362354410392119",Paris,75056,0.21212121212121213,16
22401,Charles de Gaulle - Plateau de Vanves,OUI,32,31,1,0,1,OUI,OUI,2025-03-13 15:53:31+00:00,"48.82233088973263, 2.298571803412886",Malakoff,92046,0.03125,16
15111,Olivier de Serres - Leriche,OUI,24,22,2,0,2,OUI,OUI,2025-03-13 15:56:16+00:00,"48.83460221715206, 2.2957482933998112",Paris,75056,0.08333333333333333,16
3001,Beaumarchais - Saint-Gilles,OUI,44,36,8,5,3,OUI,OUI,2025-03-13 16:02:04+00:00,"48.8580378, 2.3679352",Paris,75056,0.18181818181818182,16
12020,Cours de Vincennes - Soult,OUI,44,42,2,1,1,OUI,OUI,2025-03-13 15:57:11+00:00,"48.846918761569, 2.4105220288038",Paris,75056,0.045454545454545456,16
21026,Sèvres - Général Leclerc,OUI,29,10,19,16,3,OUI,OUI,2025-03-13 16:01:54+00:00,"48.830121559055, 2.2314262390137",Boulogne-Billancourt,92012,0.6551724137931034,16
2021,Cléry - Montmartre,OUI,58,39,19,12,7,OUI,OUI,2025-03-13 16:01:48+00:00,"48.867458, 2.3445211",Paris,75056,0.3275862068965517,16
32013,Saint-Denis - Université,OUI,18,13,5,3,2,OUI,OUI,2025-03-13 15:57:31+00:00,"48.94563430946964, 2.3638297989964485",Saint-Denis,93066,0.2777777777777778,16
14132,Bézout - Général Leclerc,OUI,28,23,5,1,4,OUI,OUI,2025-03-13 16:01:37+00:00,"48.82884804502439, 2.3285973072052",Paris,75056,0.17857142857142858,16
2003,Saint-Denis - Réaumur,OUI,31,3,28,16,12,OUI,OUI,2025-03-13 16:01:54+00:00,"48.8661116315789, 2.3507790675507594",Paris,75056,0.9032258064516129,16
4014,Blancs-Manteaux - Archives,OUI,29,7,22,18,4,OUI,OUI,2025-03-13 15:59:49+00:00,"48.85941800703, 2.3559471219778",Paris,75056,0.7586206896551724,16
22503,Joffre - Aigle,OUI,19,12,7,5,2,OUI,OUI,2025-03-13 16:01:14+00:00,"48.904033, 2.245096",La Garenne-Colombes,92035,0.3684210526315789,16
3012,Square Emile - Chautemps,OUI,24,5,19,14,5,OUI,OUI,2025-03-13 15:59:59+00:00,"48.867433724231, 2.3536357283592",Paris,75056,0.7916666666666666,16
24006,Adolphe Lalyre - Armand Silvestre,OUI,38,35,3,2,1,OUI,OUI,2025-03-13 15:59:56+00:00,"48.90406266961591, 2.273416221141815",Courbevoie,92026,0.07894736842105263,16
14022,Didot - Mariniers,OUI,35,35,0,0,0,OUI,OUI,2025-03-13 15:56:32+00:00,"48.82650543613106, 2.313136198271666",Paris,75056,0.0,16
3009,Temple - Haudriettes,OUI,19,5,14,9,5,OUI,OUI,2025-03-13 16:02:13+00:00,"48.861636880212, 2.3566960206458",Paris,75056,0.7368421052631579,16
31001,Lagny - Auguste Blanqui,OUI,26,12,14,14,0,OUI,OUI,2025-03-13 16:00:28+00:00,"48.84922568052601, 2.4218603968620305",Montreuil,93048,0.5384615384615384,16
2005,Montmartre - Etienne Marcel,OUI,16,3,13,13,0,OUI,OUI,2025-03-13 15:59:50+00:00,"48.86502194581, 2.3450684401448",Paris,75056,0.8125,16
21507,Gardenat-Lapostol - Velettes,OUI,20,14,6,1,5,OUI,OUI,2025-03-13 15:56:11+00:00,"48.87387, 2.224185",Suresnes,92073,0.3,16
23702,Hôtel de Ville de Chaville,OUI,20,20,0,0,0,OUI,OUI,2025-03-13 15:59:21+00:00,"48.80887149094033, 2.188134044408798",Chaville,92022,0.0,16
22306,Place du 17 Octobre,OUI,16,10,6,4,2,OUI,OUI,2025-03-13 16:01:48+00:00,"48.91962690034779, 2.2978286134199792",Gennevilliers,92036,0.375,16
2002,Etienne Marcel - Montorgueil,OUI,25,1,24,16,8,OUI,OUI,2025-03-13 16:01:11+00:00,"48.86450567259199, 2.3461959511041637",Paris,75056,0.96,16
19012,Lally-Tollendal - Armand Carrel,OUI,27,26,1,0,1,OUI,OUI,2025-03-13 15:52:40+00:00,"48.88270066221072, 2.374717555940151",Paris,75056,0.037037037037037035,16
4015,Mairie du 4ème,OUI,41,1,40,36,4,OUI,OUI,2025-03-13 16:01:53+00:00,"48.855949910497, 2.3563823103905",Paris,75056,0.975609756097561,16
14023,Adolphe Pinard - Victor Hugo,OUI,51,45,6,1,5,OUI,OUI,2025-03-13 15:55:02+00:00,"48.8236825874564, 2.3077843710780144",Malakoff,92046,0.11764705882352941,16
19111,Cesaria Evora - Rosa Parks,OUI,36,27,9,4,5,OUI,OUI,2025-03-13 16:02:03+00:00,"48.89717672825043, 2.3745173960924144",Paris,75056,0.25,16
22502,Kléber - National,OUI,20,18,2,1,1,OUI,OUI,2025-03-13 16:00:29+00:00,"48.906333898712234, 2.2393910586833954",La Garenne-Colombes,92035,0.1,16
9111,Victoire - Laffitte,OUI,19,4,15,14,1,OUI,OUI,2025-03-13 16:00:25+00:00,"48.87514373494672, 2.338118505144376",Paris,75056,0.7894736842105263,16
3006,Mairie du 3ème,OUI,24,1,23,19,4,OUI,OUI,2025-03-13 16:02:16+00:00,"48.86446178139141, 2.361762821674347",Paris,75056,0.9583333333333334,16
5122,Saint-Michel - Luxembourg,OUI,28,27,1,0,1,OUI,OUI,2025-03-13 16:02:00+00:00,"48.84501507626, 2.3394941166043",Paris,75056,0.03571428571428571,16
3003,Fille du Calvaire - Turenne,OUI,26,1,25,20,5,OUI,OUI,2025-03-13 15:58:32+00:00,"48.86210505412563, 2.3649600148200993",Paris,75056,0.9615384615384616,16
13125,Gare d'Austerlitz - Pont Charles de Gaulle,OUI,53,13,40,30,10,OUI,OUI,2025-03-13 16:01:41+00:00,"48.842319830109, 2.3670300096273",Paris,75056,0.7547169811320755,16
6031,Pierre Sarrazin - Saint-Michel,OUI,31,6,25,18,7,OUI,OUI,2025-03-13 16:01:44+00:00,"48.850908146398, 2.342130728066",Paris,75056,0.8064516129032258,16
21110,Parc Roger Salengro,OUI,30,6,24,21,3,OUI,OUI,2025-03-13 16:01:50+00:00,"48.905303858642, 2.31055945158",Clichy,92024,0.8,16
21215,Verdier - Jean Jaurès,OUI,32,32,0,0,0,OUI,OUI,2025-03-13 16:00:41+00:00,"48.81614048711214, 2.3123561963438988",Montrouge,92049,0.0,16
8036,Lisbonne - Monceau,OUI,46,8,38,15,23,OUI,OUI,2025-03-13 15:59:35+00:00,"48.877455676814, 2.3096942214195",Paris,75056,0.8260869565217391,16
41208,Alouettes - Maréchal de Lattre de Tassigny,OUI,21,12,9,2,7,OUI,OUI,2025-03-13 16:02:10+00:00,"48.85511009293948, 2.4930700287222862",Fontenay-sous-Bois,94033,0.42857142857142855,16
48005,Eugène Varlin - Place de la Paix,OUI,23,22,1,1,0,OUI,OUI,2025-03-13 16:00:29+00:00,"48.792862, 2.363093",Villejuif,94076,0.043478260869565216,16
1014,Rivoli - Musée du Louvre,OUI,22,0,22,11,11,OUI,OUI,2025-03-13 16:02:13+00:00,"48.86364636851945, 2.33409583568573",Paris,75056,1.0,16
14133,Froidevaux - Boulard,OUI,35,33,2,0,2,OUI,OUI,2025-03-13 16:01:18+00:00,"48.835147319625, 2.3294411972165",Paris,75056,0.05714285714285714,16
12163,Hippodrome Paris-Vincennes,OUI,42,41,1,0,1,OUI,OUI,2025-03-13 16:01:50+00:00,"48.82048387758518, 2.446271181106568",Paris,75056,0.023809523809523808,16
4012,Tiron - Rivoli,OUI,26,5,21,18,3,OUI,OUI,2025-03-13 16:02:13+00:00,"48.855692253233, 2.3579058051109",Paris,75056,0.8076923076923077,16
3002,Saint-Gilles - Turenne,OUI,13,1,12,5,7,OUI,OUI,2025-03-13 16:01:29+00:00,"48.858158956779, 2.3647149920992",Paris,75056,0.9230769230769231,16
42704,Mairie du Kremlin-Bicêtre,OUI,25,25,0,0,0,OUI,OUI,2025-03-13 15:58:32+00:00,"48.81191981537702, 2.3570189997553825",Le Kremlin-Bicêtre,94043,0.0,16
2016,Aboukir - Alexandrie,OUI,21,10,11,10,1,OUI,OUI,2025-03-13 16:01:48+00:00,"48.86868344444473, 2.3502043269474897",Paris,75056,0.5238095238095238,16
21706,Jean Bleuzen - Square du 11 Novembre,OUI,45,44,1,0,1,OUI,OUI,2025-03-13 15:54:56+00:00,"48.8232579, 2.2965213",Vanves,92075,0.022222222222222223,16
44001,Quai Jules Guesde - Saint-Simon,OUI,30,4,26,26,0,OUI,OUI,2025-03-13 16:01:23+00:00,"48.80391487219, 2.4089661620274",Vitry-sur-Seine,94081,0.8666666666666667,16
4017,Place de l'Hôtel de Ville,OUI,12,1,11,10,1,OUI,OUI,2025-03-13 16:01:08+00:00,"48.8573314, 2.351458",Paris,75056,0.9166666666666666,16
5004,Saint-Jacques - Val de Grâce,OUI,19,14,5,0,5,OUI,OUI,2025-03-13 16:02:16+00:00,"48.8417514, 2.3413893",Paris,75056,0.2631578947368421,16
26006,Bas - Gabriel Péri,OUI,30,15,15,15,0,OUI,OUI,2025-03-13 16:02:02+00:00,"48.91585580539625, 2.2948095202445984",Asnières-sur-Seine,92004,0.5,16
4009,Village Saint-Paul,OUI,27,1,26,23,3,OUI,OUI,2025-03-13 16:00:56+00:00,"48.852639866625, 2.3607301712036",Paris,75056,0.9629629629629629,16
42211,Séminaire de Conflans - Liberté,OUI,25,12,13,8,5,OUI,OUI,2025-03-13 16:01:42+00:00,"48.823194, 2.404179",Charenton-le-Pont,94018,0.52,16
10041,Gare du Nord - La Chapelle,OUI,18,16,2,0,2,OUI,OUI,2025-03-13 15:54:32+00:00,"48.884178287286, 2.3561057075858",Paris,75056,0.1111111111111111,16
42026,Barbès - Monique Maunoury,OUI,40,35,5,1,4,OUI,OUI,2025-03-13 15:56:43+00:00,"48.81552718820216, 2.3687169334905405",Ivry-sur-Seine,94041,0.125,16
4101,Bastille - Beaumarchais,OUI,19,0,19,19,0,OUI,OUI,2025-03-13 16:00:51+00:00,"48.853833463852, 2.3685702681541",Paris,75056,1.0,16
2012,Choiseul - Quatre Septembre,OUI,44,13,31,12,19,OUI,OUI,2025-03-13 16:01:34+00:00,"48.8699355331869, 2.3359975218772893",Paris,75056,0.7045454545454546,16
33020,Waldeck Rochet - Germaine Tillon,OUI,30,12,18,16,2,OUI,OUI,2025-03-13 16:01:19+00:00,"48.91105960199651, 2.3676301538944244",Aubervilliers,93001,0.6,16
21509,Gardenat Lapostol - Franklin Roosevelt,OUI,24,19,5,0,5,OUI,OUI,2025-03-13 15:58:14+00:00,"48.871839, 2.222505",Suresnes,92073,0.20833333333333334,16
32019,Place du 8 mai 1945.,OUI,28,20,8,5,3,OUI,OUI,2025-03-13 15:59:14+00:00,"48.938882272105, 2.3566243797541",Saint-Denis,93066,0.2857142857142857,16
13054,Pau Casals - Neuve Tolbiac,OUI,53,10,43,25,18,OUI,OUI,2025-03-13 16:02:11+00:00,"48.8311602, 2.3774395",Paris,75056,0.8113207547169812,16
1018,Alger - Rivoli,OUI,17,4,13,8,5,OUI,OUI,2025-03-13 15:56:55+00:00,"48.864773553495, 2.3294493936128",Paris,75056,0.7647058823529411,16
1012,Jean-Jacques Rousseau - Deux Ecus,OUI,21,2,19,15,4,OUI,OUI,2025-03-13 15:59:58+00:00,"48.86297805972131, 2.3414635285735126",Paris,75056,0.9047619047619048,16
2008,Mairie du 2ème,OUI,28,6,22,15,7,OUI,OUI,2025-03-13 15:58:10+00:00,"48.8672190355135, 2.3404625437747044",Paris,75056,0.7857142857142857,16
2004,Square Pierre Lazareff,OUI,17,7,10,4,6,OUI,OUI,2025-03-13 16:01:03+00:00,"48.867141720746, 2.3483933508396",Paris,75056,0.5882352941176471,16
1026,Place du Lieutenant Henri Karcher,OUI,29,5,24,19,5,OUI,OUI,2025-03-13 16:01:58+00:00,"48.863490871724466, 2.3400671035051346",Paris,75056,0.8275862068965517,16
19130,Place Paul Delouvrier,OUI,26,22,4,1,3,OUI,OUI,2025-03-13 15:59:17+00:00,"48.89197621431365, 2.3851288855075836",Paris,75056,0.15384615384615385,16
18015,Custine - Ramey,OUI,40,38,2,1,1,OUI,OUI,2025-03-13 15:54:30+00:00,"48.888735896947, 2.3469526693225",Paris,75056,0.05,16
35012,Candale - Mehul,OUI,25,23,2,0,2,OUI,OUI,2025-03-13 16:01:38+00:00,"48.8893935006175, 2.414379715919495",Pantin,93055,0.08,16
17106,Berthier - Porte de Clichy,OUI,24,20,4,4,0,OUI,OUI,2025-03-13 16:00:24+00:00,"48.894222687781, 2.3125872006816",Paris,75056,0.16666666666666666,16
21505,Édouard Vaillant - Place Jean Jaurès,OUI,20,14,6,2,4,OUI,OUI,2025-03-13 15:57:41+00:00,"48.86265537999924, 2.2089037319128613",Suresnes,92073,0.3,16
32024,Port - Confluence,OUI,23,7,16,4,12,OUI,OUI,2025-03-13 15:58:59+00:00,"48.936093926526, 2.3436167797955",Saint-Denis,93066,0.6956521739130435,16
4018,Saint-Bon - Rivoli,OUI,14,0,14,10,4,OUI,OUI,2025-03-13 16:00:24+00:00,"48.857999643315, 2.3502172809763",Paris,75056,1.0,16
23107,Gare de Sèvres - Ville d'Avray,OUI,22,21,1,1,0,OUI,OUI,2025-03-13 15:56:37+00:00,"48.826262366227, 2.2001516849313",Sèvres,92072,0.045454545454545456,16
16044,Porte de Saint Cloud - Parc des Princes,OUI,31,14,17,13,4,OUI,OUI,2025-03-13 16:01:59+00:00,"48.838662757066, 2.2525164484978",Paris,75056,0.5483870967741935,16
12164,Stade Pershing,OUI,26,26,0,0,0,NON,NON,2025-02-26 05:58:32+00:00,"48.829107826857, 2.4583535268903",Paris,75056,0.0,6
4007,Place de la Bastille - Bourdon,OUI,33,5,28,14,14,OUI,OUI,2025-03-13 16:02:15+00:00,"48.852364355271, 2.3681089282036",Paris,75056,0.8484848484848485,16
1023,Saint-Honoré - Musée du Louvre,OUI,21,2,19,10,9,OUI,OUI,2025-03-13 16:01:36+00:00,"48.863443132848, 2.3348781846405",Paris,75056,0.9047619047619048,16
9039,Chaussée d'Antin - Haussmann,OUI,23,9,14,7,7,OUI,OUI,2025-03-13 16:01:50+00:00,"48.87243, 2.33359",Paris,75056,0.6086956521739131,16
14201,Decrès - Alésia,OUI,30,28,2,0,2,OUI,OUI,2025-03-13 15:56:52+00:00,"48.832200060759, 2.3139070151575",Paris,75056,0.06666666666666667,16
22506,Gare des Vallées,OUI,18,10,8,3,5,OUI,OUI,2025-03-13 15:59:49+00:00,"48.913179, 2.257726",La Garenne-Colombes,92035,0.4444444444444444,16
27001,Square Victor Basch,OUI,19,5,14,11,3,OUI,OUI,2025-03-13 15:59:32+00:00,"48.914304862261, 2.2289156913757",Colombes,92025,0.7368421052631579,16
1025,Oratoire - Rivoli,OUI,17,2,15,8,7,OUI,OUI,2025-03-13 15:55:08+00:00,"48.861342760889, 2.3400047421455",Paris,75056,0.8823529411764706,16
31020,Résistance - Parmentier,OUI,32,25,7,1,6,OUI,OUI,2025-03-13 16:01:29+00:00,"48.85965138131299, 2.436705082654953",Montreuil,93048,0.21875,16
23101,Grande Rue - Europe,OUI,25,17,8,6,2,OUI,OUI,2025-03-13 16:01:51+00:00,"48.8218104687602, 2.205879874527455",Sèvres,92072,0.32,16
35005,Quai de l'Aisne - Général Leclerc,OUI,26,23,3,0,3,OUI,OUI,2025-03-13 15:54:46+00:00,"48.895713, 2.400571",Pantin,93055,0.11538461538461539,16
1116,Ventadour - Opéra,OUI,27,1,26,16,10,OUI,OUI,2025-03-13 16:00:07+00:00,"48.866810653323, 2.3343884482519",Paris,75056,0.9629629629629629,16
42028,Verdun - Carnot,OUI,28,24,4,0,4,OUI,OUI,2025-03-13 16:00:28+00:00,"48.808439376064946, 2.373795211315155",Ivry-sur-Seine,94041,0.14285714285714285,16
1017,Saint-Honoré - 29 juillet,OUI,19,7,12,9,3,OUI,OUI,2025-03-13 16:01:09+00:00,"48.86557114282421, 2.330567417577153",Paris,75056,0.631578947368421,16
12113,Cardinal Lavigerie,OUI,46,9,37,34,3,OUI,OUI,2025-03-13 16:02:01+00:00,"48.832934193699835, 2.402636749399156",Paris,75056,0.8043478260869565,16
15040,Saint-Amand - Labrouste,OUI,34,32,2,1,1,OUI,OUI,2025-03-13 16:01:44+00:00,"48.834097274832295, 2.3087677359581",Paris,75056,0.058823529411764705,16
16010,Belles Feuilles - Place de Mexico,OUI,22,19,3,2,1,OUI,OUI,2025-03-13 16:01:08+00:00,"48.865804746474, 2.2829206287861",Paris,75056,0.13636363636363635,16
6201,Saint Pères - Saint Germain,OUI,21,14,7,5,2,OUI,OUI,2025-03-13 16:01:18+00:00,"48.853729675265, 2.3300181032703",Paris,75056,0.3333333333333333,16
16201,Porte Dauphine,OUI,60,53,7,2,5,OUI,OUI,2025-03-13 16:02:14+00:00,"48.871139344351, 2.2749781616017",Paris,75056,0.11666666666666667,16
6026,Saint-Placide - Cherche Midi,OUI,66,52,14,10,4,OUI,OUI,2025-03-13 16:01:11+00:00,"48.8490535919234, 2.325317971408367",Paris,75056,0.21212121212121213,16
23042,André Theuriet - Blagis,OUI,29,19,10,10,0,OUI,OUI,2025-03-13 15:59:15+00:00,"48.77977325745441, 2.3130525648593903",Bourg-la-Reine,92014,0.3448275862068966,16
22601,Marx Dormoy - Château Sainte-Barbe,OUI,20,17,3,1,2,OUI,OUI,2025-03-13 15:56:42+00:00,"48.791782341055324, 2.297856844961643",Fontenay-aux-Roses,92032,0.15,16
42019,Lampes,OUI,43,3,40,40,0,OUI,OUI,2025-03-13 16:00:59+00:00,"48.81152481985875, 2.4017931148409843",Ivry-sur-Seine,94041,0.9302325581395349,16
42018,Amédée Huon - Fort d'Ivry,OUI,31,29,2,0,2,OUI,OUI,2025-03-13 16:00:25+00:00,"48.805131376899986, 2.388489693403244",Ivry-sur-Seine,94041,0.06451612903225806,16
32020,Jules Guesdes - Carnot,OUI,14,12,2,1,1,OUI,OUI,2025-03-13 15:56:37+00:00,"48.93828169931872, 2.3508992046117783",Saint-Denis,93066,0.14285714285714285,16
48008,Guy Môquet - Parvis Georges Marchais,OUI,30,30,0,0,0,OUI,OUI,2025-03-13 15:52:25+00:00,"48.79518840095975, 2.35943466424942",Villejuif,94076,0.0,16
1015,Place André Malraux,OUI,17,2,15,7,8,OUI,OUI,2025-03-13 16:01:45+00:00,"48.863925158727, 2.3356226831675",Paris,75056,0.8823529411764706,16
19202,Marseillaise - Grenade,OUI,44,39,5,2,3,OUI,OUI,2025-03-13 16:00:02+00:00,"48.889371092747, 2.3979396821544",Paris,75056,0.11363636363636363,16
9019,Victor Massé - Jean-Baptiste Pigalle,OUI,18,9,9,1,8,OUI,OUI,2025-03-13 16:01:39+00:00,"48.8811043724, 2.3366955667734",Paris,75056,0.5,16
5003,Le Goff - Gay-Lussac,OUI,34,9,25,8,17,OUI,OUI,2025-03-13 16:00:38+00:00,"48.846102400979, 2.3412207886577",Paris,75056,0.7352941176470589,16
44004,Place de l'Eglise - Vitry-sur-Seine,OUI,28,4,24,22,2,OUI,OUI,2025-03-13 16:02:04+00:00,"48.791922819921815, 2.395057752728462",Vitry-sur-Seine,94081,0.8571428571428571,16
17021,Jouffroy d'Abbans - Villiers,OUI,31,27,4,3,1,OUI,OUI,2025-03-13 16:00:47+00:00,"48.884215547037, 2.3056533560157",Paris,75056,0.12903225806451613,16
1024,Coquillière - Louvre,OUI,17,5,12,4,8,OUI,OUI,2025-03-13 16:01:47+00:00,"48.863795909662, 2.3425736278296",Paris,75056,0.7058823529411765,16
2020,Danielle Casanova - Opéra,OUI,20,5,15,9,6,OUI,OUI,2025-03-13 16:01:51+00:00,"48.867643242297, 2.3333894088864",Paris,75056,0.75,16
3007,Archives - Pastourelle,OUI,26,3,23,16,7,OUI,OUI,2025-03-13 15:59:13+00:00,"48.8623615, 2.3595041",Paris,75056,0.8846153846153846,16
6029,Vaugirard - Monsieur le Prince,OUI,23,8,15,4,11,OUI,OUI,2025-03-13 16:02:15+00:00,"48.848951441614, 2.3411329463124",Paris,75056,0.6521739130434783,16
28005,Jean Jaurès - Paul Lafargue,OUI,27,5,22,5,17,OUI,OUI,2025-03-13 16:02:16+00:00,"48.884933177666, 2.2484488785267",Puteaux,92062,0.8148148148148148,16
12016,Saint-Mande - Picpus,OUI,33,30,3,3,0,OUI,OUI,2025-03-13 16:01:58+00:00,"48.845127728278, 2.4015686296482",Paris,75056,0.09090909090909091,16
18112,Arthur Ranc - Hôpital Bichat,OUI,23,21,2,1,1,OUI,OUI,2025-03-13 15:57:00+00:00,"48.8978712500682, 2.333521842956543",Paris,75056,0.08695652173913043,16
23301,Les Blagis,OUI,24,10,14,7,7,OUI,OUI,2025-03-13 16:01:43+00:00,"48.785205, 2.302526",Sceaux,92071,0.5833333333333334,16
16139,Suresnes - Muette à Neuilly,OUI,29,23,6,3,3,OUI,OUI,2025-03-13 15:58:06+00:00,"48.868570404348, 2.266000919044",Paris,75056,0.20689655172413793,16
34013,Blanqui - Docteur Bauer,OUI,20,13,7,7,0,OUI,OUI,2025-03-13 16:01:48+00:00,"48.907735489085, 2.3407192814591",Saint-Ouen-sur-Seine,93070,0.35,16
6007,Bréa - Raspail,OUI,24,18,6,1,5,OUI,OUI,2025-03-13 16:00:07+00:00,"48.842738478258, 2.3297942217634",Paris,75056,0.25,16
44008,Youri Gagarine - Commune de Paris,OUI,32,10,22,11,11,OUI,OUI,2025-03-13 16:01:24+00:00,"48.782427463041, 2.3939734697342",Vitry-sur-Seine,94081,0.6875,16
12166,Parc Floral du Bel Air,OUI,24,14,10,7,3,OUI,OUI,2025-03-13 16:00:56+00:00,"48.839285711865735, 2.438560165464878",Paris,75056,0.4166666666666667,16
20140,Paganini - Davout,OUI,21,20,1,0,1,OUI,OUI,2025-03-13 15:58:50+00:00,"48.85135, 2.412021",Paris,75056,0.047619047619047616,16
22603,Place de la Division Leclerc,OUI,33,33,0,0,0,OUI,OUI,2025-03-13 16:01:49+00:00,"48.793824988636516, 2.2731140430551027",Fontenay-aux-Roses,92032,0.0,16
48012,Stalingrad - Henri Luisette,OUI,26,24,2,0,2,OUI,OUI,2025-03-13 15:53:37+00:00,"48.78363092456589, 2.366935946761926",Villejuif,94076,0.07692307692307693,16
21119,Belfort - Victor Hugo,OUI,21,6,15,12,3,OUI,OUI,2025-03-13 15:59:35+00:00,"48.9018492, 2.3172724",Clichy,92024,0.7142857142857143,16
23303,Gare de Robinson,OUI,29,29,0,0,0,OUI,OUI,2025-03-13 15:55:38+00:00,"48.7799259211605, 2.281828634440899",Sceaux,92071,0.0,16
20010,Sorbier - Gasnier-Guy,OUI,34,33,1,0,1,OUI,OUI,2025-03-13 16:01:22+00:00,"48.865217631011, 2.3936596512794",Paris,75056,0.029411764705882353,16
27006,Victor Hugo - Gare,OUI,19,14,5,4,1,OUI,OUI,2025-03-13 15:59:14+00:00,"48.923133952658, 2.2600970417261",Colombes,92025,0.2631578947368421,16
42022,Gare RER - Maurice Grandcoing,OUI,37,11,26,25,1,OUI,OUI,2025-03-13 16:00:15+00:00,"48.813881, 2.392429",Ivry-sur-Seine,94041,0.7027027027027027,16
1008,Les Halles - Saint-Eustache,OUI,32,3,29,12,17,OUI,OUI,2025-03-13 16:01:49+00:00,"48.86362695901683, 2.342623919248581",Paris,75056,0.90625,16
26012,Jardin Modèle - Pierre Boudou,OUI,15,8,7,4,3,OUI,OUI,2025-03-13 16:02:06+00:00,"48.914866710946, 2.3057010525935",Asnières-sur-Seine,92004,0.4666666666666667,16
2006,Place des Victoires,OUI,23,4,19,11,8,OUI,OUI,2025-03-13 16:01:29+00:00,"48.8660354, 2.3420333",Paris,75056,0.8260869565217391,16
10166,Strasbourg - Saint-Denis,OUI,16,10,6,4,2,OUI,OUI,2025-03-13 16:02:14+00:00,"48.869601642433, 2.3542908579111",Paris,75056,0.375,16
19046,Porte de Pantin.,OUI,33,32,1,0,1,OUI,OUI,2025-03-13 15:59:27+00:00,"48.889199725577, 2.3950181901455",Paris,75056,0.030303030303030304,16
6015,André Mazet - Saint-André des Arts,OUI,55,4,51,41,10,OUI,OUI,2025-03-13 16:01:20+00:00,"48.85375581057431, 2.3390958085656166",Paris,75056,0.9272727272727272,16
2102,Saint-Marc - Feydeau,OUI,37,8,29,14,15,OUI,OUI,2025-03-13 16:01:47+00:00,"48.870326843044, 2.3418715826353",Paris,75056,0.7837837837837838,16
32605,Mairie,OUI,20,20,0,0,0,OUI,OUI,2025-03-13 15:57:52+00:00,"48.87914304162, 2.4163350908311",Les Lilas,93045,0.0,16
8202,Londres - Europe,OUI,27,18,9,4,5,OUI,OUI,2025-03-13 16:02:00+00:00,"48.878618556803, 2.3248164693922",Paris,75056,0.3333333333333333,16
10201,Magenta - Chabrol,OUI,23,21,2,0,2,OUI,OUI,2025-03-13 15:57:04+00:00,"48.876495350882, 2.3560990020633",Paris,75056,0.08695652173913043,16
17020,Jouffroy d'Abbans - Malesherbes,OUI,26,18,8,3,5,OUI,OUI,2025-03-13 15:58:39+00:00,"48.8850134, 2.3070717",Paris,75056,0.3076923076923077,16
42210,Victor Hugo - Paul Eluard,OUI,31,1,30,25,5,OUI,OUI,2025-03-13 16:02:07+00:00,"48.819602554907, 2.4114319673051",Charenton-le-Pont,94018,0.967741935483871,16
23206,Béranger - Félix Faure,OUI,26,24,2,0,2,OUI,OUI,2025-03-13 15:56:47+00:00,"48.80404828621485, 2.2848263373723436",Châtillon,92020,0.07692307692307693,16
23104,Quai de Sèvres - Manufacture Nationale,OUI,27,13,14,6,8,OUI,OUI,2025-03-13 15:57:53+00:00,"48.828688, 2.22499",Sèvres,92072,0.5185185185185185,16
8040,Pierre Charron - Champs-Elysées,OUI,30,6,24,9,15,OUI,OUI,2025-03-13 16:00:07+00:00,"48.870103359864, 2.3043501377106",Paris,75056,0.8,16
21011,Silly - Louis Blériot,OUI,23,10,13,7,6,OUI,OUI,2025-03-13 15:59:40+00:00,"48.83219045374266, 2.2340199351310734",Boulogne-Billancourt,92012,0.5652173913043478,16
42030,Stéphanie Bouvard - Gambetta,OUI,30,22,8,5,3,OUI,OUI,2025-03-13 16:01:53+00:00,"48.814548138856, 2.4024386957288",Ivry-sur-Seine,94041,0.26666666666666666,16
15018,Dutot - Place Alleray,OUI,56,49,7,1,6,OUI,OUI,2025-03-13 16:01:26+00:00,"48.836826091766, 2.3071701095578",Paris,75056,0.125,16
20048,Bagnolet - Place Saint-Blaise,OUI,26,21,5,2,3,OUI,OUI,2025-03-13 16:00:38+00:00,"48.85973, 2.40334",Paris,75056,0.19230769230769232,16
48001,Chastenet de Géry - Marcel Paul,OUI,25,21,4,0,4,OUI,OUI,2025-03-13 16:01:01+00:00,"48.800123, 2.3567359",Villejuif,94076,0.16,16
45004,République - Louis Loucheur,OUI,37,2,35,5,30,OUI,OUI,2025-03-13 16:01:44+00:00,"48.823549261189, 2.5101865455508",Champigny-sur-Marne,94017,0.9459459459459459,16
51008,Martyrs de Châteaubriant - Jean Grandel,OUI,38,29,9,1,8,OUI,OUI,2025-03-13 15:59:31+00:00,"48.951432, 2.211214",Argenteuil,95018,0.23684210526315788,16
23202,Henri Barbusse - Gabriel Péri,OUI,17,16,1,0,1,OUI,OUI,2025-03-13 15:59:16+00:00,"48.801773795836, 2.2874166362216",Châtillon,92020,0.058823529411764705,16
19121,Belleville -  Pré Saint-Gervais,OUI,21,21,0,0,0,OUI,OUI,2025-03-13 15:59:27+00:00,"48.875565910073, 2.3930460959673",Paris,75056,0.0,16
13049,Vincent Auriol - Louise Weiss,OUI,22,5,17,11,6,OUI,OUI,2025-03-13 16:01:10+00:00,"48.834001935501, 2.3703888058662",Paris,75056,0.7727272727272727,16
13015,Chevaleret - Louise Weiss,OUI,35,8,27,21,6,OUI,OUI,2025-03-13 16:01:42+00:00,"48.832586513351, 2.37121138812",Paris,75056,0.7714285714285715,16
17202,Mariotte - Batignolles,OUI,18,16,2,0,2,OUI,OUI,2025-03-13 15:57:16+00:00,"48.884571659595, 2.321469503475",Paris,75056,0.1111111111111111,16
25007,Bons Raisins - Voltaire,OUI,24,23,1,1,0,OUI,OUI,2025-03-13 15:52:22+00:00,"48.87282451461399, 2.1947155570850896",Rueil-Malmaison,92063,0.041666666666666664,16
32011,Stade de France - Francis de Pressensé,OUI,43,25,18,1,17,OUI,OUI,2025-03-13 16:02:02+00:00,"48.919141953558, 2.3620655760169",Saint-Denis,93066,0.4186046511627907,16
19114,Manin - Secrétan,OUI,20,17,3,2,1,OUI,OUI,2025-03-13 15:56:56+00:00,"48.8791665, 2.3787959",Paris,75056,0.15,16
12202,Charenton - Wattignies,OUI,40,30,10,5,5,OUI,OUI,2025-03-13 16:02:03+00:00,"48.836919119234, 2.3916775206425",Paris,75056,0.25,16
12123,Château de Vincennes,OUI,49,45,4,2,2,OUI,OUI,2025-03-13 15:57:03+00:00,"48.84423193255657, 2.439209537709179",Paris,75056,0.08163265306122448,16
10202,Bichat - Grange aux Belles,OUI,29,28,1,1,0,OUI,OUI,2025-03-13 16:02:07+00:00,"48.873688, 2.365015",Paris,75056,0.034482758620689655,16
13024,Bobillot - Tolbiac,OUI,32,29,3,1,2,OUI,OUI,2025-03-13 16:01:27+00:00,"48.8255961335041, 2.350204177200794",Paris,75056,0.09375,16
8018,Saint-Augustin,OUI,31,9,22,13,9,OUI,OUI,2025-03-13 16:01:44+00:00,"48.8762009747008, 2.319786250591278",Paris,75056,0.7096774193548387,16
24005,Edith Cavell - Volta,OUI,32,30,2,1,1,OUI,OUI,2025-03-13 15:54:06+00:00,"48.901616564286975, 2.269354350864887",Courbevoie,92026,0.0625,16
31104,Mairie de Rosny-sous-Bois,OUI,26,11,15,10,5,OUI,OUI,2025-03-13 16:00:13+00:00,"48.871256519012, 2.4865807592869",Rosny-sous-Bois,93064,0.5769230769230769,16
20142,Mûriers - Père Lachaise,OUI,19,19,0,0,0,OUI,OUI,2025-03-13 15:58:37+00:00,"48.864130509668044, 2.39164982067019",Paris,75056,0.0,16
42024,Danielle Casanova - Ledru-Rollin,OUI,28,0,28,26,2,OUI,OUI,2025-03-13 16:00:04+00:00,"48.815783497876815, 2.383259721100331",Ivry-sur-Seine,94041,1.0,16
18135,Ney - Porte de Montmartre,OUI,23,20,3,1,2,OUI,OUI,2025-03-13 16:02:03+00:00,"48.897918, 2.3364872",Paris,75056,0.13043478260869565,16
5027,Gobelins - Port-Royal,OUI,36,12,24,22,2,OUI,OUI,2025-03-13 16:00:29+00:00,"48.837135900263, 2.3515201359987",Paris,75056,0.6666666666666666,16
24101,Place Charles de Gaulle,OUI,23,21,2,0,2,OUI,OUI,2025-03-13 16:00:30+00:00,"48.826073335699, 2.1894485725692",Ville-d'Avray,92077,0.08695652173913043,16
11111,Léon Frot - Charonne,OUI,18,8,10,5,5,OUI,OUI,2025-03-13 16:01:39+00:00,"48.854963800335234, 2.387217085372007",Paris,75056,0.5555555555555556,16
34011,Clef des Champs - Albert Dhalenne,OUI,25,9,16,12,4,OUI,OUI,2025-03-13 16:00:39+00:00,"48.914938, 2.330665",Saint-Ouen-sur-Seine,93070,0.64,16
18016,Francoeur - Caulaincourt,OUI,33,31,2,0,2,OUI,OUI,2025-03-13 16:01:29+00:00,"48.8899944409612, 2.342529706656933",Paris,75056,0.06060606060606061,16
21329,Gare - Aristide Briand,OUI,28,7,21,18,3,OUI,OUI,2025-03-13 16:02:06+00:00,"48.821410564722, 2.2555950104387",Issy-les-Moulineaux,92040,0.75,16
19117,Euryale Dehaynin - Loire,OUI,30,18,12,5,7,OUI,OUI,2025-03-13 16:01:41+00:00,"48.886248917304805, 2.3774591088294987",Paris,75056,0.4,16
21704,Place du Maréchal de Lattre de Tassigny,OUI,27,24,3,3,0,OUI,OUI,2025-03-13 16:01:00+00:00,"48.821707715257055, 2.2853431485432423",Vanves,92075,0.1111111111111111,16
15053,Lecourbe - Convention,OUI,44,27,17,13,4,OUI,OUI,2025-03-13 16:02:05+00:00,"48.83923319241899, 2.2915197908878326",Paris,75056,0.38636363636363635,16
21002,Place Denfert-Rochereau,OUI,20,19,1,0,1,OUI,OUI,2025-03-13 16:01:59+00:00,"48.843252536286684, 2.245987951755524",Boulogne-Billancourt,92012,0.05,16
41103,Place de la vache noire,OUI,23,21,2,0,2,OUI,OUI,2025-03-13 16:00:38+00:00,"48.81040517059777, 2.327060401439667",Arcueil,94003,0.08695652173913043,16
24004,Paix - Verdun,OUI,33,25,8,5,3,OUI,OUI,2025-03-13 15:58:53+00:00,"48.900504, 2.261173",Courbevoie,92026,0.24242424242424243,16
41602,Place Charles Digeon,OUI,31,28,3,3,0,OUI,OUI,2025-03-13 16:00:05+00:00,"48.84354203133597, 2.418427169322968",Saint-Mandé,94067,0.0967741935483871,16
23041,Général Leclerc - Bièvre,OUI,24,20,4,2,2,OUI,OUI,2025-03-13 16:02:15+00:00,"48.782414428747316, 2.3166695237159733",Bourg-la-Reine,92014,0.16666666666666666,16
20012,Buzenval - Vignoles,OUI,17,15,2,0,2,OUI,OUI,2025-03-13 15:59:07+00:00,"48.853858171688, 2.4000040814281",Paris,75056,0.11764705882352941,16
15203,Porte de Versailles,OUI,27,18,9,3,6,OUI,OUI,2025-03-13 16:01:49+00:00,"48.832324016657, 2.2875617349045",Paris,75056,0.3333333333333333,16
14004,Port Royal - Hôpital Cochin,OUI,22,20,2,0,2,OUI,OUI,2025-03-13 16:00:10+00:00,"48.838608030238, 2.3406994164846",Paris,75056,0.09090909090909091,16
13116,Place du Docteur Yersin,OUI,50,47,3,0,3,OUI,OUI,2025-03-13 15:55:26+00:00,"48.82010494991975, 2.3725583776831627",Paris,75056,0.06,16
42303,Place Eustache Deschamps,OUI,20,10,10,5,5,OUI,OUI,2025-03-13 15:58:19+00:00,"48.793855, 2.336637",Cachan,94016,0.5,16
48006,Maxime Gorki - Paul Vaillant-Couturier,OUI,19,19,0,0,0,OUI,OUI,2025-03-13 16:00:10+00:00,"48.79673508795443, 2.3683342337608337",Villejuif,94076,0.0,16
41605,Général De Gaulle - Vivien,OUI,21,15,6,3,3,OUI,OUI,2025-03-13 15:54:10+00:00,"48.83607420090204, 2.4189166724681854",Saint-Mandé,94067,0.2857142857142857,16
15012,Cambronne - Mademoiselle,OUI,66,61,5,3,2,OUI,OUI,2025-03-13 15:59:42+00:00,"48.843277330035214, 2.30230766886348",Paris,75056,0.07575757575757576,16
35013,Guillaume Tell - Parc Henri Barbusse,OUI,19,17,2,1,1,OUI,OUI,2025-03-13 16:02:15+00:00,"48.88958925894009, 2.4198862910270695",Pantin,93055,0.10526315789473684,16
21022,Dôme - République,OUI,24,1,23,22,1,OUI,OUI,2025-03-13 16:02:11+00:00,"48.832681, 2.250257",Boulogne-Billancourt,92012,0.9583333333333334,16
13120,Pierre Joseph Desault,OUI,18,8,10,8,2,OUI,OUI,2025-03-13 16:00:33+00:00,"48.82110230800372, 2.378775402903557",Paris,75056,0.5555555555555556,16
20003,Pyrénées - Cours de Vincennes,OUI,19,17,2,1,1,OUI,OUI,2025-03-13 15:58:20+00:00,"48.847796779935, 2.4061721563339",Paris,75056,0.10526315789473684,16
15024,Suffren - La Motte-Piquet,OUI,22,6,16,14,2,OUI,OUI,2025-03-13 16:01:03+00:00,"48.850881230919, 2.3012199997902",Paris,75056,0.7272727272727273,16
15041,Franquet - Labrouste,OUI,37,31,6,1,5,OUI,OUI,2025-03-13 16:00:51+00:00,"48.83287705011431, 2.306762784719467",Paris,75056,0.16216216216216217,16
13036,Olympiades,OUI,36,31,5,1,4,OUI,OUI,2025-03-13 16:01:35+00:00,"48.826764665199, 2.3650860786438",Paris,75056,0.1388888888888889,16
10003,Hauteville - Bonne Nouvelle,OUI,17,2,15,14,1,OUI,OUI,2025-03-13 15:59:17+00:00,"48.87077436024, 2.3496496368327",Paris,75056,0.8823529411764706,16
14009,Tombe Issoire - René Coty,OUI,36,34,2,0,2,OUI,OUI,2025-03-13 16:01:59+00:00,"48.830512876709, 2.3343613743782",Paris,75056,0.05555555555555555,16
11022,Roquette - Auguste Laurent,OUI,15,9,6,4,2,OUI,OUI,2025-03-13 15:54:01+00:00,"48.858001906023354, 2.381797702650783",Paris,75056,0.4,16
16017,Siam - La Pompe,OUI,16,10,6,2,4,OUI,OUI,2025-03-13 15:58:12+00:00,"48.861720329027264, 2.275346568555312",Paris,75056,0.375,16
13028,Gouthière - Poterne des Peupliers,OUI,31,26,5,2,3,OUI,OUI,2025-03-13 15:59:40+00:00,"48.820507, 2.351342",Paris,75056,0.16129032258064516,16
18021,Marcadet - Ramey,OUI,21,17,4,1,3,OUI,OUI,2025-03-13 16:02:04+00:00,"48.890875, 2.3449019",Paris,75056,0.19047619047619047,16
15069,Félix Faure - Convention,OUI,44,16,28,17,11,OUI,OUI,2025-03-13 15:59:03+00:00,"48.841249336041, 2.2883866008495",Paris,75056,0.6363636363636364,16
20013,Alexandre Dumas - Place de la Réunion,OUI,45,43,2,1,1,OUI,OUI,2025-03-13 16:00:06+00:00,"48.85533710742046, 2.3997703687646292",Paris,75056,0.044444444444444446,16
14027,Gergovie - Alésia,OUI,54,51,3,0,3,OUI,OUI,2025-03-13 16:02:16+00:00,"48.83088717455243, 2.318882101207347",Paris,75056,0.05555555555555555,16
5033,Saint-Séverin - Saint-Michel,OUI,30,0,30,24,6,OUI,OUI,2025-03-13 15:58:54+00:00,"48.852731305488, 2.3440927639604",Paris,75056,1.0,16
48002,LCL Campus - Place Oscar Niemeyer,OUI,37,35,2,1,1,OUI,OUI,2025-03-13 15:57:53+00:00,"48.805342480621576, 2.363983690738678",Villejuif,94076,0.05405405405405406,16
25004,Marcel Pourtout - Édouard Manet,OUI,24,5,19,19,0,OUI,OUI,2025-03-13 16:00:24+00:00,"48.87555620763429, 2.1655967831611638",Rueil-Malmaison,92063,0.7916666666666666,16
30003,Moscou - Edouard Vaillant,OUI,29,21,8,4,4,OUI,OUI,2025-03-13 16:00:15+00:00,"48.90755810177, 2.4689837335263",Bobigny,93008,0.27586206896551724,16
15027,Duhamel - André Gide,OUI,20,15,5,0,5,OUI,OUI,2025-03-13 15:55:40+00:00,"48.8365662244334, 2.312707121097412",Paris,75056,0.25,16
20020,Pyrénées - Charles Renouvier,OUI,29,28,1,0,1,OUI,OUI,2025-03-13 16:00:05+00:00,"48.86095933229224, 2.400421852042113",Paris,75056,0.034482758620689655,16
31105,Lavoisier - Missak Manouchian,OUI,15,11,4,1,3,OUI,OUI,2025-03-13 15:59:17+00:00,"48.86286468896063, 2.495676465332508",Rosny-sous-Bois,93064,0.26666666666666666,16
12008,Hector Malot - Daumesnil,OUI,52,0,52,47,5,OUI,OUI,2025-03-13 16:02:05+00:00,"48.84693552991762, 2.3770876228809357",Paris,75056,1.0,16
22701,Général Leclerc - République,OUI,28,9,19,17,2,OUI,OUI,2025-03-13 16:00:12+00:00,"48.915885074177, 2.2682306702811",Bois-Colombes,92009,0.6785714285714286,16
12102,Bercy - Traversiére,OUI,30,2,28,27,1,OUI,OUI,2025-03-13 16:01:49+00:00,"48.846192642574, 2.3703800886869",Paris,75056,0.9333333333333333,16
17110,Legendre - Nollet,OUI,29,28,1,0,1,OUI,OUI,2025-03-13 16:01:50+00:00,"48.887742186754224, 2.320293079881375",Paris,75056,0.034482758620689655,16
12119,Dom-Pérignon - Gravelle,OUI,47,32,15,11,4,OUI,OUI,2025-03-13 16:02:16+00:00,"48.825481574435, 2.409880310297",Paris,75056,0.3191489361702128,16
31701,Mairie de Bagnolet,OUI,28,25,3,0,3,OUI,OUI,2025-03-13 15:53:37+00:00,"48.868421318555, 2.4179587885737",Bagnolet,93006,0.10714285714285714,16
13006,Duméril - Jeanne d'Arc,OUI,40,23,17,13,4,OUI,OUI,2025-03-13 15:57:43+00:00,"48.838151608087, 2.3571084495564",Paris,75056,0.425,16
30004,Jean Jaurès - Place de la Libération,OUI,28,9,19,9,10,OUI,OUI,2025-03-13 15:57:43+00:00,"48.90617751921, 2.4391458057475",Bobigny,93008,0.6785714285714286,16
43007,Hôtel de Ville de Vincennes,OUI,26,24,2,2,0,OUI,OUI,2025-03-13 16:02:03+00:00,"48.84827609706963, 2.4398955702781677",Vincennes,94080,0.07692307692307693,16
14035,Maine - Jean Zay,OUI,47,40,7,0,7,OUI,OUI,2025-03-13 16:00:31+00:00,"48.837925263898, 2.3225428909063",Paris,75056,0.14893617021276595,16
15050,Dominique Pado - Croix Nivert,OUI,22,18,4,2,2,OUI,OUI,2025-03-13 15:58:13+00:00,"48.83648798164934, 2.2897250577807426",Paris,75056,0.18181818181818182,16
8046,Marceau - Président Wilson,OUI,30,4,26,21,5,OUI,OUI,2025-03-13 16:01:54+00:00,"48.8652359, 2.3002513",Paris,75056,0.8666666666666667,16
16025,Jean de la Fontaine - Boulainvilliers,OUI,66,19,47,44,3,OUI,OUI,2025-03-13 16:01:56+00:00,"48.85264791461651, 2.2758664190769196",Paris,75056,0.7121212121212122,16
14005,René Coty - Place Denfert-Rochereau,OUI,35,33,2,0,2,OUI,OUI,2025-03-13 16:00:22+00:00,"48.833056477316, 2.3329411447048",Paris,75056,0.05714285714285714,16
43004,Montreuil - République,OUI,23,16,7,6,1,OUI,OUI,2025-03-13 15:53:13+00:00,"48.85026349463687, 2.4345204234123234",Vincennes,94080,0.30434782608695654,16
8007,Rome - Provence,OUI,29,4,25,22,3,OUI,OUI,2025-03-13 15:57:46+00:00,"48.874230055580306, 2.325570111724113",Paris,75056,0.8620689655172413,16
17117,Pereire - Saussure,OUI,31,29,2,1,1,OUI,OUI,2025-03-13 15:59:20+00:00,"48.888229075478, 2.3101296275854",Paris,75056,0.06451612903225806,16
21207,Verdier - République,OUI,29,25,4,2,2,OUI,OUI,2025-03-13 16:01:04+00:00,"48.815403766277, 2.31739372015",Montrouge,92049,0.13793103448275862,16
16116,George Sand - Jean de La Fontaine,OUI,29,21,8,6,2,OUI,OUI,2025-03-13 16:00:27+00:00,"48.84986918764119, 2.268257387525699",Paris,75056,0.27586206896551724,16
15120,Colonel Pierre Avia,OUI,28,10,18,15,3,OUI,OUI,2025-03-13 16:01:31+00:00,"48.8296843300915, 2.275342586850291",Paris,75056,0.6428571428571429,16
15045,Porte de la Plaine,OUI,35,35,0,0,0,OUI,OUI,2025-03-13 15:59:50+00:00,"48.82805169605981, 2.2924277186393742",Paris,75056,0.0,16
16033,Marché d'Auteuil,OUI,31,13,18,17,1,OUI,OUI,2025-03-13 15:58:15+00:00,"48.84842761367387, 2.265253821160005",Paris,75056,0.5806451612903226,16
12022,Sahel - Général Michel Bizot,OUI,30,23,7,6,1,OUI,OUI,2025-03-13 16:01:15+00:00,"48.840872964793355, 2.4044444784522057",Paris,75056,0.23333333333333334,16
16023,Passy - Place du Costa Rica,OUI,29,25,4,1,3,OUI,OUI,2025-03-13 16:01:19+00:00,"48.8584893, 2.2839655",Paris,75056,0.13793103448275862,16
21023,Ancienne Mairie - André Morizet,OUI,25,12,13,7,6,OUI,OUI,2025-03-13 15:59:22+00:00,"48.838311, 2.234077",Boulogne-Billancourt,92012,0.52,16
24007,Jean-Baptiste Charcot - Sainte-Geneviève,OUI,21,19,2,2,0,OUI,OUI,2025-03-13 15:52:46+00:00,"48.90310883721567, 2.278892956674099",Courbevoie,92026,0.09523809523809523,16
42205,Place Aristide Briand,OUI,35,21,14,10,4,OUI,OUI,2025-03-13 15:58:22+00:00,"48.82189236575831, 2.413003742694855",Charenton-le-Pont,94018,0.4,16
13055,M.- A. Lagroua Weill-Hallé -  F. Dolto,OUI,58,19,39,24,15,OUI,OUI,2025-03-13 16:01:42+00:00,"48.828595283857425, 2.380220606266108",Paris,75056,0.6724137931034483,16
22404,Pierre Brossolette - 12 Février 1934,OUI,24,22,2,0,2,OUI,OUI,2025-03-13 15:58:21+00:00,"48.8176962416867, 2.3076123744249344",Malakoff,92046,0.08333333333333333,16
21027,Fief - République,OUI,25,3,22,17,5,OUI,OUI,2025-03-13 16:02:16+00:00,"48.83170888166024, 2.255771979689598",Boulogne-Billancourt,92012,0.88,16
20032,Square des Amandiers,OUI,26,24,2,1,1,OUI,OUI,2025-03-13 15:58:55+00:00,"48.86615630668046, 2.3891324177384377",Paris,75056,0.07692307692307693,16
20011,Pyrénées - Dagorno,OUI,20,18,2,1,1,OUI,OUI,2025-03-13 16:01:49+00:00,"48.855425770695085, 2.4051643162965775",Paris,75056,0.1,16
20014,Charonne - Alexandre Dumas,OUI,34,32,2,0,2,OUI,OUI,2025-03-13 16:02:15+00:00,"48.856077415056, 2.3948693275452",Paris,75056,0.058823529411764705,16
13023,Bobillot - Moulin des Prés,OUI,28,28,0,0,0,OUI,OUI,2025-03-13 15:58:50+00:00,"48.828657346203, 2.353020646317",Paris,75056,0.0,16
20110,Gambetta - Tourelles,OUI,20,19,1,0,1,OUI,OUI,2025-03-13 15:55:09+00:00,"48.875337902264, 2.4059921130538",Paris,75056,0.05,16
12040,Porte de Charenton,OUI,66,53,13,9,4,OUI,OUI,2025-03-13 16:00:13+00:00,"48.831240105856, 2.3989107459784",Paris,75056,0.19696969696969696,16
21218,Gabriel Péri - Place de la Libération,OUI,17,17,0,0,0,OUI,OUI,2025-03-13 16:00:29+00:00,"48.819828421929, 2.3117361743705",Montrouge,92049,0.0,16
20106,Mairie du 20ème,OUI,27,24,3,0,3,OUI,OUI,2025-03-13 15:58:14+00:00,"48.865302324275, 2.3990669846535",Paris,75056,0.1111111111111111,16
17006,Guy Môquet - Compoint,OUI,33,26,7,0,7,OUI,OUI,2025-03-13 15:58:57+00:00,"48.89213559044868, 2.32321947813034",Paris,75056,0.21212121212121213,16
6020,Place Saint-André des Arts,OUI,33,3,30,21,9,OUI,OUI,2025-03-13 16:01:25+00:00,"48.852886173881, 2.3426544293761",Paris,75056,0.9090909090909091,16
18101,Championnet.,OUI,21,19,2,0,2,OUI,OUI,2025-03-13 15:53:16+00:00,"48.8953643, 2.3498166",Paris,75056,0.09523809523809523,16
21007,Rond-Point Rhin et Danube,OUI,53,45,8,5,3,OUI,OUI,2025-03-13 16:02:06+00:00,"48.840452820991764, 2.2280225157737736",Boulogne-Billancourt,92012,0.1509433962264151,16
6028,Quatre Vents - Carrefour de l'Odéon,OUI,37,1,36,21,15,OUI,OUI,2025-03-13 16:00:11+00:00,"48.851751374458864, 2.338161695134053",Paris,75056,0.972972972972973,16
21016,Point du Jour - Jean Jaurès,OUI,39,22,17,15,2,OUI,OUI,2025-03-13 16:02:12+00:00,"48.828753141436465, 2.245911467014621",Boulogne-Billancourt,92012,0.4358974358974359,16
20005,Reynaldo Hahn - Lagny,OUI,19,14,5,5,0,OUI,OUI,2025-03-13 15:58:07+00:00,"48.849266043601794, 2.412330328844772",Paris,75056,0.2631578947368421,16
19123,Metz - Marne,OUI,29,27,2,0,2,OUI,OUI,2025-03-13 15:57:52+00:00,"48.891163, 2.3865705",Paris,75056,0.06896551724137931,16
11016,Philippe-Auguste,OUI,48,43,5,0,5,OUI,OUI,2025-03-13 16:01:40+00:00,"48.851853488265, 2.3932945355773",Paris,75056,0.10416666666666667,16
22007,Commandant Charcot - Bretteville,OUI,31,7,24,14,10,OUI,OUI,2025-03-13 16:01:28+00:00,"48.87530570765423, 2.2558460757136345",Neuilly-sur-Seine,92051,0.7741935483870968,16
12122,Bois de Vincennes - Polygone,OUI,51,42,9,4,5,OUI,OUI,2025-03-13 16:01:02+00:00,"48.83544491617421, 2.431421081436563",Paris,75056,0.17647058823529413,16
12039,Général Michel Bizot - Claude Decaen,OUI,38,25,13,11,2,OUI,OUI,2025-03-13 16:01:10+00:00,"48.83481262982544, 2.400927788127704",Paris,75056,0.34210526315789475,16
21205,Arthur Auger - Jean Jaurès,OUI,23,22,1,0,1,OUI,OUI,2025-03-13 15:53:48+00:00,"48.813736445585235, 2.3069277405738835",Montrouge,92049,0.043478260869565216,16
5031,Lacépède - Linné,OUI,48,8,40,28,12,OUI,OUI,2025-03-13 16:00:56+00:00,"48.8437035476636, 2.354651279747486",Paris,75056,0.8333333333333334,16
6004,Regard - Rennes,OUI,46,33,13,10,3,OUI,OUI,2025-03-13 15:59:39+00:00,"48.847385404956, 2.3268555477262",Paris,75056,0.2826086956521739,16
12017,Saint-Mandé - Docteur Arnold Netter,OUI,36,31,5,4,1,OUI,OUI,2025-03-13 15:58:44+00:00,"48.84462585769668, 2.404946386814118",Paris,75056,0.1388888888888889,16
15114,Pasteur - Cotentin,OUI,9,5,4,2,2,OUI,OUI,2025-03-13 15:58:02+00:00,"48.8389284, 2.316356",Paris,75056,0.4444444444444444,16
14025,Jacquier - Didot,OUI,30,29,1,0,1,OUI,OUI,2025-03-13 15:54:01+00:00,"48.82953336292279, 2.318179272115231",Paris,75056,0.03333333333333333,16
11029,Ménilmontant - Oberkampf,OUI,39,20,19,7,12,OUI,OUI,2025-03-13 16:02:03+00:00,"48.866617658681, 2.3830134404158",Paris,75056,0.48717948717948717,16
19014,Lorraine - Jean Jaurès,OUI,19,14,5,0,5,OUI,OUI,2025-03-13 16:02:13+00:00,"48.8863865, 2.3825772",Paris,75056,0.2631578947368421,16
21510,Fontaine du Tertre - Calvaire,OUI,23,22,1,0,1,OUI,OUI,2025-03-13 15:55:38+00:00,"48.8702539, 2.2187778",Suresnes,92073,0.043478260869565216,16
15014,Volontaires - Vaugirard,OUI,33,31,2,0,2,OUI,OUI,2025-03-13 16:01:15+00:00,"48.84132050184004, 2.30808901725357",Paris,75056,0.06060606060606061,16
11038,Temple - Charlot,OUI,42,12,30,29,1,OUI,OUI,2025-03-13 16:00:49+00:00,"48.865709343796, 2.3652737250724",Paris,75056,0.7142857142857143,16
11028,Guillaume Bertrand - République,OUI,38,34,4,2,2,OUI,OUI,2025-03-13 16:01:48+00:00,"48.863825174341, 2.380906377155",Paris,75056,0.10526315789473684,16
8003,Galilée - Vernet,OUI,47,23,24,11,13,OUI,OUI,2025-03-13 16:02:14+00:00,"48.871715878697, 2.2985444962978",Paris,75056,0.5106382978723404,16
22014,Victor Hugo - Bineau,OUI,24,24,0,0,0,OUI,OUI,2025-03-13 16:01:30+00:00,"48.88758225888669, 2.2783890366554265",Neuilly-sur-Seine,92051,0.0,16
24010,Charles de Gaulle - Rue de l'Alma,OUI,27,9,18,5,13,OUI,OUI,2025-03-13 16:00:47+00:00,"48.896620592993, 2.252313240191",Courbevoie,92026,0.6666666666666666,16
15044,Dantzig - Lefebvre,OUI,33,32,1,0,1,OUI,OUI,2025-03-13 16:01:03+00:00,"48.83013921586756, 2.295934036374092",Paris,75056,0.030303030303030304,16
26010,Louis Armand - Bernard Palissy,OUI,17,6,11,6,5,OUI,OUI,2025-03-13 15:57:34+00:00,"48.916974, 2.313384",Asnières-sur-Seine,92004,0.6470588235294118,16
25002,Hôtel de Ville de Rueil-Malmaison,OUI,19,3,16,10,6,OUI,OUI,2025-03-13 16:01:11+00:00,"48.878194, 2.181724",Rueil-Malmaison,92063,0.8421052631578947,16
20030,Ménilmontant - Père Lachaise,OUI,40,32,8,0,8,OUI,OUI,2025-03-13 16:01:45+00:00,"48.863287291502, 2.3869940266013",Paris,75056,0.2,16
15113,Arsonval - Falguière,OUI,24,22,2,0,2,OUI,OUI,2025-03-13 15:58:54+00:00,"48.84040040365445, 2.313117867297474",Paris,75056,0.08333333333333333,16
3201,Payenne - Square George Caïn,OUI,22,6,16,14,2,OUI,OUI,2025-03-13 16:00:55+00:00,"48.8578329, 2.3622643",Paris,75056,0.7272727272727273,16
6005,Montparnasse -  Square Ozanam,OUI,49,37,12,12,0,OUI,OUI,2025-03-13 16:01:05+00:00,"48.843310567822, 2.3265242949128",Paris,75056,0.24489795918367346,16
20035,Pyrénées - Ménilmontant,OUI,25,22,3,0,3,OUI,OUI,2025-03-13 15:59:43+00:00,"48.8693268535238, 2.395084574818611",Paris,75056,0.12,16
16022,Jean Bologne - Passy,OUI,19,16,3,1,2,OUI,OUI,2025-03-13 15:59:57+00:00,"48.857566889784465, 2.280027395306772",Paris,75056,0.15789473684210525,16
21508,Georges Pompidou - Verdun,OUI,24,6,18,10,8,OUI,OUI,2025-03-13 16:01:23+00:00,"48.875481, 2.232443",Suresnes,92073,0.75,16
19001,Crimée - Ourcq,OUI,56,50,6,4,2,OUI,OUI,2025-03-13 15:59:33+00:00,"48.894104140316, 2.3729460884673",Paris,75056,0.10714285714285714,16
9029,Saint-Lazare - Place d'Estienne d'Orves,OUI,39,7,32,24,8,OUI,OUI,2025-03-13 15:59:37+00:00,"48.8768345, 2.3329067",Paris,75056,0.8205128205128205,16
48011,Epi d'Or - Chevilly,OUI,20,17,3,0,3,OUI,OUI,2025-03-13 15:55:41+00:00,"48.781109786782, 2.3549050362061",Villejuif,94076,0.15,16
19007,Flandre - Ourcq,OUI,28,24,4,1,3,OUI,OUI,2025-03-13 15:56:26+00:00,"48.89260159189023, 2.3790915682911873",Paris,75056,0.14285714285714285,16
5105,Geoffroy-Saint-Hilaire - Saint-Marcel,OUI,17,9,8,8,0,OUI,OUI,2025-03-13 15:59:39+00:00,"48.83907826424974, 2.356877340669728",Paris,75056,0.47058823529411764,16
41212,Nungesser - Santé,OUI,22,19,3,0,3,OUI,OUI,2025-03-13 15:58:15+00:00,"48.852335, 2.448967",Fontenay-sous-Bois,94033,0.13636363636363635,16
11018,Saint-Maur - République,OUI,36,29,7,3,4,OUI,OUI,2025-03-13 15:56:14+00:00,"48.864185861455, 2.3783174157143",Paris,75056,0.19444444444444445,16
41304,Port - Maurice Chevalier,OUI,30,3,27,23,4,OUI,OUI,2025-03-13 16:02:06+00:00,"48.832474421632, 2.490257616467",Nogent-sur-Marne,94052,0.9,16
21107,Bertrand Sincholle - Henri Barbusse,OUI,18,9,9,7,2,OUI,OUI,2025-03-13 16:01:00+00:00,"48.89925982394349, 2.3042294383049016",Clichy,92024,0.5,16
7007,Musée d'Orsay,OUI,63,4,59,43,16,OUI,OUI,2025-03-13 16:01:44+00:00,"48.859726157909, 2.3258604481816",Paris,75056,0.9365079365079365,16
13037,Ivry - Baudricourt,OUI,20,16,4,2,2,OUI,OUI,2025-03-13 15:58:51+00:00,"48.824695995415006, 2.363106073577468",Paris,75056,0.2,16
26011,Ménil - Argenteuil,OUI,18,13,5,3,2,OUI,OUI,2025-03-13 15:57:05+00:00,"48.925901818305, 2.2741496502338",Asnières-sur-Seine,92004,0.2777777777777778,16
6009,Guynemer - Jardin du Luxembourg,OUI,34,19,15,11,4,OUI,OUI,2025-03-13 16:01:58+00:00,"48.8466127, 2.3325478",Paris,75056,0.4411764705882353,16
22208,Stalingrad - Barbara,OUI,19,17,2,0,2,OUI,OUI,2025-03-13 15:55:01+00:00,"48.809223658808, 2.3175904558822",Bagneux,92007,0.10526315789473684,16
42027,Verdun - Pierre et Marie Curie,OUI,26,20,6,3,3,OUI,OUI,2025-03-13 16:02:07+00:00,"48.812822398263286, 2.3707106709480286",Ivry-sur-Seine,94041,0.23076923076923078,16
10025,Jemmapes - Ecluses Saint-Martin,OUI,13,13,0,0,0,OUI,OUI,2025-03-13 15:56:27+00:00,"48.87748519186726, 2.3660067468881607",Paris,75056,0.0,16
16104,Paul Valery - Victor Hugo,OUI,34,22,12,0,12,OUI,OUI,2025-03-13 16:01:50+00:00,"48.87137406080164, 2.2887128591537476",Paris,75056,0.35294117647058826,16
32305,Saint-Germain - Verdun,OUI,29,29,0,0,0,OUI,OUI,2025-03-13 15:58:21+00:00,"48.882877330093, 2.4331868384644",Romainville,93063,0.0,16
20033,Etienne Dolet - Place Maurice Chevalier,OUI,47,42,5,3,2,OUI,OUI,2025-03-13 16:00:43+00:00,"48.86798303359366, 2.3851405311143026",Paris,75056,0.10638297872340426,16
22305,Jean Jaurès - Place du Dr Roux,OUI,34,27,7,7,0,OUI,OUI,2025-03-13 15:58:44+00:00,"48.927567032796, 2.2947337017374",Gennevilliers,92036,0.20588235294117646,16
30005,Convention - Campus de Bobigny,OUI,29,21,8,3,5,OUI,OUI,2025-03-13 15:58:26+00:00,"48.914920058264, 2.4172238067445",Bobigny,93008,0.27586206896551724,16
22507,Châteaudun - Place de la Liberté,OUI,25,20,5,2,3,OUI,OUI,2025-03-13 15:56:34+00:00,"48.90970830301211, 2.2454486480600626",La Garenne-Colombes,92035,0.2,16
17050,Batignolles - Abel Truchet,OUI,25,22,3,0,3,OUI,OUI,2025-03-13 15:59:48+00:00,"48.883103904582, 2.3238347490884",Paris,75056,0.12,16
22602,Place Henri Dunant - Gare RER,OUI,30,29,1,0,1,OUI,OUI,2025-03-13 15:59:37+00:00,"48.788093281931, 2.2909234046643",Fontenay-aux-Roses,92032,0.03333333333333333,16
13013,Saint-Marcel - Hôpital,OUI,20,1,19,13,6,OUI,OUI,2025-03-13 16:01:55+00:00,"48.839504424583, 2.3609894170229",Paris,75056,0.95,16
23201,Avenir,OUI,41,35,6,6,0,OUI,OUI,2025-03-13 16:00:16+00:00,"48.8103438, 2.3003776",Châtillon,92020,0.14634146341463414,16
8044,Alfred de Vigny - Place du Général Brocard,OUI,32,22,10,6,4,OUI,OUI,2025-03-13 15:59:12+00:00,"48.87836138361425, 2.305254448220567",Paris,75056,0.3125,16
12165,Champs de Manoeuvre - Cartoucherie,OUI,32,3,29,14,15,OUI,OUI,2025-03-13 16:01:27+00:00,"48.835261, 2.447974",Paris,75056,0.90625,16
1201,Perrault - Place du Louvre,OUI,28,15,13,9,4,OUI,OUI,2025-03-13 16:01:17+00:00,"48.860273568996, 2.3412468419093",Paris,75056,0.4642857142857143,16
12001,Bastille - Biscornet,OUI,59,3,56,47,9,OUI,OUI,2025-03-13 16:01:37+00:00,"48.851355779579, 2.369220033288",Paris,75056,0.9491525423728814,16
51007,Résistance - Romain Rolland,OUI,28,22,6,0,6,OUI,OUI,2025-03-13 16:00:25+00:00,"48.950873482371, 2.2310190077797",Argenteuil,95018,0.21428571428571427,16
22018,Charles de Gaulle - Les Sablons,OUI,35,24,11,9,2,OUI,OUI,2025-03-13 16:02:01+00:00,"48.880987514929, 2.2715748726513",Neuilly-sur-Seine,92051,0.3142857142857143,16
17036,Place Tristan Bernard,OUI,28,18,10,2,8,OUI,OUI,2025-03-13 16:01:41+00:00,"48.8794936, 2.2915423",Paris,75056,0.35714285714285715,16
21320,Président Roosevelt - Rouget de Lisle,OUI,40,4,36,21,15,OUI,OUI,2025-03-13 15:57:26+00:00,"48.83047518749, 2.2616135525345",Issy-les-Moulineaux,92040,0.9,16
11040,Temple - Jean-Pierre Timbaud,OUI,32,6,26,20,6,OUI,OUI,2025-03-13 16:00:34+00:00,"48.86446597201, 2.3660597205162",Paris,75056,0.8125,16
21327,Jean Bouin - Gouverneur Général Eboué,OUI,31,4,27,27,0,OUI,OUI,2025-03-13 16:01:39+00:00,"48.824792734266, 2.2651904328524",Issy-les-Moulineaux,92040,0.8709677419354839,16
13008,Place d'Italie - Soeur Rosalie,OUI,51,48,3,1,2,OUI,OUI,2025-03-13 16:01:25+00:00,"48.831908520394, 2.3546943448098",Paris,75056,0.058823529411764705,16
17127,Porte de Clichy - Place des Nations Unies,OUI,37,8,29,27,2,OUI,OUI,2025-03-13 16:01:33+00:00,"48.896737263309504, 2.310542999196392",Paris,75056,0.7837837837837838,16
21511,Marcel Monge - Marcel Dassault,OUI,46,11,35,31,4,OUI,OUI,2025-03-13 16:01:48+00:00,"48.86096384533371, 2.2246733296048142",Suresnes,92073,0.7608695652173914,16
26008,Henri Barbusse - Bourguignons,OUI,32,21,11,2,9,OUI,OUI,2025-03-13 15:57:30+00:00,"48.91301722799713, 2.2734212270774417",Asnières-sur-Seine,92004,0.34375,16
21033,Sèvres - Maréchal Juin,OUI,18,5,13,12,1,OUI,OUI,2025-03-13 16:01:10+00:00,"48.8324305, 2.2292812",Boulogne-Billancourt,92012,0.7222222222222222,16
34008,Garibaldi - Gabriel Péri,OUI,28,19,9,3,6,OUI,OUI,2025-03-13 16:02:07+00:00,"48.905741911394, 2.3316044208059",Saint-Ouen-sur-Seine,93070,0.32142857142857145,16
21112,Claude Debussy - Marc Bloch,OUI,52,43,9,7,2,OUI,OUI,2025-03-13 16:00:58+00:00,"48.910388180512, 2.3117771744728",Clichy,92024,0.17307692307692307,16
31301,Gare RER,OUI,27,25,2,0,2,OUI,OUI,2025-03-13 16:01:34+00:00,"48.896280181078, 2.4581568985227",Noisy-le-Sec,93053,0.07407407407407407,16
22703,Place Jean Mermoz,OUI,30,21,9,4,5,OUI,OUI,2025-03-13 16:01:44+00:00,"48.9220937, 2.2718348",Bois-Colombes,92009,0.3,16
31303,Simone Signoret - Paris,OUI,26,18,8,4,4,OUI,OUI,2025-03-13 15:59:19+00:00,"48.903600624712865, 2.465406596265139",Noisy-le-Sec,93053,0.3076923076923077,16
25009,Place des Arts - Jean Mermoz,OUI,20,5,15,14,1,OUI,OUI,2025-03-13 15:58:59+00:00,"48.880391139734, 2.1832160452221",Rueil-Malmaison,92063,0.75,16
10026,Gare de l'Est - Chateau Landon,OUI,55,50,5,1,4,OUI,OUI,2025-03-13 16:02:01+00:00,"48.879305, 2.362424",Paris,75056,0.09090909090909091,16
41101,Paul Doumer - Stalingrad,OUI,24,17,7,4,3,OUI,OUI,2025-03-13 16:00:05+00:00,"48.806518992199, 2.3368880152702",Arcueil,94003,0.2916666666666667,16
17010,Jonquière - Docteur Paul Brousse,OUI,36,27,9,7,2,OUI,OUI,2025-03-13 16:02:15+00:00,"48.894799816683985, 2.318705212173216",Paris,75056,0.25,16
16140,Hippodrome de Longchamp,OUI,24,5,19,15,4,OUI,OUI,2025-03-13 15:58:51+00:00,"48.86413226532, 2.239905372262",Paris,75056,0.7916666666666666,16
18023,Ordener - Poissonniers,OUI,35,34,1,0,1,OUI,OUI,2025-03-13 15:58:40+00:00,"48.891213890844654, 2.351288666219873",Paris,75056,0.02857142857142857,16
23106,Pavé des Gardes - Charles Vaillant,OUI,20,15,5,5,0,OUI,OUI,2025-03-13 15:57:41+00:00,"48.81168551728, 2.2111820107205",Sèvres,92072,0.25,16
8008,Joseph Sansboeuf - Saint Lazare,OUI,32,18,14,11,3,OUI,OUI,2025-03-13 16:01:09+00:00,"48.875315630653, 2.3229019716382",Paris,75056,0.4375,16
15032,Félix Faure - Lourmel,OUI,54,39,15,11,4,OUI,OUI,2025-03-13 16:01:50+00:00,"48.83868901709515, 2.2818081825971603",Paris,75056,0.2777777777777778,16
31201,Suzanne Masson,OUI,33,10,23,13,10,OUI,OUI,2025-03-13 16:01:58+00:00,"48.923306888013, 2.3847292397611",La Courneuve,93027,0.696969696969697,16
20037,Gambetta - Saint Fargeau,OUI,24,23,1,0,1,OUI,OUI,2025-03-13 15:58:34+00:00,"48.871244610447015, 2.4039056897163396",Paris,75056,0.041666666666666664,16
13204,Tolbiac - Boussingault,OUI,41,37,4,2,2,OUI,OUI,2025-03-13 16:00:25+00:00,"48.826177754027, 2.3420378552202",Paris,75056,0.0975609756097561,16
19045,Macdonald - Césaria Evora,OUI,65,54,11,9,2,OUI,OUI,2025-03-13 15:57:35+00:00,"48.89883, 2.37933",Paris,75056,0.16923076923076924,16
13035,Choisy - Tolbiac,OUI,20,15,5,1,4,OUI,OUI,2025-03-13 15:54:32+00:00,"48.82591155587, 2.3602393269539",Paris,75056,0.25,16
22302,Gare RER - Général de Gaulle,OUI,38,16,22,14,8,OUI,OUI,2025-03-13 16:01:34+00:00,"48.933548439566, 2.3064726536317",Gennevilliers,92036,0.5789473684210527,16
13053,Chevaleret - Tolbiac,OUI,21,12,9,8,1,OUI,OUI,2025-03-13 16:01:48+00:00,"48.82941, 2.375934",Paris,75056,0.42857142857142855,16
15062,Convention - Lourmel,OUI,35,16,19,16,3,OUI,OUI,2025-03-13 16:01:19+00:00,"48.842055041656, 2.2859910875559",Paris,75056,0.5428571428571428,16
34009,Dora Maar - Nadia Guendouz,OUI,28,14,14,11,3,OUI,OUI,2025-03-13 16:02:15+00:00,"48.905452421305, 2.3220406472683",Saint-Ouen-sur-Seine,93070,0.5,16
10114,Granges aux Belles - Hôpital Saint-Louis,OUI,59,58,1,0,1,OUI,OUI,2025-03-13 15:58:55+00:00,"48.874794994841, 2.366669436985",Paris,75056,0.01694915254237288,16
10151,Gare du Nord - Faubourg Saint-Denis,OUI,28,20,8,1,7,OUI,OUI,2025-03-13 16:00:48+00:00,"48.879612765504, 2.3568402975798",Paris,75056,0.2857142857142857,16
18134,Ney - Porte de Clignancourt,OUI,24,24,0,0,0,OUI,OUI,2025-03-13 15:57:05+00:00,"48.8978867, 2.3458001",Paris,75056,0.0,16
8031,Jean Mermoz - Champs-Elysées,OUI,46,12,34,19,15,OUI,OUI,2025-03-13 16:00:42+00:00,"48.869689856852, 2.3107324540615",Paris,75056,0.7391304347826086,16
13203,Square de Choisy - Eastman,OUI,23,17,6,1,5,OUI,OUI,2025-03-13 15:54:23+00:00,"48.828543456283, 2.3583075090494",Paris,75056,0.2608695652173913,16
22209,Verdun - Henri Barbusse,OUI,23,21,2,0,2,OUI,OUI,2025-03-13 16:00:36+00:00,"48.802056061754, 2.3159965061736",Bagneux,92007,0.08695652173913043,16
47007,Liberté - Vert-de-Maisons,OUI,20,2,18,15,3,OUI,OUI,2025-03-13 16:00:28+00:00,"48.790147809608, 2.4328628182411",Maisons-Alfort,94046,0.9,16
45005,Stalingrad - Général de Gaulle,OUI,26,12,14,4,10,OUI,OUI,2025-03-13 16:01:52+00:00,"48.823450589614, 2.4965062363218",Champigny-sur-Marne,94017,0.5384615384615384,16
13202,Place Farhat Hached,OUI,28,2,26,14,12,OUI,OUI,2025-03-13 16:02:00+00:00,"48.825487045602, 2.3816306985827",Paris,75056,0.9285714285714286,16
35021,Cartier Bresson - Denis Papin,OUI,31,25,6,4,2,OUI,OUI,2025-03-13 15:57:13+00:00,"48.902616, 2.397814",Pantin,93055,0.1935483870967742,16
13051,Halle Freyssinet - Parvis Alan Turing,OUI,23,8,15,6,9,OUI,OUI,2025-03-13 16:00:50+00:00,"48.832846814471, 2.3711421713233",Paris,75056,0.6521739130434783,16
18045,Pierre Ginier - Clichy,OUI,15,14,1,0,1,OUI,OUI,2025-03-13 16:00:28+00:00,"48.8867667, 2.326228",Paris,75056,0.06666666666666667,16
8038,François 1er - Montaigne,OUI,52,16,36,25,11,OUI,OUI,2025-03-13 16:00:47+00:00,"48.866887649978, 2.3066755757207",Paris,75056,0.6923076923076923,16
14110,Abbé Carton - Plantes,OUI,25,23,2,0,2,OUI,OUI,2025-03-13 16:01:55+00:00,"48.827673823166, 2.3209181427956",Paris,75056,0.08,16
19204,Rampal - Belleville,OUI,19,17,2,0,2,OUI,OUI,2025-03-13 15:56:14+00:00,"48.873114661405, 2.3798409114805",Paris,75056,0.10526315789473684,16
18018,Carpeaux - Place Jacques Froment,OUI,17,17,0,0,0,OUI,OUI,2025-03-13 16:01:28+00:00,"48.8906542, 2.3309428",Paris,75056,0.0,16
5201,Saint-Jacques - Soufflot,OUI,16,6,10,1,9,OUI,OUI,2025-03-13 16:00:05+00:00,"48.846280383395, 2.3430785379567",Paris,75056,0.625,16
21954,Val-Fleury,OUI,23,15,8,2,6,OUI,OUI,2025-03-13 16:02:04+00:00,"48.807671407991, 2.2407217696309",Meudon,92048,0.34782608695652173,16
18041,Rochechouart - Martyrs,OUI,17,12,5,1,4,OUI,OUI,2025-03-13 15:59:48+00:00,"48.882193779572, 2.3405495658517",Paris,75056,0.29411764705882354,16
11201,Faubourg St-Antoine - Place de la Nation,OUI,16,13,3,1,2,OUI,OUI,2025-03-13 16:02:04+00:00,"48.8487726, 2.393606",Paris,75056,0.1875,16
11102,Alexandre Dumas - Voltaire,OUI,58,54,4,2,2,OUI,OUI,2025-03-13 15:53:11+00:00,"48.852888670365, 2.3891476408096",Paris,75056,0.06896551724137931,16
12106,Gare de Lyon - Roland Barthes,OUI,67,16,51,51,0,OUI,OUI,2025-03-13 16:01:05+00:00,"48.84395729494058, 2.3790882155299187",Paris,75056,0.7611940298507462,16
18044,Clichy - Douai,OUI,32,28,4,0,4,OUI,OUI,2025-03-13 16:01:54+00:00,"48.883687771522, 2.328063700029",Paris,75056,0.125,16
23205,Parc des Pierrettes,OUI,22,21,1,0,1,OUI,OUI,2025-03-13 16:00:07+00:00,"48.7973062, 2.2909969",Châtillon,92020,0.045454545454545456,16
16103,Traktir - Foch,OUI,20,5,15,3,12,OUI,OUI,2025-03-13 15:59:27+00:00,"48.872755334614, 2.2915497802487",Paris,75056,0.75,16
32023,Guy Môquet - Jean Moulin,OUI,27,11,16,10,6,OUI,OUI,2025-03-13 16:00:32+00:00,"48.940931521020836, 2.363948999931771",Saint-Denis,93066,0.5925925925925926,16
11046,Place de la République - Voltaire,OUI,16,6,10,10,0,OUI,OUI,2025-03-13 16:00:53+00:00,"48.866830968942, 2.3654810339212",Paris,75056,0.625,16
25010,Maréchal Leclerc de Hauteclocque - Marché Buzenval,OUI,29,25,4,2,2,OUI,OUI,2025-03-13 15:55:58+00:00,"48.858446, 2.192077",Rueil-Malmaison,92063,0.13793103448275862,16
11009,Boulets - Voltaire,OUI,24,20,4,0,4,OUI,OUI,2025-03-13 16:01:12+00:00,"48.85218705621, 2.3890301585197",Paris,75056,0.16666666666666666,16
11001,Richard Lenoir - Place de la Bastille,OUI,46,21,25,18,7,OUI,OUI,2025-03-13 16:00:54+00:00,"48.8538327, 2.3697222",Paris,75056,0.5434782608695652,16
35001,Jean Jaurès - Ouvrières Pivéreuses,OUI,21,17,4,1,3,OUI,OUI,2025-03-13 16:02:04+00:00,"48.910423437526, 2.3995766043663",Pantin,93055,0.19047619047619047,16
23203,Division Leclerc - Kléber,OUI,25,21,4,1,3,OUI,OUI,2025-03-13 16:01:49+00:00,"48.798666226364, 2.2833752789972",Châtillon,92020,0.16,16
7111,Ecole Militaire - Place Joffre,OUI,25,10,15,13,2,OUI,OUI,2025-03-13 16:00:21+00:00,"48.852060203583, 2.3017993569374",Paris,75056,0.6,16
9035,Gare Saint-Lazare - Place de Budapest,OUI,43,21,22,16,6,OUI,OUI,2025-03-13 16:02:16+00:00,"48.877753, 2.327339",Paris,75056,0.5116279069767442,16
11012,Montreuil - Voltaire,OUI,32,25,7,0,7,OUI,OUI,2025-03-13 15:57:30+00:00,"48.850507011842, 2.3930755582745",Paris,75056,0.21875,16
17126,Hélène et François Missoffe - Emile Borel,OUI,28,8,20,17,3,OUI,OUI,2025-03-13 16:01:54+00:00,"48.89990653843488, 2.321543991674844",Paris,75056,0.7142857142857143,16
15105,Fédération - Suffren,OUI,25,11,14,11,3,OUI,OUI,2025-03-13 16:01:56+00:00,"48.852828153442, 2.2978776320815",Paris,75056,0.56,16
34005,Adrien Lesesne - Docteur Bauer,OUI,29,26,3,0,3,OUI,OUI,2025-03-13 16:00:38+00:00,"48.90263867304635, 2.348248063431511",Saint-Ouen-sur-Seine,93070,0.10344827586206896,16
18205,Mauroy - Cheminots,OUI,29,25,4,1,3,OUI,OUI,2025-03-13 16:00:00+00:00,"48.897715198403, 2.357895075822",Paris,75056,0.13793103448275862,16
26009,Marceau Delorme - Pierre Brossolette,OUI,26,19,7,2,5,OUI,OUI,2025-03-13 15:58:24+00:00,"48.91206062860357, 2.295897423568745",Asnières-sur-Seine,92004,0.2692307692307692,16
8057,Hoche - Tilsitt,OUI,31,28,3,2,1,OUI,OUI,2025-03-13 15:52:47+00:00,"48.874836457837, 2.2971323132515",Paris,75056,0.0967741935483871,16
34012,Bateliers - Quai de Seine,OUI,22,13,9,4,5,OUI,OUI,2025-03-13 15:57:45+00:00,"48.915817585516, 2.3239533298594",Saint-Ouen-sur-Seine,93070,0.4090909090909091,16
9025,Taitbout - Châteaudun,OUI,53,4,49,48,1,OUI,OUI,2025-03-13 16:01:59+00:00,"48.876383969379, 2.3353566779335",Paris,75056,0.9245283018867925,16
23204,Roland Garros - Jean Bouin,OUI,28,28,0,0,0,OUI,OUI,2025-03-13 15:59:27+00:00,"48.809460857173, 2.2853198638301",Châtillon,92020,0.0,16
40007,Préfecture de Créteil,OUI,27,8,19,14,5,OUI,OUI,2025-03-13 16:01:45+00:00,"48.783680285918, 2.4544713672215",Créteil,94028,0.7037037037037037,16
21514,Place de la Paix - Abbé Saint-Pierre,OUI,24,22,2,1,1,OUI,OUI,2025-03-13 15:59:25+00:00,"48.86462724459225, 2.2047570338469806",Suresnes,92073,0.08333333333333333,16
40010,Haut du Mont-Mesly,OUI,21,18,3,2,1,OUI,OUI,2025-03-13 15:47:05+00:00,"48.780191921646, 2.4685737495183",Créteil,94028,0.14285714285714285,16
5107,Pontoise - La Tournelle,OUI,22,4,18,11,7,OUI,OUI,2025-03-13 15:59:19+00:00,"48.850458009188, 2.3524542754922",Paris,75056,0.8181818181818182,16
40013,Hôtel de Ville de Créteil,OUI,36,16,20,13,7,OUI,OUI,2025-03-13 15:59:53+00:00,"48.77699496201, 2.4552552404284",Créteil,94028,0.5555555555555556,16
18026,Ruisseau - Ordener,OUI,33,28,5,1,4,OUI,OUI,2025-03-13 15:58:39+00:00,"48.89299462568024, 2.340144887566567",Paris,75056,0.15151515151515152,16
12201,Dugommier,OUI,53,45,8,5,3,OUI,OUI,2025-03-13 15:59:39+00:00,"48.838811048815, 2.3896577954292",Paris,75056,0.1509433962264151,16
18024,Clignancourt - Ordener,OUI,35,35,0,0,0,OUI,OUI,2025-03-13 15:58:40+00:00,"48.891457726153774, 2.348636478060487",Paris,75056,0.0,16
26005,Hôtel de Ville d'Asnières sur Seine,OUI,25,13,12,2,10,OUI,OUI,2025-03-13 16:01:36+00:00,"48.90999330025577, 2.288238108158112",Asnières-sur-Seine,92004,0.48,16
19018,Cité de la Musique,OUI,53,26,27,13,14,OUI,OUI,2025-03-13 16:00:33+00:00,"48.888796556487, 2.3925811931922",Paris,75056,0.5094339622641509,16
23703,Gare de Chaville Rive Gauche,OUI,18,17,1,1,0,OUI,OUI,2025-03-13 15:58:11+00:00,"48.805160304345, 2.188277207315",Chaville,92022,0.05555555555555555,16
16006,Lauriston - Copernic,OUI,19,15,4,1,3,OUI,OUI,2025-03-13 16:01:59+00:00,"48.86926, 2.289918",Paris,75056,0.21052631578947367,16
13106,Bobillot - Paulin Mery,OUI,21,20,1,1,0,OUI,OUI,2025-03-13 15:59:10+00:00,"48.829899841747, 2.3543356766749",Paris,75056,0.047619047619047616,16
13205,Choisy - Pointe d'Ivry,OUI,24,22,2,0,2,OUI,OUI,2025-03-13 16:01:49+00:00,"48.822154170359, 2.3633708034878",Paris,75056,0.08333333333333333,16
31202,Gabriel Péri - Jules Ferry,OUI,27,11,16,15,1,OUI,OUI,2025-03-13 16:01:45+00:00,"48.926182814311, 2.3912295762525",La Courneuve,93027,0.5925925925925926,16
7201,Place De Fontenoy - Saxe,OUI,18,2,16,11,5,OUI,OUI,2025-03-13 16:01:33+00:00,"48.850270554523, 2.3069813815839",Paris,75056,0.8888888888888888,16
20137,Borrégo - Gambetta,OUI,25,22,3,0,3,OUI,OUI,2025-03-13 15:46:12+00:00,"48.87330497045532, 2.4014145880937576",Paris,75056,0.12,16
15013,Volontaires - Lecourbe,OUI,29,26,3,1,2,OUI,OUI,2025-03-13 15:59:54+00:00,"48.84351378799, 2.3065522313118",Paris,75056,0.10344827586206896,16
31708,Noisy le Sec - Jean-Baptiste Clément,OUI,21,19,2,0,2,OUI,OUI,2025-03-13 15:55:25+00:00,"48.874515389637, 2.4152836203575",Bagnolet,93006,0.09523809523809523,16
1003,Saint-Denis - Rivoli,OUI,43,6,37,24,13,OUI,OUI,2025-03-13 16:01:42+00:00,"48.859059340842, 2.3476943001151",Paris,75056,0.8604651162790697,16
21501,Pont de Suresnes,OUI,15,9,6,4,2,OUI,OUI,2025-03-13 15:58:00+00:00,"48.867415092322, 2.2258946679617",Suresnes,92073,0.4,16
10013,Alibert - Jemmapes,OUI,59,56,3,1,2,OUI,OUI,2025-03-13 16:01:55+00:00,"48.871044051984, 2.3661044619878",Paris,75056,0.05084745762711865,16
18042,Place Pigalle,OUI,20,16,4,0,4,OUI,OUI,2025-03-13 16:02:05+00:00,"48.8827555, 2.3361566",Paris,75056,0.2,16
19203,Pailleron - Bouret,OUI,27,24,3,1,2,OUI,OUI,2025-03-13 16:01:12+00:00,"48.880516995482, 2.3763902374411",Paris,75056,0.1111111111111111,16
11037,Faubourg Du Temple - Republique,OUI,38,12,26,23,3,OUI,OUI,2025-03-13 16:01:14+00:00,"48.867872484749, 2.3648982158072",Paris,75056,0.6842105263157895,16
21404,Jean Jaurès - Gare de Clamart,OUI,20,18,2,0,2,OUI,OUI,2025-03-13 16:01:10+00:00,"48.81321981219, 2.2716768079163",Clamart,92023,0.1,16
11014,Place de la Nation - Taillebourg,OUI,46,45,1,0,1,OUI,OUI,2025-03-13 15:56:54+00:00,"48.8488408, 2.3973043",Paris,75056,0.021739130434782608,16
17123,Mstislav Rostropovitch - Berthier,OUI,18,8,10,3,7,OUI,OUI,2025-03-13 15:59:02+00:00,"48.892120821173975, 2.309234105050564",Paris,75056,0.5555555555555556,16
35002,Jean Jaurès - Presles,OUI,31,23,8,5,3,OUI,OUI,2025-03-13 16:01:48+00:00,"48.907134414988, 2.3960057280531",Pantin,93055,0.25806451612903225,16
6001,Institut de France,OUI,17,2,15,9,6,OUI,OUI,2025-03-13 16:01:50+00:00,"48.857615678565, 2.3358313530377",Paris,75056,0.8823529411764706,16
11020,Belfort - Voltaire,OUI,39,31,8,2,6,OUI,OUI,2025-03-13 16:02:11+00:00,"48.8563358, 2.3829901",Paris,75056,0.20512820512820512,16
17038,Grande Armée - Brunel,OUI,60,31,29,7,22,OUI,OUI,2025-03-13 16:01:39+00:00,"48.876116, 2.288124",Paris,75056,0.48333333333333334,16
8039,Colisée - Champs-Elysées,OUI,16,5,11,5,6,OUI,OUI,2025-03-13 15:59:40+00:00,"48.870475399387, 2.3076190799475",Paris,75056,0.6875,16
8052,Balzac - Champs Elysées,OUI,30,9,21,10,11,OUI,OUI,2025-03-13 15:59:35+00:00,"48.872699639621, 2.3001953959465",Paris,75056,0.7,16
12157,Fabre d'Eglantine - Place de la Nation,OUI,66,61,5,2,3,OUI,OUI,2025-03-13 15:52:56+00:00,"48.8471116, 2.3956204",Paris,75056,0.07575757575757576,16
33019,Madeleine Vionnet,OUI,37,17,20,7,13,OUI,OUI,2025-03-13 15:59:28+00:00,"48.902519074064, 2.3740895837545",Aubervilliers,93001,0.5405405405405406,16
21213,Vanne - Général de Gaulle,OUI,25,24,1,0,1,OUI,OUI,2025-03-13 15:57:47+00:00,"48.815007, 2.328318",Montrouge,92049,0.04,16
8002,Gare Saint-Lazare - Cour du Havre,OUI,43,12,31,13,18,OUI,OUI,2025-03-13 16:02:09+00:00,"48.875674400851, 2.3265598341823",Paris,75056,0.7209302325581395,16
3004,Place de la République - Temple,OUI,17,3,14,7,7,OUI,OUI,2025-03-13 16:01:26+00:00,"48.867211201859, 2.3635464370545",Paris,75056,0.8235294117647058,16
21021,Enfants du Paradis - Peupliers,OUI,59,6,53,30,23,OUI,OUI,2025-03-13 16:01:33+00:00,"48.833122686454, 2.2571459412575",Boulogne-Billancourt,92012,0.8983050847457628,16
15060,Place de la Montagne du Goulet,OUI,20,4,16,15,1,OUI,OUI,2025-03-13 16:02:12+00:00,"48.8443415, 2.2773844",Paris,75056,0.8,16
21302,Aristide Briand - Place de la Résistance,OUI,37,3,34,31,3,OUI,OUI,2025-03-13 16:01:40+00:00,"48.82124248401006, 2.2511002421379094",Issy-les-Moulineaux,92040,0.918918918918919,16
11011,Richard Lenoir - Voltaire,OUI,25,9,16,14,2,OUI,OUI,2025-03-13 15:59:45+00:00,"48.86164273878, 2.3727491497993",Paris,75056,0.64,16
9104,Caumartin - Provence,OUI,22,4,18,12,6,OUI,OUI,2025-03-13 16:02:01+00:00,"48.874422773426545, 2.3284685611724854",Paris,75056,0.8181818181818182,16
7023,Bourdonnais - Tour Eiffel,OUI,57,4,53,44,9,OUI,OUI,2025-03-13 15:59:53+00:00,"48.860897797941, 2.295599598447",Paris,75056,0.9298245614035088,16
7109,Place Joffre - Frédéric le Play,OUI,37,26,11,9,2,OUI,OUI,2025-03-13 16:00:59+00:00,"48.853754486938, 2.3044242337346",Paris,75056,0.2972972972972973,16
7025,Octave Gréard - Tour Eiffel,OUI,31,13,18,11,7,OUI,OUI,2025-03-13 16:01:33+00:00,"48.856502977696, 2.2931787543289",Paris,75056,0.5806451612903226,16
4108,Quai de Béthune - Pont de la Tournelle,OUI,25,1,24,19,5,OUI,OUI,2025-03-13 16:02:16+00:00,"48.85097433194, 2.3563072085381",Paris,75056,0.96,16
40012,Stade de la Habette,OUI,16,14,2,0,2,OUI,OUI,2025-03-13 15:56:53+00:00,"48.774397033806, 2.4668785263921",Créteil,94028,0.125,16
12107,Diderot - Pierre Bourdan,OUI,21,15,6,3,3,OUI,OUI,2025-03-13 15:58:38+00:00,"48.847648620797, 2.3902582749724",Paris,75056,0.2857142857142857,16
40014,Créteil Pointe du Lac,OUI,28,3,25,9,16,OUI,OUI,2025-03-13 16:00:34+00:00,"48.769807356177, 2.4623027310281",Créteil,94028,0.8928571428571429,16
23011,Bineau - Louise Michel,OUI,26,15,11,10,1,OUI,OUI,2025-03-13 16:01:37+00:00,"48.88666162207, 2.2843274474144",Levallois-Perret,92044,0.4230769230769231,16
16005,Raymond Poincaré - Place Victor Hugo,OUI,22,13,9,0,9,OUI,OUI,2025-03-13 16:00:03+00:00,"48.87030612437, 2.2850745414202",Paris,75056,0.4090909090909091,16
12105,Bercy - Villot,OUI,36,8,28,24,4,OUI,OUI,2025-03-13 16:01:56+00:00,"48.841795009027, 2.3767850184816",Paris,75056,0.7777777777777778,16
40003,Centre Hospitalier Intercommunal de Créteil,OUI,17,16,1,0,1,OUI,OUI,2025-03-13 16:01:44+00:00,"48.797078298909, 2.463801423807",Créteil,94028,0.058823529411764705,16
23801,Place de la Gare,OUI,20,15,5,2,3,OUI,OUI,2025-03-13 16:01:44+00:00,"48.838513582184, 2.1866139007512",Garches,92033,0.25,16
40004,Créteil Village,OUI,25,4,21,7,14,OUI,OUI,2025-03-13 16:02:06+00:00,"48.79122395576, 2.4642198533952",Créteil,94028,0.84,16
40008,Créteil Pompadour,OUI,44,10,34,11,23,OUI,OUI,2025-03-13 16:01:33+00:00,"48.773011623355, 2.435166164893",Créteil,94028,0.7727272727272727,16
14021,Place de la Porte de Châtillon,OUI,58,57,1,0,1,OUI,OUI,2025-03-13 16:01:12+00:00,"48.8242469, 2.3186306",Paris,75056,0.017241379310344827,16
40015,Iles de Loisirs de Créteil,OUI,24,4,20,11,9,OUI,OUI,2025-03-13 16:01:33+00:00,"48.780258200618, 2.4455094301232",Créteil,94028,0.8333333333333334,16
51005,Yves Farges - Route d'Enghien,OUI,33,15,18,6,12,OUI,OUI,2025-03-13 15:59:37+00:00,"48.95756799268, 2.2834496977978",Argenteuil,95018,0.5454545454545454,16
10031,Louis Blanc - Aqueduc,OUI,36,33,3,1,2,OUI,OUI,2025-03-13 16:00:34+00:00,"48.882030182599, 2.363561578095",Paris,75056,0.08333333333333333,16
32004,Wilson - Landy,OUI,38,19,19,15,4,OUI,OUI,2025-03-13 16:01:48+00:00,"48.91516726221354, 2.357633225619793",Saint-Denis,93066,0.5,16
35014,Charles de Gaulle - Jean Lolive,OUI,25,24,1,1,0,OUI,OUI,2025-03-13 16:00:58+00:00,"48.8932644350857, 2.4126765131950383",Pantin,93055,0.04,16
15103,Cauchy - Cévennes,OUI,50,8,42,40,2,OUI,OUI,2025-03-13 16:01:59+00:00,"48.843372571022, 2.2751328349113",Paris,75056,0.84,16
18043,Clichy - Place Blanche,OUI,18,4,14,2,12,OUI,OUI,2025-03-13 16:01:41+00:00,"48.883601088297, 2.3332237824798",Paris,75056,0.7777777777777778,16
15026,Bir Hakeim,OUI,32,12,20,17,3,OUI,OUI,2025-03-13 16:01:19+00:00,"48.853844054334, 2.289705348222",Paris,75056,0.625,16
1022,Danielle Casanova - Place Vendôme,OUI,37,10,27,19,8,OUI,OUI,2025-03-13 16:01:58+00:00,"48.868266498223, 2.3304839059711",Paris,75056,0.7297297297297297,16
41301,Bois de Vincennes - Gare,OUI,50,48,2,0,2,OUI,OUI,2025-03-13 16:01:04+00:00,"48.836022242887, 2.470833995083",Nogent-sur-Marne,94052,0.04,16
32012,Carrefour Pleyel,OUI,65,39,26,13,13,OUI,OUI,2025-03-13 16:00:06+00:00,"48.92034156960326, 2.3438543826341625",Saint-Denis,93066,0.4,16
34014,Michelet - Dr Bauer,OUI,30,27,3,1,2,OUI,OUI,2025-03-13 15:55:14+00:00,"48.906125424194, 2.3440374449846",Saint-Ouen-sur-Seine,93070,0.1,16
27004,Gare de la Garenne-Colombes,OUI,27,16,11,7,4,OUI,OUI,2025-03-13 16:02:08+00:00,"48.909752, 2.239145",Colombes,92025,0.4074074074074074,16
1002,Victoria - Place du Chatelet,OUI,19,3,16,11,5,OUI,OUI,2025-03-13 16:01:49+00:00,"48.857992591527, 2.3469167947769",Paris,75056,0.8421052631578947,16
12010,Daumesnil - Picpus,OUI,20,12,8,6,2,OUI,OUI,2025-03-13 15:59:41+00:00,"48.8374688, 2.401765",Paris,75056,0.4,16
4104,Sebastopol - Rambuteau,OUI,15,6,9,5,4,OUI,OUI,2025-03-13 16:00:28+00:00,"48.86181809267, 2.3501381278038",Paris,75056,0.6,16
13123,BNF - Bibliothèque Nationale de France,OUI,46,3,43,27,16,OUI,OUI,2025-03-13 16:02:10+00:00,"48.8350268238, 2.3760157451034",Paris,75056,0.9347826086956522,16
32001,Proudhon - Président Wilson,OUI,30,15,15,10,5,OUI,OUI,2025-03-13 16:02:12+00:00,"48.906442763495, 2.3584905266762",Saint-Denis,93066,0.5,16
40002,Bleuets - Bordières,OUI,21,16,5,3,2,OUI,OUI,2025-03-13 15:59:10+00:00,"48.802117531472, 2.4543687905029",Créteil,94028,0.23809523809523808,16
12127,Tremblay - Lac des Minimes,OUI,53,18,35,10,25,OUI,OUI,2025-03-13 16:01:17+00:00,"48.834131261494, 2.4547516554594",Paris,75056,0.660377358490566,16
15056,Place Balard,OUI,27,10,17,15,2,OUI,OUI,2025-03-13 16:01:42+00:00,"48.836395736424, 2.2784192115068",Paris,75056,0.6296296296296297,16
8004,Malesherbes - Place de la Madeleine,OUI,78,11,67,32,35,OUI,OUI,2025-03-13 16:01:33+00:00,"48.870406028483, 2.323243509808",Paris,75056,0.8589743589743589,16
44015,Rouget de L'isle - Watteau,OUI,20,8,12,1,11,OUI,OUI,2025-03-13 17:00:46+00:00,"48.778192750803, 2.3963020229163",Vitry-sur-Seine,94081,0.6,17
16107,Benjamin Godard - Victor Hugo,OUI,32,31,1,1,0,OUI,OUI,2025-03-13 16:57:57+00:00,"48.865983, 2.275725",Paris,75056,0.03125,17
9020,Toudouze - Clauzel,OUI,21,18,3,0,3,OUI,OUI,2025-03-13 17:00:51+00:00,"48.87929591733507, 2.3373600840568547",Paris,75056,0.14285714285714285,17
40001,Hôpital Mondor,OUI,28,12,16,10,6,OUI,OUI,2025-03-13 17:01:58+00:00,"48.798922410229, 2.4537451531298",Créteil,94028,0.5714285714285714,17
13007,Le Brun - Gobelins,OUI,48,34,14,13,1,OUI,OUI,2025-03-13 17:00:21+00:00,"48.835092787824, 2.3534681351338",Paris,75056,0.2916666666666667,17
14111,Cassini - Denfert-Rochereau,OUI,22,20,2,2,0,OUI,OUI,2025-03-13 17:01:28+00:00,"48.837525839067, 2.3360354080796",Paris,75056,0.09090909090909091,17
7002,Vaneau - Sèvres,OUI,34,18,16,12,4,OUI,OUI,2025-03-13 16:58:29+00:00,"48.848563233059, 2.3204218259346",Paris,75056,0.47058823529411764,17
14014,Jourdan - Stade Charléty,OUI,58,52,6,3,3,OUI,OUI,2025-03-13 16:59:58+00:00,"48.819428333369, 2.3433353751898",Paris,75056,0.10344827586206896,17
25006,Place Nelson Mandela,OUI,22,19,3,0,3,OUI,OUI,2025-03-13 16:55:07+00:00,"48.862453313908, 2.1961666225454",Rueil-Malmaison,92063,0.13636363636363635,17
32017,Basilique,OUI,18,12,6,2,4,OUI,OUI,2025-03-13 16:57:43+00:00,"48.93626891059109, 2.3588666820200914",Saint-Denis,93066,0.3333333333333333,17
32304,Charcot - Benfleet,OUI,28,27,1,0,1,NON,NON,2025-03-13 16:55:49+00:00,"48.878370277021, 2.440523876268",Romainville,93063,0.03571428571428571,17
11104,Charonne - Robert et Sonia Delaunay,OUI,20,19,1,0,1,OUI,OUI,2025-03-13 17:01:01+00:00,"48.855907555969, 2.3925706744194",Paris,75056,0.05,17
7003,Square Boucicaut,OUI,58,37,21,19,2,OUI,OUI,2025-03-13 17:02:10+00:00,"48.851296433665276, 2.325061820447445",Paris,75056,0.3620689655172414,17
8026,Messine - Place Du Pérou,OUI,11,4,7,5,2,OUI,OUI,2025-03-13 16:58:51+00:00,"48.875448033960744, 2.315508019010038",Paris,75056,0.6363636363636364,17
5016,Thouin - Cardinal Lemoine,OUI,15,9,6,0,6,OUI,OUI,2025-03-13 16:59:40+00:00,"48.84504716661511, 2.3494647851273465",Paris,75056,0.4,17
6003,Saint-Sulpice,OUI,21,4,17,12,5,OUI,OUI,2025-03-13 17:02:16+00:00,"48.85165383178419, 2.3308077827095985",Paris,75056,0.8095238095238095,17
11025,Froment - Bréguet,OUI,42,23,19,15,4,OUI,OUI,2025-03-13 17:01:40+00:00,"48.8570414504784, 2.37289470306807",Paris,75056,0.4523809523809524,17
5110,Lacépède - Monge,OUI,23,16,7,0,7,OUI,OUI,2025-03-13 17:00:58+00:00,"48.84389286531899, 2.3519663885235786",Paris,75056,0.30434782608695654,17
17026,Jouffroy d'Abbans - Wagram,OUI,39,28,11,7,4,OUI,OUI,2025-03-13 17:00:26+00:00,"48.881973298352, 2.301132157445",Paris,75056,0.28205128205128205,17
6108,Saint-Romain - Cherche-Midi,OUI,16,0,16,13,3,OUI,OUI,2025-03-13 17:02:04+00:00,"48.84708159081946, 2.321374788880348",Paris,75056,1.0,17
6021,Beaux-Arts - Bonaparte,OUI,19,10,9,7,2,OUI,OUI,2025-03-13 17:00:47+00:00,"48.856451985396, 2.3348518833518",Paris,75056,0.47368421052631576,17
33006,André Karman - République,OUI,29,27,2,0,2,OUI,OUI,2025-03-13 16:59:31+00:00,"48.91039875761846, 2.3851355910301213",Aubervilliers,93001,0.06896551724137931,17
15202,Bracion - Périphérique,OUI,30,27,3,0,3,OUI,OUI,2025-03-13 16:55:33+00:00,"48.826103771275, 2.3004549373748",Paris,75056,0.1,17
42016,Pierre et Marie Curie - Maurice Thorez,OUI,25,23,2,1,1,OUI,OUI,2025-03-13 17:02:20+00:00,"48.81580226360801, 2.376804985105991",Ivry-sur-Seine,94041,0.08,17
31024,Romainville - Vaillant-Couturier,OUI,36,33,3,0,3,OUI,OUI,2025-03-13 17:01:10+00:00,"48.86785, 2.446748",Montreuil,93048,0.08333333333333333,17
40011,Bas du Mont-Mesly,OUI,26,17,9,6,3,OUI,OUI,2025-03-13 17:02:23+00:00,"48.779035118572, 2.4609763908985",Créteil,94028,0.34615384615384615,17
2022,Saint-Fiacre - Poissonière,OUI,33,20,13,11,2,OUI,OUI,2025-03-13 17:01:33+00:00,"48.870828911558, 2.3459213599563",Paris,75056,0.3939393939393939,17
21010,Silly - Galliéni,OUI,25,9,16,12,4,OUI,OUI,2025-03-13 17:01:08+00:00,"48.835583838706, 2.2325500845909",Boulogne-Billancourt,92012,0.64,17
17044,Porte de Saint-Ouen - Bessières,OUI,40,24,16,12,4,OUI,OUI,2025-03-13 17:00:53+00:00,"48.89792240854517, 2.32851451022192",Paris,75056,0.4,17
30002,Jean Rostand - Paul Vaillant Couturier,OUI,39,30,9,8,1,OUI,OUI,2025-03-13 16:57:35+00:00,"48.908168131015, 2.4530601033354",Bobigny,93008,0.23076923076923078,17
21326,Moulin de Pierre - Abbé Grégoire,OUI,20,14,6,0,6,OUI,OUI,2025-03-13 17:01:08+00:00,"48.822036188382, 2.2754641655975",Issy-les-Moulineaux,92040,0.3,17
17041,Guersant - Gouvion-Saint-Cyr,OUI,33,12,21,16,5,OUI,OUI,2025-03-13 17:02:01+00:00,"48.88287775178599, 2.287667370814871",Paris,75056,0.6363636363636364,17
20143,Ramponeau - Belleville,OUI,44,38,6,1,5,OUI,OUI,2025-03-13 17:02:14+00:00,"48.871031137596, 2.379056852114",Paris,75056,0.13636363636363635,17
15047,Morillons - Dantzig,OUI,51,51,0,0,0,OUI,OUI,2025-03-13 16:56:56+00:00,"48.83310149953933, 2.299380004405976",Paris,75056,0.0,17
21216,Louis Lejeune - Barbès,OUI,24,23,1,0,1,OUI,OUI,2025-03-13 16:59:48+00:00,"48.81807418981508, 2.3267009854316716",Montrouge,92049,0.041666666666666664,17
12109,Mairie du 12ème,OUI,30,28,2,2,0,OUI,OUI,2025-03-13 17:01:17+00:00,"48.840855311763, 2.3875549435616",Paris,75056,0.06666666666666667,17
19027,Serrurier,OUI,18,17,1,0,1,OUI,OUI,2025-03-13 17:01:35+00:00,"48.880493403246, 2.398064173758",Paris,75056,0.05555555555555555,17
8050,Boétie - Ponthieu,OUI,41,13,28,12,16,OUI,OUI,2025-03-13 17:02:08+00:00,"48.871417284355, 2.3076787590981",Paris,75056,0.6829268292682927,17
17048,De Toqueville - Terrasse,OUI,30,27,3,2,1,OUI,OUI,2025-03-13 16:58:13+00:00,"48.882428, 2.314002",Paris,75056,0.1,17
13101,Croulebarde - Corvisart,OUI,33,27,6,6,0,OUI,OUI,2025-03-13 17:01:10+00:00,"48.830981659316855, 2.3481646925210953",Paris,75056,0.18181818181818182,17
14108,Le Brix et Mesmin - Jourdan,OUI,20,19,1,1,0,OUI,OUI,2025-03-13 17:01:33+00:00,"48.82234096593411, 2.327861653302471",Paris,75056,0.05,17
8103,Artois - Berri,OUI,22,15,7,6,1,OUI,OUI,2025-03-13 17:02:11+00:00,"48.87393521240818, 2.3064258322119713",Paris,75056,0.3181818181818182,17
19033,Cambrai - Benjamin Constant,OUI,41,40,1,0,1,OUI,OUI,2025-03-13 17:01:52+00:00,"48.89594736851349, 2.381133802246315",Paris,75056,0.024390243902439025,17
14013,Liard - Amiral Mouchez,OUI,26,24,2,1,1,OUI,OUI,2025-03-13 17:01:49+00:00,"48.8214169, 2.342167",Paris,75056,0.07692307692307693,17
17025,Chazelles - Courcelles,OUI,32,29,3,0,3,OUI,OUI,2025-03-13 16:56:56+00:00,"48.879406604954, 2.3034455627202988",Paris,75056,0.09375,17
13118,Regnault - Patay,OUI,62,15,47,42,5,OUI,OUI,2025-03-13 17:02:20+00:00,"48.82435782216384, 2.377065159380436",Paris,75056,0.7580645161290323,17
43002,Lagny - Victor Basch,OUI,24,24,0,0,0,OUI,OUI,2025-03-13 17:02:06+00:00,"48.84884147189881, 2.426325418925233",Vincennes,94080,0.0,17
15112,Vigée-Lebrun - Anselme Payen,OUI,23,20,3,0,3,OUI,OUI,2025-03-13 17:01:54+00:00,"48.838683941628375, 2.3110422492027287",Paris,75056,0.13043478260869565,17
16138,Saint-Cloud - Hippodrome,OUI,30,23,7,3,4,OUI,OUI,2025-03-13 16:59:53+00:00,"48.85772148887421, 2.2549109905958176",Paris,75056,0.23333333333333334,17
13030,Italie - Tolbiac,OUI,21,21,0,0,0,OUI,OUI,2025-03-13 17:02:10+00:00,"48.82557229464416, 2.3576171323657036",Paris,75056,0.0,17
15068,Général Martial Valin - Pont du Garigliano,OUI,16,12,4,0,4,OUI,OUI,2025-03-13 16:57:52+00:00,"48.83823094269141, 2.270506024360657",Paris,75056,0.25,17
18111,Félix Ziem - Armand Gauthier,OUI,24,17,7,0,7,OUI,OUI,2025-03-13 17:01:55+00:00,"48.88949630486821, 2.333393658804396",Paris,75056,0.2916666666666667,17
22207,Rond-point du Dr Albert Schweitzer,OUI,21,12,9,2,7,OUI,OUI,2025-03-13 17:00:20+00:00,"48.78980918988166, 2.3143940046429634",Bagneux,92007,0.42857142857142855,17
48003,Youri Gagarine - Karl Marx,OUI,22,20,2,1,1,OUI,OUI,2025-03-13 16:59:05+00:00,"48.78448485079149, 2.35908430069685",Villejuif,94076,0.09090909090909091,17
92002,Théâtre des Amandiers - Palais des sports,OUI,22,10,12,8,4,OUI,OUI,2025-03-13 16:58:34+00:00,"48.892648526839, 2.2136941552162",Nanterre,92050,0.5454545454545454,17
43009,Place Jean-Spire-Lemaître,OUI,47,34,13,7,6,OUI,OUI,2025-03-13 17:02:18+00:00,"48.8468428626593, 2.452062070369721",Vincennes,94080,0.2765957446808511,17
31028,Raspail Barbès,OUI,28,28,0,0,0,OUI,OUI,2025-03-13 16:54:41+00:00,"48.8529945, 2.4247387",Montreuil,93048,0.0,17
9001,Bellefond - Poissonnière,OUI,15,15,0,0,0,OUI,OUI,2025-03-13 16:59:47+00:00,"48.87759897050706, 2.348463758826256",Paris,75056,0.0,17
44017,Jules Guesde - Pont du Port à l'Anglais,OUI,26,0,26,24,2,OUI,OUI,2025-03-13 17:01:47+00:00,"48.79628807093802, 2.417212128639221",Vitry-sur-Seine,94081,1.0,17
17032,Jean Oestreicher - Porte de Champerret,OUI,21,12,9,4,5,OUI,OUI,2025-03-13 16:59:24+00:00,"48.88655580065981, 2.288640439510346",Paris,75056,0.42857142857142855,17
16118,Michel-Ange - Parent de Rosan,OUI,23,17,6,4,2,OUI,OUI,2025-03-13 17:00:36+00:00,"48.840579923690115, 2.2584119439125065",Paris,75056,0.2608695652173913,17
8016,Square Louis XVI,OUI,29,12,17,12,5,OUI,OUI,2025-03-13 17:02:26+00:00,"48.87320440102894, 2.323658830743138",Paris,75056,0.5862068965517241,17
2017,Caire - Dussoubs,OUI,40,18,22,21,1,OUI,OUI,2025-03-13 17:02:09+00:00,"48.86785342111862, 2.349364310503006",Paris,75056,0.55,17
10115,Granges aux Belles,OUI,26,25,1,1,0,OUI,OUI,2025-03-13 16:59:35+00:00,"48.8761373390584, 2.3680844979417",Paris,75056,0.038461538461538464,17
9008,Tour d'Auvergne - Rodier,OUI,16,12,4,1,3,OUI,OUI,2025-03-13 17:01:58+00:00,"48.879161, 2.343698",Paris,75056,0.25,17
41303,Gare de Nogent-le-Perreux,OUI,31,14,17,11,6,OUI,OUI,2025-03-13 16:58:27+00:00,"48.83842553348809, 2.493693307042122",Nogent-sur-Marne,94052,0.5483870967741935,17
8048,Marceau - Chaillot,OUI,21,10,11,1,10,OUI,OUI,2025-03-13 16:57:47+00:00,"48.868834023334, 2.2986030816809",Paris,75056,0.5238095238095238,17
12031,Gabriel Lamé,OUI,33,21,12,6,6,OUI,OUI,2025-03-13 17:01:38+00:00,"48.8351212784276, 2.385534569621086",Paris,75056,0.36363636363636365,17
9002,Abbeville - Faubourg Poissonnière,OUI,14,13,1,1,0,OUI,OUI,2025-03-13 17:01:49+00:00,"48.879223, 2.349147",Paris,75056,0.07142857142857142,17
1001,Quai de l'Horloge - Pont Neuf,OUI,16,3,13,8,5,OUI,OUI,2025-03-13 16:58:52+00:00,"48.857058739111, 2.3417982839439",Paris,75056,0.8125,17
16110,Octave Feuillet - Albéric Magnard,OUI,20,18,2,0,2,OUI,OUI,2025-03-13 17:01:09+00:00,"48.86106902949534, 2.2730283066630363",Paris,75056,0.1,17
13104,Gare d'Austerlitz - Quai Saint-Bernard,OUI,26,2,24,15,9,OUI,OUI,2025-03-13 16:59:16+00:00,"48.84369030864, 2.3657163977623",Paris,75056,0.9230769230769231,17
10029,Dunkerque - Rocroy,OUI,24,17,7,0,7,OUI,OUI,2025-03-13 17:01:36+00:00,"48.880726, 2.351464",Paris,75056,0.2916666666666667,17
17040,Pereire - Ternes,OUI,48,38,10,3,7,OUI,OUI,2025-03-13 17:01:30+00:00,"48.87973954830735, 2.288012132048607",Paris,75056,0.20833333333333334,17
10161,Gare de l'Est - Faubourg-Saint-Martin,OUI,32,28,4,1,3,OUI,OUI,2025-03-13 17:00:30+00:00,"48.875642647477, 2.3594588041306",Paris,75056,0.125,17
8009,Gare Saint-Lazare - Isly,OUI,24,16,8,2,6,OUI,OUI,2025-03-13 17:00:40+00:00,"48.874777677621296, 2.326515804784655",Paris,75056,0.3333333333333333,17
5022,Boulangers - Cardinal Lemoine,OUI,18,17,1,0,1,OUI,OUI,2025-03-13 16:59:07+00:00,"48.8462904, 2.3521495",Paris,75056,0.05555555555555555,17
31103,Gare Rosny-Bois-Perrier,OUI,32,12,20,1,19,OUI,OUI,2025-03-13 17:01:57+00:00,"48.88115023337061, 2.480436824262142",Rosny-sous-Bois,93064,0.625,17
21328,Verger - Colonel Guichard,OUI,29,27,2,0,2,OUI,OUI,2025-03-13 17:00:02+00:00,"48.816376985087, 2.2670380088932",Issy-les-Moulineaux,92040,0.06896551724137931,17
8053,Place Georges Guillaumin,OUI,28,22,6,2,4,OUI,OUI,2025-03-13 17:00:43+00:00,"48.874750203957, 2.301771435326",Paris,75056,0.21428571428571427,17
9038,Douai - Bruxelles,OUI,26,24,2,1,1,OUI,OUI,2025-03-13 17:00:43+00:00,"48.88320784122797, 2.3308449949028507",Paris,75056,0.07692307692307693,17
9014,Faubourg Montmartre - La Fayette,OUI,33,12,21,17,4,OUI,OUI,2025-03-13 17:01:10+00:00,"48.875254549053, 2.3408536612988",Paris,75056,0.6363636363636364,17
17008,Porte Pouchet-Bessières,OUI,23,10,13,11,2,OUI,OUI,2025-03-13 17:02:12+00:00,"48.8978765, 2.3230632",Paris,75056,0.5652173913043478,17
19105,Ambroise Rendu - Porte Brunet,OUI,16,13,3,1,2,OUI,OUI,2025-03-13 16:58:46+00:00,"48.883667, 2.395733",Paris,75056,0.1875,17
7018,Ségur - d'Estrées,OUI,18,16,2,2,0,OUI,OUI,2025-03-13 17:02:22+00:00,"48.851419978983, 2.3097044974566",Paris,75056,0.1111111111111111,17
22409,Henri Barbusse - Stalingrad,OUI,16,7,9,1,8,OUI,OUI,2025-03-13 17:02:28+00:00,"48.814183748660554, 2.2872862592339516",Malakoff,92046,0.5625,17
18203,Lamarck - Saint-Ouen,OUI,40,40,0,0,0,NON,NON,2025-03-13 17:00:45+00:00,"48.891334555236, 2.3272445342326",Paris,75056,0.0,17
19015,Thionville - Ourcq,OUI,23,20,3,1,2,OUI,OUI,2025-03-13 16:59:56+00:00,"48.88917613743794, 2.3833653330802917",Paris,75056,0.13043478260869565,17
5005,Gay Lussac - Saint-Jacques,OUI,22,21,1,0,1,OUI,OUI,2025-03-13 17:01:36+00:00,"48.844730256132, 2.3419239448664",Paris,75056,0.045454545454545456,17
9022,Rossini - Laffitte,OUI,33,23,10,8,2,OUI,OUI,2025-03-13 17:02:01+00:00,"48.87334627510507, 2.337980867701675",Paris,75056,0.30303030303030304,17
21323,Charlot - Stade Gabriel Voisin,OUI,31,0,31,29,2,OUI,OUI,2025-03-13 17:02:23+00:00,"48.827228120536, 2.268122527474",Issy-les-Moulineaux,92040,1.0,17
26003,Argenteuil - Voltaire,OUI,15,5,10,1,9,OUI,OUI,2025-03-13 17:01:11+00:00,"48.91864865955558, 2.2814112156629562",Asnières-sur-Seine,92004,0.6666666666666666,17
9106,Boudreau - Auber,OUI,27,16,11,9,2,OUI,OUI,2025-03-13 17:00:35+00:00,"48.87219, 2.329423",Paris,75056,0.4074074074074074,17
19003,Quai de la Seine,OUI,24,21,3,1,2,OUI,OUI,2025-03-13 17:02:20+00:00,"48.884492238407525, 2.3703941702842717",Paris,75056,0.125,17
31706,Château - République,OUI,24,24,0,0,0,OUI,OUI,2025-03-13 16:54:28+00:00,"48.862923800596, 2.4155035614967",Bagnolet,93006,0.0,17
12151,Gare de Lyon - Place Louis Armand,OUI,56,6,50,35,15,OUI,OUI,2025-03-13 17:02:08+00:00,"48.845515089794, 2.3726498446286",Paris,75056,0.8928571428571429,17
17004,Legendre - Clichy,OUI,38,35,3,2,1,OUI,OUI,2025-03-13 17:01:16+00:00,"48.88896161855884, 2.322528975094376",Paris,75056,0.07894736842105263,17
5020,Institut du Monde Arabe - Saint-Germain,OUI,37,8,29,26,3,OUI,OUI,2025-03-13 17:02:26+00:00,"48.849063299501, 2.3558086529374",Paris,75056,0.7837837837837838,17
92007,Pesaro - Préfecture,OUI,21,17,4,3,1,OUI,OUI,2025-03-13 16:59:38+00:00,"48.89577046284005, 2.223908342421055",Nanterre,92050,0.19047619047619047,17
9028,Moncey - Blanche,OUI,17,12,5,0,5,OUI,OUI,2025-03-13 17:02:09+00:00,"48.88006587474148, 2.3310810327529907",Paris,75056,0.29411764705882354,17
16026,Ranelagh - Mozart,OUI,7,4,3,1,2,OUI,OUI,2025-03-13 16:58:18+00:00,"48.8554439, 2.2704418",Paris,75056,0.42857142857142855,17
10107,Gare du Nord - Hôpital Lariboisière,OUI,49,49,0,0,0,OUI,OUI,2025-03-13 17:02:19+00:00,"48.881949, 2.352339",Paris,75056,0.0,17
26002,Redoute - Les Courtilles,OUI,38,17,21,18,3,OUI,OUI,2025-03-13 17:02:24+00:00,"48.929867194519, 2.2836696356535",Asnières-sur-Seine,92004,0.5526315789473685,17
17043,Belidor - Gouvion-Saint-Cyr,OUI,38,26,12,12,0,OUI,OUI,2025-03-13 16:55:33+00:00,"48.88022154052015, 2.2854680567979813",Paris,75056,0.3157894736842105,17
16039,Exelmans - Versailles,OUI,47,18,29,22,7,OUI,OUI,2025-03-13 17:01:36+00:00,"48.84097491091973, 2.264390252530575",Paris,75056,0.6170212765957447,17
19026,Place de Rhin et Danube,OUI,14,11,3,0,3,OUI,OUI,2025-03-13 16:57:02+00:00,"48.88192765861766, 2.392586767673493",Paris,75056,0.21428571428571427,17
45003,11 Novembre 1918 - 8 Mai 1945,OUI,36,13,23,14,9,OUI,OUI,2025-03-13 16:58:42+00:00,"48.80889533774377, 2.5382421165704727",Champigny-sur-Marne,94017,0.6388888888888888,17
11023,Saint-Maur - Roquette,OUI,46,41,5,3,2,OUI,OUI,2025-03-13 17:02:02+00:00,"48.858688774062955, 2.383553994571467",Paris,75056,0.10869565217391304,17
8034,Berri - Haussmann,OUI,33,12,21,16,5,OUI,OUI,2025-03-13 17:02:09+00:00,"48.874746047357135, 2.3082953318953514",Paris,75056,0.6363636363636364,17
11002,Roquette - Thiéré,OUI,20,4,16,13,3,OUI,OUI,2025-03-13 16:58:32+00:00,"48.85507930579506, 2.3733686318721463",Paris,75056,0.8,17
5032,Panthéon - Valette,OUI,39,38,1,0,1,OUI,OUI,2025-03-13 17:02:27+00:00,"48.847020571652, 2.3464982619671",Paris,75056,0.02564102564102564,17
12111,Claude Decaen - Cannebière,OUI,27,26,1,0,1,OUI,OUI,2025-03-13 17:02:01+00:00,"48.83761417037952, 2.397253782195704",Paris,75056,0.037037037037037035,17
18107,Chartres - La Charbonnière,OUI,34,31,3,0,3,OUI,OUI,2025-03-13 17:01:01+00:00,"48.8847601, 2.3534657",Paris,75056,0.08823529411764706,17
11047,Amelot - Saint-Sébastien,OUI,28,6,22,16,6,OUI,OUI,2025-03-13 17:01:38+00:00,"48.861142162761, 2.3677996181077",Paris,75056,0.7857142857142857,17
6006,Notre-Dame-des-Champs - Stanislas,OUI,17,16,1,1,0,OUI,OUI,2025-03-13 17:02:25+00:00,"48.84479928858768, 2.329337755887181",Paris,75056,0.058823529411764705,17
19043,Delphine Seyrig - Général Leclerc,OUI,52,49,3,2,1,OUI,OUI,2025-03-13 17:00:22+00:00,"48.893923963057865, 2.39790290594101",Pantin,93055,0.057692307692307696,17
8010,Liège - Moscou,OUI,15,12,3,0,3,OUI,OUI,2025-03-13 17:01:57+00:00,"48.8795431, 2.3264628",Paris,75056,0.2,17
20042,Pyrénées - Emmery,OUI,39,37,2,0,2,OUI,OUI,2025-03-13 17:02:28+00:00,"48.872010281270974, 2.392039597034455",Paris,75056,0.05128205128205128,17
31022,Mairie de Montreuil,OUI,51,47,4,2,2,OUI,OUI,2025-03-13 17:02:02+00:00,"48.86131452758348, 2.440614402294159",Montreuil,93048,0.0784313725490196,17
15067,Desaix - Edgar Faure,OUI,11,3,8,6,2,OUI,OUI,2025-03-13 17:01:53+00:00,"48.852804604940296, 2.293077029857222",Paris,75056,0.7272727272727273,17
14020,Cimetière de Montrouge,OUI,58,52,6,1,5,OUI,OUI,2025-03-13 17:00:06+00:00,"48.821466904768, 2.3215785772007",Paris,75056,0.10344827586206896,17
17030,Pereire - Rennequin,OUI,22,18,4,2,2,OUI,OUI,2025-03-13 17:01:41+00:00,"48.88364782887555, 2.2952447086572647",Paris,75056,0.18181818181818182,17
33017,Anatole France - President Roosevelt,OUI,25,21,4,1,3,OUI,OUI,2025-03-13 16:57:15+00:00,"48.9155156, 2.3814103",Aubervilliers,93001,0.16,17
11027,Saint-Ambroise - Parmentier,OUI,35,24,11,7,4,OUI,OUI,2025-03-13 17:01:12+00:00,"48.862147844548, 2.3772348091006",Paris,75056,0.3142857142857143,17
15042,Henry Farman,OUI,15,10,5,5,0,OUI,OUI,2025-03-13 16:57:43+00:00,"48.83372430280548, 2.2713854536414146",Paris,75056,0.3333333333333333,17
12128,Pyramide - Ecole du Breuil,OUI,33,31,2,1,1,OUI,OUI,2025-03-13 16:56:00+00:00,"48.82237977153955, 2.4586871266365056",Paris,75056,0.06060606060606061,17
33102,Gabriel Péri - Francisco Ferrer,OUI,18,17,1,0,1,OUI,OUI,2025-03-13 17:02:22+00:00,"48.88633710236977, 2.407338917255402",Le Pré-Saint-Gervais,93061,0.05555555555555555,17
46002,Rouget de Lisle,OUI,35,4,31,16,15,OUI,OUI,2025-03-13 16:58:54+00:00,"48.764615483395254, 2.4071189761161804",Choisy-le-Roi,94022,0.8857142857142857,17
42706,Roger Salengro - Fontainebleau,OUI,24,22,2,1,1,OUI,OUI,2025-03-13 17:01:57+00:00,"48.814548697325, 2.3611663654447",Le Kremlin-Bicêtre,94043,0.08333333333333333,17
10016,Récollets - Square Villemin,OUI,16,13,3,1,2,OUI,OUI,2025-03-13 16:59:14+00:00,"48.875034655883944, 2.359801238597928",Paris,75056,0.1875,17
44006,Concorde - Stalingrad,OUI,35,26,9,4,5,OUI,OUI,2025-03-13 17:01:14+00:00,"48.7985844, 2.3821302",Vitry-sur-Seine,94081,0.2571428571428571,17
31009,Place Du Général De Gaulle,OUI,25,23,2,0,2,OUI,OUI,2025-03-13 17:01:59+00:00,"48.8687591, 2.4329931",Montreuil,93048,0.08,17
19120,Carducci - Place Hannah Arendt,OUI,27,24,3,0,3,OUI,OUI,2025-03-13 17:02:06+00:00,"48.877436681515796, 2.3860743641853337",Paris,75056,0.1111111111111111,17
41302,Charles de Gaulle - Beauté,OUI,48,46,2,0,2,OUI,OUI,2025-03-13 17:02:14+00:00,"48.83649602312711, 2.479562651149885",Nogent-sur-Marne,94052,0.041666666666666664,17
18003,Cimetière de Montmartre,OUI,43,39,4,0,4,OUI,OUI,2025-03-13 17:01:12+00:00,"48.886472466142, 2.3328901827335",Paris,75056,0.09302325581395349,17
18011,Pajol - Place Herbert,OUI,39,36,3,2,1,OUI,OUI,2025-03-13 16:59:56+00:00,"48.8927825, 2.3635598",Paris,75056,0.07692307692307693,17
11113,Richard Lenoir - Republique,OUI,56,31,25,22,3,OUI,OUI,2025-03-13 17:02:00+00:00,"48.8667175, 2.3692541",Paris,75056,0.44642857142857145,17
21212,Marne - Germain Dardan,OUI,20,19,1,0,1,OUI,OUI,2025-03-13 16:59:02+00:00,"48.81217465201, 2.3035024699104",Montrouge,92049,0.05,17
14003,Schoelcher - Raspail,OUI,47,43,4,2,2,OUI,OUI,2025-03-13 17:01:36+00:00,"48.83681733526843, 2.3312794080411474",Paris,75056,0.0851063829787234,17
15104,Hôpital Européen Georges Pompidou,OUI,62,19,43,40,3,OUI,OUI,2025-03-13 17:02:12+00:00,"48.837695319163, 2.2753742337227",Paris,75056,0.6935483870967742,17
19101,Square Simon Bolivar,OUI,21,17,4,3,1,OUI,OUI,2025-03-13 17:01:01+00:00,"48.875089888322, 2.3826304078102",Paris,75056,0.19047619047619047,17
43008,Fontenay - Libération,OUI,24,20,4,3,1,OUI,OUI,2025-03-13 16:58:03+00:00,"48.847803063647, 2.4451419711113",Vincennes,94080,0.16666666666666666,17
41209,Cimetière de Fontenay-sous-Bois,OUI,15,14,1,0,1,OUI,OUI,2025-03-13 17:02:03+00:00,"48.84706173362218, 2.4787822365760808",Fontenay-sous-Bois,94033,0.06666666666666667,17
5018,Mutualité,OUI,37,12,25,23,2,OUI,OUI,2025-03-13 16:58:47+00:00,"48.848225572724, 2.3502873256803",Paris,75056,0.6756756756756757,17
18028,Championnet - Vauvenargues,OUI,31,29,2,1,1,OUI,OUI,2025-03-13 16:57:06+00:00,"48.89401874744574, 2.3319872841238976",Paris,75056,0.06451612903225806,17
19103,Manin - Carrières d'Amérique,OUI,16,13,3,1,2,OUI,OUI,2025-03-13 17:01:50+00:00,"48.88467214209463, 2.3919698596000676",Paris,75056,0.1875,17
15106,Grenelle - Violet,OUI,33,12,21,20,1,OUI,OUI,2025-03-13 17:02:23+00:00,"48.84993035512154, 2.294612042605877",Paris,75056,0.6363636363636364,17
14138,Porte de Vanves,OUI,29,28,1,0,1,OUI,OUI,2025-03-13 17:01:11+00:00,"48.828012849445, 2.3056878894567",Paris,75056,0.034482758620689655,17
5124,Erasme - Ulm,OUI,21,21,0,0,0,OUI,OUI,2025-03-13 17:01:56+00:00,"48.84264375274712, 2.3445946723222733",Paris,75056,0.0,17
12114,Victor Hugo - Jeanne Jugan,OUI,27,24,3,1,2,OUI,OUI,2025-03-13 16:57:28+00:00,"48.843949064031825, 2.415081394834419",Paris,75056,0.1111111111111111,17
18046,Etienne Jodelle - Saint Ouen,OUI,32,29,3,1,2,OUI,OUI,2025-03-13 17:01:38+00:00,"48.88794016394694, 2.326124420314341",Paris,75056,0.09375,17
46003,Conservatoire de Musique,OUI,24,2,22,19,3,OUI,OUI,2025-03-13 17:02:25+00:00,"48.77093586667601, 2.4034014344215398",Choisy-le-Roi,94022,0.9166666666666666,17
22406,Guy Môquet - Etienne Dolet,OUI,22,16,6,1,5,OUI,OUI,2025-03-13 17:02:27+00:00,"48.81527009991819, 2.298078276995073",Malakoff,92046,0.2727272727272727,17
21312,Lucie Aubrac - Fort,OUI,29,22,7,0,7,OUI,OUI,2025-03-13 16:57:04+00:00,"48.818144834008976, 2.271184623241425",Issy-les-Moulineaux,92040,0.2413793103448276,17
31102,Boissière - Etienne Dolet,OUI,20,16,4,1,3,OUI,OUI,2025-03-13 17:01:08+00:00,"48.876111, 2.4677312",Montreuil,93048,0.2,17
14008,Mouton Duvernet - Général Leclerc,OUI,25,22,3,0,3,OUI,OUI,2025-03-13 16:59:39+00:00,"48.831632518293, 2.3293121159077",Paris,75056,0.12,17
18022,Marcadet - Barbès,OUI,34,28,6,3,3,OUI,OUI,2025-03-13 17:01:12+00:00,"48.890451120965, 2.3490573929687",Paris,75056,0.17647058823529413,17
13001,Port-Royal - Hôpital du Val-de-Grâce,OUI,16,11,5,2,3,OUI,OUI,2025-03-13 17:01:10+00:00,"48.837668272811, 2.3448138346607",Paris,75056,0.3125,17
8054,Bertie Albrecht - Hoche,OUI,31,29,2,0,2,OUI,OUI,2025-03-13 17:00:02+00:00,"48.87614039826388, 2.301303138307601",Paris,75056,0.06451612903225806,17
8017,Rocher - Laborde,OUI,64,59,5,3,2,OUI,OUI,2025-03-13 16:58:30+00:00,"48.87590240712654, 2.322616316378116",Paris,75056,0.078125,17
15109,Cevennes - Bergers,OUI,28,11,17,12,5,OUI,OUI,2025-03-13 17:01:47+00:00,"48.84240765130395, 2.281037718057633",Paris,75056,0.6071428571428571,17
15054,Lecourbe - Jean Maridor,OUI,18,4,14,11,3,OUI,OUI,2025-03-13 17:02:27+00:00,"48.83796366147599, 2.2877392172813416",Paris,75056,0.7777777777777778,17
35010,Hoche - Jean Lolive,OUI,20,11,9,0,9,OUI,OUI,2025-03-13 17:01:42+00:00,"48.89110239200789, 2.402843534946442",Pantin,93055,0.45,17
14106,Marc Sangnier - Porte de Vanves,OUI,20,20,0,0,0,OUI,OUI,2025-03-13 16:55:41+00:00,"48.825218683556734, 2.3107116669416428",Paris,75056,0.0,17
8045,Place de la Reine Astrid,OUI,56,24,32,28,4,OUI,OUI,2025-03-13 17:00:35+00:00,"48.864920982538, 2.3025491823859",Paris,75056,0.5714285714285714,17
2111,Chabanais - Petits Champs,OUI,28,5,23,18,5,OUI,OUI,2025-03-13 17:00:41+00:00,"48.86703740186721, 2.336716018617153",Paris,75056,0.8214285714285714,17
15133,Saint Lambert - Blomet,OUI,27,19,8,3,5,OUI,OUI,2025-03-13 16:59:09+00:00,"48.83659148147257, 2.2930556908249855",Paris,75056,0.2962962962962963,17
21209,Molière - République,OUI,30,27,3,1,2,OUI,OUI,2025-03-13 16:57:37+00:00,"48.81111581390707, 2.3145738624448158",Montrouge,92049,0.1,17
14012,Sibelle - Alésia,OUI,37,36,1,1,0,OUI,OUI,2025-03-13 16:56:37+00:00,"48.826701758539215, 2.3384983465075493",Paris,75056,0.02702702702702703,17
44013,Edouard Tremblay - Julian Grimaux,OUI,30,29,1,0,1,OUI,OUI,2025-03-13 16:48:20+00:00,"48.781383825117, 2.3723508417606",Vitry-sur-Seine,94081,0.03333333333333333,17
21005,Hôtel de Ville de Boulogne Billancourt,OUI,26,12,14,11,3,OUI,OUI,2025-03-13 17:01:34+00:00,"48.83495885166784, 2.2416803240776066",Boulogne-Billancourt,92012,0.5384615384615384,17
44003,Gabriel Péri - Danielle Casanova,OUI,20,9,11,9,2,OUI,OUI,2025-03-13 17:01:35+00:00,"48.790114, 2.4025777",Vitry-sur-Seine,94081,0.55,17
10042,Enghien - Faubourg Poissonnière,OUI,32,21,11,9,2,OUI,OUI,2025-03-13 17:01:44+00:00,"48.872420063053, 2.3483952362828",Paris,75056,0.34375,17
15034,Lakanal - Commerce,OUI,46,10,36,28,8,OUI,OUI,2025-03-13 16:58:35+00:00,"48.84442462786544, 2.294059172272682",Paris,75056,0.782608695652174,17
17203,Place de la Porte de Champeret,OUI,27,13,14,12,2,OUI,OUI,2025-03-13 16:56:17+00:00,"48.886062068226, 2.2917001576821",Paris,75056,0.5185185185185185,17
5028,Censier - Jardin des Plantes,OUI,27,6,21,16,5,OUI,OUI,2025-03-13 17:01:53+00:00,"48.84107178161383, 2.355475388467312",Paris,75056,0.7777777777777778,17
42014,Place Marcel Cachin,OUI,32,8,24,21,3,OUI,OUI,2025-03-13 16:59:44+00:00,"48.81411442356866, 2.39090770483017",Ivry-sur-Seine,94041,0.75,17
48010,Karl Marx,OUI,16,7,9,1,8,OUI,OUI,2025-03-13 16:52:59+00:00,"48.784527937293184, 2.3646667979455587",Villejuif,94076,0.5625,17
4016,Lobau - Hôtel de Ville,OUI,58,6,52,46,6,OUI,OUI,2025-03-13 17:02:00+00:00,"48.8562118, 2.3532536",Paris,75056,0.896551724137931,17
22203,Tertres - Fontaine,OUI,27,22,5,0,5,OUI,OUI,2025-03-13 17:00:03+00:00,"48.787553654715644, 2.306235730648041",Bagneux,92007,0.18518518518518517,17
14124,David Weill - Parc Montsouris,OUI,22,20,2,1,1,OUI,OUI,2025-03-13 17:01:58+00:00,"48.821092374256104, 2.333725690841675",Paris,75056,0.09090909090909091,17
1119,Cossonnerie - Sébastopol,OUI,23,2,21,14,7,OUI,OUI,2025-03-13 17:01:14+00:00,"48.86132665908402, 2.349419631063938",Paris,75056,0.9130434782608695,17
15110,Place Robert Guillemard,OUI,21,11,10,8,2,OUI,OUI,2025-03-13 16:59:44+00:00,"48.836191728066666, 2.2811267160086417",Paris,75056,0.47619047619047616,17
25003,Henri Ste-Claire Déville - Paul Héroult,OUI,20,9,11,5,6,OUI,OUI,2025-03-13 17:02:23+00:00,"48.892663, 2.172411",Rueil-Malmaison,92063,0.55,17
21006,Marcelin Berthelot,OUI,27,22,5,3,2,OUI,OUI,2025-03-13 17:00:10+00:00,"48.8415473058801, 2.233161628246308",Boulogne-Billancourt,92012,0.18518518518518517,17
20115,Louis Lumière - Porte de Bagnolet,OUI,20,19,1,0,1,OUI,OUI,2025-03-13 16:56:59+00:00,"48.86431136000005, 2.4105210229754443",Paris,75056,0.05,17
20131,Repos - Cimetière du Père Lachaise,OUI,33,33,0,0,0,OUI,OUI,2025-03-13 16:59:20+00:00,"48.859358523593, 2.3896131366845",Paris,75056,0.0,17
31003,Paris - Emile Zola,OUI,29,22,7,7,0,OUI,OUI,2025-03-13 16:59:43+00:00,"48.854898095789295, 2.4186685681343083",Montreuil,93048,0.2413793103448276,17
6025,Assas - Rennes,OUI,31,7,24,16,8,OUI,OUI,2025-03-13 17:00:15+00:00,"48.8492084999386, 2.32851454623001",Paris,75056,0.7741935483870968,17
11039,Richard Lenoir - Jean-Pierre Timbaud,OUI,34,12,22,19,3,OUI,OUI,2025-03-13 17:00:50+00:00,"48.865804276686, 2.3693370749669",Paris,75056,0.6470588235294118,17
21015,Nationale - Place Jules Guesde,OUI,22,17,5,4,1,OUI,OUI,2025-03-13 17:02:20+00:00,"48.82753962462998, 2.2416052222251897",Boulogne-Billancourt,92012,0.22727272727272727,17
19024,Botzaris - Parc des Buttes Chaumont,OUI,20,19,1,0,1,OUI,OUI,2025-03-13 16:57:00+00:00,"48.877951, 2.381464",Paris,75056,0.05,17
41202,Gare Rer de Fontenay sous Bois,OUI,60,58,2,1,1,OUI,OUI,2025-03-13 17:01:07+00:00,"48.8436279, 2.4630465",Fontenay-sous-Bois,94033,0.03333333333333333,17
41601,Général De Gaulle - Alouette,OUI,23,16,7,4,3,OUI,OUI,2025-03-13 17:02:10+00:00,"48.839109, 2.4175664",Saint-Mandé,94067,0.30434782608695654,17
42021,Raspail - Manufacture des Oeillets,OUI,30,15,15,15,0,OUI,OUI,2025-03-13 17:00:26+00:00,"48.8094458, 2.3903009",Ivry-sur-Seine,94041,0.5,17
23006,Jules Guesde - Alsace,OUI,24,13,11,8,3,OUI,OUI,2025-03-13 17:02:05+00:00,"48.890566275506, 2.2950777411461",Levallois-Perret,92044,0.4583333333333333,17
35020,Marcelle - Thalie,OUI,20,19,1,0,1,OUI,OUI,2025-03-13 16:55:11+00:00,"48.8835462, 2.4137883",Pantin,93055,0.05,17
17105,Place Madeleine Daniélou,OUI,42,31,11,11,0,OUI,OUI,2025-03-13 17:01:23+00:00,"48.883498, 2.282015",Paris,75056,0.2619047619047619,17
1020,Cambon - Rivoli,OUI,37,26,11,4,7,OUI,OUI,2025-03-13 17:02:20+00:00,"48.866143390992, 2.3251800647137",Paris,75056,0.2972972972972973,17
11105,Parmentier - République,OUI,21,11,10,3,7,OUI,OUI,2025-03-13 17:00:14+00:00,"48.8644954, 2.3750124",Paris,75056,0.47619047619047616,17
22402,Jean Jaurès - Salvador Allende,OUI,42,38,4,2,2,OUI,OUI,2025-03-13 17:02:01+00:00,"48.821475594736775, 2.3026576638221745",Malakoff,92046,0.09523809523809523,17
16108,Sablons - Georges Mandel,OUI,38,36,2,1,1,OUI,OUI,2025-03-13 17:00:24+00:00,"48.863875, 2.28189",Paris,75056,0.05263157894736842,17
9116,Victoire - Chaussée d'Antin,OUI,24,17,7,6,1,OUI,OUI,2025-03-13 17:02:27+00:00,"48.875065791004396, 2.3316738009452824",Paris,75056,0.2916666666666667,17
17125,Marie-Georges Picquart - Pereire,OUI,32,31,1,0,1,OUI,OUI,2025-03-13 17:02:16+00:00,"48.88863669349711, 2.3111706599593163",Paris,75056,0.03125,17
11030,Oberkampf - République,OUI,21,9,12,4,8,OUI,OUI,2025-03-13 17:01:59+00:00,"48.86531608707, 2.37611478491",Paris,75056,0.5714285714285714,17
19022,Marché Secrétan,OUI,25,18,7,4,3,OUI,OUI,2025-03-13 17:02:10+00:00,"48.88125496379482, 2.373463287949562",Paris,75056,0.28,17
17013,Legendre - Dulong,OUI,23,21,2,1,1,OUI,OUI,2025-03-13 16:59:36+00:00,"48.885325169402904, 2.316423766314984",Paris,75056,0.08695652173913043,17
16008,Galilée - Kléber,OUI,30,25,5,1,4,OUI,OUI,2025-03-13 17:02:07+00:00,"48.867411865714, 2.2907813801148",Paris,75056,0.16666666666666666,17
11026,Chemin Vert - Saint-Maur,OUI,44,39,5,3,2,OUI,OUI,2025-03-13 17:01:52+00:00,"48.86112461407359, 2.381299026310444",Paris,75056,0.11363636363636363,17
11024,Mairie du 11ème,OUI,49,14,35,21,14,OUI,OUI,2025-03-13 17:00:29+00:00,"48.858925, 2.3789759",Paris,75056,0.7142857142857143,17
32604,Square du Théâtre du Garde-Chasse,OUI,50,50,0,0,0,OUI,OUI,2025-03-13 16:55:41+00:00,"48.881287375060616, 2.420119643211365",Les Lilas,93045,0.0,17
15021,Joseph Liouville - Croix Nivert,OUI,62,42,20,20,0,OUI,OUI,2025-03-13 16:54:55+00:00,"48.844835471244416, 2.297508493065834",Paris,75056,0.3225806451612903,17
21008,Victor Hugo - Galliéni,OUI,33,14,19,15,4,OUI,OUI,2025-03-13 16:59:18+00:00,"48.838020154411, 2.2460845112801",Boulogne-Billancourt,92012,0.5757575757575758,17
9010,Rochechouart lamartine,OUI,24,15,9,2,7,OUI,OUI,2025-03-13 17:01:33+00:00,"48.876719895109, 2.344393021854",Paris,75056,0.375,17
20134,Lieutenant Chauré - Etienne Marey,OUI,19,19,0,0,0,OUI,OUI,2025-03-13 17:02:22+00:00,"48.86746195408435, 2.405970990657807",Paris,75056,0.0,17
18009,Jean-François Lépine - Stephenson,OUI,19,18,1,0,1,OUI,OUI,2025-03-13 16:58:36+00:00,"48.88611466796807, 2.356855627529275",Paris,75056,0.05263157894736842,17
22016,Charles de Gaulle - Sablonville,OUI,26,23,3,1,2,OUI,OUI,2025-03-13 17:00:09+00:00,"48.87991924860035, 2.2763770446181297",Neuilly-sur-Seine,92051,0.11538461538461539,17
43005,Gare RER de Vincennes,OUI,48,42,6,2,4,OUI,OUI,2025-03-13 17:00:40+00:00,"48.847563015126106, 2.433383166790009",Vincennes,94080,0.125,17
32302,Chemin Vert - Fraternité,OUI,20,17,3,0,3,OUI,OUI,2025-03-13 17:01:54+00:00,"48.877141208359035, 2.4461565166711807",Romainville,93063,0.15,17
16136,Théophile Gautier - François Millet,OUI,27,2,25,19,6,OUI,OUI,2025-03-13 17:02:08+00:00,"48.85034821320644, 2.273029983043671",Paris,75056,0.9259259259259259,17
16040,Exelmans - Michel-Ange,OUI,31,17,14,13,1,OUI,OUI,2025-03-13 17:02:01+00:00,"48.84309486651855, 2.2597770800669053",Paris,75056,0.45161290322580644,17
19032,Villette - Belleville,OUI,39,21,18,3,15,OUI,OUI,2025-03-13 17:02:23+00:00,"48.8726877314, 2.376461327076",Paris,75056,0.46153846153846156,17
22006,Pierret - Madrid,OUI,26,17,9,8,1,OUI,OUI,2025-03-13 17:01:22+00:00,"48.882976576876565, 2.260125767248034",Neuilly-sur-Seine,92051,0.34615384615384615,17
21701,Larmeroux - Baudelaire,OUI,28,21,7,0,7,OUI,OUI,2025-03-13 17:00:42+00:00,"48.816939911292, 2.2809894804846",Vanves,92075,0.25,17
21104,Madame de Sanzillon - Mozart,OUI,22,11,11,9,2,OUI,OUI,2025-03-13 17:01:58+00:00,"48.90379820774301, 2.3187401890754704",Clichy,92024,0.5,17
22003,Beffroy,OUI,26,17,9,5,4,OUI,OUI,2025-03-13 17:00:58+00:00,"48.886591074488, 2.2613945603371",Neuilly-sur-Seine,92051,0.34615384615384615,17
11042,Grand Prieuré - Crussol,OUI,45,28,17,17,0,OUI,OUI,2025-03-13 17:00:43+00:00,"48.864660627935, 2.3692265531829",Paris,75056,0.37777777777777777,17
13050,Quai Panhard et Levassor,OUI,56,35,21,19,2,OUI,OUI,2025-03-13 17:01:43+00:00,"48.828374828097, 2.3842737458056",Paris,75056,0.375,17
32026,Leroy des Barres - Médiathèque,OUI,26,3,23,11,12,OUI,OUI,2025-03-13 17:01:59+00:00,"48.928253687082, 2.3681719727966",Saint-Denis,93066,0.8846153846153846,17
24001,Arche - Léonard de Vinci,OUI,26,24,2,2,0,OUI,OUI,2025-03-13 16:56:49+00:00,"48.89790972494496, 2.2383723043644914",Courbevoie,92026,0.07692307692307693,17
9005,Square d'Anvers,OUI,32,27,5,0,5,OUI,OUI,2025-03-13 17:01:44+00:00,"48.882633484311, 2.3448844062122",Paris,75056,0.15625,17
14136,Auguste Cain - Jean Moulin,OUI,40,40,0,0,0,OUI,OUI,2025-03-13 17:01:03+00:00,"48.82577028927573, 2.3210415244102482",Paris,75056,0.0,17
1013,Place du Palais Royal,OUI,64,19,45,38,7,OUI,OUI,2025-03-13 16:57:33+00:00,"48.862382970647, 2.3384822532535",Paris,75056,0.703125,17
10014,Marseille - Beaurepaire,OUI,49,21,28,27,1,OUI,OUI,2025-03-13 17:02:26+00:00,"48.871624306962985, 2.3639265082738348",Paris,75056,0.5714285714285714,17
13002,Arago - Glacière,OUI,25,16,9,5,4,OUI,OUI,2025-03-13 17:02:26+00:00,"48.83486054775774, 2.3445770524322067",Paris,75056,0.36,17
11035,Parmentier - Abel Rabaud,OUI,51,44,7,2,5,OUI,OUI,2025-03-13 17:00:53+00:00,"48.86921273836114, 2.371688821240712",Paris,75056,0.13725490196078433,17
42301,Gare Arcueil - Cachan,OUI,25,21,4,0,4,OUI,OUI,2025-03-13 17:00:29+00:00,"48.799824, 2.328171",Arcueil,94003,0.16,17
42010,Mairie d'Ivry-sur-Seine,OUI,51,22,29,24,5,OUI,OUI,2025-03-13 17:00:58+00:00,"48.81057120969284, 2.3842826485633855",Ivry-sur-Seine,94041,0.5686274509803921,17
42015,Place Jean Ferrat,OUI,24,20,4,0,4,OUI,OUI,2025-03-13 17:02:27+00:00,"48.8184945213025, 2.3744174838066106",Ivry-sur-Seine,94041,0.16666666666666666,17
15046,Parc Georges Brassens - Brancion,OUI,28,26,2,0,2,OUI,OUI,2025-03-13 16:58:43+00:00,"48.83227829269761, 2.3022570088505745",Paris,75056,0.07142857142857142,17
32016,Place de la Porte de Paris,OUI,34,26,8,3,5,OUI,OUI,2025-03-13 17:00:40+00:00,"48.93009363207303, 2.3564037680625916",Saint-Denis,93066,0.23529411764705882,17
46001,Place Paul Eluard,OUI,19,4,15,9,6,OUI,OUI,2025-03-13 17:00:57+00:00,"48.7672039733195, 2.4144977331161503",Choisy-le-Roi,94022,0.7894736842105263,17
15201,Place Amédée Gordini - Lefebvre,OUI,36,31,5,2,3,OUI,OUI,2025-03-13 17:00:47+00:00,"48.83061737745, 2.2920634208276",Paris,75056,0.1388888888888889,17
17028,Reims - Raymond Pitet,OUI,36,12,24,20,4,OUI,OUI,2025-03-13 17:02:10+00:00,"48.8888, 2.296319",Paris,75056,0.6666666666666666,17
18201,Tristan Tzara -  Tchaïkovski,OUI,33,31,2,0,2,OUI,OUI,2025-03-13 16:59:42+00:00,"48.89490221746837, 2.3648490384221077",Paris,75056,0.06060606060606061,17
21301,Saint-Vincent - Verdun,OUI,33,25,8,4,4,OUI,OUI,2025-03-13 16:59:19+00:00,"48.819211549234495, 2.254007756710053",Issy-les-Moulineaux,92040,0.24242424242424243,17
92008,Hôtel de Ville de Nanterre,OUI,36,18,18,9,9,OUI,OUI,2025-03-13 17:02:24+00:00,"48.892371898250424, 2.205548956990242",Nanterre,92050,0.5,17
42302,Aristide Briand - Gare de Bagneux,OUI,20,15,5,3,2,OUI,OUI,2025-03-13 17:01:04+00:00,"48.79387269664978, 2.321148812770844",Cachan,94016,0.25,17
41402,Victor Hugo - Ecoles,OUI,22,6,16,9,7,OUI,OUI,2025-03-13 17:00:01+00:00,"48.80476007936134, 2.4180373930262093",Alfortville,94002,0.7272727272727273,17
19029,Seine - Flandre,OUI,19,18,1,1,0,OUI,OUI,2025-03-13 17:00:48+00:00,"48.886785741479684, 2.3746193200349808",Paris,75056,0.05263157894736842,17
18012,Stephenson - Doudeauville,OUI,36,34,2,0,2,OUI,OUI,2025-03-13 17:02:09+00:00,"48.888537048944826, 2.3561610281467438",Paris,75056,0.05555555555555555,17
9032,Mathurins - Auber,OUI,35,16,19,16,3,OUI,OUI,2025-03-13 17:01:36+00:00,"48.872988840744, 2.3294984212276",Paris,75056,0.5428571428571428,17
19125,Place de l'Édit de Nantes,OUI,29,25,4,0,4,OUI,OUI,2025-03-13 16:59:33+00:00,"48.88879, 2.3785",Paris,75056,0.13793103448275862,17
19016,Hautpoul - Jean Jaurès,OUI,30,20,10,3,7,OUI,OUI,2025-03-13 17:00:49+00:00,"48.886393679436, 2.3865414544355",Paris,75056,0.3333333333333333,17
14036,Boulard - Daguerre,OUI,43,40,3,1,2,OUI,OUI,2025-03-13 17:00:50+00:00,"48.83446472680611, 2.3293386027216907",Paris,75056,0.06976744186046512,17
32003,Wilson - Métallurgie,OUI,28,11,17,11,6,OUI,OUI,2025-03-13 16:57:49+00:00,"48.909423010092326, 2.3584435880184174",Saint-Denis,93066,0.6071428571428571,17
5123,Saint-Germain - Thenard,OUI,29,2,27,12,15,OUI,OUI,2025-03-13 17:01:54+00:00,"48.850571, 2.3471015",Paris,75056,0.9310344827586207,17
8025,Miromesnil - La Boétie,OUI,33,24,9,6,3,OUI,OUI,2025-03-13 17:02:14+00:00,"48.873722412917, 2.3158480972052",Paris,75056,0.2727272727272727,17
11036,Jules Ferry - Faubourg du Temple Paris,OUI,56,33,23,22,1,OUI,OUI,2025-03-13 17:02:00+00:00,"48.868397, 2.3678933",Paris,75056,0.4107142857142857,17
7102,Mairie du 7ème,OUI,47,19,28,24,4,OUI,OUI,2025-03-13 17:02:16+00:00,"48.8577967, 2.3192664",Paris,75056,0.5957446808510638,17
9021,Saint Georges - d'Aumale,OUI,23,22,1,1,0,OUI,OUI,2025-03-13 17:00:58+00:00,"48.87778639599673, 2.337429821491241",Paris,75056,0.043478260869565216,17
23009,Anatole France - Louise Michel,OUI,47,38,9,6,3,OUI,OUI,2025-03-13 17:01:01+00:00,"48.88873214926474, 2.2881576418876652",Levallois-Perret,92044,0.19148936170212766,17
20121,Boyer - Ménilmontant,OUI,19,12,7,0,7,OUI,OUI,2025-03-13 16:55:10+00:00,"48.868895162679, 2.3919824145635",Paris,75056,0.3684210526315789,17
12027,Montgallet - Charenton,OUI,15,2,13,12,1,OUI,OUI,2025-03-13 16:58:07+00:00,"48.842647778701, 2.3861649278137",Paris,75056,0.8666666666666667,17
19013,Laumière - Petit,OUI,31,21,10,2,8,OUI,OUI,2025-03-13 17:01:41+00:00,"48.88467368538326, 2.380039058625698",Paris,75056,0.3225806451612903,17
21313,Guynemer - Séverine,OUI,23,21,2,1,1,OUI,OUI,2025-03-13 17:00:49+00:00,"48.83091743371036, 2.2790706530213356",Issy-les-Moulineaux,92040,0.08695652173913043,17
42504,Gare RER de Gentilly,OUI,30,24,6,1,5,OUI,OUI,2025-03-13 17:00:38+00:00,"48.814280450380224, 2.3410347104072575",Gentilly,94037,0.2,17
17102,Alfred Roll - Berthier,OUI,26,21,5,5,0,OUI,OUI,2025-03-13 16:58:39+00:00,"48.887808570529, 2.3000952981763",Paris,75056,0.19230769230769232,17
26013,Quai du docteur Dervaux,OUI,26,18,8,7,1,OUI,OUI,2025-03-13 17:00:57+00:00,"48.910482, 2.297998",Asnières-sur-Seine,92004,0.3076923076923077,17
26007,Square Gilbert Thomain,OUI,19,15,4,1,3,OUI,OUI,2025-03-13 16:56:08+00:00,"48.90717373809284, 2.2695400938391685",Asnières-sur-Seine,92004,0.21052631578947367,17
20111,Villiers de l'Isle Adam - Pyrénées,OUI,20,20,0,0,0,OUI,OUI,2025-03-13 16:55:31+00:00,"48.867362, 2.396222",Paris,75056,0.0,17
16111,Faustin Hélie - Desbordes-Valmore,OUI,27,24,3,1,2,OUI,OUI,2025-03-13 16:59:12+00:00,"48.859403, 2.276522",Paris,75056,0.1111111111111111,17
20043,Charonne - Avron,OUI,25,21,4,1,3,OUI,OUI,2025-03-13 17:00:15+00:00,"48.851602665222, 2.3984030470379",Paris,75056,0.16,17
11007,Jean Macé - Faidherbe,OUI,56,43,13,9,4,OUI,OUI,2025-03-13 17:02:26+00:00,"48.85337548426, 2.3828620836139",Paris,75056,0.23214285714285715,17
31010,Stalingrad - Désiré Chevalier,OUI,42,36,6,3,3,OUI,OUI,2025-03-13 16:58:26+00:00,"48.85670169739857, 2.445072233676911",Montreuil,93048,0.14285714285714285,17
17045,Place des Ternes.,OUI,45,44,1,0,1,OUI,OUI,2025-03-13 17:01:10+00:00,"48.878438631226516, 2.297727763652802",Paris,75056,0.022222222222222223,17
19008,Flandre - Alphonse Karr,OUI,26,23,3,0,3,OUI,OUI,2025-03-13 17:02:26+00:00,"48.89465, 2.381868",Paris,75056,0.11538461538461539,17
11115,Montreuil - Gonnet,OUI,24,18,6,1,5,OUI,OUI,2025-03-13 16:58:13+00:00,"48.850500564921, 2.3890856287864",Paris,75056,0.25,17
11004,Charonne - Faubourg Saint-Antoine,OUI,32,15,17,14,3,OUI,OUI,2025-03-13 17:01:24+00:00,"48.852191909696, 2.3740932717919",Paris,75056,0.53125,17
7015,Varenne,OUI,45,21,24,17,7,OUI,OUI,2025-03-13 17:02:08+00:00,"48.857202661803, 2.3152771219611",Paris,75056,0.5333333333333333,17
51004,Général Delambre - Prebuard,OUI,28,21,7,2,5,OUI,OUI,2025-03-13 16:58:34+00:00,"48.93870344444, 2.2234171606307",Argenteuil,95018,0.25,17
12009,Charenton - Diderot,OUI,18,0,18,15,3,OUI,OUI,2025-03-13 17:02:00+00:00,"48.846171461187, 2.3793068155646",Paris,75056,1.0,17
5021,Jussieu - Fossés Saint-Bernard,OUI,35,20,15,12,3,OUI,OUI,2025-03-13 17:02:29+00:00,"48.847185510023, 2.3534858599305",Paris,75056,0.42857142857142855,17
12115,Porte de Vincennes,OUI,32,27,5,1,4,OUI,OUI,2025-03-13 17:02:10+00:00,"48.846454, 2.415514",Paris,75056,0.15625,17
19205,Simon Bolivar - Henri Turot,OUI,23,15,8,0,8,OUI,OUI,2025-03-13 17:00:41+00:00,"48.877475489801, 2.3739709492211",Paris,75056,0.34782608695652173,17
23001,Paul Vaillant Couturier - Chaptal,OUI,36,18,18,15,3,OUI,OUI,2025-03-13 17:02:17+00:00,"48.893479576183, 2.2775253653526",Levallois-Perret,92044,0.5,17
43003,Hôpital Bégin,OUI,26,26,0,0,0,NON,NON,2025-03-13 17:01:26+00:00,"48.84571672113, 2.4272462725639",Vincennes,94080,0.0,17
41102,Gare de Laplace,OUI,43,40,3,1,2,OUI,OUI,2025-03-13 16:58:16+00:00,"48.80893199114179, 2.3349460959434514",Arcueil,94003,0.06976744186046512,17
42029,Stalingrad - Germaine Tailleferre,OUI,28,25,3,2,1,OUI,OUI,2025-03-13 16:53:57+00:00,"48.80257200481316, 2.3786691203713417",Ivry-sur-Seine,94041,0.10714285714285714,17
16124,Route de Sèvres - Porte de Bagatelle,OUI,66,7,59,54,5,OUI,OUI,2025-03-13 17:00:34+00:00,"48.87525984132485, 2.249415814876557",Paris,75056,0.8939393939393939,17
8035,Bienfaisance - Place de Narvik,OUI,34,23,11,10,1,OUI,OUI,2025-03-13 16:59:22+00:00,"48.87660163459077, 2.3129771277308464",Paris,75056,0.3235294117647059,17
33003,Bordier - Félix Faure,OUI,44,30,14,8,6,OUI,OUI,2025-03-13 17:00:37+00:00,"48.90390751882016, 2.3830059170722966",Aubervilliers,93001,0.3181818181818182,17
28001,Richard Wallace - Place du 8 Mai 1945,OUI,27,15,12,11,1,OUI,OUI,2025-03-13 17:02:17+00:00,"48.87866794788021, 2.2420343756675725",Puteaux,92062,0.4444444444444444,17
5106,Cujas - Saint-Michel,OUI,19,12,7,0,7,OUI,OUI,2025-03-13 17:02:00+00:00,"48.848191348584, 2.341831654854",Paris,75056,0.3684210526315789,17
15025,Dupleix - du Guesclin,OUI,45,18,27,24,3,OUI,OUI,2025-03-13 17:00:00+00:00,"48.85147910413369, 2.296709530055523",Paris,75056,0.6,17
22505,Mairie de La Garenne Colombes,OUI,22,16,6,5,1,OUI,OUI,2025-03-13 17:01:31+00:00,"48.90663823468682, 2.24679596722126",La Garenne-Colombes,92035,0.2727272727272727,17
35018,Ancien Canal - Hélène Brion,OUI,23,21,2,1,1,OUI,OUI,2025-03-13 16:59:44+00:00,"48.89484799296163, 2.4188338592648506",Pantin,93055,0.08695652173913043,17
13045,Jean Colly - Tolbiac,OUI,35,31,4,1,3,OUI,OUI,2025-03-13 17:02:04+00:00,"48.827817291597846, 2.3705490678548813",Paris,75056,0.11428571428571428,17
18110,Departement - Pajol,OUI,16,7,9,5,4,OUI,OUI,2025-03-13 17:02:05+00:00,"48.886674849730184, 2.3613611608743668",Paris,75056,0.5625,17
32010,Place aux Étoiles,OUI,37,23,14,5,9,OUI,OUI,2025-03-13 17:01:55+00:00,"48.91835629408464, 2.3523425683379173",Saint-Denis,93066,0.3783783783783784,17
19005,Flandre - Riquet,OUI,20,13,7,5,2,OUI,OUI,2025-03-13 17:01:57+00:00,"48.888013281448, 2.3737595955229",Paris,75056,0.35,17
12034,Pirogues de Bercy - Libourne,OUI,48,36,12,8,4,OUI,OUI,2025-03-13 17:00:52+00:00,"48.832308, 2.38637",Paris,75056,0.25,17
10113,Parmentier - Hôpital Saint-Louis,OUI,40,37,3,1,2,OUI,OUI,2025-03-13 17:00:04+00:00,"48.871379874257, 2.3698963836667",Paris,75056,0.075,17
15033,Place Violet,OUI,27,19,8,7,1,OUI,OUI,2025-03-13 17:01:14+00:00,"48.84487893836502, 2.2905756533145905",Paris,75056,0.2962962962962963,17
41606,Pasteur - Gambetta,OUI,19,16,3,1,2,OUI,OUI,2025-03-13 16:59:17+00:00,"48.84572797384512, 2.4236011505126953",Saint-Mandé,94067,0.15789473684210525,17
25008,Place du 8 Mai 1945,OUI,18,14,4,4,0,OUI,OUI,2025-03-13 17:00:11+00:00,"48.871552174017, 2.2025031970585",Rueil-Malmaison,92063,0.2222222222222222,17
17011,Fragonard - Porte de Clichy,OUI,52,33,19,15,4,OUI,OUI,2025-03-13 17:00:24+00:00,"48.894155633419, 2.3143893107772",Paris,75056,0.36538461538461536,17
19044,Grands Moulins de Pantin,OUI,50,46,4,2,2,OUI,OUI,2025-03-13 17:00:17+00:00,"48.89738369720229, 2.3959985375404362",Paris,75056,0.08,17
43402,Place de Verdun,OUI,40,21,19,18,1,OUI,OUI,2025-03-13 17:02:00+00:00,"48.8202823, 2.473775",Joinville-le-Pont,94042,0.475,17
33001,Victor Hugo - Magasins Généraux,OUI,33,31,2,1,1,OUI,OUI,2025-03-13 17:00:12+00:00,"48.903281401126755, 2.368072383105755",Aubervilliers,93001,0.06060606060606061,17
33018,Edouard Poisson - Victor Hugo,OUI,27,22,5,2,3,OUI,OUI,2025-03-13 17:02:25+00:00,"48.91118557052621, 2.379864752692811",Aubervilliers,93001,0.18518518518518517,17
20132,Réunion - Avron,OUI,26,25,1,0,1,OUI,OUI,2025-03-13 17:01:46+00:00,"48.852566752033766, 2.403928068708116",Paris,75056,0.038461538461538464,17
12013,Montgallet - Reuilly,OUI,14,10,4,3,1,OUI,OUI,2025-03-13 16:59:20+00:00,"48.844291, 2.3896481",Paris,75056,0.2857142857142857,17
5119,Jussieu - Guy de la Brosse,OUI,39,36,3,1,2,OUI,OUI,2025-03-13 17:02:17+00:00,"48.845665, 2.355653",Paris,75056,0.07692307692307693,17
21305,Place Jacques Madaule,OUI,22,4,18,17,1,OUI,OUI,2025-03-13 17:00:57+00:00,"48.823933787309, 2.2606918215752",Issy-les-Moulineaux,92040,0.8181818181818182,17
35009,Jean Lolive - Parc Stalingrad,OUI,21,19,2,0,2,OUI,OUI,2025-03-13 17:00:05+00:00,"48.89206174403158, 2.4091735482215886",Pantin,93055,0.09523809523809523,17
6013,Jacques Callot - Mazarine,OUI,27,3,24,23,1,OUI,OUI,2025-03-13 16:56:03+00:00,"48.855280175332, 2.3375743255019",Paris,75056,0.8888888888888888,17
19019,Petit - Manin,OUI,22,22,0,0,0,NON,NON,2025-03-13 16:58:20+00:00,"48.886506875343, 2.3938155401308",Paris,75056,0.0,17
8033,Commandant Rivière,OUI,39,11,28,21,7,OUI,OUI,2025-03-13 17:02:17+00:00,"48.872933, 2.309796",Paris,75056,0.717948717948718,17
27002,Parc Pierre Lagravère,OUI,30,11,19,10,9,OUI,OUI,2025-03-13 17:01:04+00:00,"48.92650488131725, 2.239069678491417",Colombes,92025,0.6333333333333333,17
16121,Jardin d'Acclimatation,OUI,30,26,4,4,0,OUI,OUI,2025-03-13 16:59:17+00:00,"48.878772242510465, 2.270772233605385",Paris,75056,0.13333333333333333,17
21109,Guichet - Jean Jaurès,OUI,23,18,5,4,1,OUI,OUI,2025-03-13 17:01:21+00:00,"48.905169868129036, 2.3023840785026555",Clichy,92024,0.21739130434782608,17
15010,Square Cambronne,OUI,58,4,54,52,2,OUI,OUI,2025-03-13 17:01:23+00:00,"48.84756654526, 2.3025691509247",Paris,75056,0.9310344827586207,17
31012,Place Carnot,OUI,21,20,1,0,1,OUI,OUI,2025-03-13 16:59:18+00:00,"48.85593932186797, 2.441531717777252",Montreuil,93048,0.047619047619047616,17
17037,Bayen - Pereire,OUI,21,9,12,9,3,OUI,OUI,2025-03-13 17:02:26+00:00,"48.881804409079656, 2.2921088710427284",Paris,75056,0.5714285714285714,17
14104,Boyer-Barret - Raymond Losserand,OUI,22,20,2,0,2,OUI,OUI,2025-03-13 17:01:25+00:00,"48.83329880233322, 2.3173383995890617",Paris,75056,0.09090909090909091,17
18141,Clignancourt - Sofia,OUI,19,15,4,1,3,OUI,OUI,2025-03-13 16:58:19+00:00,"48.88511992309783, 2.34719488842051",Paris,75056,0.21052631578947367,17
20119,Square des Saint-Simoniens,OUI,25,22,3,0,3,OUI,OUI,2025-03-13 17:00:15+00:00,"48.8701796, 2.3967273",Paris,75056,0.12,17
33009,Félix Faure - Sadi Carnot,OUI,33,29,4,2,2,OUI,OUI,2025-03-13 17:00:09+00:00,"48.90812110228388, 2.378623187541962",Aubervilliers,93001,0.12121212121212122,17
31705,Champeaux - Gallieni,OUI,47,45,2,0,2,OUI,OUI,2025-03-13 16:58:28+00:00,"48.864459134684644, 2.4161778017878532",Bagnolet,93006,0.0425531914893617,17
25005,18 juin 1940 - Buzenval,OUI,25,19,6,2,4,OUI,OUI,2025-03-13 16:56:05+00:00,"48.868807, 2.185428",Rueil-Malmaison,92063,0.24,17
6030,Assas - Vaugirard,OUI,33,25,8,5,3,OUI,OUI,2025-03-13 17:02:25+00:00,"48.848274111398, 2.3292413726449",Paris,75056,0.24242424242424243,17
19115,Porte de la Villette,OUI,26,25,1,0,1,OUI,OUI,2025-03-13 16:58:10+00:00,"48.89835196548483, 2.386150136590004",Paris,75056,0.038461538461538464,17
23802,Raymond Poincaré - Allée de la Marche,OUI,22,17,5,5,0,OUI,OUI,2025-03-13 17:01:16+00:00,"48.838634069623, 2.1724102640451",Garches,92033,0.22727272727272727,17
14034,Ouest - Château,OUI,23,15,8,2,6,OUI,OUI,2025-03-13 17:01:11+00:00,"48.83617286014242, 2.319392143923804",Paris,75056,0.34782608695652173,17
15017,Place Falguière,OUI,23,21,2,1,1,OUI,OUI,2025-03-13 17:02:09+00:00,"48.83629973941847, 2.3104464635252953",Paris,75056,0.08695652173913043,17
16018,Flandrin - Henri Martin,OUI,17,11,6,1,5,OUI,OUI,2025-03-13 17:01:38+00:00,"48.8643275, 2.2724174",Paris,75056,0.35294117647058826,17
17018,Parc Monceau,OUI,18,16,2,1,1,OUI,OUI,2025-03-13 17:01:59+00:00,"48.881077914129, 2.3095492646098",Paris,75056,0.1111111111111111,17
24002,Gare de Courbevoie,OUI,32,21,11,1,10,OUI,OUI,2025-03-13 17:00:41+00:00,"48.8993867, 2.2506506",Courbevoie,92026,0.34375,17
18005,Tardieu - Chappe,OUI,16,8,8,1,7,OUI,OUI,2025-03-13 16:58:14+00:00,"48.884146759782, 2.341845408082",Paris,75056,0.5,17
16034,Porte d'Auteuil,OUI,32,30,2,1,1,OUI,OUI,2025-03-13 17:01:38+00:00,"48.8479394142243, 2.2608396783471107",Paris,75056,0.0625,17
20136,Henri Chevreau - Couronnes,OUI,26,26,0,0,0,OUI,OUI,2025-03-13 16:58:46+00:00,"48.87033205312931, 2.388777695596218",Paris,75056,0.0,17
41404,Carnot - Pâquerettes,OUI,24,6,18,17,1,OUI,OUI,2025-03-13 17:01:58+00:00,"48.79592939432515, 2.4261841177940373",Alfortville,94002,0.75,17
43006,Vignerons - Minimes,OUI,28,28,0,0,0,OUI,OUI,2025-03-13 17:00:49+00:00,"48.841486, 2.430793",Vincennes,94080,0.0,17
7009,Assemblée Nationale,OUI,74,14,60,30,30,OUI,OUI,2025-03-13 16:59:05+00:00,"48.861411014652, 2.3201214185208",Paris,75056,0.8108108108108109,17
15028,Grenelle - Dr Finlay,OUI,69,4,65,64,1,OUI,OUI,2025-03-13 17:01:41+00:00,"48.851315406715976, 2.2919502854347233",Paris,75056,0.9420289855072463,17
15122,Place Charles Vallin,OUI,26,19,7,3,4,OUI,OUI,2025-03-13 17:01:34+00:00,"48.835523812041, 2.3025986552238",Paris,75056,0.2692307692307692,17
8102,Lamennais - Washington,OUI,25,14,11,8,3,OUI,OUI,2025-03-13 17:00:43+00:00,"48.87352990026496, 2.303444892168045",Paris,75056,0.44,17
42707,Place Jean-Baptiste Clément,OUI,24,21,3,1,2,OUI,OUI,2025-03-13 17:00:54+00:00,"48.81240466867336, 2.3617091774940495",Le Kremlin-Bicêtre,94043,0.125,17
31702,Pierre et Marie Curie - Julien Grimau,OUI,18,15,3,0,3,OUI,OUI,2025-03-13 16:58:17+00:00,"48.870714014863225, 2.424097023904324",Bagnolet,93006,0.16666666666666666,17
92003,Chanzy - Sud-Est,OUI,25,18,7,1,6,OUI,OUI,2025-03-13 17:02:08+00:00,"48.888912037698766, 2.195632159709931",Nanterre,92050,0.28,17
7004,Raspail - Varenne,OUI,16,16,0,0,0,OUI,OUI,2025-03-13 17:01:49+00:00,"48.853147816545, 2.3263905197382",Paris,75056,0.0,17
8055,Courcelles - Place des Ternes,OUI,28,21,7,1,6,OUI,OUI,2025-03-13 17:01:14+00:00,"48.878199928923124, 2.2992860188665043",Paris,75056,0.25,17
2010,Uzès - Montmartre,OUI,25,6,19,10,9,OUI,OUI,2025-03-13 17:01:44+00:00,"48.870790980240706, 2.3431010171771054",Paris,75056,0.76,17
23701,Parvis Robert Schuman - Roger Salengro,OUI,24,18,6,2,4,OUI,OUI,2025-03-13 17:01:51+00:00,"48.812657470558754, 2.1921751275658607",Chaville,92022,0.25,17
11114,Ledru-Rollin - Charonne,OUI,32,5,27,21,6,OUI,OUI,2025-03-13 17:02:19+00:00,"48.85345855607243, 2.3772463581947094",Paris,75056,0.84375,17
17007,Navier - Epinettes,OUI,36,29,7,4,3,OUI,OUI,2025-03-13 16:55:35+00:00,"48.89587780769155, 2.3226776719093327",Paris,75056,0.19444444444444445,17
5116,Place Valhubert,OUI,51,2,49,44,5,OUI,OUI,2025-03-13 17:01:25+00:00,"48.844182577315, 2.3640366643667",Paris,75056,0.9607843137254902,17
21502,Verdun - Place Henri IV,OUI,26,10,16,12,4,OUI,OUI,2025-03-13 17:01:41+00:00,"48.870797375639214, 2.2277003154158592",Suresnes,92073,0.6153846153846154,17
7006,Quai Voltaire,OUI,32,6,26,21,5,OUI,OUI,2025-03-13 17:02:07+00:00,"48.858942986179, 2.3314182047146",Paris,75056,0.8125,17
12024,Gare de Bercy,OUI,34,9,25,20,5,OUI,OUI,2025-03-13 16:57:14+00:00,"48.839794573906, 2.3826066032052",Paris,75056,0.7352941176470589,17
8012,Batignolles - Place de Clichy,OUI,47,40,7,2,5,OUI,OUI,2025-03-13 17:01:57+00:00,"48.883474535757, 2.326493114233",Paris,75056,0.14893617021276595,17
16129,Ceinture du Lac Inferieure - Saint-Cloud,OUI,40,39,1,0,1,OUI,OUI,2025-03-13 16:57:09+00:00,"48.86218070933143, 2.2617871686816216",Paris,75056,0.025,17
20040,Parc de Belleville - Julien Lacroix,OUI,26,25,1,0,1,OUI,OUI,2025-03-13 16:59:15+00:00,"48.8703459, 2.3842214",Paris,75056,0.038461538461538464,17
35019,Anatole France - Jean Lolive,OUI,28,28,0,0,0,OUI,OUI,2025-03-13 17:02:24+00:00,"48.8949922, 2.4253764",Pantin,93055,0.0,17
17017,Gare de Pont-Cardinet,OUI,33,26,7,4,3,OUI,OUI,2025-03-13 17:02:19+00:00,"48.88713901475306, 2.314494143994255",Paris,75056,0.21212121212121213,17
20113,Piat - Parc de Belleville,OUI,20,17,3,0,3,OUI,OUI,2025-03-13 17:01:21+00:00,"48.87195626635528, 2.384981390278095",Paris,75056,0.15,17
34002,Capitaine Glarner - Gabriel Péri,OUI,24,20,4,2,2,OUI,OUI,2025-03-13 16:59:43+00:00,"48.902449900418745, 2.3304807533425724",Saint-Ouen-sur-Seine,93070,0.16666666666666666,17
12126,Gravelle - Route du Bac,OUI,48,46,2,2,0,OUI,OUI,2025-03-13 17:01:35+00:00,"48.824407, 2.418455",Paris,75056,0.041666666666666664,17
23002,Pont de Levallois-bécon,OUI,49,43,6,5,1,OUI,OUI,2025-03-13 17:02:06+00:00,"48.8984179, 2.2791311",Levallois-Perret,92044,0.12244897959183673,17
20036,Ménilmontant - Pelleport,OUI,31,30,1,0,1,OUI,OUI,2025-03-13 17:01:43+00:00,"48.870682633845, 2.3989596023316",Paris,75056,0.03225806451612903,17
13102,Pitié-Salpêtrière,OUI,50,35,15,11,4,OUI,OUI,2025-03-13 17:02:08+00:00,"48.83748810318667, 2.365213818848133",Paris,75056,0.3,17
41604,Lagny - Joffre,OUI,30,29,1,1,0,OUI,OUI,2025-03-13 16:53:21+00:00,"48.84930687084088, 2.417949736118317",Saint-Mandé,94067,0.03333333333333333,17
15055,Vasco de Gama,OUI,52,26,26,21,5,OUI,OUI,2025-03-13 16:59:04+00:00,"48.83671783466264, 2.283664085650799",Paris,75056,0.5,17
15029,Emeriau - Place de Brazzaville,OUI,51,32,19,18,1,OUI,OUI,2025-03-13 17:02:28+00:00,"48.850785261674964, 2.2871585190296173",Paris,75056,0.37254901960784315,17
14130,Jonquoy - Didot,OUI,28,26,2,1,1,OUI,OUI,2025-03-13 16:57:09+00:00,"48.82890454823947, 2.31648076325655",Paris,75056,0.07142857142857142,17
10005,Petites Ecuries - Faubourg Poissonnière,OUI,16,1,15,15,0,OUI,OUI,2025-03-13 16:52:38+00:00,"48.87397217237368, 2.348388757504776",Paris,75056,0.9375,17
41207,Place du Général de Gaulle,OUI,28,25,3,0,3,OUI,OUI,2025-03-13 17:01:07+00:00,"48.8525288, 2.4877332",Fontenay-sous-Bois,94033,0.10714285714285714,17
26001,Gare d'Asnières sur Seine,OUI,21,14,7,6,1,OUI,OUI,2025-03-13 17:02:09+00:00,"48.90636459217474, 2.2835066914558415",Asnières-sur-Seine,92004,0.3333333333333333,17
21308,Bara - Henri Farman,OUI,57,26,31,30,1,OUI,OUI,2025-03-13 17:02:11+00:00,"48.833218027457846, 2.2677567601203923",Issy-les-Moulineaux,92040,0.543859649122807,17
92004,Nanterre - Université,OUI,19,9,10,8,2,OUI,OUI,2025-03-13 16:58:02+00:00,"48.901365, 2.212693",Nanterre,92050,0.5263157894736842,17
19037,Belleville - Porte des Lilas,OUI,28,26,2,0,2,OUI,OUI,2025-03-13 16:57:01+00:00,"48.87660391892763, 2.404769691129476",Paris,75056,0.07142857142857142,17
18020,Francoeur - Marcadet,OUI,20,17,3,2,1,OUI,OUI,2025-03-13 17:01:43+00:00,"48.89104123261663, 2.340014585442034",Paris,75056,0.15,17
6018,Michelet - Assas,OUI,15,12,3,3,0,OUI,OUI,2025-03-13 16:59:47+00:00,"48.842741502832, 2.3350211977959",Paris,75056,0.2,17
5026,Pascal - Claude Bernard,OUI,46,24,22,19,3,OUI,OUI,2025-03-13 17:02:12+00:00,"48.839061952159746, 2.3499782010912895",Paris,75056,0.4782608695652174,17
21105,Morice - Général Leclerc,OUI,25,14,11,7,4,OUI,OUI,2025-03-13 17:02:25+00:00,"48.90245471981591, 2.3128929734230046",Clichy,92024,0.44,17
5002,Sommerard - Saint-Jacques,OUI,33,5,28,22,6,OUI,OUI,2025-03-13 17:02:17+00:00,"48.850310432924466, 2.345015835298588",Paris,75056,0.8484848484848485,17
32014,Place du Cornillon - Stade de France,OUI,33,4,29,18,11,OUI,OUI,2025-03-13 17:02:27+00:00,"48.92540695835961, 2.3644426837563515",Saint-Denis,93066,0.8787878787878788,17
14018,Porte d'Orléans,OUI,45,43,2,1,1,OUI,OUI,2025-03-13 17:01:14+00:00,"48.8227639, 2.3249313",Paris,75056,0.044444444444444446,17
18032,Porte de Clignancourt.,OUI,53,47,6,1,5,OUI,OUI,2025-03-13 17:01:02+00:00,"48.897488, 2.343996",Paris,75056,0.11320754716981132,17
21013,Pierre Grenier - Pont de Billancourt,OUI,21,10,11,8,3,OUI,OUI,2025-03-13 16:58:31+00:00,"48.8258020742942, 2.2487989068031315",Boulogne-Billancourt,92012,0.5238095238095238,17
17124,Porte de Saint-Ouen - Henri Huchard,OUI,26,8,18,13,5,OUI,OUI,2025-03-13 17:02:10+00:00,"48.898708366365064, 2.3295360803604126",Paris,75056,0.6923076923076923,17
42503,Vladimir Ilitch Lénine - Andrée Chedid,OUI,31,25,6,1,5,OUI,OUI,2025-03-13 17:02:18+00:00,"48.813240124373, 2.3319716067039",Gentilly,94037,0.1935483870967742,17
44012,Génie - Mozart,OUI,18,16,2,1,1,OUI,OUI,2025-03-13 16:59:32+00:00,"48.794902381218904, 2.3734183609485626",Vitry-sur-Seine,94081,0.1111111111111111,17
21111,Professeur René Leriche - Général Leclerc,OUI,50,42,8,4,4,OUI,OUI,2025-03-13 16:59:51+00:00,"48.90782845483013, 2.307887971401215",Clichy,92024,0.16,17
17027,Place du Maréchal Juin - Péreire,OUI,44,18,26,18,8,OUI,OUI,2025-03-13 17:01:59+00:00,"48.885263, 2.298286",Paris,75056,0.5909090909090909,17
7014,Saint-François-Xavier,OUI,42,37,5,2,3,OUI,OUI,2025-03-13 17:01:26+00:00,"48.85154484769, 2.3146149516106",Paris,75056,0.11904761904761904,17
31016,Lucie Aubrac - Franklin,OUI,35,30,5,0,5,OUI,OUI,2025-03-13 16:58:32+00:00,"48.86223916006812, 2.4435862898826604",Montreuil,93048,0.14285714285714285,17
10023,Gare de l'Est - Verdun,OUI,13,10,3,3,0,OUI,OUI,2025-03-13 17:02:22+00:00,"48.876156054271, 2.3609149083206",Paris,75056,0.23076923076923078,17
51003,Hôtel de Ville d'Argenteuil,OUI,29,12,17,10,7,OUI,OUI,2025-03-13 16:54:28+00:00,"48.946504, 2.2496396",Argenteuil,95018,0.5862068965517241,17
13026,Place Jean Delay,OUI,34,16,18,6,12,OUI,OUI,2025-03-13 17:02:20+00:00,"48.823316, 2.354336",Paris,75056,0.5294117647058824,17
22101,Gare Routière de Saint Cloud,OUI,29,14,15,11,4,OUI,OUI,2025-03-13 17:01:00+00:00,"48.84288183896324, 2.222245037555695",Saint-Cloud,92064,0.5172413793103449,17
14139,Pierre Larousse - Raymond Losserand,OUI,30,30,0,0,0,OUI,OUI,2025-03-13 17:01:50+00:00,"48.83059564231877, 2.3119183257222176",Paris,75056,0.0,17
13016,Primo Levi - Frigos,OUI,33,12,21,19,2,OUI,OUI,2025-03-13 17:02:25+00:00,"48.83094844846017, 2.37965351592796",Paris,75056,0.6363636363636364,17
11101,Charles Delescluze,OUI,48,18,30,25,5,OUI,OUI,2025-03-13 17:01:19+00:00,"48.85242200848887, 2.380632497370243",Paris,75056,0.625,17
8051,Batignolles - Rome,OUI,12,10,2,0,2,OUI,OUI,2025-03-13 17:01:21+00:00,"48.881823370566806, 2.3202589899301524",Paris,75056,0.16666666666666666,17
10015,Lucien Sampaix - Récollets,OUI,40,35,5,2,3,OUI,OUI,2025-03-13 17:01:41+00:00,"48.874330377560476, 2.3621229082345963",Paris,75056,0.125,17
9115,Milton - Manuel,OUI,21,18,3,0,3,OUI,OUI,2025-03-13 17:00:56+00:00,"48.878249, 2.341181",Paris,75056,0.14285714285714285,17
12011,Charenton - Place du Col Bourgoin,OUI,35,11,24,20,4,OUI,OUI,2025-03-13 17:02:21+00:00,"48.844867319554, 2.3825789350545",Paris,75056,0.6857142857142857,17
19039,Edouard Pailleron - Simon Bolivar,OUI,23,22,1,1,0,OUI,OUI,2025-03-13 17:01:19+00:00,"48.87979886049996, 2.374839261174202",Paris,75056,0.043478260869565216,17
12032,Porte Dorée,OUI,35,9,26,15,11,OUI,OUI,2025-03-13 17:01:40+00:00,"48.8354337, 2.4077132",Paris,75056,0.7428571428571429,17
21003,Jean Jaurès - Jean Baptiste Clément,OUI,39,34,5,3,2,OUI,OUI,2025-03-13 17:01:20+00:00,"48.84576261454011, 2.2369650006294255",Boulogne-Billancourt,92012,0.1282051282051282,17
6103,Mézières - Rennes,OUI,53,48,5,2,3,OUI,OUI,2025-03-13 17:02:09+00:00,"48.85023459321703, 2.3303819820284843",Paris,75056,0.09433962264150944,17
17122,Bridaine - Lamandé,OUI,28,25,3,0,3,OUI,OUI,2025-03-13 16:54:41+00:00,"48.8862074, 2.3206239",Paris,75056,0.10714285714285714,17
15038,Place Adolphe Cherioux - Vaugirard,OUI,62,53,9,1,8,OUI,OUI,2025-03-13 17:02:17+00:00,"48.83959442800459, 2.3010657727718353",Paris,75056,0.14516129032258066,17
20027,Porte de Ménilmontant,OUI,15,14,1,0,1,OUI,OUI,2025-03-13 17:01:36+00:00,"48.8691543609174, 2.40932246879487",Paris,75056,0.06666666666666667,17
21032,Sèvres-Gallieni,OUI,24,4,20,19,1,OUI,OUI,2025-03-13 17:00:59+00:00,"48.837809408957, 2.2281519323587",Boulogne-Billancourt,92012,0.8333333333333334,17
31007,Paris - Désiré Préaux,OUI,44,37,7,1,6,OUI,OUI,2025-03-13 17:02:26+00:00,"48.85742876694898, 2.4323049187660217",Montreuil,93048,0.1590909090909091,17
20021,Indre - Prairies,OUI,38,33,5,1,4,OUI,OUI,2025-03-13 16:59:41+00:00,"48.86254398506782, 2.403290458023548",Paris,75056,0.13157894736842105,17
15108,Lourmel - Marie Skobtsov,OUI,22,16,6,2,4,OUI,OUI,2025-03-13 17:02:07+00:00,"48.844974, 2.287283",Paris,75056,0.2727272727272727,17
7005,Raspail - Bac,OUI,50,35,15,12,3,OUI,OUI,2025-03-13 17:02:26+00:00,"48.855628721101, 2.3256602883339",Paris,75056,0.3,17
17046,Mac-Mahon - Brey,OUI,24,21,3,2,1,OUI,OUI,2025-03-13 16:59:33+00:00,"48.877532084130166, 2.294512536052928",Paris,75056,0.125,17
21019,Edouard Vaillant - Paul-Adolphe Souriau,OUI,26,2,24,21,3,OUI,OUI,2025-03-13 17:02:19+00:00,"48.834845858829, 2.2479459643364",Boulogne-Billancourt,92012,0.9230769230769231,17
17121,Square des Epinettes,OUI,20,18,2,1,1,OUI,OUI,2025-03-13 17:00:59+00:00,"48.89383909781389, 2.325953990221024",Paris,75056,0.1,17
19109,Tanger - Place du Maroc,OUI,19,16,3,1,2,OUI,OUI,2025-03-13 16:57:51+00:00,"48.8862524447104, 2.3689296841621403",Paris,75056,0.15789473684210525,17
19038,Lassus - Delouvain,OUI,19,17,2,2,0,OUI,OUI,2025-03-13 17:01:12+00:00,"48.8755044846, 2.3890327325519",Paris,75056,0.10526315789473684,17
31019,Vincennes - Douy-Delcupe,OUI,37,31,6,1,5,OUI,OUI,2025-03-13 17:00:23+00:00,"48.85493692155721, 2.436049282550812",Montreuil,93048,0.16216216216216217,17
18029,Emile Blemont - Poteau,OUI,38,34,4,2,2,OUI,OUI,2025-03-13 17:02:17+00:00,"48.8943782, 2.3415122",Paris,75056,0.10526315789473684,17
13043,Dunois - Clisson,OUI,50,37,13,8,5,OUI,OUI,2025-03-13 16:58:16+00:00,"48.832294, 2.3674523",Paris,75056,0.26,17
9031,Provence - Chaussée d'Antin,OUI,24,8,16,15,1,OUI,OUI,2025-03-13 17:02:07+00:00,"48.87428447542072, 2.332976511564311",Paris,75056,0.6666666666666666,17
2009,Filles Saint-Thomas - Place de la Bourse,OUI,58,29,29,21,8,OUI,OUI,2025-03-13 17:02:27+00:00,"48.868899890853, 2.3397543845203",Paris,75056,0.5,17
14002,Edgar Quinet - Raspail,OUI,45,42,3,0,3,OUI,OUI,2025-03-13 17:02:21+00:00,"48.83940266673835, 2.32971478253603",Paris,75056,0.06666666666666667,17
44102,Verdun - Adrien Damalix,OUI,26,21,5,4,1,OUI,OUI,2025-03-13 17:02:25+00:00,"48.8222334178559, 2.4215328320860863",Saint-Maurice,94069,0.19230769230769232,17
15035,Place Etienne Pernet,OUI,43,7,36,31,5,OUI,OUI,2025-03-13 17:02:17+00:00,"48.84243457133779, 2.2921819612383847",Paris,75056,0.8372093023255814,17
16032,Eglise d'Auteuil,OUI,20,11,9,4,5,OUI,OUI,2025-03-13 17:01:50+00:00,"48.84749841771691, 2.26848387135299",Paris,75056,0.45,17
18049,Porte d'Aubervilliers,OUI,53,48,5,4,1,OUI,OUI,2025-03-13 17:02:09+00:00,"48.89859661942376, 2.3689722642302513",Paris,75056,0.09433962264150944,17
22001,Château - Bineau,OUI,20,1,19,16,3,OUI,OUI,2025-03-13 17:00:33+00:00,"48.890404028589806, 2.270106375217438",Neuilly-sur-Seine,92051,0.95,17
21014,Hameau Fleuri - Marché,OUI,20,5,15,12,3,OUI,OUI,2025-03-13 16:58:37+00:00,"48.831448892608314, 2.2412404417991643",Boulogne-Billancourt,92012,0.75,17
18025,Mairie du 18ème,OUI,40,35,5,0,5,OUI,OUI,2025-03-13 17:01:10+00:00,"48.892939296937605, 2.3445510864257812",Paris,75056,0.125,17
11006,Ledru-Rollin - Place du Père Chaillet,OUI,36,0,36,24,12,OUI,OUI,2025-03-13 17:00:15+00:00,"48.856433706943704, 2.379020587761426",Paris,75056,1.0,17
9023,Laffitte - Italiens,OUI,31,23,8,7,1,OUI,OUI,2025-03-13 17:02:04+00:00,"48.871815737396, 2.3372015478451",Paris,75056,0.25806451612903225,17
47005,Ecole Vétérinaire,OUI,34,22,12,11,1,OUI,OUI,2025-03-13 17:02:13+00:00,"48.81488859822486, 2.4224362157778994",Maisons-Alfort,94046,0.35294117647058826,17
14122,Colonel Monteil - Brune,OUI,19,16,3,3,0,OUI,OUI,2025-03-13 16:59:12+00:00,"48.82650293311, 2.3092747998272",Paris,75056,0.15789473684210525,17
19127,Aubervilliers - Curial,OUI,23,15,8,4,4,OUI,OUI,2025-03-13 17:02:28+00:00,"48.89088305227546, 2.3688579350709915",Paris,75056,0.34782608695652173,17
16123,Mahatma Gandhi,OUI,24,7,17,13,4,OUI,OUI,2025-03-13 16:59:05+00:00,"48.876356, 2.264205",Paris,75056,0.7083333333333334,17
15070,Balard - Montagne de la Fage,OUI,33,2,31,28,3,OUI,OUI,2025-03-13 17:02:00+00:00,"48.83850740333351, 2.2782871127128606",Paris,75056,0.9393939393939394,17
19040,Belleville - Télégraphe,OUI,40,39,1,0,1,OUI,OUI,2025-03-13 16:59:35+00:00,"48.8756045, 2.3995549",Paris,75056,0.025,17
1120,Lavandieres Sainte Opportune - Rivoli,OUI,25,6,19,16,3,OUI,OUI,2025-03-13 17:02:25+00:00,"48.859279702476, 2.3466217517853",Paris,75056,0.76,17
17047,Courcelles - Pierre Demours,OUI,24,2,22,11,11,OUI,OUI,2025-03-13 17:01:56+00:00,"48.883769733273496, 2.29858466343129",Paris,75056,0.9166666666666666,17
47004,Stade Auguste Delaune,OUI,21,1,20,20,0,OUI,OUI,2025-03-13 17:02:26+00:00,"48.80896378683884, 2.4345204234123234",Maisons-Alfort,94046,0.9523809523809523,17
6016,Danton - Serpente,OUI,20,5,15,14,1,OUI,OUI,2025-03-13 16:59:41+00:00,"48.852297362582, 2.3414132371545",Paris,75056,0.75,17
18033,Belliard - Damrémont,OUI,34,31,3,1,2,OUI,OUI,2025-03-13 17:02:21+00:00,"48.89669238777841, 2.338023450388167",Paris,75056,0.08823529411764706,17
41204,République - Danton,OUI,19,18,1,0,1,OUI,OUI,2025-03-13 16:55:22+00:00,"48.85249172181667, 2.462034523487091",Fontenay-sous-Bois,94033,0.05263157894736842,17
15002,Maine - Antoine Bourdelle,OUI,17,4,13,10,3,OUI,OUI,2025-03-13 16:59:47+00:00,"48.84308531746595, 2.320263946784738",Paris,75056,0.7647058823529411,17
19009,Cité des Sciences et de l'Industrie,OUI,27,22,5,1,4,OUI,OUI,2025-03-13 17:01:36+00:00,"48.89659571178903, 2.384599149227142",Paris,75056,0.18518518518518517,17
21310,Kléber - Gouverneur Général Eboué,OUI,21,5,16,15,1,OUI,OUI,2025-03-13 16:58:14+00:00,"48.826885843069796, 2.2723413258790965",Issy-les-Moulineaux,92040,0.7619047619047619,17
18109,Pajol - Riquet,OUI,44,37,7,3,4,OUI,OUI,2025-03-13 16:59:33+00:00,"48.88960028134536, 2.3628534749150276",Paris,75056,0.1590909090909091,17
23007,Président Wilson - Jean Jaures,OUI,25,10,15,10,5,OUI,OUI,2025-03-13 17:02:26+00:00,"48.89034054052266, 2.2920683026313786",Levallois-Perret,92044,0.6,17
21703,Square du Carrefour de l'Insurrection,OUI,19,19,0,0,0,OUI,OUI,2025-03-13 17:00:05+00:00,"48.820864559770676, 2.291113436222077",Vanves,92075,0.0,17
20016,Pyrénées - Maraîchers,OUI,32,30,2,1,1,OUI,OUI,2025-03-13 16:57:11+00:00,"48.85714001395299, 2.4043509364128113",Paris,75056,0.0625,17
35017,Toffier Decaux - Cartier Bresson,OUI,18,14,4,4,0,OUI,OUI,2025-03-13 17:00:03+00:00,"48.90165072551549, 2.4017545580863957",Pantin,93055,0.2222222222222222,17
32015,Gare RER de Saint-Denis,OUI,37,25,12,9,3,OUI,OUI,2025-03-13 17:01:18+00:00,"48.93554324248177, 2.3471488058567047",Saint-Denis,93066,0.32432432432432434,17
20118,Orteaux - Mouraud,OUI,24,24,0,0,0,OUI,OUI,2025-03-13 16:58:35+00:00,"48.85558642847872, 2.408762907764669",Paris,75056,0.0,17
10010,Place Jacques Bonsergent,OUI,32,13,19,17,2,OUI,OUI,2025-03-13 17:01:48+00:00,"48.870948218595, 2.3612049221992",Paris,75056,0.59375,17
16021,François Ponsard - La Muette,OUI,23,22,1,0,1,OUI,OUI,2025-03-13 16:59:46+00:00,"48.8583666, 2.2744515",Paris,75056,0.043478260869565216,17
16043,Place de Passy,OUI,12,9,3,2,1,OUI,OUI,2025-03-13 17:00:40+00:00,"48.85780291711202, 2.277500546942199",Paris,75056,0.25,17
9117,Bellefond - Maubeuge,OUI,28,28,0,0,0,OUI,OUI,2025-03-13 16:59:09+00:00,"48.878255397645, 2.3452642187476",Paris,75056,0.0,17
18008,Square Léon,OUI,33,32,1,0,1,OUI,OUI,2025-03-13 17:00:36+00:00,"48.88667396788626, 2.353205569088459",Paris,75056,0.030303030303030304,17
20023,Pelleport - Belgrand,OUI,14,13,1,0,1,OUI,OUI,2025-03-13 16:57:30+00:00,"48.86500081847653, 2.403980836377493",Paris,75056,0.07142857142857142,17
7008,Villersexel - Saint-Germain,OUI,16,10,6,4,2,OUI,OUI,2025-03-13 16:58:43+00:00,"48.858297001218, 2.3237934708595",Paris,75056,0.375,17
10020,Chabrol - d'Hauteville,OUI,10,10,0,0,0,OUI,OUI,2025-03-13 17:02:10+00:00,"48.877018388033, 2.3513179644942",Paris,75056,0.0,17
42703,Fontainebleau - Edmond Michelet,OUI,45,43,2,0,2,OUI,OUI,2025-03-13 17:00:03+00:00,"48.80956436844049, 2.3626908659935",Le Kremlin-Bicêtre,94043,0.044444444444444446,17
18113,Lepic - Armée d'Orient,OUI,24,24,0,0,0,OUI,OUI,2025-03-13 17:00:04+00:00,"48.887536403814, 2.3343077301979",Paris,75056,0.0,17
14030,Pernety - Raymond Losserand,OUI,31,29,2,0,2,OUI,OUI,2025-03-13 16:59:37+00:00,"48.834254627953, 2.317609339387",Paris,75056,0.06451612903225806,17
20201,Eugène Reisz - Davout,OUI,19,12,7,1,6,OUI,OUI,2025-03-13 17:00:30+00:00,"48.85631874632638, 2.410396970808506",Paris,75056,0.3684210526315789,17
11041,Square Saint-Ambroise,OUI,39,21,18,16,2,OUI,OUI,2025-03-13 17:00:48+00:00,"48.860934, 2.375841",Paris,75056,0.46153846153846156,17
13046,Eugène Oudiné - Dessous Des Berges,OUI,42,22,20,15,5,OUI,OUI,2025-03-13 17:01:25+00:00,"48.8256423, 2.3750226",Paris,75056,0.47619047619047616,17
31703,Sadi Carnot - François Mitterrand,OUI,26,22,4,0,4,OUI,OUI,2025-03-13 16:58:26+00:00,"48.87532687671517, 2.4241617321968083",Bagnolet,93006,0.15384615384615385,17
22102,Mont Valérien - Michel Salles,OUI,24,8,16,12,4,OUI,OUI,2025-03-13 17:01:44+00:00,"48.8561915, 2.2152966",Saint-Cloud,92064,0.6666666666666666,17
35003,Gabrielle Josserand - Edouard Vaillant,OUI,24,20,4,3,1,OUI,OUI,2025-03-13 17:01:26+00:00,"48.90271566255436, 2.3933270573616032",Pantin,93055,0.16666666666666666,17
4110,Neuve Saint-Pierre - Beautreillis,OUI,19,17,2,1,1,OUI,OUI,2025-03-13 17:02:04+00:00,"48.85355351439652, 2.3639122769236565",Paris,75056,0.10526315789473684,17
15031,Théâtre - Lourmel,OUI,51,14,37,35,2,OUI,OUI,2025-03-13 17:01:09+00:00,"48.8482070397636, 2.2898658737540245",Paris,75056,0.7254901960784313,17
17022,Pereire - Place de Wagram,OUI,44,43,1,0,1,OUI,OUI,2025-03-13 17:00:39+00:00,"48.887070607581215, 2.304111124531457",Paris,75056,0.022727272727272728,17
5121,Square René Viviani - Montebello,OUI,32,1,31,25,6,OUI,OUI,2025-03-13 17:02:03+00:00,"48.851904891406, 2.3478421568871",Paris,75056,0.96875,17
23304,Mairie de Sceaux,OUI,33,31,2,1,1,OUI,OUI,2025-03-13 16:57:03+00:00,"48.778916905132, 2.2887361764861",Sceaux,92071,0.06060606060606061,17
16015,Bassano -  Iéna,OUI,15,13,2,0,2,OUI,OUI,2025-03-13 17:02:02+00:00,"48.868144510482075, 2.296149600985935",Paris,75056,0.13333333333333333,17
6017,Sénat - Condé,OUI,29,13,16,15,1,OUI,OUI,2025-03-13 17:01:40+00:00,"48.84954227788459, 2.337939441204071",Paris,75056,0.5517241379310345,17
14112,Méchain - Faubourg Saint-Jacques,OUI,14,13,1,1,0,OUI,OUI,2025-03-13 17:01:06+00:00,"48.83586772099485, 2.33798034198275",Paris,75056,0.07142857142857142,17
13103,Hôpital Pitié Salpêtrière,OUI,47,45,2,1,1,OUI,OUI,2025-03-13 17:00:36+00:00,"48.8377016, 2.3604946",Paris,75056,0.0425531914893617,17
9026,Jean-Baptiste Pigalle - La Bruyere,OUI,17,12,5,0,5,OUI,OUI,2025-03-13 17:00:30+00:00,"48.87939826447722, 2.333709173337285",Paris,75056,0.29411764705882354,17
12161,Diderot - Reuilly,OUI,43,15,28,26,2,OUI,OUI,2025-03-13 17:02:14+00:00,"48.847208456061, 2.3861273378134",Paris,75056,0.6511627906976745,17
21001,Transvaal - Charles de Gaulle,OUI,27,19,8,4,4,OUI,OUI,2025-03-13 17:00:28+00:00,"48.848280403628806, 2.2373420120857195",Boulogne-Billancourt,92012,0.2962962962962963,17
9101,Cadet - La Fayette,OUI,18,8,10,9,1,OUI,OUI,2025-03-13 16:58:43+00:00,"48.875601632672, 2.3435704037547",Paris,75056,0.5555555555555556,17
11010,Boulets - Faubourg Saint-Antoine,OUI,42,35,7,4,3,OUI,OUI,2025-03-13 17:01:50+00:00,"48.849259262115, 2.3917546141943",Paris,75056,0.16666666666666666,17
11043,Place Pasdeloup,OUI,20,9,11,10,1,OUI,OUI,2025-03-13 17:01:56+00:00,"48.862654215631, 2.3670325062844",Paris,75056,0.55,17
16122,Route de la Muette - Porte de Neuilly,OUI,48,40,8,5,3,OUI,OUI,2025-03-13 17:01:24+00:00,"48.8798926, 2.2587671",Paris,75056,0.16666666666666666,17
13010,Place d'Italie - Vincent Auriol,OUI,38,33,5,0,5,OUI,OUI,2025-03-13 17:02:20+00:00,"48.831481874467, 2.3567550292319",Paris,75056,0.13157894736842105,17
16027,Mozart - Jasmin,OUI,62,55,7,4,3,OUI,OUI,2025-03-13 17:01:55+00:00,"48.85286124871689, 2.268483570651513",Paris,75056,0.11290322580645161,17
32603,Calmette,OUI,31,30,1,1,0,OUI,OUI,2025-03-13 17:02:19+00:00,"48.88104925098552, 2.424993216991425",Les Lilas,93045,0.03225806451612903,17
20116,Haies - Réunion,OUI,20,20,0,0,0,OUI,OUI,2025-03-13 16:58:32+00:00,"48.85386896766491, 2.402426162238911",Paris,75056,0.0,17
21311,Parvis Corentin Celton,OUI,52,12,40,37,3,OUI,OUI,2025-03-13 17:02:19+00:00,"48.82747252522725, 2.2784319519996648",Issy-les-Moulineaux,92040,0.7692307692307693,17
6107,Place Alphonse Deville,OUI,22,6,16,13,3,OUI,OUI,2025-03-13 17:02:28+00:00,"48.850188262662, 2.3275961726904",Paris,75056,0.7272727272727273,17
31023,Place François Mitterand,OUI,34,34,0,0,0,OUI,OUI,2025-03-13 16:56:36+00:00,"48.86492782016328, 2.442958317697048",Montreuil,93048,0.0,17
16029,Maison de Radio - France,OUI,41,1,40,39,1,OUI,OUI,2025-03-13 17:02:21+00:00,"48.85132886434057, 2.277785539627075",Paris,75056,0.975609756097561,17
21024,Billancourt - Général Leclerc,OUI,22,21,1,0,1,OUI,OUI,2025-03-13 17:01:08+00:00,"48.8322649, 2.2380413",Boulogne-Billancourt,92012,0.045454545454545456,17
8019,Naples - Rome,OUI,25,24,1,0,1,OUI,OUI,2025-03-13 17:00:14+00:00,"48.879960700846226, 2.321358695626259",Paris,75056,0.04,17
2001,Greneta - Sebastopol,OUI,31,1,30,28,2,OUI,OUI,2025-03-13 17:01:12+00:00,"48.865242333228, 2.3516669869423",Paris,75056,0.967741935483871,17
9017,Lallier - Trudaine,OUI,28,25,3,0,3,OUI,OUI,2025-03-13 17:01:12+00:00,"48.88109246617963, 2.3408224806189537",Paris,75056,0.10714285714285714,17
20019,Place du Maquis du Vercors,OUI,30,30,0,0,0,OUI,OUI,2025-03-13 16:57:56+00:00,"48.877321579493575, 2.4083782732486725",Paris,75056,0.0,17
16112,Chernoviz - Raynouard,OUI,36,34,2,0,2,OUI,OUI,2025-03-13 17:01:35+00:00,"48.8569864146289, 2.282173218142987",Paris,75056,0.05555555555555555,17
18137,Poissonniers - Nord,OUI,27,26,1,0,1,OUI,OUI,2025-03-13 16:56:09+00:00,"48.892511213520656, 2.3522228747606277",Paris,75056,0.037037037037037035,17
15003,Gare Montparnasse - Vaugirard,OUI,65,35,30,7,23,OUI,OUI,2025-03-13 17:00:06+00:00,"48.8418071798797, 2.31951002690117",Paris,75056,0.46153846153846156,17
7101,Raspail - Chomel,OUI,48,20,28,23,5,OUI,OUI,2025-03-13 17:01:50+00:00,"48.852233164303, 2.3266580700874",Paris,75056,0.5833333333333334,17
6032,Sabot - Rennes,OUI,24,4,20,18,2,OUI,OUI,2025-03-13 17:01:11+00:00,"48.852575112948415, 2.331552766263485",Paris,75056,0.8333333333333334,17
8056,Beaujon - Wagram,OUI,28,26,2,1,1,OUI,OUI,2025-03-13 17:00:41+00:00,"48.875352455985, 2.2964416444302",Paris,75056,0.07142857142857142,17
7020,Champ de Mars - Cler,OUI,40,13,27,25,2,OUI,OUI,2025-03-13 16:59:44+00:00,"48.856691550115315, 2.306646779179573",Paris,75056,0.675,17
17116,Reims - Porte d'Asnières,OUI,25,21,4,1,3,OUI,OUI,2025-03-13 17:01:38+00:00,"48.891834448210986, 2.300144659954865",Paris,75056,0.16,17
10036,Aqueduc - Villette,OUI,24,20,4,0,4,OUI,OUI,2025-03-13 17:00:28+00:00,"48.883886063895, 2.367198803315",Paris,75056,0.16666666666666666,17
13041,Porte d'Ivry,OUI,49,47,2,1,1,OUI,OUI,2025-03-13 17:01:12+00:00,"48.821768747596, 2.3688706755638",Paris,75056,0.04081632653061224,17
15107,Palais des Sports,OUI,19,3,16,14,2,OUI,OUI,2025-03-13 17:01:37+00:00,"48.833468517426, 2.2858720645308",Paris,75056,0.8421052631578947,17
12108,Bercy.,OUI,62,23,39,34,5,OUI,OUI,2025-03-13 17:02:23+00:00,"48.839966914994, 2.3788625746965",Paris,75056,0.6290322580645161,17
18017,Caulaincourt - Place Constantin Pecqueur,OUI,41,41,0,0,0,OUI,OUI,2025-03-13 17:01:43+00:00,"48.889677905028, 2.3381787144261",Paris,75056,0.0,17
14006,Saint-Jacques - Tombe Issoire,OUI,20,18,2,1,1,OUI,OUI,2025-03-13 17:00:22+00:00,"48.833206330538864, 2.3369108140468597",Paris,75056,0.1,17
19041,Belleville - Pyrénées,OUI,38,37,1,0,1,OUI,OUI,2025-03-13 17:02:11+00:00,"48.8741908, 2.3860039",Paris,75056,0.02631578947368421,17
21114,Gustave Eiffel - Parc des Impressionnistes,OUI,30,19,11,11,0,OUI,OUI,2025-03-13 17:02:28+00:00,"48.90390619651018, 2.2946908324956894",Clichy,92024,0.36666666666666664,17
1117,Pont Neuf - Rivoli,OUI,26,9,17,12,5,OUI,OUI,2025-03-13 17:02:07+00:00,"48.860089892617, 2.344057559967",Paris,75056,0.6538461538461539,17
31013,Centenaire - Sorins,OUI,40,38,2,0,2,OUI,OUI,2025-03-13 16:55:28+00:00,"48.85853523359734, 2.4273508787155156",Montreuil,93048,0.05,17
23903,Stade Gaston Bouillant,OUI,29,20,9,6,3,OUI,OUI,2025-03-13 17:00:04+00:00,"48.939958667023, 2.3279571813836",Villeneuve-la-Garenne,92078,0.3103448275862069,17
32018,Franciade - Gabriel Péri,OUI,25,20,5,3,2,OUI,OUI,2025-03-13 17:00:20+00:00,"48.93261499331498, 2.355954498052597",Saint-Denis,93066,0.2,17
31704,Jeanne Hornet - Girardot,OUI,28,28,0,0,0,OUI,OUI,2025-03-13 16:54:21+00:00,"48.873802681432146, 2.427820265293122",Bagnolet,93006,0.0,17
20202,Dupont de l'Eure - Gambetta,OUI,29,29,0,0,0,OUI,OUI,2025-03-13 16:58:13+00:00,"48.8679385, 2.4003649",Paris,75056,0.0,17
17201,Porte Maillot - Perreire,OUI,49,32,17,7,10,OUI,OUI,2025-03-13 17:02:22+00:00,"48.878021154637, 2.2842371277102",Paris,75056,0.3469387755102041,17
11003,Keller - La Roquette,OUI,33,17,16,13,3,OUI,OUI,2025-03-13 17:01:58+00:00,"48.8555508, 2.3752778",Paris,75056,0.48484848484848486,17
15059,Parc André Citroën,OUI,64,2,62,58,4,OUI,OUI,2025-03-13 17:02:16+00:00,"48.840639944296655, 2.2780618071556096",Paris,75056,0.96875,17
15020,Mairie du 15ème,OUI,31,23,8,7,1,OUI,OUI,2025-03-13 17:00:43+00:00,"48.8417762, 2.2986539",Paris,75056,0.25806451612903225,17
23403,Chateau,OUI,21,19,2,1,1,OUI,OUI,2025-03-13 16:53:40+00:00,"48.774661399959, 2.3135878035462",Bourg-la-Reine,92014,0.09523809523809523,17
13113,Vistule - Choisy,OUI,33,26,7,5,2,OUI,OUI,2025-03-13 17:00:41+00:00,"48.82365543660611, 2.3615723848342896",Paris,75056,0.21212121212121213,17
4013,Vieille du Temple - Francs Bourgeois,OUI,27,6,21,20,1,OUI,OUI,2025-03-13 16:59:38+00:00,"48.858256413365815, 2.35821794718504",Paris,75056,0.7777777777777778,17
15061,Square Desnouettes,OUI,22,15,7,6,1,OUI,OUI,2025-03-13 17:01:16+00:00,"48.83476837934194, 2.284142297394666",Paris,75056,0.3181818181818182,17
45001,Hôtel de Ville de Champigny sur Marne,OUI,21,4,17,9,8,OUI,OUI,2025-03-13 17:02:19+00:00,"48.813810628405, 2.5096759200096",Champigny-sur-Marne,94017,0.8095238095238095,17
20017,Saint-Blaise - Mouraud,OUI,27,26,1,0,1,OUI,OUI,2025-03-13 16:53:04+00:00,"48.85696177597818, 2.40869477391243",Paris,75056,0.037037037037037035,17
9118,Faubourg Poissonniere - Delta,OUI,36,36,0,0,0,OUI,OUI,2025-03-13 17:01:27+00:00,"48.882555807626765, 2.3497482016682625",Paris,75056,0.0,17
11019,Charonne - Philippe-Auguste,OUI,30,27,3,2,1,OUI,OUI,2025-03-13 16:59:17+00:00,"48.855603162026, 2.39054639062",Paris,75056,0.1,17
10163,Gare du Nord - Demarquay,OUI,29,25,4,0,4,OUI,OUI,2025-03-13 17:01:08+00:00,"48.881154, 2.358411",Paris,75056,0.13793103448275862,17
23008,Hôtel de Ville de Levallois Perret,OUI,25,1,24,19,5,OUI,OUI,2025-03-13 16:58:33+00:00,"48.89314451997415, 2.2888818383216862",Levallois-Perret,92044,0.96,17
19023,Manin - Simon Bolivar,OUI,23,21,2,0,2,OUI,OUI,2025-03-13 16:59:17+00:00,"48.876499654127, 2.3794073625991",Paris,75056,0.08695652173913043,17
8015,Roquépine - Malesherbes,OUI,51,20,31,27,4,OUI,OUI,2025-03-13 17:02:14+00:00,"48.87345073390807, 2.320404499769211",Paris,75056,0.6078431372549019,17
18138,Station Paris Basketball - Ney - Charles Hermite,OUI,19,14,5,1,4,OUI,OUI,2025-03-13 17:02:09+00:00,"48.898748039775, 2.3645754531026",Paris,75056,0.2631578947368421,17
14116,Romain Rolland,OUI,25,23,2,1,1,OUI,OUI,2025-03-13 17:00:45+00:00,"48.820215229662765, 2.3234144234418346",Montrouge,92049,0.08,17
7016,Surcouf - Université,OUI,57,16,41,35,6,OUI,OUI,2025-03-13 17:02:14+00:00,"48.861273016278, 2.3094535509142",Paris,75056,0.7192982456140351,17
47002,Les Juilliottes,OUI,21,5,16,11,5,OUI,OUI,2025-03-13 16:56:21+00:00,"48.8043072, 2.4437362",Maisons-Alfort,94046,0.7619047619047619,17
4011,Hôtel de Ville - Pont-Marie,OUI,31,1,30,28,2,OUI,OUI,2025-03-13 17:02:01+00:00,"48.853899645527, 2.3569472506642",Paris,75056,0.967741935483871,17
33005,République - Henri Barbusse,OUI,32,23,9,5,4,OUI,OUI,2025-03-13 17:01:07+00:00,"48.90661553626751, 2.389432489871979",Aubervilliers,93001,0.28125,17
12041,Bois de Vincennes.,OUI,58,52,6,2,4,OUI,OUI,2025-03-13 17:00:55+00:00,"48.8338064, 2.4132221",Saint-Mandé,94067,0.10344827586206896,17
7026,Place de Finlande,OUI,24,2,22,14,8,OUI,OUI,2025-03-13 16:57:14+00:00,"48.862408335967, 2.3113624379039",Paris,75056,0.9166666666666666,17
7013,Duroc - Place de Breteuil,OUI,44,26,18,17,1,OUI,OUI,2025-03-13 17:01:23+00:00,"48.847460641142, 2.3126140236855",Paris,75056,0.4090909090909091,17
5019,Poissy - Saint-Germain,OUI,24,7,17,14,3,OUI,OUI,2025-03-13 17:02:06+00:00,"48.84969649427, 2.3529685288668",Paris,75056,0.7083333333333334,17
17016,Brochant - Square des Batignolles,OUI,31,26,5,2,3,OUI,OUI,2025-03-13 17:00:34+00:00,"48.88818698581028, 2.316861143151153",Paris,75056,0.16129032258064516,17
1016,Thérèse - Opéra,OUI,24,2,22,21,1,OUI,OUI,2025-03-13 17:00:43+00:00,"48.866483514509, 2.3344334212238",Paris,75056,0.9166666666666666,17
18019,Square Raymond Souplex,OUI,51,50,1,0,1,OUI,OUI,2025-03-13 17:02:28+00:00,"48.89183721478911, 2.335426103165901",Paris,75056,0.0196078431372549,17
17033,Carnot - Général Lanrezac,OUI,29,28,1,0,1,OUI,OUI,2025-03-13 16:59:08+00:00,"48.875443870736, 2.2938242935036",Paris,75056,0.034482758620689655,17
14007,Ferrus - Saint-Jacques,OUI,33,29,4,1,3,OUI,OUI,2025-03-13 17:02:26+00:00,"48.8313878, 2.3408563",Paris,75056,0.12121212121212122,17
11034,Parmentier - Fontaine au Roi,OUI,46,31,15,12,3,OUI,OUI,2025-03-13 17:02:21+00:00,"48.86787670551736, 2.372705978671471",Paris,75056,0.32608695652173914,17
10164,Claude Vellefaux - Sambre et Meuse,OUI,32,27,5,2,3,OUI,OUI,2025-03-13 17:01:04+00:00,"48.875022, 2.370478",Paris,75056,0.15625,17
9012,Rougemont - Poissonnière,OUI,30,12,18,13,5,OUI,OUI,2025-03-13 17:01:01+00:00,"48.871611569354755, 2.345873080193996",Paris,75056,0.6,17
20103,Le Vau - Maurice Bertaux,OUI,23,23,0,0,0,OUI,OUI,2025-03-13 16:56:16+00:00,"48.86803439043193, 2.411030612453627",Paris,75056,0.0,17
41206,Place des Larris,OUI,34,29,5,1,4,OUI,OUI,2025-03-13 17:00:34+00:00,"48.8568363, 2.4780236",Fontenay-sous-Bois,94033,0.14705882352941177,17
2014,Daunou - Louis le Grand,OUI,32,11,21,9,12,OUI,OUI,2025-03-13 17:01:24+00:00,"48.869113, 2.332515",Paris,75056,0.65625,17
19031,Manin - Crimée,OUI,20,4,16,3,13,OUI,OUI,2025-03-13 17:00:52+00:00,"48.8831217743719, 2.3863670602440834",Paris,75056,0.8,17
4109,Mornay - Sully,OUI,14,7,7,1,6,OUI,OUI,2025-03-13 16:59:18+00:00,"48.84970399548416, 2.364460788667202",Paris,75056,0.5,17
13114,Nationale - Marcel Duchamp,OUI,23,21,2,0,2,OUI,OUI,2025-03-13 17:01:02+00:00,"48.82463749337136, 2.3678014799952507",Paris,75056,0.08695652173913043,17
3101,Porte Saint-Martin,OUI,30,3,27,22,5,OUI,OUI,2025-03-13 17:00:49+00:00,"48.86860172112996, 2.35570102930069",Paris,75056,0.9,17
21108,Mairie de Clichy,OUI,44,30,14,11,3,OUI,OUI,2025-03-13 17:02:28+00:00,"48.903653634661, 2.3059353232384",Clichy,92024,0.3181818181818182,17
8105,François 1er - Lincoln,OUI,29,15,14,0,14,OUI,OUI,2025-03-13 17:02:20+00:00,"48.869517979344, 2.3024262188416",Paris,75056,0.4827586206896552,17
6014,Pont de Lodi - Dauphine,OUI,21,2,19,13,6,OUI,OUI,2025-03-13 17:01:20+00:00,"48.855296898603285, 2.339947307565249",Paris,75056,0.9047619047619048,17
11048,Place Mireille Havet,OUI,39,6,33,27,6,OUI,OUI,2025-03-13 17:02:25+00:00,"48.850533, 2.383756",Paris,75056,0.8461538461538461,17
31018,Gambetta - Michelet,OUI,30,24,6,3,3,OUI,OUI,2025-03-13 17:01:21+00:00,"48.85273792380526, 2.429966032505036",Montreuil,93048,0.2,17
19030,Melun - Jean Jaurès,OUI,26,25,1,0,1,OUI,OUI,2025-03-13 17:01:23+00:00,"48.8837796723475, 2.376477420330048",Paris,75056,0.038461538461538464,17
2110,Jeûneurs - Mulhouse,OUI,28,22,6,6,0,OUI,OUI,2025-03-13 17:00:01+00:00,"48.868997, 2.346925",Paris,75056,0.21428571428571427,17
21004,Jean Jaurès - Reine,OUI,31,7,24,22,2,OUI,OUI,2025-03-13 17:01:39+00:00,"48.84009622558849, 2.239872515201569",Boulogne-Billancourt,92012,0.7741935483870968,17
11107,Faidherbe - Dahomey,OUI,41,22,19,14,5,OUI,OUI,2025-03-13 17:00:04+00:00,"48.851358329771806, 2.383823134795429",Paris,75056,0.4634146341463415,17
11044,Square du Bataclan,OUI,18,2,16,14,2,OUI,OUI,2025-03-13 17:00:45+00:00,"48.8633762, 2.3711327",Paris,75056,0.8888888888888888,17
9113,Bleue - Trévise,OUI,24,7,17,10,7,OUI,OUI,2025-03-13 17:01:31+00:00,"48.87578906564573, 2.347289621829987",Paris,75056,0.7083333333333334,17
16041,Versailles - Claude Terrasse,OUI,44,14,30,26,4,OUI,OUI,2025-03-13 17:02:27+00:00,"48.840219338074, 2.263834191153",Paris,75056,0.6818181818181818,17
15058,Place du Moulin de Javel,OUI,47,26,21,20,1,OUI,OUI,2025-03-13 17:01:31+00:00,"48.84021670922, 2.2716060653329",Paris,75056,0.44680851063829785,17
8029,Place du Canada,OUI,55,20,35,21,14,OUI,OUI,2025-03-13 17:00:52+00:00,"48.865346269363, 2.3101937879648",Paris,75056,0.6363636363636364,17
2101,Bachaumont - Montmartre,OUI,32,15,17,17,0,OUI,OUI,2025-03-13 17:01:21+00:00,"48.86617395079137, 2.3449775576591496",Paris,75056,0.53125,17
11110,Roquette - Folie Regnault,OUI,49,46,3,0,3,OUI,OUI,2025-03-13 17:02:13+00:00,"48.859246959155485, 2.386553623578705",Paris,75056,0.061224489795918366,17
8049,Georges V - François 1er,OUI,22,15,7,4,3,OUI,OUI,2025-03-13 17:02:01+00:00,"48.87034, 2.30082",Paris,75056,0.3181818181818182,17
12153,Terroirs de France - Lheureux,OUI,53,33,20,18,2,OUI,OUI,2025-03-13 17:02:18+00:00,"48.83212027074841, 2.388618104159832",Paris,75056,0.37735849056603776,17
12154,Square Georges Melies,OUI,38,23,15,10,5,OUI,OUI,2025-03-13 16:58:15+00:00,"48.84070239213081, 2.409667745232582",Paris,75056,0.39473684210526316,17
14127,Odessa - Départ,OUI,39,29,10,4,6,OUI,OUI,2025-03-13 16:57:18+00:00,"48.842885590081, 2.3244281485677",Paris,75056,0.2564102564102564,17
22017,Charles de Gaulle - Louis Philippe,OUI,26,23,3,2,1,OUI,OUI,2025-03-13 17:02:24+00:00,"48.881742142181, 2.2710045335353",Neuilly-sur-Seine,92051,0.11538461538461539,17
14016,René Coty - Parc Montsouris,OUI,53,50,3,0,3,OUI,OUI,2025-03-13 16:59:23+00:00,"48.82479134498032, 2.336124926805496",Paris,75056,0.05660377358490566,17
19021,Mairie du 19ème,OUI,24,24,0,0,0,OUI,OUI,2025-03-13 17:02:13+00:00,"48.88256264247959, 2.3812624812126164",Paris,75056,0.0,17
12033,François Truffaut - Saint Emilion,OUI,66,12,54,50,4,OUI,OUI,2025-03-13 17:02:13+00:00,"48.83372354344807, 2.386601903271428",Paris,75056,0.8181818181818182,17
17104,Jardin Marguerite Long,OUI,21,16,5,1,4,OUI,OUI,2025-03-13 17:01:56+00:00,"48.8816985773914, 2.2836575657129288",Paris,75056,0.23809523809523808,17
18142,Jessaint - Marx Dormoy,OUI,29,28,1,1,0,OUI,OUI,2025-03-13 16:59:25+00:00,"48.88484543106364, 2.358930408954621",Paris,75056,0.034482758620689655,17
22002,Argenson - Château,OUI,24,11,13,11,2,OUI,OUI,2025-03-13 16:58:34+00:00,"48.888559314669514, 2.2642001509666447",Neuilly-sur-Seine,92051,0.5416666666666666,17
18035,René Binet - Porte de Montmartre,OUI,36,34,2,0,2,OUI,OUI,2025-03-13 16:59:10+00:00,"48.89905109950848, 2.3365534096956253",Paris,75056,0.05555555555555555,17
35008,Place de l'Eglise - Pantin,OUI,28,27,1,0,1,OUI,OUI,2025-03-13 16:57:25+00:00,"48.892809461520265, 2.4124351143836975",Pantin,93055,0.03571428571428571,17
13110,Moulin de la Pointe,OUI,21,19,2,2,0,OUI,OUI,2025-03-13 17:00:30+00:00,"48.82092946051445, 2.3563179373741145",Paris,75056,0.09523809523809523,17
13022,Butte aux Cailles - Esperance,OUI,30,25,5,3,2,OUI,OUI,2025-03-13 17:00:55+00:00,"48.82758774190948, 2.3492151126265526",Paris,75056,0.16666666666666666,17
15009,Suffren - Pérignon,OUI,44,5,39,34,5,OUI,OUI,2025-03-13 17:01:54+00:00,"48.84717561492764, 2.307052147596786",Paris,75056,0.8863636363636364,17
20045,Louis Ganne - Davout,OUI,28,26,2,0,2,OUI,OUI,2025-03-13 17:00:18+00:00,"48.86338720692607, 2.409725748002529",Paris,75056,0.07142857142857142,17
23005,Gare de Clichy-Levallois,OUI,25,7,18,17,1,OUI,OUI,2025-03-13 17:02:02+00:00,"48.89679827481989, 2.2984680533409123",Levallois-Perret,92044,0.72,17
13019,Fernand Braudel - Vincent Auriol,OUI,36,19,17,14,3,OUI,OUI,2025-03-13 17:02:09+00:00,"48.83637852318147, 2.3723404482007027",Paris,75056,0.4722222222222222,17
21120,Docteur Calmette - Martre,OUI,30,28,2,2,0,OUI,OUI,2025-03-13 17:01:41+00:00,"48.898969358483, 2.3086513252383",Clichy,92024,0.06666666666666667,17
5030,Sorbonne - Ecoles,OUI,48,34,14,3,11,OUI,OUI,2025-03-13 17:00:14+00:00,"48.849686566191, 2.3434996604919",Paris,75056,0.2916666666666667,17
14125,Dareau - Broussais,OUI,21,19,2,0,2,OUI,OUI,2025-03-13 17:01:04+00:00,"48.8307758, 2.3361804",Paris,75056,0.09523809523809523,17
21952,Place Tony de Graaff,OUI,42,13,29,20,9,OUI,OUI,2025-03-13 17:01:50+00:00,"48.8181645, 2.2458109",Meudon,92048,0.6904761904761905,17
21009,Le Corbusier - Jean Jaurès,OUI,44,21,23,21,2,OUI,OUI,2025-03-13 17:00:40+00:00,"48.83780830557548, 2.2408381104469304",Boulogne-Billancourt,92012,0.5227272727272727,17
9015,Lamartine - Faubourg Montmartre,OUI,28,16,12,2,10,OUI,OUI,2025-03-13 17:02:20+00:00,"48.876613982891, 2.3397656902671",Paris,75056,0.42857142857142855,17
31017,Jean Moulin - Paul Doumer,OUI,17,15,2,1,1,OUI,OUI,2025-03-13 17:01:59+00:00,"48.8622179854695, 2.45533436536789",Montreuil,93048,0.11764705882352941,17
16031,Vignes - Boulainvilliers,OUI,20,18,2,0,2,OUI,OUI,2025-03-13 17:01:21+00:00,"48.856399483950504, 2.275240458548069",Paris,75056,0.1,17
13047,Boutroux - Porte de Vitry,OUI,49,27,22,19,3,OUI,OUI,2025-03-13 16:59:41+00:00,"48.822632, 2.377738",Paris,75056,0.4489795918367347,17
17005,Brochant - Clichy,OUI,52,46,6,0,6,OUI,OUI,2025-03-13 16:59:58+00:00,"48.89032998912038, 2.319730559929781",Paris,75056,0.11538461538461539,17
18114,Véron - Lepic,OUI,23,23,0,0,0,OUI,OUI,2025-03-13 17:00:48+00:00,"48.88526123395252, 2.334559857845307",Paris,75056,0.0,17
21017,Place Marcel Sembat,OUI,53,13,40,38,2,OUI,OUI,2025-03-13 17:02:26+00:00,"48.83328865030686, 2.2441747784614567",Boulogne-Billancourt,92012,0.7547169811320755,17
44103,Pont De Charenton,OUI,18,2,16,11,5,OUI,OUI,2025-03-13 17:00:11+00:00,"48.8179685, 2.4199531",Saint-Maurice,94069,0.8888888888888888,17
12120,Lac Daumesnil - Saint-Maurice,OUI,49,40,9,6,3,OUI,OUI,2025-03-13 16:53:39+00:00,"48.82774555743318, 2.4183654785156246",Paris,75056,0.1836734693877551,17
22403,Pierre Brossolette - Adolphe Pinard,OUI,23,23,0,0,0,OUI,OUI,2025-03-13 17:02:15+00:00,"48.821772279548, 2.3131558299065",Malakoff,92046,0.0,17
22012,Madeleine Michelis - Roule,OUI,23,20,3,3,0,OUI,OUI,2025-03-13 17:00:38+00:00,"48.88260431301364, 2.2773634269833565",Neuilly-sur-Seine,92051,0.13043478260869565,17
42011,Quai Marcel Boyer - Victor Hugo,OUI,28,17,11,11,0,OUI,OUI,2025-03-13 17:01:56+00:00,"48.822556366667, 2.3920395970345",Ivry-sur-Seine,94041,0.39285714285714285,17
23105,Sèvres Rive Gauche,OUI,33,21,12,11,1,OUI,OUI,2025-03-13 16:57:17+00:00,"48.821443218278, 2.2150785306885",Sèvres,92072,0.36363636363636365,17
42004,Westermeyer - Paul Vaillant-Couturier,OUI,26,16,10,10,0,OUI,OUI,2025-03-13 17:02:07+00:00,"48.819116181578764, 2.3966637253761296",Ivry-sur-Seine,94041,0.38461538461538464,17
20117,Saint-Fargeau - Mortier,OUI,31,30,1,0,1,OUI,OUI,2025-03-13 17:01:13+00:00,"48.87266656122256, 2.407912909984589",Paris,75056,0.03225806451612903,17
22103,Senard - Charles Blum,OUI,24,13,11,4,7,OUI,OUI,2025-03-13 17:01:27+00:00,"48.857315824799, 2.221091687679291",Saint-Cloud,92064,0.4583333333333333,17
48009,République - Auguste Perret,OUI,30,28,2,2,0,OUI,OUI,2025-03-13 16:59:16+00:00,"48.78695280952244, 2.3518594354391094",Villejuif,94076,0.06666666666666667,17
14128,Gergovie - Vercingétorix,OUI,29,22,7,1,6,OUI,OUI,2025-03-13 17:02:26+00:00,"48.83453413883994, 2.313154547426182",Paris,75056,0.2413793103448276,17
4107,Beaumarchais - Pas de la Mule,OUI,16,3,13,4,9,OUI,OUI,2025-03-13 17:02:01+00:00,"48.855580507049, 2.3684333673431",Paris,75056,0.8125,17
19036,Hôpital Robert Debré,OUI,33,31,2,0,2,OUI,OUI,2025-03-13 16:59:41+00:00,"48.88005222200894, 2.4008650346327003",Paris,75056,0.06060606060606061,17
20047,Cours de Vincennes - Davout,OUI,48,47,1,0,1,OUI,OUI,2025-03-13 17:01:41+00:00,"48.847238029966, 2.4107042336225",Paris,75056,0.020833333333333332,17
31026,Demi-Lune - Aristide Briand,OUI,20,18,2,0,2,OUI,OUI,2025-03-13 17:01:51+00:00,"48.87626381919953, 2.4562818557024",Montreuil,93048,0.1,17
9013,Mairie du 9ème,OUI,24,12,12,6,6,OUI,OUI,2025-03-13 17:02:24+00:00,"48.873267137583, 2.3407534480528",Paris,75056,0.5,17
17001,Guy Môquet - Saint-Ouen,OUI,44,40,4,1,3,OUI,OUI,2025-03-13 17:02:03+00:00,"48.892777719023975, 2.3270335793495183",Paris,75056,0.09090909090909091,17
21951,Place Centrale,OUI,22,19,3,1,2,OUI,OUI,2025-03-13 16:55:13+00:00,"48.78740167690531, 2.2278830409049992",Meudon,92048,0.13636363636363635,17
12129,Bois de Vincennes - Porte Jaune,OUI,35,31,4,4,0,OUI,OUI,2025-03-13 17:00:23+00:00,"48.838751246689455, 2.4605489149689674",Paris,75056,0.11428571428571428,17
92005,Gare de Nanterre Ville,OUI,42,20,22,19,3,OUI,OUI,2025-03-13 17:01:33+00:00,"48.8950295, 2.1957932",Nanterre,92050,0.5238095238095238,17
13020,Paul Klee - Place Augusta Holmes,OUI,43,28,15,5,10,OUI,OUI,2025-03-13 17:01:58+00:00,"48.838946417408025, 2.3704235663952966",Paris,75056,0.3488372093023256,17
19113,Pré Saint-Gervais - Lilas,OUI,27,25,2,0,2,OUI,OUI,2025-03-13 17:02:03+00:00,"48.877870626988, 2.3959073424339",Paris,75056,0.07407407407407407,17
7010,Constantine - Université,OUI,59,29,30,27,3,OUI,OUI,2025-03-13 17:01:36+00:00,"48.860680473738, 2.3148481955842",Paris,75056,0.5084745762711864,17
10039,Sambre et Meuse - Villette,OUI,23,15,8,0,8,OUI,OUI,2025-03-13 16:58:12+00:00,"48.874405666217, 2.3738072379951",Paris,75056,0.34782608695652173,17
35015,Averroès - Aimé Césaire,OUI,18,13,5,1,4,OUI,OUI,2025-03-13 16:56:42+00:00,"48.91405323432864, 2.412636950612068",Pantin,93055,0.2777777777777778,17
31101,Jules Guesde - Laennec,OUI,19,15,4,0,4,OUI,OUI,2025-03-13 16:58:04+00:00,"48.87628983900398, 2.5006942078471184",Rosny-sous-Bois,93064,0.21052631578947367,17
15019,Paul Barruel - Vaugirard,OUI,36,33,3,1,2,OUI,OUI,2025-03-13 17:01:25+00:00,"48.84014918546239, 2.3044332861900334",Paris,75056,0.08333333333333333,17
35004,Place du Président Salvador Allende,OUI,59,58,1,0,1,OUI,OUI,2025-03-13 16:55:53+00:00,"48.897307310356055, 2.40079153681279",Pantin,93055,0.01694915254237288,17
20203,Evariste Galois,OUI,20,19,1,0,1,OUI,OUI,2025-03-13 16:55:17+00:00,"48.873341356228, 2.4133544409574",Paris,75056,0.05,17
31707,Edouard Vaillant - Galliéni,OUI,48,47,1,0,1,OUI,OUI,2025-03-13 17:02:28+00:00,"48.858462881661, 2.4147954583168",Bagnolet,93006,0.020833333333333332,17
7024,Rapp - Place du Général Gouraud,OUI,30,23,7,5,2,OUI,OUI,2025-03-13 17:01:27+00:00,"48.858102885107, 2.3004072904587",Paris,75056,0.23333333333333334,17
8011,Clapeyron - Moscou,OUI,15,15,0,0,0,OUI,OUI,2025-03-13 16:59:35+00:00,"48.88078819514121, 2.324815057218075",Paris,75056,0.0,17
20004,Commandant l'Herminier - Gallieni,OUI,17,15,2,1,1,OUI,OUI,2025-03-13 17:01:17+00:00,"48.847040552603, 2.4160453677177",Paris,75056,0.11764705882352941,17
19124,Alexander Fleming - Belvédère,OUI,31,27,4,0,4,OUI,OUI,2025-03-13 16:56:57+00:00,"48.88179064200294, 2.4030599377642674",Paris,75056,0.12903225806451613,17
13515,Auguste Blanqui - Glacière,OUI,60,57,3,0,3,OUI,OUI,2025-03-13 17:00:49+00:00,"48.831151602964, 2.343822196126",Paris,75056,0.05,17
14113,Santé - Arago,OUI,37,37,0,0,0,OUI,OUI,2025-03-13 16:58:48+00:00,"48.83507657562064, 2.3415737262044938",Paris,75056,0.0,17
10152,Gare du Nord - Place de Valenciennes,OUI,23,2,21,9,12,OUI,OUI,2025-03-13 17:01:52+00:00,"48.879089, 2.354235",Paris,75056,0.9130434782608695,17
32021,Place du Front Populaire - George Sand,OUI,64,45,19,13,6,OUI,OUI,2025-03-13 17:01:56+00:00,"48.90680713698062, 2.364541214992642",Saint-Denis,93066,0.296875,17
9036,Athènes - Clichy,OUI,18,13,5,1,4,OUI,OUI,2025-03-13 17:01:43+00:00,"48.878113787876, 2.32956021945824",Paris,75056,0.2777777777777778,17
12150,Bastille - Quai de la Rapée,OUI,26,2,24,22,2,OUI,OUI,2025-03-13 17:01:42+00:00,"48.84682410855, 2.3669364675879",Paris,75056,0.9230769230769231,17
13117,Stade Georges Carpentier,OUI,40,40,0,0,0,OUI,OUI,2025-03-13 16:58:39+00:00,"48.820482438381, 2.3668321967125",Paris,75056,0.0,17
11031,Jacquard - Ternaux,OUI,39,13,26,17,9,OUI,OUI,2025-03-13 17:01:41+00:00,"48.8646605, 2.373162",Paris,75056,0.6666666666666666,17
17029,Pierre Demours - Laugier,OUI,36,31,5,1,4,OUI,OUI,2025-03-13 17:01:24+00:00,"48.8813072, 2.294846",Paris,75056,0.1388888888888889,17
12125,Pyramide - Parc Floral,OUI,50,44,6,3,3,OUI,OUI,2025-03-13 17:00:31+00:00,"48.837442, 2.440452",Paris,75056,0.12,17
10004,Metz - Faubourg Saint-Denis,OUI,44,11,33,32,1,OUI,OUI,2025-03-13 17:01:37+00:00,"48.870893, 2.353521",Paris,75056,0.75,17
9016,Choron - Martyrs,OUI,17,12,5,2,3,OUI,OUI,2025-03-13 17:00:50+00:00,"48.877851443503, 2.3396701365709",Paris,75056,0.29411764705882354,17
11103,Pelée - Alphonse Baudin,OUI,35,22,13,7,6,OUI,OUI,2025-03-13 17:01:09+00:00,"48.8600265, 2.3710541",Paris,75056,0.37142857142857144,17
15131,Charles Lecocq - Lecourbe,OUI,28,9,19,8,11,OUI,OUI,2025-03-13 17:00:24+00:00,"48.84044, 2.294867",Paris,75056,0.6785714285714286,17
19025,Botzaris - Crimée,OUI,20,19,1,0,1,OUI,OUI,2025-03-13 17:02:24+00:00,"48.87959698690176, 2.3887913337477067",Paris,75056,0.05,17
10037,Quai de Valmy,OUI,24,21,3,1,2,OUI,OUI,2025-03-13 17:02:07+00:00,"48.88126951579429, 2.368186041712761",Paris,75056,0.125,17
16009,Saint-Didier - Raymond Poincaré,OUI,17,17,0,0,0,OUI,OUI,2025-03-13 16:54:34+00:00,"48.86642312020962, 2.285863497192411",Paris,75056,0.0,17
15125,Parc Suzanne Lenglen,OUI,50,4,46,44,2,OUI,OUI,2025-03-13 17:02:29+00:00,"48.833250690537874, 2.2765403240919113",Paris,75056,0.92,17
21029,Cours de l'Ile Seguin - Parc Billancourt,OUI,27,3,24,19,5,OUI,OUI,2025-03-13 17:01:14+00:00,"48.82714055843935, 2.234234511852265",Boulogne-Billancourt,92012,0.8888888888888888,17
13027,Mazagran - Pierre de Coubertin,OUI,15,12,3,3,0,OUI,OUI,2025-03-13 16:59:15+00:00,"48.816218640260445, 2.344226874411106",Paris,75056,0.2,17
16003,André Maurois - Joseph et Marie Hackin,OUI,27,14,13,11,2,OUI,OUI,2025-03-13 17:02:18+00:00,"48.8778983, 2.2789591",Paris,75056,0.48148148148148145,17
21118,Neuilly - Petit,OUI,14,5,9,7,2,OUI,OUI,2025-03-13 17:00:11+00:00,"48.898965361341254, 2.29627937078476",Clichy,92024,0.6428571428571429,17
15072,Place Fernand Forest,OUI,26,3,23,17,6,OUI,OUI,2025-03-13 17:02:11+00:00,"48.849269143836, 2.281863167882",Paris,75056,0.8846153846153846,17
20039,Belleville - Couronnes,OUI,48,47,1,0,1,OUI,OUI,2025-03-13 16:57:15+00:00,"48.868831082877, 2.3809862136841",Paris,75056,0.020833333333333332,17
12006,Gare de Lyon - Van Gogh,OUI,41,18,23,18,5,OUI,OUI,2025-03-13 16:59:35+00:00,"48.843839785643, 2.3704450240357",Paris,75056,0.5609756097560976,17
21203,Place Jules Ferry,OUI,28,27,1,0,1,OUI,OUI,2025-03-13 16:59:24+00:00,"48.812107928414775, 2.325837314128876",Montrouge,92049,0.03571428571428571,17
10110,Louis Blanc - Jemmapes,OUI,31,23,8,1,7,OUI,OUI,2025-03-13 17:02:08+00:00,"48.879330755297, 2.3684485629201",Paris,75056,0.25806451612903225,17
5034,Censier - Santeuil,OUI,65,28,37,33,4,OUI,OUI,2025-03-13 16:59:51+00:00,"48.840658921385234, 2.3537524044513702",Paris,75056,0.5692307692307692,17
21115,Chancé Milly - Cimetière Communal Sud,OUI,32,13,19,18,1,OUI,OUI,2025-03-13 17:01:35+00:00,"48.89687189382465, 2.303922325372696",Clichy,92024,0.59375,17
10017,Gare de l'Est - Fidélité,OUI,11,2,9,7,2,OUI,OUI,2025-03-13 17:00:42+00:00,"48.874575, 2.356796",Paris,75056,0.8181818181818182,17
21708,Marcel Yol - Jullien,OUI,28,27,1,0,1,OUI,OUI,2025-03-13 16:59:47+00:00,"48.82537611802588, 2.287235018058929",Vanves,92075,0.03571428571428571,17
22013,Mairie de Neuilly sur Seine,OUI,31,21,10,5,5,OUI,OUI,2025-03-13 17:01:40+00:00,"48.88494728765838, 2.2677031159400944",Neuilly-sur-Seine,92051,0.3225806451612903,17
13048,Wurtz - Tolbiac,OUI,28,28,0,0,0,NON,NON,2025-03-13 12:52:17+00:00,"48.82631195621, 2.344585955143",Paris,75056,0.0,13
21316,Cimetière d'Issy-les-Moulineaux,OUI,24,21,3,0,3,OUI,OUI,2025-03-13 17:01:44+00:00,"48.817699773925, 2.2609312087297",Issy-les-Moulineaux,92040,0.125,17
41210,Hôtel de ville de Fontenay-sous-Bois,OUI,19,16,3,0,3,OUI,OUI,2025-03-13 16:56:06+00:00,"48.84949749106274, 2.4750164151191716",Fontenay-sous-Bois,94033,0.15789473684210525,17
10153,Gare du Nord - Denain,OUI,19,14,5,2,3,OUI,OUI,2025-03-13 17:01:57+00:00,"48.879595787608, 2.3544725775719",Paris,75056,0.2631578947368421,17
42304,Marc Sangnier - Division Leclerc,OUI,21,7,14,13,1,OUI,OUI,2025-03-13 17:02:07+00:00,"48.78599652305309, 2.329955510795116",Cachan,94016,0.6666666666666666,17
16014,Eylau - Trocadéro,OUI,22,22,0,0,0,OUI,OUI,2025-03-13 17:01:03+00:00,"48.863354122371, 2.2864209115505",Paris,75056,0.0,17
15052,Convention - Vaugirard,OUI,46,21,25,16,9,OUI,OUI,2025-03-13 17:02:13+00:00,"48.83767682233156, 2.295586926020252",Paris,75056,0.5434782608695652,17
16007,Longchamp - Place d'Iéna,OUI,23,20,3,2,1,OUI,OUI,2025-03-13 17:01:29+00:00,"48.864917233434, 2.2926748171449",Paris,75056,0.13043478260869565,17
31021,Résistance - Hoche,OUI,28,23,5,0,5,OUI,OUI,2025-03-13 17:02:13+00:00,"48.864273423741956, 2.435784414410591",Montreuil,93048,0.17857142857142858,17
21702,Gare SNCF Vanves-Malakoff,OUI,49,46,3,1,2,OUI,OUI,2025-03-13 16:55:19+00:00,"48.819002163836444, 2.292150005103606",Vanves,92075,0.061224489795918366,17
44002,Paul Vaillant-Couturier - Gare RER,OUI,25,4,21,17,4,OUI,OUI,2025-03-13 17:01:57+00:00,"48.80108159069614, 2.402097210288048",Vitry-sur-Seine,94081,0.84,17
11109,Pierre Levée - Fontaine Timbaud,OUI,21,9,12,5,7,OUI,OUI,2025-03-13 17:01:43+00:00,"48.86632723374305, 2.3711163550615306",Paris,75056,0.5714285714285714,17
13039,Ivry - Simone Weil,OUI,18,17,1,1,0,OUI,OUI,2025-03-13 17:01:46+00:00,"48.823283932030755, 2.3659095168113713",Paris,75056,0.05555555555555555,17
16115,Raffet - Montmorency,OUI,40,39,1,0,1,OUI,OUI,2025-03-13 16:56:59+00:00,"48.85258670812, 2.2629252456151954",Paris,75056,0.025,17
21031,Cimetière de Boulogne-Billancourt,OUI,38,10,28,25,3,OUI,OUI,2025-03-13 17:01:06+00:00,"48.830764, 2.252024",Boulogne-Billancourt,92012,0.7368421052631579,17
15123,Commerce - Letellier,OUI,42,26,16,10,6,OUI,OUI,2025-03-13 17:01:30+00:00,"48.84797660373612, 2.2966245196598805",Paris,75056,0.38095238095238093,17
22604,Hôtel de Ville de Fontenay-aux-Roses,OUI,32,26,6,1,5,OUI,OUI,2025-03-13 17:02:16+00:00,"48.790844603480856, 2.2871455930319455",Fontenay-aux-Roses,92032,0.1875,17
21030,Fessart - Château,OUI,20,10,10,7,3,OUI,OUI,2025-03-13 17:02:11+00:00,"48.84245, 2.23989",Boulogne-Billancourt,92012,0.5,17
11032,Jean-Pierre Timbaud - Vaucouleurs,OUI,44,22,22,7,15,OUI,OUI,2025-03-13 17:02:11+00:00,"48.867937, 2.377885",Paris,75056,0.5,17
16024,Ranelagh - Maison de la Radio,OUI,20,3,17,14,3,OUI,OUI,2025-03-13 16:57:47+00:00,"48.85293603169479, 2.280449643731117",Paris,75056,0.85,17
21955,Vaugirard - Verrerie,OUI,24,3,21,17,4,OUI,OUI,2025-03-13 16:59:47+00:00,"48.820881336842, 2.2367222622987",Meudon,92048,0.875,17
15043,Brancion - Lefebvre,OUI,9,5,4,1,3,OUI,OUI,2025-03-13 16:59:26+00:00,"48.82900222785569, 2.301431038163409",Paris,75056,0.4444444444444444,17
13121,Bruneseau - Quai d'Ivry,OUI,46,4,42,41,1,OUI,OUI,2025-03-13 17:02:11+00:00,"48.824945637583, 2.3885661363602",Ivry-sur-Seine,94041,0.9130434782608695,17
17039,Place Saint-Ferdinand,OUI,38,19,19,3,16,OUI,OUI,2025-03-13 17:01:20+00:00,"48.87815529789739, 2.288518047864942",Paris,75056,0.5,17
21307,Victor Cresson - Telles de la Poterie,OUI,29,18,11,10,1,OUI,OUI,2025-03-13 17:02:20+00:00,"48.822698842979, 2.2686498274964",Issy-les-Moulineaux,92040,0.3793103448275862,17
20009,Docteurs Déjérine - Pte de Montreuil,OUI,20,19,1,1,0,OUI,OUI,2025-03-13 16:58:57+00:00,"48.85398448133697, 2.41208288897222",Paris,75056,0.05,17
21028,Pierre Lefaucheux - Traversière,OUI,33,21,12,11,1,OUI,OUI,2025-03-13 17:02:18+00:00,"48.82435208303827, 2.2417913004755974",Boulogne-Billancourt,92012,0.36363636363636365,17
42305,Vanne - Saussaies,OUI,19,17,2,0,2,OUI,OUI,2025-03-13 16:54:45+00:00,"48.786404, 2.338848",Cachan,94016,0.10526315789473684,17
4003,Quai aux Fleurs - Pont Saint-Louis,OUI,21,5,16,14,2,OUI,OUI,2025-03-13 17:01:18+00:00,"48.852915956209, 2.3521957173944",Paris,75056,0.7619047619047619,17
16101,Malakoff - Place de la Porte Maillot,OUI,26,18,8,2,6,OUI,OUI,2025-03-13 17:02:09+00:00,"48.876733496638, 2.2834577411413",Paris,75056,0.3076923076923077,17
21219,Amaury Duval - Gabriel Péri,OUI,36,36,0,0,0,OUI,OUI,2025-03-13 16:57:10+00:00,"48.81718759671675, 2.323841750621796",Montrouge,92049,0.0,17
8001,Petit Palais,OUI,44,10,34,25,9,OUI,OUI,2025-03-13 17:00:15+00:00,"48.8667692, 2.3157655",Paris,75056,0.7727272727272727,17
31025,Paul Signac - Aristide Briand,OUI,33,32,1,0,1,OUI,OUI,2025-03-13 16:55:58+00:00,"48.86950262156371, 2.4502260982990265",Montreuil,93048,0.030303030303030304,17
10012,Vinaigriers - Magenta,OUI,24,12,12,6,6,OUI,OUI,2025-03-13 17:00:15+00:00,"48.8731167, 2.3593052",Paris,75056,0.5,17
20122,Vitruve - Davout,OUI,23,22,1,1,0,OUI,OUI,2025-03-13 17:00:37+00:00,"48.86053161154489, 2.4091592812626543",Paris,75056,0.043478260869565216,17
10018,Square Alban Satragne,OUI,29,18,11,3,8,OUI,OUI,2025-03-13 16:56:39+00:00,"48.875388227727, 2.3559567333359",Paris,75056,0.3793103448275862,17
16020,Place de la Porte de Passy,OUI,34,31,3,3,0,OUI,OUI,2025-03-13 16:55:34+00:00,"48.857341095470794, 2.2644165538827115",Paris,75056,0.08823529411764706,17
32301,Mairie de Romainville,OUI,17,16,1,1,0,OUI,OUI,2025-03-13 17:00:49+00:00,"48.885109, 2.435679",Romainville,93063,0.058823529411764705,17
15023,La Motte-Picquet - Grenelle,OUI,34,4,30,23,7,OUI,OUI,2025-03-13 17:01:07+00:00,"48.84858321339195, 2.299347817897797",Paris,75056,0.8823529411764706,17
20108,Jardin de l'Hospice Debrousse,OUI,23,22,1,0,1,OUI,OUI,2025-03-13 16:54:55+00:00,"48.861451061938, 2.40568600595",Paris,75056,0.043478260869565216,17
22501,Théâtre de La Garenne,OUI,20,11,9,0,9,OUI,OUI,2025-03-13 17:01:32+00:00,"48.905658361454, 2.2345951981176",La Garenne-Colombes,92035,0.45,17
13011,Hôpital - Campo-Formio,OUI,11,8,3,1,2,OUI,OUI,2025-03-13 17:00:56+00:00,"48.835405, 2.358218",Paris,75056,0.2727272727272727,17
4010,Saint-Antoine Sévigné,OUI,22,2,20,16,4,OUI,OUI,2025-03-13 17:01:55+00:00,"48.8550222, 2.3612322",Paris,75056,0.9090909090909091,17
5014,Jean Calvin - Tournefort,OUI,28,26,2,1,1,OUI,OUI,2025-03-13 16:58:07+00:00,"48.84158856925782, 2.348489575088024",Paris,75056,0.07142857142857142,17
40009,Lycée Saint Exupéry - Juliette Savar,OUI,29,18,11,8,3,OUI,OUI,2025-03-13 16:53:37+00:00,"48.783021513972, 2.4637357216879",Créteil,94028,0.3793103448275862,17
8549,George V - Christophe Colomb,OUI,23,20,3,0,3,OUI,OUI,2025-03-13 17:02:00+00:00,"48.87046, 2.30104",Paris,75056,0.13043478260869565,17
12043,Daumesnil - Hébrard,OUI,39,9,30,26,4,OUI,OUI,2025-03-13 17:02:14+00:00,"48.8429, 2.38474",Paris,75056,0.7692307692307693,17
23902,Gallieni - Lycée Charles Petitet,OUI,43,21,22,17,5,OUI,OUI,2025-03-13 17:01:01+00:00,"48.927640283627, 2.3308986340524",Villeneuve-la-Garenne,92078,0.5116279069767442,17
20007,Buzenval - Avron,OUI,49,43,6,4,2,OUI,OUI,2025-03-13 17:02:22+00:00,"48.851617204999, 2.4015135973077",Paris,75056,0.12244897959183673,17
23003,Président Wilson - Baudin,OUI,27,11,16,12,4,OUI,OUI,2025-03-13 17:01:57+00:00,"48.89826887103676, 2.2849336266517644",Levallois-Perret,92044,0.5925925925925926,17
13033,Porte d'Italie,OUI,13,11,2,1,1,OUI,OUI,2025-03-13 16:54:52+00:00,"48.817161987718954, 2.360236309468746",Paris,75056,0.15384615384615385,17
14131,Jourdan - Monticelli,OUI,30,30,0,0,0,OUI,OUI,2025-03-13 16:59:38+00:00,"48.822032, 2.329095",Paris,75056,0.0,17
42701,Charles Gide - Fort de Bicêtre,OUI,29,26,3,0,3,OUI,OUI,2025-03-13 16:59:06+00:00,"48.8071937956922, 2.353984415531159",Le Kremlin-Bicêtre,94043,0.10344827586206896,17
10105,Mazagran - Bonne Nouvelle,OUI,25,17,8,7,1,OUI,OUI,2025-03-13 17:01:20+00:00,"48.870047123655, 2.3511248454452",Paris,75056,0.32,17
13126,Place Nationale - Château-des-Rentiers,OUI,18,12,6,1,5,OUI,OUI,2025-03-13 17:01:07+00:00,"48.829268, 2.365212",Paris,75056,0.3333333333333333,17
21204,Estienne d'Orves - Henri Ginoux,OUI,30,29,1,0,1,OUI,OUI,2025-03-13 17:02:18+00:00,"48.815388220397274, 2.320886790760933",Montrouge,92049,0.03333333333333333,17
14101,Gare Montparnasse - Edgar Quinet,OUI,33,28,5,1,4,OUI,OUI,2025-03-13 17:00:55+00:00,"48.841487851079, 2.3233232282801",Paris,75056,0.15151515151515152,17
42209,Place de l'Europe - Quai de Bercy,OUI,15,3,12,10,2,OUI,OUI,2025-03-13 17:02:08+00:00,"48.82529858840266, 2.3945679143071175",Charenton-le-Pont,94018,0.8,17
8020,Batignolles - Beudant,OUI,43,40,3,1,2,OUI,OUI,2025-03-13 16:58:58+00:00,"48.88216401466375, 2.319852970540523",Paris,75056,0.06976744186046512,17
11021,Charonne - Pierre Bayle,OUI,23,21,2,1,1,OUI,OUI,2025-03-13 17:01:10+00:00,"48.858445054262, 2.3903981223891",Paris,75056,0.08695652173913043,17
17015,Place de Lévis,OUI,47,44,3,1,2,OUI,OUI,2025-03-13 17:02:27+00:00,"48.883546851533254, 2.3131933808326726",Paris,75056,0.06382978723404255,17
21217,Louis Rolland - République,OUI,26,23,3,1,2,OUI,OUI,2025-03-13 17:00:57+00:00,"48.81710889740748, 2.3193106434955717",Montrouge,92049,0.11538461538461539,17
42003,Place de l'Insurrection d'Août 1944,OUI,28,1,27,22,5,OUI,OUI,2025-03-13 17:02:09+00:00,"48.81477852751594, 2.398074567317963",Ivry-sur-Seine,94041,0.9642857142857143,17
12007,Gare de Lyon - Chalon,OUI,45,4,41,23,18,OUI,OUI,2025-03-13 17:02:12+00:00,"48.845666194202, 2.3741452395916",Paris,75056,0.9111111111111111,17
4001,Arcole - Notre-Dame,OUI,28,15,13,5,8,OUI,OUI,2025-03-13 17:00:07+00:00,"48.853883541328, 2.3493797332048",Paris,75056,0.4642857142857143,17
25001,Colmar - Victor Hugo,OUI,31,15,16,12,4,OUI,OUI,2025-03-13 16:59:09+00:00,"48.88652251096166, 2.173960916697979",Rueil-Malmaison,92063,0.5161290322580645,17
17023,Porte d'Asnières,OUI,33,24,9,6,3,OUI,OUI,2025-03-13 17:01:26+00:00,"48.89035817610495, 2.3036286234855656",Paris,75056,0.2727272727272727,17
47001,Place de la Gare,OUI,45,5,40,39,1,OUI,OUI,2025-03-13 17:02:24+00:00,"48.80253358011283, 2.4275037646293645",Maisons-Alfort,94046,0.8888888888888888,17
19108,Gaston Tessier - Rosa Parks RER,OUI,37,34,3,0,3,OUI,OUI,2025-03-13 17:02:28+00:00,"48.8963765, 2.3743692",Paris,75056,0.08108108108108109,17
44101,Place Mongolfier,OUI,37,23,14,10,4,OUI,OUI,2025-03-13 17:00:59+00:00,"48.815160030060376, 2.4592879414558415",Saint-Maurice,94069,0.3783783783783784,17
44007,Camille Groult - Guy Môquet,OUI,22,3,19,15,4,OUI,OUI,2025-03-13 16:59:54+00:00,"48.787482746521306, 2.3976725712418556",Vitry-sur-Seine,94081,0.8636363636363636,17
14010,Jean Moulin - Place Victor et Hélène Basch,OUI,37,31,6,2,4,OUI,OUI,2025-03-13 17:02:12+00:00,"48.82764910241, 2.3261967301369",Paris,75056,0.16216216216216217,17
4002,Marché aux fleurs,OUI,20,12,8,6,2,OUI,OUI,2025-03-13 17:02:26+00:00,"48.855258115391, 2.3473754525185",Paris,75056,0.4,17
13128,Quai de la Gare - Pont de Bercy,OUI,29,1,28,24,4,OUI,OUI,2025-03-13 17:02:22+00:00,"48.83730787972, 2.3740861260598",Paris,75056,0.9655172413793104,17
17003,Jacques Kellner - Saint-Ouen,OUI,43,35,8,3,5,OUI,OUI,2025-03-13 17:01:57+00:00,"48.895809485802886, 2.327897409164145",Paris,75056,0.18604651162790697,17
43010,La Jarry - Place Diderot,OUI,25,23,2,0,2,OUI,OUI,2025-03-13 17:00:03+00:00,"48.849726940367326, 2.452013790607453",Vincennes,94080,0.08,17
42501,Raspail - Albert Schweitzer,OUI,27,9,18,18,0,OUI,OUI,2025-03-13 17:01:46+00:00,"48.81031545, 2.34395871",Gentilly,94037,0.6666666666666666,17
17107,Berthier - Place Stuart Merril,OUI,34,19,15,7,8,OUI,OUI,2025-03-13 17:00:13+00:00,"48.885927922355044, 2.2933450341224675",Paris,75056,0.4411764705882353,17
6008,Assas - Luxembourg,OUI,33,31,2,2,0,OUI,OUI,2025-03-13 17:02:06+00:00,"48.843734468779, 2.3334283818759",Paris,75056,0.06060606060606061,17
15057,Lucien Bossoutrot - Général Martial Vallin,OUI,37,26,11,10,1,OUI,OUI,2025-03-13 17:01:32+00:00,"48.836956046311, 2.2741072252393",Paris,75056,0.2972972972972973,17
13109,Brillat-Savarin - Küss,OUI,21,15,6,6,0,OUI,OUI,2025-03-13 17:00:12+00:00,"48.822203, 2.350422",Paris,75056,0.2857142857142857,17
16002,Pergolèse - Malakoff,OUI,36,31,5,1,4,OUI,OUI,2025-03-13 16:57:29+00:00,"48.87521088779225, 2.2842781618237495",Paris,75056,0.1388888888888889,17
43001,Paris - Laitières,OUI,22,14,8,2,6,OUI,OUI,2025-03-13 17:01:42+00:00,"48.84630274151258, 2.4207553267478947",Vincennes,94080,0.36363636363636365,17
15004,Vaugirard - Pasteur,OUI,21,15,6,3,3,OUI,OUI,2025-03-13 17:01:50+00:00,"48.84040868803496, 2.3154367133975033",Paris,75056,0.2857142857142857,17
22206,Louis Pasteur - Albert Petit,OUI,30,27,3,1,2,OUI,OUI,2025-03-13 17:02:14+00:00,"48.796261, 2.317289",Bagneux,92007,0.1,17
15005,Place Jacques et Thérèse Tréfouël,OUI,42,38,4,2,2,OUI,OUI,2025-03-13 17:02:27+00:00,"48.842726498317, 2.3125657439232",Paris,75056,0.09523809523809523,17
15030,Emeriau - Beaugrenelle,OUI,70,18,52,49,3,OUI,OUI,2025-03-13 17:02:05+00:00,"48.84791249714942, 2.2843059897422795",Paris,75056,0.7428571428571429,17
21401,Mairie de Clamart,OUI,31,28,3,0,3,OUI,OUI,2025-03-13 16:53:05+00:00,"48.800612, 2.262151",Clamart,92023,0.0967741935483871,17
9114,Faubourg Poissonnière - Dunkerque,OUI,29,25,4,1,3,OUI,OUI,2025-03-13 17:02:26+00:00,"48.880883445404436, 2.349934279918671",Paris,75056,0.13793103448275862,17
13044,Place Jeanne d'Arc,OUI,35,28,7,2,5,OUI,OUI,2025-03-13 17:01:20+00:00,"48.829575, 2.369126",Paris,75056,0.2,17
16011,Victor Hugo - La Pompe,OUI,39,38,1,1,0,OUI,OUI,2025-03-13 16:59:05+00:00,"48.86795222470859, 2.28146318346262",Paris,75056,0.02564102564102564,17
9027,Douai - Pierre Fontaine,OUI,23,20,3,1,2,OUI,OUI,2025-03-13 16:56:16+00:00,"48.88229101148092, 2.33324121683836",Paris,75056,0.13043478260869565,17
35007,Benjamin Delessert - Jean Lolive,OUI,21,17,4,2,2,OUI,OUI,2025-03-13 16:58:04+00:00,"48.89392043619345, 2.417981922626496",Pantin,93055,0.19047619047619047,17
17108,Bessières - Porte de Clichy,OUI,30,17,13,8,5,OUI,OUI,2025-03-13 17:01:19+00:00,"48.89611762451474, 2.31790903955698",Paris,75056,0.43333333333333335,17
13032,Italie - Jardin Joan Miro,OUI,24,19,5,3,2,OUI,OUI,2025-03-13 17:01:17+00:00,"48.81990914045756, 2.3592948541045193",Paris,75056,0.20833333333333334,17
23004,Paul Vaillant-Couturier - Victor Hugo,OUI,34,1,33,31,2,OUI,OUI,2025-03-13 17:02:25+00:00,"48.89819702263572, 2.293848017974069",Levallois-Perret,92044,0.9705882352941176,17
10165,Gare de l'Est - Place du 11 Novembre 1918,OUI,39,22,17,8,9,OUI,OUI,2025-03-13 17:01:42+00:00,"48.876327, 2.3585464",Paris,75056,0.4358974358974359,17
22408,Place du 14 Juillet,OUI,22,22,0,0,0,OUI,OUI,2025-03-13 16:55:05+00:00,"48.819266959525, 2.3011998832226",Malakoff,92046,0.0,17
15064,Javel - André Citroën,OUI,41,5,36,32,4,OUI,OUI,2025-03-13 17:02:29+00:00,"48.846276485475, 2.2786368057132",Paris,75056,0.8780487804878049,17
5012,Estrapade - Ulm,OUI,15,11,4,2,2,OUI,OUI,2025-03-13 16:54:29+00:00,"48.84512772828, 2.3454568170362",Paris,75056,0.26666666666666666,17
22303,Lucien Lanternier - Le Luth,OUI,25,8,17,12,5,OUI,OUI,2025-03-13 17:01:00+00:00,"48.93159430558871, 2.2889783978462224",Gennevilliers,92036,0.68,17
8037,Monceau - Malesherbes,OUI,36,35,1,0,1,OUI,OUI,2025-03-13 17:02:16+00:00,"48.8795079, 2.3145456",Paris,75056,0.027777777777777776,17
92001,Mairie de quartier du Plateau - Mont-Valérien,OUI,20,11,9,4,5,OUI,OUI,2025-03-13 16:56:44+00:00,"48.8799933, 2.2072437",Nanterre,92050,0.45,17
1021,Halles - Bourdonnais,OUI,18,8,10,8,2,OUI,OUI,2025-03-13 16:59:47+00:00,"48.860448992575, 2.3460162431002",Paris,75056,0.5555555555555556,17
23010,Voltaire - Anatole France,OUI,26,13,13,7,6,OUI,OUI,2025-03-13 17:00:11+00:00,"48.891999360256904, 2.284262739121914",Levallois-Perret,92044,0.5,17
7017,La Motte-Picquet - La Tour Maubourg,OUI,40,32,8,5,3,OUI,OUI,2025-03-13 16:59:33+00:00,"48.856926701847, 2.3096215831203",Paris,75056,0.2,17
6027,Blaise-Desgoffe - Vaugirard,OUI,32,29,3,2,1,OUI,OUI,2025-03-13 16:59:26+00:00,"48.846128877747, 2.3242672160268",Paris,75056,0.09375,17
35006,Delizy - Louis Nadot,OUI,20,17,3,0,3,OUI,OUI,2025-03-13 16:57:32+00:00,"48.896212845581346, 2.4094578623771667",Pantin,93055,0.15,17
18007,Goutte d'or - Barbès,OUI,19,13,6,4,2,OUI,OUI,2025-03-13 17:01:40+00:00,"48.885124323627, 2.3496962338686",Paris,75056,0.3157894736842105,17
22015,Île de la Jatte,OUI,22,10,12,5,7,OUI,OUI,2025-03-13 16:59:51+00:00,"48.894036161302104, 2.2666339203715324",Neuilly-sur-Seine,92051,0.5454545454545454,17
19128,Quai de l'Oise - Aisne,OUI,28,23,5,3,2,OUI,OUI,2025-03-13 17:02:24+00:00,"48.8906231, 2.3833701",Paris,75056,0.17857142857142858,17
12018,Saint-Mandé - Fabre d'Eglantine,OUI,33,29,4,0,4,OUI,OUI,2025-03-13 17:02:25+00:00,"48.8453579, 2.3965022",Paris,75056,0.12121212121212122,17
18006,Square Louise Michel,OUI,35,33,2,0,2,OUI,OUI,2025-03-13 16:54:37+00:00,"48.884687354509, 2.3441386967897",Paris,75056,0.05714285714285714,17
44005,Place Saint-Just,OUI,22,17,5,2,3,OUI,OUI,2025-03-13 17:02:04+00:00,"48.790379518724265, 2.3895226791501045",Vitry-sur-Seine,94081,0.22727272727272727,17
17119,Toqueville - Cardinet,OUI,31,20,11,4,7,OUI,OUI,2025-03-13 17:00:38+00:00,"48.88490187110713, 2.3109393194317818",Paris,75056,0.3548387096774194,17
4020,Place Edmond Michelet,OUI,23,3,20,18,2,OUI,OUI,2025-03-13 17:01:28+00:00,"48.860134890542, 2.3500636965036",Paris,75056,0.8695652173913043,17
15011,Cambronne - Villa Croix Nivert,OUI,60,43,17,17,0,OUI,OUI,2025-03-13 17:01:14+00:00,"48.845847561366, 2.3017574474216",Paris,75056,0.2833333333333333,17
15022,Emile Zola - Fondary,OUI,40,9,31,30,1,OUI,OUI,2025-03-13 17:02:21+00:00,"48.847051143113745, 2.2953405976295476",Paris,75056,0.775,17
9004,Gérando - Rochechouart,OUI,21,19,2,0,2,OUI,OUI,2025-03-13 17:00:38+00:00,"48.88294340845, 2.3464846238494",Paris,75056,0.09523809523809523,17
11017,Charonne - Bureau,OUI,44,43,1,0,1,OUI,OUI,2025-03-13 17:00:27+00:00,"48.854176, 2.396093",Paris,75056,0.022727272727272728,17
51002,Placette Grégoire Collas,OUI,25,13,12,4,8,OUI,OUI,2025-03-13 16:57:02+00:00,"48.94342014002797, 2.2487476095557213",Argenteuil,95018,0.48,17
21306,Place Lafayette,OUI,61,20,41,39,2,OUI,OUI,2025-03-13 17:01:06+00:00,"48.829654975522, 2.2638675570488",Issy-les-Moulineaux,92040,0.6721311475409836,17
32601,Porte des Lilas - Faidherbe,OUI,39,38,1,1,0,OUI,OUI,2025-03-13 16:57:06+00:00,"48.87861855668978, 2.4120327830314636",Les Lilas,93045,0.02564102564102564,17
33015,Charles Tillon - Cimetière Communal,OUI,27,2,25,7,18,OUI,OUI,2025-03-13 17:01:12+00:00,"48.91844023641836, 2.3935630917549138",Aubervilliers,93001,0.9259259259259259,17
33016,Fort d'Aubervilliers,OUI,22,13,9,6,3,OUI,OUI,2025-03-13 16:59:20+00:00,"48.91502382370325, 2.4035281687974925",Aubervilliers,93001,0.4090909090909091,17
15311,Quai du Président Roosevelt - Pont Aval,OUI,30,5,25,21,4,OUI,OUI,2025-03-13 17:01:21+00:00,"48.8343883676388, 2.2656820714473724",Paris,75056,0.8333333333333334,17
10162,Alexandre Parodi - Quai de Valmy,OUI,24,24,0,0,0,OUI,OUI,2025-03-13 17:01:18+00:00,"48.879359419425, 2.3665961623192",Paris,75056,0.0,17
41205,Maréchal Joffre - Verdun,OUI,20,19,1,0,1,OUI,OUI,2025-03-13 16:59:38+00:00,"48.85385, 2.470307",Fontenay-sous-Bois,94033,0.05,17
15071,Suffren - Champ de Mars,OUI,23,13,10,9,1,OUI,OUI,2025-03-13 17:02:29+00:00,"48.8547194, 2.2952168",Paris,75056,0.43478260869565216,17
44016,Balzac - Olympes de Gouges,OUI,28,9,19,9,10,OUI,OUI,2025-03-13 17:02:13+00:00,"48.77850332486751, 2.4006786569952965",Vitry-sur-Seine,94081,0.6785714285714286,17
9024,Taitbout - La Fayette,OUI,51,18,33,25,8,OUI,OUI,2025-03-13 17:02:18+00:00,"48.8733298892, 2.3352625966072",Paris,75056,0.6470588235294118,17
12026,Place Ginette Hamelin,OUI,49,21,28,21,7,OUI,OUI,2025-03-13 16:59:41+00:00,"48.837853, 2.382064",Paris,75056,0.5714285714285714,17
17111,Lemercier - Cardinet,OUI,24,14,10,6,4,OUI,OUI,2025-03-13 17:01:54+00:00,"48.890097168851746, 2.317377626895905",Paris,75056,0.4166666666666667,17
6012,Saint-Germain - Ciseaux,OUI,18,2,16,12,4,OUI,OUI,2025-03-13 17:01:47+00:00,"48.853305277595, 2.3344654618827",Paris,75056,0.8888888888888888,17
21319,Esplanade du Foncet - Camille Desmoulins,OUI,27,4,23,18,5,OUI,OUI,2025-03-13 17:02:14+00:00,"48.827090233494964, 2.2606857866048813",Issy-les-Moulineaux,92040,0.8518518518518519,17
13009,Auguste Blanqui - Corvisart,OUI,23,17,6,4,2,OUI,OUI,2025-03-13 16:58:03+00:00,"48.8300989, 2.3502726",Paris,75056,0.2608695652173913,17
9102,Londres - Place d'Estienne d'Orves,OUI,24,7,17,15,2,OUI,OUI,2025-03-13 16:59:34+00:00,"48.876693805756986, 2.3305362090468407",Paris,75056,0.7083333333333334,17
27005,Gare du Stade,OUI,18,14,4,3,1,OUI,OUI,2025-03-13 16:57:28+00:00,"48.9312676, 2.2603778",Colombes,92025,0.2222222222222222,17
9006,Dunkerque - Trudaine,OUI,16,12,4,1,3,OUI,OUI,2025-03-13 17:01:45+00:00,"48.88215166773376, 2.3463253676891327",Paris,75056,0.25,17
8201,Arsène Houssaye - Friedland,OUI,29,28,1,0,1,OUI,OUI,2025-03-13 17:02:18+00:00,"48.874510616163, 2.2994716674148",Paris,75056,0.034482758620689655,17
8116,Champs-Elysees - Bassano,OUI,25,25,0,0,0,NON,NON,2021-02-21 19:09:18+00:00,"48.871811807816, 2.300238981843",Paris,75056,0.0,19
18030,Joseph Dijon - Ornano,OUI,36,32,4,3,1,OUI,OUI,2025-03-13 17:02:28+00:00,"48.89374453351521, 2.3476678133010864",Paris,75056,0.1111111111111111,17
92006,Place Nelson Mandela,OUI,30,21,9,3,6,OUI,OUI,2025-03-13 17:01:29+00:00,"48.897874318180556, 2.2182820737361912",Nanterre,92050,0.3,17
5024,Place Monge,OUI,20,17,3,2,1,OUI,OUI,2025-03-13 17:02:05+00:00,"48.842761803051, 2.3524079471827",Paris,75056,0.15,17
31005,Square Denise Buisson,OUI,45,43,2,0,2,OUI,OUI,2025-03-13 17:02:05+00:00,"48.8562322730982, 2.426436245441437",Montreuil,93048,0.044444444444444446,17
21314,Chemin de Bretagne,OUI,28,4,24,21,3,OUI,OUI,2025-03-13 17:02:24+00:00,"48.824753068884, 2.2588385956052",Issy-les-Moulineaux,92040,0.8571428571428571,17
13516,Glacière - Soeur Catherine Marie,OUI,40,38,2,0,2,OUI,OUI,2025-03-13 16:58:06+00:00,"48.829522989420596, 2.343570403754711",Paris,75056,0.05,17
12038,Picpus - Louis Braille,OUI,43,41,2,1,1,OUI,OUI,2025-03-13 17:00:43+00:00,"48.839988788912, 2.4005256685521",Paris,75056,0.046511627906976744,17
9034,Godot de Mauroy - Madeleine,OUI,21,10,11,2,9,OUI,OUI,2025-03-13 17:02:08+00:00,"48.869789, 2.326347",Paris,75056,0.5238095238095238,17
12005,Crozatier - Faubourg Saint-Antoine,OUI,39,2,37,31,6,OUI,OUI,2025-03-13 17:02:11+00:00,"48.850440013405, 2.378901366211",Paris,75056,0.9487179487179487,17
12035,Madagascar - Meuniers,OUI,32,23,9,7,2,OUI,OUI,2025-03-13 17:01:33+00:00,"48.83460464474706, 2.3970650508999825",Paris,75056,0.28125,17
12155,Rottembourg - Général Michel Bizot,OUI,41,38,3,2,1,OUI,OUI,2025-03-13 17:01:24+00:00,"48.83787825992554, 2.4044052511453633",Paris,75056,0.07317073170731707,17
10021,Marché Saint-Quentin,OUI,13,11,2,1,1,OUI,OUI,2025-03-13 17:00:44+00:00,"48.877356057652, 2.3545114456374",Paris,75056,0.15384615384615385,17
9011,Geoffroy - Marie,OUI,17,8,9,8,1,OUI,OUI,2025-03-13 17:02:24+00:00,"48.873781940593325, 2.344513876337893",Paris,75056,0.5294117647058824,17
44011,Lebrun - Colonel Fabien,OUI,27,26,1,0,1,OUI,OUI,2025-03-13 16:53:51+00:00,"48.78266870733145, 2.381317801773548",Vitry-sur-Seine,94081,0.037037037037037035,17
12028,Vivaldi - Antoine-Julien Hénard,OUI,27,21,6,2,4,OUI,OUI,2025-03-13 17:01:42+00:00,"48.841923663276546, 2.389728979467376",Paris,75056,0.2222222222222222,17
2108,Vivienne - Montmartre,OUI,36,8,28,17,11,OUI,OUI,2025-03-13 17:01:46+00:00,"48.871347597383, 2.3414588347077",Paris,75056,0.7777777777777778,17
5115,Buffon - Jardin des Plantes,OUI,30,9,21,19,2,OUI,OUI,2025-03-13 17:01:16+00:00,"48.842668466104875, 2.3618587106466293",Paris,75056,0.7,17
12101,Charenton - Prague,OUI,28,2,26,19,7,OUI,OUI,2025-03-13 17:01:28+00:00,"48.848175129981, 2.3763584494312",Paris,75056,0.9285714285714286,17
41211,Louis Xavier de Ricard - Ancienne Mairie,OUI,34,30,4,3,1,OUI,OUI,2025-03-13 17:00:58+00:00,"48.84629899065091, 2.472420372068882",Fontenay-sous-Bois,94033,0.11764705882352941,17
5001,Harpe - Saint-Germain,OUI,40,17,23,17,6,OUI,OUI,2025-03-13 17:00:43+00:00,"48.851518815017, 2.3436703160405",Paris,75056,0.575,17
21707,Square Etienne Jarousse,OUI,22,13,9,1,8,OUI,OUI,2025-03-13 17:02:00+00:00,"48.82485182597129, 2.2925933450460434",Vanves,92075,0.4090909090909091,17
51001,Gare d'Argenteuil,OUI,37,19,18,4,14,OUI,OUI,2025-03-13 17:00:08+00:00,"48.947022436806705, 2.256898172199726",Argenteuil,95018,0.4864864864864865,17
4019,Cloître Saint-Merri - Renard,OUI,29,6,23,19,4,OUI,OUI,2025-03-13 16:56:05+00:00,"48.858835448898, 2.3518279194832",Paris,75056,0.7931034482758621,17
15039,Abbé Groult - Convention,OUI,12,10,2,0,2,OUI,OUI,2025-03-13 17:01:35+00:00,"48.83596927866069, 2.302064039509349",Paris,75056,0.16666666666666666,17
15129,Hôpital Necker,OUI,35,28,7,6,1,OUI,OUI,2025-03-13 17:00:07+00:00,"48.846043490118454, 2.313245013356209",Paris,75056,0.2,17
21402,Place Aimé Césaire,OUI,27,25,2,0,2,OUI,OUI,2025-03-13 16:55:37+00:00,"48.783194713067815, 2.2429127991199493",Clamart,92023,0.07407407407407407,17
8027,Mairie du 8ème,OUI,14,12,2,0,2,OUI,OUI,2025-03-13 16:53:29+00:00,"48.877932, 2.318264",Paris,75056,0.14285714285714285,17
41403,Gare RER - Malleret-Joinville,OUI,19,3,16,12,4,OUI,OUI,2025-03-13 17:01:14+00:00,"48.802936, 2.42531",Alfortville,94002,0.8421052631578947,17
21315,Jules Guesdes - Général de Gaulle,OUI,24,23,1,0,1,OUI,OUI,2025-03-13 17:01:26+00:00,"48.81930581291959, 2.278934195637703",Issy-les-Moulineaux,92040,0.041666666666666664,17
13018,Bruant - Vincent Auriol,OUI,25,16,9,6,3,OUI,OUI,2025-03-13 17:02:14+00:00,"48.834848452929, 2.3668264996271",Paris,75056,0.36,17
23102,Hôtel de Ville de Sèvres,OUI,31,19,12,11,1,OUI,OUI,2025-03-13 16:53:36+00:00,"48.824363561289, 2.2131047397852",Sèvres,92072,0.3870967741935484,17
9007,Condorcet - Turgot,OUI,19,15,4,1,3,OUI,OUI,2025-03-13 17:01:24+00:00,"48.87985155789093, 2.345232367515564",Paris,75056,0.21052631578947367,17
15036,Croix Nivert - Square Saint-Lambert,OUI,47,47,0,0,0,NON,NON,2025-03-03 09:03:43+00:00,"48.843051521591, 2.2952004522085",Paris,75056,0.0,9
13052,Leredde - Tolbiac,OUI,41,21,20,12,8,OUI,OUI,2025-03-13 16:57:21+00:00,"48.82887629664, 2.3744382709265",Paris,75056,0.4878048780487805,17
6022,Marché Saint-Germain,OUI,19,2,17,8,9,OUI,OUI,2025-03-13 17:01:23+00:00,"48.85165625855281, 2.335500307381153",Paris,75056,0.8947368421052632,17
20105,Benoît Frachon - République,OUI,29,28,1,0,1,OUI,OUI,2025-03-13 16:55:31+00:00,"48.85230729014318, 2.415605485439301",Paris,75056,0.034482758620689655,17
15006,Cherche-Midi - Hôpital Necker,OUI,35,32,3,2,1,OUI,OUI,2025-03-13 17:02:21+00:00,"48.84461063309956, 2.317914068698883",Paris,75056,0.08571428571428572,17
33103,Jean Jaurès - Jules Jacquemin,OUI,22,19,3,1,2,OUI,OUI,2025-03-13 16:58:19+00:00,"48.88433053604843, 2.4082902455152104",Le Pré-Saint-Gervais,93061,0.13636363636363635,17
21303,Jean Monnet - Iles,OUI,31,0,31,25,6,OUI,OUI,2025-03-13 17:02:22+00:00,"48.823393984057304, 2.2497073194874866",Issy-les-Moulineaux,92040,1.0,17
14011,Place des Droits de l'Enfant,OUI,39,37,2,1,1,OUI,OUI,2025-03-13 17:01:41+00:00,"48.8274804, 2.3319217",Paris,75056,0.05128205128205128,17
33014,Parc Eli Lotar,OUI,19,10,9,6,3,OUI,OUI,2025-03-13 17:02:13+00:00,"48.91844993053703, 2.3727085813879967",Aubervilliers,93001,0.47368421052631576,17
20044,Davout - Volga,OUI,27,25,2,1,1,OUI,OUI,2025-03-13 16:57:48+00:00,"48.852919679957296, 2.410522909779111",Paris,75056,0.07407407407407407,17
17024,Villiers - Batignolles,OUI,23,23,0,0,0,OUI,OUI,2025-03-13 17:02:03+00:00,"48.88125253846116, 2.31653843075037",Paris,75056,0.0,17
16019,Porte de la Muette,OUI,34,30,4,0,4,OUI,OUI,2025-03-13 17:02:18+00:00,"48.86302317841182, 2.2687188170157406",Paris,75056,0.11764705882352941,17
15127,Place Charles Michels,OUI,35,9,26,19,7,OUI,OUI,2025-03-13 16:58:17+00:00,"48.846401, 2.28502",Paris,75056,0.7428571428571429,17
33012,Landy - Heurtault,OUI,29,23,6,1,5,OUI,OUI,2025-03-13 17:00:49+00:00,"48.915096534520316, 2.375951372087002",Aubervilliers,93001,0.20689655172413793,17
14032,Mairie du 14ème,OUI,31,29,2,1,1,OUI,OUI,2025-03-13 17:00:25+00:00,"48.83254578123, 2.3254923149943",Paris,75056,0.06451612903225806,17
3102,Bourg l'Abbé - Saint-Martin,OUI,37,2,35,27,8,OUI,OUI,2025-03-13 17:02:09+00:00,"48.86393331949257, 2.352406270802021",Paris,75056,0.9459459459459459,17
41401,Marne - Charles de Gaulle,OUI,25,11,14,12,2,OUI,OUI,2025-03-13 17:01:19+00:00,"48.815071719544434, 2.4121668934822087",Alfortville,94002,0.56,17
10019,Paradis - Hauteville,OUI,31,24,7,5,2,OUI,OUI,2025-03-13 17:00:51+00:00,"48.874999954666755, 2.3522757401923404",Paris,75056,0.22580645161290322,17
6002,Saint-Benoît - Jacob,OUI,20,10,10,9,1,OUI,OUI,2025-03-13 17:01:58+00:00,"48.85545136013941, 2.3334722220897675",Paris,75056,0.5,17
10033,Gare du Nord - Saint-Vincent de Paul,OUI,24,22,2,0,2,OUI,OUI,2025-03-13 16:58:43+00:00,"48.880955741648, 2.3524305148385",Paris,75056,0.08333333333333333,17
14031,Didot - Place de Moro-Giafferi,OUI,20,14,6,3,3,OUI,OUI,2025-03-13 17:02:23+00:00,"48.8337, 2.3215",Paris,75056,0.3,17
2013,Favart - Italiens,OUI,16,13,3,0,3,OUI,OUI,2025-03-13 17:01:55+00:00,"48.871446353921, 2.3382901058508",Paris,75056,0.1875,17
20022,Porte de Bagnolet,OUI,33,31,2,0,2,OUI,OUI,2025-03-13 17:02:27+00:00,"48.864707139122984, 2.408344637349607",Paris,75056,0.06060606060606061,17
11033,Bréguet - Sabin,OUI,30,9,21,16,5,OUI,OUI,2025-03-13 17:01:54+00:00,"48.856931678257, 2.3706749462105",Paris,75056,0.7,17
14026,Plantes - Moulin Vert,OUI,45,43,2,1,1,OUI,OUI,2025-03-13 17:01:36+00:00,"48.83005755305626, 2.3232302069664006",Paris,75056,0.044444444444444446,17
41203,Stalingrad - Rigollots,OUI,50,45,5,1,4,OUI,OUI,2025-03-13 17:00:38+00:00,"48.84997403844251, 2.45557576417923",Fontenay-sous-Bois,94033,0.1,17
10008,Cité Riverin - Château d'Eau,OUI,17,1,16,14,2,OUI,OUI,2025-03-13 17:00:36+00:00,"48.870702423554306, 2.358739863900845",Paris,75056,0.9411764705882353,17
18039,Jardins d'Eole,OUI,19,16,3,2,1,OUI,OUI,2025-03-13 16:57:59+00:00,"48.8869703, 2.3668488",Paris,75056,0.15789473684210525,17
16012,Flandrin - Longchamp,OUI,40,19,21,6,15,OUI,OUI,2025-03-13 17:02:12+00:00,"48.86877849178477, 2.274354539176829",Paris,75056,0.525,17
16036,Porte Molitor,OUI,57,26,31,27,4,OUI,OUI,2025-03-13 17:01:48+00:00,"48.84524763511433, 2.2569015249609947",Paris,75056,0.543859649122807,17
12036,Reuilly - Place Felix Eboue,OUI,41,40,1,1,0,OUI,OUI,2025-03-13 17:01:59+00:00,"48.84030274499962, 2.394630398715453",Paris,75056,0.024390243902439025,17
42505,Charles Frérot - Albert Guilpin,OUI,28,22,6,3,3,OUI,OUI,2025-03-13 17:01:54+00:00,"48.8155839183714, 2.3505029082298283",Gentilly,94037,0.21428571428571427,17
12015,Place de la Nation - Picpus,OUI,36,34,2,1,1,OUI,OUI,2025-03-13 17:01:58+00:00,"48.846821681548, 2.4001130461693",Paris,75056,0.05555555555555555,17
8117,Place de la Madeleine - Royale,OUI,40,11,29,21,8,OUI,OUI,2025-03-13 17:01:50+00:00,"48.869228052648, 2.324421107769",Paris,75056,0.725,17
26004,Gare RER les Grésillons,OUI,22,18,4,2,2,OUI,OUI,2025-03-13 17:00:53+00:00,"48.919898633572764, 2.31458459136273",Asnières-sur-Seine,92004,0.18181818181818182,17
10032,Claude Vellefaux - Hôpital Saint-Louis,OUI,32,27,5,3,2,OUI,OUI,2025-03-13 16:56:38+00:00,"48.872859139003, 2.3700717069851",Paris,75056,0.15625,17
16042,Murat - Porte de Saint-Cloud,OUI,37,2,35,32,3,OUI,OUI,2025-03-13 17:01:01+00:00,"48.83750862621299, 2.2577651962637906",Paris,75056,0.9459459459459459,17
48004,Maxime Gorki - Louis Aragon,OUI,20,18,2,0,2,OUI,OUI,2025-03-13 17:01:54+00:00,"48.78909814728443, 2.368387877941132",Villejuif,94076,0.1,17
15008,Sèvres - Lecourbe,OUI,61,52,9,9,0,OUI,OUI,2025-03-13 16:55:13+00:00,"48.8447677, 2.3110086",Paris,75056,0.14754098360655737,17
14001,Edgar Quinet - Gaité,OUI,26,22,4,1,3,OUI,OUI,2025-03-13 16:59:04+00:00,"48.841160928966, 2.324595451355",Paris,75056,0.15384615384615385,17
11112,Jules Vallès - Charonne,OUI,23,12,11,11,0,OUI,OUI,2025-03-13 17:02:26+00:00,"48.854284379935, 2.3847674578428",Paris,75056,0.4782608695652174,17
18139,Poissonniers - Championnet,OUI,28,26,2,0,2,OUI,OUI,2025-03-13 17:02:15+00:00,"48.89543299733937, 2.3530178144574165",Paris,75056,0.07142857142857142,17
5007,Ecoles - Carmes,OUI,32,10,22,16,6,OUI,OUI,2025-03-13 17:01:33+00:00,"48.848904447989405, 2.3473486304283147",Paris,75056,0.6875,17
1006,Grande Truanderie - Saint-Denis,OUI,27,3,24,15,9,OUI,OUI,2025-03-13 17:01:38+00:00,"48.8626302, 2.3498075",Paris,75056,0.8888888888888888,17
16105,Crevaux - Bugeaud,OUI,31,26,5,0,5,OUI,OUI,2025-03-13 16:57:53+00:00,"48.87080942867, 2.2811490076919",Paris,75056,0.16129032258064516,17
15001,Gare Montparnasse - Arrivée,OUI,41,24,17,10,7,OUI,OUI,2025-03-13 17:02:05+00:00,"48.843827994315, 2.3225811123848",Paris,75056,0.4146341463414634,17
4006,Bourdon - Pont Morland,OUI,50,20,30,28,2,OUI,OUI,2025-03-13 17:02:14+00:00,"48.8478103, 2.3659356",Paris,75056,0.6,17
19110,Square Claude Bernard,OUI,28,26,2,1,1,OUI,OUI,2025-03-13 17:02:23+00:00,"48.89876016219984, 2.375325746834278",Paris,75056,0.07142857142857142,17
6010,Chevreuse - Montparnasse,OUI,14,12,2,0,2,OUI,OUI,2025-03-13 17:01:10+00:00,"48.841739161231, 2.3315522167367",Paris,75056,0.14285714285714285,17
22201,Henri Ravera - Gabriel Péri,OUI,28,26,2,0,2,OUI,OUI,2025-03-13 17:00:30+00:00,"48.79722273833844, 2.302115857601166",Bagneux,92007,0.07142857142857142,17
45002,Roger Salengro - Général de Gaulle,OUI,27,16,11,4,7,OUI,OUI,2025-03-13 16:59:29+00:00,"48.820029010376956, 2.4846760556101803",Champigny-sur-Marne,94017,0.4074074074074074,17
18202,Diane Arbus,OUI,37,28,9,4,5,OUI,OUI,2025-03-13 17:02:28+00:00,"48.898800717199, 2.3524022474885",Paris,75056,0.24324324324324326,17
15128,Cadix - Hameau,OUI,36,27,9,5,4,OUI,OUI,2025-03-13 17:00:53+00:00,"48.8340107632249, 2.289516180753708",Paris,75056,0.25,17
3008,Perle - Vieille du Temple,OUI,34,7,27,22,5,OUI,OUI,2025-03-13 17:00:18+00:00,"48.8601346, 2.3611206",Paris,75056,0.7941176470588235,17
44014,Camille Risch - Paul Armangot,OUI,25,20,5,4,1,OUI,OUI,2025-03-13 16:55:59+00:00,"48.774703, 2.373685",Vitry-sur-Seine,94081,0.2,17
5015,Epée de Bois - Mouffetard,OUI,63,61,2,1,1,OUI,OUI,2025-03-13 16:58:57+00:00,"48.841508690388835, 2.350066713988781",Paris,75056,0.031746031746031744,17
12037,Reuilly - Daumesnil,OUI,35,30,5,1,4,OUI,OUI,2025-03-13 17:02:03+00:00,"48.8395385, 2.3972516",Paris,75056,0.14285714285714285,17
47003,Charentonneau - Maisons Alfort,OUI,20,11,9,4,5,OUI,OUI,2025-03-13 17:00:09+00:00,"48.809932980484355, 2.443288456496946",Maisons-Alfort,94046,0.45,17
1007,Turbigo - Française,OUI,16,2,14,6,8,OUI,OUI,2025-03-13 17:02:13+00:00,"48.86358858111446, 2.3477794602513313",Paris,75056,0.875,17
18004,Place des Abbesses,OUI,12,9,3,0,3,OUI,OUI,2025-03-13 16:57:37+00:00,"48.884542726149725, 2.3386867716908455",Paris,75056,0.25,17
16013,Mairie du 16ème,OUI,35,35,0,0,0,OUI,OUI,2025-03-13 17:00:34+00:00,"48.863936848471994, 2.2765953093767166",Paris,75056,0.0,17
20001,Place de la Nation - Charonne,OUI,35,33,2,2,0,OUI,OUI,2025-03-13 17:00:10+00:00,"48.848364667777, 2.3997623859813",Paris,75056,0.05714285714285714,17
7012,Cité Vaneau,OUI,24,14,10,7,3,OUI,OUI,2025-03-13 16:58:41+00:00,"48.8542210666207, 2.319614924490452",Paris,75056,0.4166666666666667,17
20008,Pyrénées - Avron,OUI,32,28,4,0,4,OUI,OUI,2025-03-13 17:01:55+00:00,"48.853246898211985, 2.405871044529538",Paris,75056,0.125,17
18034,Leibniz - Jean Dollfus,OUI,32,29,3,0,3,OUI,OUI,2025-03-13 17:00:17+00:00,"48.896328348515986, 2.333390423834684",Paris,75056,0.09375,17
12019,Gare de Reuilly - Picpus,OUI,26,25,1,1,0,OUI,OUI,2025-03-13 16:59:53+00:00,"48.84267354116789, 2.3972943797707558",Paris,75056,0.038461538461538464,17
20104,Louis Lumière.,OUI,22,22,0,0,0,OUI,OUI,2025-03-13 16:59:31+00:00,"48.86216198070008, 2.41112578185621",Paris,75056,0.0,17
8110,Gare Saint-Lazare - Stockholm,OUI,31,21,10,6,4,OUI,OUI,2025-03-13 17:00:00+00:00,"48.877127316667654, 2.322417162358761",Paris,75056,0.3225806451612903,17
14135,Jourdan - Cité Universitaire,OUI,38,29,9,4,5,OUI,OUI,2025-03-13 17:02:27+00:00,"48.819897343156676, 2.3397007964124366",Paris,75056,0.23684210526315788,17
3010,Beaubourg - Michel-le-Comte,OUI,15,2,13,10,3,OUI,OUI,2025-03-13 17:02:28+00:00,"48.862534941806, 2.3543103039265",Paris,75056,0.8666666666666667,17
20024,Gambetta - Père Lachaise,OUI,27,26,1,0,1,OUI,OUI,2025-03-13 17:02:23+00:00,"48.864295696165875, 2.398228667282044",Paris,75056,0.037037037037037035,17
12156,Niger - Soult,OUI,23,18,5,1,4,OUI,OUI,2025-03-13 17:01:07+00:00,"48.84369906369085, 2.410361237220498",Paris,75056,0.21739130434782608,17
9009,Square Montholon,OUI,16,9,7,1,6,OUI,OUI,2025-03-13 16:59:13+00:00,"48.876620377545024, 2.3457641154527664",Paris,75056,0.4375,17
18140,Porte de Clignancourt - Ney,OUI,39,33,6,3,3,OUI,OUI,2025-03-13 16:54:08+00:00,"48.899641123987095, 2.344321422278881",Paris,75056,0.15384615384615385,17
21309,Mairie d'Issy,OUI,39,26,13,13,0,OUI,OUI,2025-03-13 17:02:20+00:00,"48.823767792468, 2.2723111510277",Issy-les-Moulineaux,92040,0.3333333333333333,17
10034,Louis Blanc - La Chapelle,OUI,21,21,0,0,0,OUI,OUI,2025-03-13 16:52:32+00:00,"48.884008964514, 2.3599335551262",Paris,75056,0.0,17
16102,Pergolèse - Marbeau,OUI,26,23,3,0,3,OUI,OUI,2025-03-13 16:56:52+00:00,"48.873568706869, 2.2815125225299",Paris,75056,0.11538461538461539,17
6104,Herschel - Observatoire,OUI,34,30,4,3,1,OUI,OUI,2025-03-13 17:00:00+00:00,"48.84342376221923, 2.3376645147800446",Paris,75056,0.11764705882352941,17
19002,Centquatre,OUI,37,33,4,1,3,NON,NON,2025-03-13 17:01:50+00:00,"48.889333538455, 2.3707854375243",Paris,75056,0.10810810810810811,17
4021,Centre Georges Pompidou,OUI,26,5,21,19,2,OUI,OUI,2025-03-13 17:01:39+00:00,"48.861419, 2.352581",Paris,75056,0.8076923076923077,17
17019,Phalsbourg - Villiers,OUI,19,16,3,0,3,OUI,OUI,2025-03-13 16:58:27+00:00,"48.88242307900951, 2.3090453445911407",Paris,75056,0.15789473684210525,17
20034,Sorbier - Ménilmontant,OUI,24,20,4,0,4,OUI,OUI,2025-03-13 16:59:53+00:00,"48.868542395661, 2.3897721245885",Paris,75056,0.16666666666666666,17
19010,Emile Reynaud - Porte de la Villette,OUI,22,16,6,4,2,OUI,OUI,2025-03-13 17:02:07+00:00,"48.90098953630053, 2.3887022584676743",Paris,75056,0.2727272727272727,17
13005,Cordelières - Arago,OUI,44,15,29,26,3,OUI,OUI,2025-03-13 17:00:07+00:00,"48.83548071896613, 2.348572461702221",Paris,75056,0.6590909090909091,17
41405,Place de l'Europe - Alfortville,OUI,24,4,20,18,2,OUI,OUI,2025-03-13 16:58:54+00:00,"48.78913702405837, 2.4284800887107854",Alfortville,94002,0.8333333333333334,17
19201,Petit - Georges Thill,OUI,23,21,2,0,2,OUI,OUI,2025-03-13 16:59:47+00:00,"48.88603131999171, 2.3895753175020222",Paris,75056,0.08695652173913043,17
20006,Pyrénées - Plaine,OUI,12,9,3,3,0,OUI,OUI,2025-03-13 16:58:51+00:00,"48.85026702458, 2.4062821269035",Paris,75056,0.25,17
10009,Mairie du 10ème,OUI,18,2,16,13,3,OUI,OUI,2025-03-13 17:00:32+00:00,"48.872089449907, 2.3575825989246",Paris,75056,0.8888888888888888,17
14019,Sarrette - Général Leclerc,OUI,22,21,1,0,1,OUI,OUI,2025-03-13 17:01:23+00:00,"48.825030852925, 2.3264128693982",Paris,75056,0.045454545454545456,17
22301,Chausson - Gabriel Péri,OUI,21,12,9,9,0,OUI,OUI,2025-03-13 17:02:20+00:00,"48.921891003481115, 2.2952306270599365",Gennevilliers,92036,0.42857142857142855,17
31709,Place de la Fraternité,OUI,22,18,4,2,2,OUI,OUI,2025-03-13 16:58:09+00:00,"48.85716405838368, 2.422847449779511",Montreuil,93048,0.18181818181818182,17
15132,Bargue -  Dutot,OUI,21,18,3,2,1,OUI,OUI,2025-03-13 17:02:26+00:00,"48.837884, 2.308876",Paris,75056,0.14285714285714285,17
10027,Dunkerque - Alsace,OUI,20,20,0,0,0,OUI,OUI,2025-03-13 16:56:31+00:00,"48.879355, 2.358379",Paris,75056,0.0,17
8028,Arsène Houssaye - Champs-Elysées,OUI,28,14,14,3,11,OUI,OUI,2025-03-13 16:57:37+00:00,"48.873409276267, 2.2977904602885",Paris,75056,0.5,17
22401,Charles de Gaulle - Plateau de Vanves,OUI,32,30,2,1,1,OUI,OUI,2025-03-13 17:00:49+00:00,"48.82233088973263, 2.298571803412886",Malakoff,92046,0.0625,17
10011,Bourse du Travail,OUI,17,9,8,6,2,OUI,OUI,2025-03-13 17:01:26+00:00,"48.868976638826, 2.3623438552022",Paris,75056,0.47058823529411764,17
12002,Lacuée - Lyon,OUI,16,3,13,7,6,OUI,OUI,2025-03-13 17:00:37+00:00,"48.849268481958, 2.3704585433006",Paris,75056,0.8125,17
21953,Gare de Bellevue,OUI,20,19,1,0,1,OUI,OUI,2025-03-13 16:59:18+00:00,"48.8192404685572, 2.2295309230685234",Meudon,92048,0.05,17
21506,Maurice Payret-Dortail,OUI,22,20,2,0,2,OUI,OUI,2025-03-13 16:54:51+00:00,"48.87811957063342, 2.2233625128865246",Suresnes,92073,0.09090909090909091,17
14137,Maurice d'Ocagne - General Maudhuy,OUI,28,27,1,0,1,OUI,OUI,2025-03-13 17:02:19+00:00,"48.82414282524159, 2.3158789426088333",Paris,75056,0.03571428571428571,17
4103,Archives - Rivoli,OUI,21,8,13,9,4,OUI,OUI,2025-03-13 17:01:59+00:00,"48.857346707443, 2.3539767041802",Paris,75056,0.6190476190476191,17
3011,Turbigo - Réaumur,OUI,28,6,22,19,3,OUI,OUI,2025-03-13 17:02:23+00:00,"48.865574047531, 2.3564198613167",Paris,75056,0.7857142857142857,17
3001,Beaumarchais - Saint-Gilles,OUI,44,38,6,5,1,OUI,OUI,2025-03-13 17:00:27+00:00,"48.8580378, 2.3679352",Paris,75056,0.13636363636363635,17
10006,Petites Ecuries - Faubourg Saint-Denis,OUI,27,18,9,8,1,OUI,OUI,2025-03-13 17:02:01+00:00,"48.87287120589831, 2.3542150855064397",Paris,75056,0.3333333333333333,17
9037,Parme - Clichy,OUI,22,22,0,0,0,OUI,OUI,2025-03-13 17:01:46+00:00,"48.881266424227, 2.3281970934506",Paris,75056,0.0,17
14103,Maine - Liancourt,OUI,25,21,4,0,4,OUI,OUI,2025-03-13 17:02:00+00:00,"48.835064363954, 2.323731449974",Paris,75056,0.16,17
32013,Saint-Denis - Université,OUI,18,16,2,1,1,OUI,OUI,2025-03-13 17:01:58+00:00,"48.94563430946964, 2.3638297989964485",Saint-Denis,93066,0.1111111111111111,17
7021,Bosquet - Saint-Dominique,OUI,27,25,2,1,1,OUI,OUI,2025-03-13 16:57:44+00:00,"48.858651709526, 2.3037165802346",Paris,75056,0.07407407407407407,17
20029,Frères Flavien - Porte des Lilas,OUI,23,23,0,0,0,OUI,OUI,2025-03-13 16:57:49+00:00,"48.8780992764359, 2.41104629853209",Paris,75056,0.0,17
2015,Louis le Grand - Italiens,OUI,33,19,14,13,1,OUI,OUI,2025-03-13 17:00:08+00:00,"48.870508937204, 2.3340544619393",Paris,75056,0.42424242424242425,17
2003,Saint-Denis - Réaumur,OUI,32,9,23,17,6,OUI,OUI,2025-03-13 17:01:58+00:00,"48.8661116315789, 2.3507790675507594",Paris,75056,0.71875,17
21026,Sèvres - Général Leclerc,OUI,30,17,13,10,3,OUI,OUI,2025-03-13 16:59:23+00:00,"48.830121559055, 2.2314262390137",Boulogne-Billancourt,92012,0.43333333333333335,17
22503,Joffre - Aigle,OUI,19,11,8,6,2,OUI,OUI,2025-03-13 17:01:53+00:00,"48.904033, 2.245096",La Garenne-Colombes,92035,0.42105263157894735,17
19129,Solitaires - Place des Fêtes,OUI,29,29,0,0,0,NON,NON,2025-02-23 09:26:05+00:00,"48.876601, 2.391769",Paris,75056,0.0,9
1102,Française - Etienne Marcel,OUI,35,0,35,25,10,OUI,OUI,2025-03-13 17:00:40+00:00,"48.864053304653766, 2.347587011754513",Paris,75056,1.0,17
13017,Nationale - Vincent Auriol,OUI,33,24,9,2,7,OUI,OUI,2025-03-13 17:02:05+00:00,"48.83252708397293, 2.362354410392119",Paris,75056,0.2727272727272727,17
15111,Olivier de Serres - Leriche,OUI,24,23,1,0,1,OUI,OUI,2025-03-13 17:02:20+00:00,"48.83460221715206, 2.2957482933998112",Paris,75056,0.041666666666666664,17
12020,Cours de Vincennes - Soult,OUI,44,43,1,0,1,OUI,OUI,2025-03-13 17:01:40+00:00,"48.846918761569, 2.4105220288038",Paris,75056,0.022727272727272728,17
24006,Adolphe Lalyre - Armand Silvestre,OUI,38,32,6,3,3,OUI,OUI,2025-03-13 16:59:16+00:00,"48.90406266961591, 2.273416221141815",Courbevoie,92026,0.15789473684210525,17
2021,Cléry - Montmartre,OUI,56,50,6,3,3,OUI,OUI,2025-03-13 17:02:18+00:00,"48.867458, 2.3445211",Paris,75056,0.10714285714285714,17
4014,Blancs-Manteaux - Archives,OUI,28,9,19,15,4,OUI,OUI,2025-03-13 16:58:42+00:00,"48.85941800703, 2.3559471219778",Paris,75056,0.6785714285714286,17
3009,Temple - Haudriettes,OUI,19,6,13,9,4,OUI,OUI,2025-03-13 17:01:45+00:00,"48.861636880212, 2.3566960206458",Paris,75056,0.6842105263157895,17
2005,Montmartre - Etienne Marcel,OUI,16,0,16,15,1,OUI,OUI,2025-03-13 17:00:37+00:00,"48.86502194581, 2.3450684401448",Paris,75056,1.0,17
14132,Bézout - Général Leclerc,OUI,28,24,4,1,3,OUI,OUI,2025-03-13 17:02:23+00:00,"48.82884804502439, 2.3285973072052",Paris,75056,0.14285714285714285,17
3012,Square Emile - Chautemps,OUI,22,3,19,15,4,OUI,OUI,2025-03-13 17:01:56+00:00,"48.867433724231, 2.3536357283592",Paris,75056,0.8636363636363636,17
23702,Hôtel de Ville de Chaville,OUI,20,17,3,1,2,OUI,OUI,2025-03-13 17:02:21+00:00,"48.80887149094033, 2.188134044408798",Chaville,92022,0.15,17
21507,Gardenat-Lapostol - Velettes,OUI,20,16,4,0,4,OUI,OUI,2025-03-13 16:56:56+00:00,"48.87387, 2.224185",Suresnes,92073,0.2,17
14022,Didot - Mariniers,OUI,34,32,2,0,2,OUI,OUI,2025-03-13 17:01:14+00:00,"48.82650543613106, 2.313136198271666",Paris,75056,0.058823529411764705,17
22306,Place du 17 Octobre,OUI,15,14,1,1,0,OUI,OUI,2025-03-13 17:02:27+00:00,"48.91962690034779, 2.2978286134199792",Gennevilliers,92036,0.06666666666666667,17
2002,Etienne Marcel - Montorgueil,OUI,25,2,23,18,5,OUI,OUI,2025-03-13 17:02:16+00:00,"48.86450567259199, 2.3461959511041637",Paris,75056,0.92,17
14023,Adolphe Pinard - Victor Hugo,OUI,50,44,6,1,5,OUI,OUI,2025-03-13 16:58:19+00:00,"48.8236825874564, 2.3077843710780144",Malakoff,92046,0.12,17
19012,Lally-Tollendal - Armand Carrel,OUI,27,20,7,1,6,OUI,OUI,2025-03-13 17:01:42+00:00,"48.88270066221072, 2.374717555940151",Paris,75056,0.25925925925925924,17
22502,Kléber - National,OUI,20,19,1,0,1,OUI,OUI,2025-03-13 17:00:32+00:00,"48.906333898712234, 2.2393910586833954",La Garenne-Colombes,92035,0.05,17
31001,Lagny - Auguste Blanqui,OUI,26,21,5,5,0,OUI,OUI,2025-03-13 17:02:08+00:00,"48.84922568052601, 2.4218603968620305",Montreuil,93048,0.19230769230769232,17
4015,Mairie du 4ème,OUI,40,2,38,34,4,OUI,OUI,2025-03-13 17:02:03+00:00,"48.855949910497, 2.3563823103905",Paris,75056,0.95,17
3006,Mairie du 3ème,OUI,23,2,21,13,8,OUI,OUI,2025-03-13 17:01:44+00:00,"48.86446178139141, 2.361762821674347",Paris,75056,0.9130434782608695,17
3003,Fille du Calvaire - Turenne,OUI,25,2,23,20,3,OUI,OUI,2025-03-13 16:59:15+00:00,"48.86210505412563, 2.3649600148200993",Paris,75056,0.92,17
5122,Saint-Michel - Luxembourg,OUI,28,27,1,0,1,OUI,OUI,2025-03-13 17:01:10+00:00,"48.84501507626, 2.3394941166043",Paris,75056,0.03571428571428571,17
19111,Cesaria Evora - Rosa Parks,OUI,35,32,3,3,0,OUI,OUI,2025-03-13 17:01:09+00:00,"48.89717672825043, 2.3745173960924144",Paris,75056,0.08571428571428572,17
21110,Parc Roger Salengro,OUI,31,11,20,19,1,OUI,OUI,2025-03-13 17:01:58+00:00,"48.905303858642, 2.31055945158",Clichy,92024,0.6451612903225806,17
9111,Victoire - Laffitte,OUI,19,9,10,10,0,OUI,OUI,2025-03-13 17:00:33+00:00,"48.87514373494672, 2.338118505144376",Paris,75056,0.5263157894736842,17
8036,Lisbonne - Monceau,OUI,46,17,29,11,18,OUI,OUI,2025-03-13 16:59:43+00:00,"48.877455676814, 2.3096942214195",Paris,75056,0.6304347826086957,17
13125,Gare d'Austerlitz - Pont Charles de Gaulle,OUI,53,19,34,30,4,OUI,OUI,2025-03-13 17:02:24+00:00,"48.842319830109, 2.3670300096273",Paris,75056,0.6415094339622641,17
6031,Pierre Sarrazin - Saint-Michel,OUI,31,10,21,18,3,OUI,OUI,2025-03-13 17:02:28+00:00,"48.850908146398, 2.342130728066",Paris,75056,0.6774193548387096,17
14133,Froidevaux - Boulard,OUI,34,30,4,2,2,OUI,OUI,2025-03-13 16:59:28+00:00,"48.835147319625, 2.3294411972165",Paris,75056,0.11764705882352941,17
48005,Eugène Varlin - Place de la Paix,OUI,23,20,3,1,2,OUI,OUI,2025-03-13 17:02:07+00:00,"48.792862, 2.363093",Villejuif,94076,0.13043478260869565,17
21215,Verdier - Jean Jaurès,OUI,33,33,0,0,0,OUI,OUI,2025-03-13 16:59:41+00:00,"48.81614048711214, 2.3123561963438988",Montrouge,92049,0.0,17
4012,Tiron - Rivoli,OUI,27,0,27,23,4,OUI,OUI,2025-03-13 17:00:43+00:00,"48.855692253233, 2.3579058051109",Paris,75056,1.0,17
41208,Alouettes - Maréchal de Lattre de Tassigny,OUI,21,16,5,1,4,OUI,OUI,2025-03-13 17:01:42+00:00,"48.85511009293948, 2.4930700287222862",Fontenay-sous-Bois,94033,0.23809523809523808,17
42704,Mairie du Kremlin-Bicêtre,OUI,25,24,1,1,0,OUI,OUI,2025-03-13 17:01:48+00:00,"48.81191981537702, 2.3570189997553825",Le Kremlin-Bicêtre,94043,0.04,17
21706,Jean Bleuzen - Square du 11 Novembre,OUI,45,44,1,0,1,OUI,OUI,2025-03-13 16:55:36+00:00,"48.8232579, 2.2965213",Vanves,92075,0.022222222222222223,17
1014,Rivoli - Musée du Louvre,OUI,19,4,15,9,6,OUI,OUI,2025-03-13 17:01:35+00:00,"48.86364636851945, 2.33409583568573",Paris,75056,0.7894736842105263,17
4017,Place de l'Hôtel de Ville,OUI,13,5,8,8,0,OUI,OUI,2025-03-13 17:01:15+00:00,"48.8573314, 2.351458",Paris,75056,0.6153846153846154,17
26006,Bas - Gabriel Péri,OUI,30,15,15,14,1,OUI,OUI,2025-03-13 17:02:11+00:00,"48.91585580539625, 2.2948095202445984",Asnières-sur-Seine,92004,0.5,17
2012,Choiseul - Quatre Septembre,OUI,43,21,22,11,11,OUI,OUI,2025-03-13 17:02:06+00:00,"48.8699355331869, 2.3359975218772893",Paris,75056,0.5116279069767442,17
42211,Séminaire de Conflans - Liberté,OUI,24,23,1,1,0,OUI,OUI,2025-03-13 17:01:42+00:00,"48.823194, 2.404179",Charenton-le-Pont,94018,0.041666666666666664,17
3002,Saint-Gilles - Turenne,OUI,14,3,11,5,6,OUI,OUI,2025-03-13 17:02:01+00:00,"48.858158956779, 2.3647149920992",Paris,75056,0.7857142857142857,17
42026,Barbès - Monique Maunoury,OUI,40,36,4,0,4,OUI,OUI,2025-03-13 17:02:27+00:00,"48.81552718820216, 2.3687169334905405",Ivry-sur-Seine,94041,0.1,17
2004,Square Pierre Lazareff,OUI,17,5,12,5,7,OUI,OUI,2025-03-13 17:01:44+00:00,"48.867141720746, 2.3483933508396",Paris,75056,0.7058823529411765,17
12163,Hippodrome Paris-Vincennes,OUI,42,41,1,0,1,OUI,OUI,2025-03-13 17:02:19+00:00,"48.82048387758518, 2.446271181106568",Paris,75056,0.023809523809523808,17
35012,Candale - Mehul,OUI,25,19,6,0,6,OUI,OUI,2025-03-13 16:59:57+00:00,"48.8893935006175, 2.414379715919495",Pantin,93055,0.24,17
21509,Gardenat Lapostol - Franklin Roosevelt,OUI,24,21,3,0,3,OUI,OUI,2025-03-13 17:02:26+00:00,"48.871839, 2.222505",Suresnes,92073,0.125,17
4018,Saint-Bon - Rivoli,OUI,16,5,11,10,1,OUI,OUI,2025-03-13 17:01:39+00:00,"48.857999643315, 2.3502172809763",Paris,75056,0.6875,17
13054,Pau Casals - Neuve Tolbiac,OUI,52,29,23,15,8,OUI,OUI,2025-03-13 17:02:22+00:00,"48.8311602, 2.3774395",Paris,75056,0.4423076923076923,17
44001,Quai Jules Guesde - Saint-Simon,OUI,30,3,27,27,0,OUI,OUI,2025-03-13 17:01:32+00:00,"48.80391487219, 2.4089661620274",Vitry-sur-Seine,94081,0.9,17
1012,Jean-Jacques Rousseau - Deux Ecus,OUI,21,9,12,9,3,OUI,OUI,2025-03-13 17:00:54+00:00,"48.86297805972131, 2.3414635285735126",Paris,75056,0.5714285714285714,17
4007,Place de la Bastille - Bourdon,OUI,29,8,21,12,9,OUI,OUI,2025-03-13 17:01:22+00:00,"48.852364355271, 2.3681089282036",Paris,75056,0.7241379310344828,17
19130,Place Paul Delouvrier,OUI,26,24,2,1,1,OUI,OUI,2025-03-13 16:58:40+00:00,"48.89197621431365, 2.3851288855075836",Paris,75056,0.07692307692307693,17
22506,Gare des Vallées,OUI,18,13,5,1,4,OUI,OUI,2025-03-13 17:00:32+00:00,"48.913179, 2.257726",La Garenne-Colombes,92035,0.2777777777777778,17
21505,Édouard Vaillant - Place Jean Jaurès,OUI,21,15,6,3,3,OUI,OUI,2025-03-13 16:58:20+00:00,"48.86265537999924, 2.2089037319128613",Suresnes,92073,0.2857142857142857,17
18015,Custine - Ramey,OUI,41,31,10,2,8,OUI,OUI,2025-03-13 16:59:30+00:00,"48.888735896947, 2.3469526693225",Paris,75056,0.24390243902439024,17
2016,Aboukir - Alexandrie,OUI,21,10,11,9,2,OUI,OUI,2025-03-13 17:01:57+00:00,"48.86868344444473, 2.3502043269474897",Paris,75056,0.5238095238095238,17
1116,Ventadour - Opéra,OUI,27,5,22,16,6,OUI,OUI,2025-03-13 17:00:37+00:00,"48.866810653323, 2.3343884482519",Paris,75056,0.8148148148148148,17
16044,Porte de Saint Cloud - Parc des Princes,OUI,31,17,14,12,2,OUI,OUI,2025-03-13 17:02:03+00:00,"48.838662757066, 2.2525164484978",Paris,75056,0.45161290322580644,17
1017,Saint-Honoré - 29 juillet,OUI,19,9,10,7,3,OUI,OUI,2025-03-13 17:01:17+00:00,"48.86557114282421, 2.330567417577153",Paris,75056,0.5263157894736842,17
5004,Saint-Jacques - Val de Grâce,OUI,19,16,3,0,3,OUI,OUI,2025-03-13 16:59:24+00:00,"48.8417514, 2.3413893",Paris,75056,0.15789473684210525,17
15040,Saint-Amand - Labrouste,OUI,34,25,9,5,4,OUI,OUI,2025-03-13 16:56:19+00:00,"48.834097274832295, 2.3087677359581",Paris,75056,0.2647058823529412,17
4009,Village Saint-Paul,OUI,27,3,24,21,3,OUI,OUI,2025-03-13 17:01:05+00:00,"48.852639866625, 2.3607301712036",Paris,75056,0.8888888888888888,17
6026,Saint-Placide - Cherche Midi,OUI,65,50,15,14,1,OUI,OUI,2025-03-13 17:02:18+00:00,"48.8490535919234, 2.325317971408367",Paris,75056,0.23076923076923078,17
10041,Gare du Nord - La Chapelle,OUI,18,16,2,0,2,OUI,OUI,2025-03-13 17:00:12+00:00,"48.884178287286, 2.3561057075858",Paris,75056,0.1111111111111111,17
19202,Marseillaise - Grenade,OUI,44,38,6,1,5,OUI,OUI,2025-03-13 17:01:29+00:00,"48.889371092747, 2.3979396821544",Paris,75056,0.13636363636363635,17
4101,Bastille - Beaumarchais,OUI,20,4,16,13,3,OUI,OUI,2025-03-13 17:02:08+00:00,"48.853833463852, 2.3685702681541",Paris,75056,0.8,17
14201,Decrès - Alésia,OUI,30,28,2,1,1,OUI,OUI,2025-03-13 16:56:07+00:00,"48.832200060759, 2.3139070151575",Paris,75056,0.06666666666666667,17
33020,Waldeck Rochet - Germaine Tillon,OUI,29,14,15,13,2,OUI,OUI,2025-03-13 16:58:11+00:00,"48.91105960199651, 2.3676301538944244",Aubervilliers,93001,0.5172413793103449,17
32019,Place du 8 mai 1945.,OUI,28,16,12,7,5,OUI,OUI,2025-03-13 16:59:53+00:00,"48.938882272105, 2.3566243797541",Saint-Denis,93066,0.42857142857142855,17
6007,Bréa - Raspail,OUI,24,21,3,0,3,OUI,OUI,2025-03-13 17:01:57+00:00,"48.842738478258, 2.3297942217634",Paris,75056,0.125,17
9039,Chaussée d'Antin - Haussmann,OUI,22,15,7,4,3,OUI,OUI,2025-03-13 17:02:16+00:00,"48.87243, 2.33359",Paris,75056,0.3181818181818182,17
22603,Place de la Division Leclerc,OUI,33,31,2,0,2,OUI,OUI,2025-03-13 16:52:27+00:00,"48.793824988636516, 2.2731140430551027",Fontenay-aux-Roses,92032,0.06060606060606061,17
1025,Oratoire - Rivoli,OUI,17,6,11,7,4,OUI,OUI,2025-03-13 16:56:00+00:00,"48.861342760889, 2.3400047421455",Paris,75056,0.6470588235294118,17
16201,Porte Dauphine,OUI,59,57,2,1,1,OUI,OUI,2025-03-13 17:01:56+00:00,"48.871139344351, 2.2749781616017",Paris,75056,0.03389830508474576,17
1018,Alger - Rivoli,OUI,17,8,9,4,5,OUI,OUI,2025-03-13 17:02:26+00:00,"48.864773553495, 2.3294493936128",Paris,75056,0.5294117647058824,17
23042,André Theuriet - Blagis,OUI,30,23,7,6,1,OUI,OUI,2025-03-13 16:59:55+00:00,"48.77977325745441, 2.3130525648593903",Bourg-la-Reine,92014,0.23333333333333334,17
2008,Mairie du 2ème,OUI,28,11,17,14,3,OUI,OUI,2025-03-13 16:59:46+00:00,"48.8672190355135, 2.3404625437747044",Paris,75056,0.6071428571428571,17
1026,Place du Lieutenant Henri Karcher,OUI,28,7,21,18,3,OUI,OUI,2025-03-13 17:02:08+00:00,"48.863490871724466, 2.3400671035051346",Paris,75056,0.75,17
32020,Jules Guesdes - Carnot,OUI,14,13,1,1,0,OUI,OUI,2025-03-13 16:57:16+00:00,"48.93828169931872, 2.3508992046117783",Saint-Denis,93066,0.07142857142857142,17
23101,Grande Rue - Europe,OUI,25,12,13,8,5,OUI,OUI,2025-03-13 16:57:06+00:00,"48.8218104687602, 2.205879874527455",Sèvres,92072,0.52,17
27006,Victor Hugo - Gare,OUI,19,8,11,7,4,OUI,OUI,2025-03-13 17:02:21+00:00,"48.923133952658, 2.2600970417261",Colombes,92025,0.5789473684210527,17
17106,Berthier - Porte de Clichy,OUI,24,19,5,4,1,OUI,OUI,2025-03-13 17:02:06+00:00,"48.894222687781, 2.3125872006816",Paris,75056,0.20833333333333334,17
1015,Place André Malraux,OUI,17,3,14,7,7,OUI,OUI,2025-03-13 16:58:37+00:00,"48.863925158727, 2.3356226831675",Paris,75056,0.8235294117647058,17
32024,Port - Confluence,OUI,23,9,14,3,11,OUI,OUI,2025-03-13 16:59:37+00:00,"48.936093926526, 2.3436167797955",Saint-Denis,93066,0.6086956521739131,17
1008,Les Halles - Saint-Eustache,OUI,32,8,24,10,14,OUI,OUI,2025-03-13 17:02:18+00:00,"48.86362695901683, 2.342623919248581",Paris,75056,0.75,17
23107,Gare de Sèvres - Ville d'Avray,OUI,22,21,1,0,1,OUI,OUI,2025-03-13 16:57:19+00:00,"48.826262366227, 2.2001516849313",Sèvres,92072,0.045454545454545456,17
2006,Place des Victoires,OUI,22,11,11,10,1,OUI,OUI,2025-03-13 17:02:11+00:00,"48.8660354, 2.3420333",Paris,75056,0.5,17
6201,Saint Pères - Saint Germain,OUI,20,16,4,2,2,OUI,OUI,2025-03-13 16:59:32+00:00,"48.853729675265, 2.3300181032703",Paris,75056,0.2,17
9019,Victor Massé - Jean-Baptiste Pigalle,OUI,17,14,3,1,2,OUI,OUI,2025-03-13 17:00:52+00:00,"48.8811043724, 2.3366955667734",Paris,75056,0.17647058823529413,17
22601,Marx Dormoy - Château Sainte-Barbe,OUI,20,16,4,1,3,OUI,OUI,2025-03-13 16:57:17+00:00,"48.791782341055324, 2.297856844961643",Fontenay-aux-Roses,92032,0.2,17
44004,Place de l'Eglise - Vitry-sur-Seine,OUI,28,0,28,25,3,OUI,OUI,2025-03-13 16:58:42+00:00,"48.791922819921815, 2.395057752728462",Vitry-sur-Seine,94081,1.0,17
42018,Amédée Huon - Fort d'Ivry,OUI,30,27,3,0,3,OUI,OUI,2025-03-13 17:01:08+00:00,"48.805131376899986, 2.388489693403244",Ivry-sur-Seine,94041,0.1,17
12164,Stade Pershing,OUI,26,26,0,0,0,NON,NON,2025-02-26 05:58:32+00:00,"48.829107826857, 2.4583535268903",Paris,75056,0.0,6
10201,Magenta - Chabrol,OUI,23,19,4,0,4,OUI,OUI,2025-03-13 16:59:57+00:00,"48.876495350882, 2.3560990020633",Paris,75056,0.17391304347826086,17
1023,Saint-Honoré - Musée du Louvre,OUI,21,6,15,7,8,OUI,OUI,2025-03-13 17:02:21+00:00,"48.863443132848, 2.3348781846405",Paris,75056,0.7142857142857143,17
23301,Les Blagis,OUI,24,13,11,7,4,OUI,OUI,2025-03-13 17:01:52+00:00,"48.785205, 2.302526",Sceaux,92071,0.4583333333333333,17
48008,Guy Môquet - Parvis Georges Marchais,OUI,30,29,1,0,1,OUI,OUI,2025-03-13 16:52:57+00:00,"48.79518840095975, 2.35943466424942",Villejuif,94076,0.03333333333333333,17
34013,Blanqui - Docteur Bauer,OUI,21,18,3,3,0,OUI,OUI,2025-03-13 17:02:03+00:00,"48.907735489085, 2.3407192814591",Saint-Ouen-sur-Seine,93070,0.14285714285714285,17
5003,Le Goff - Gay-Lussac,OUI,34,24,10,2,8,OUI,OUI,2025-03-13 16:58:46+00:00,"48.846102400979, 2.3412207886577",Paris,75056,0.29411764705882354,17
44008,Youri Gagarine - Commune de Paris,OUI,32,10,22,11,11,OUI,OUI,2025-03-13 17:00:11+00:00,"48.782427463041, 2.3939734697342",Vitry-sur-Seine,94081,0.6875,17
27001,Square Victor Basch,OUI,18,3,15,11,4,OUI,OUI,2025-03-13 17:01:46+00:00,"48.914304862261, 2.2289156913757",Colombes,92025,0.8333333333333334,17
23104,Quai de Sèvres - Manufacture Nationale,OUI,27,18,9,5,4,OUI,OUI,2025-03-13 16:58:53+00:00,"48.828688, 2.22499",Sèvres,92072,0.3333333333333333,17
17021,Jouffroy d'Abbans - Villiers,OUI,31,28,3,2,1,OUI,OUI,2025-03-13 17:02:26+00:00,"48.884215547037, 2.3056533560157",Paris,75056,0.0967741935483871,17
21011,Silly - Louis Blériot,OUI,23,13,10,3,7,OUI,OUI,2025-03-13 17:00:02+00:00,"48.83219045374266, 2.2340199351310734",Boulogne-Billancourt,92012,0.43478260869565216,17
3007,Archives - Pastourelle,OUI,26,10,16,12,4,OUI,OUI,2025-03-13 17:01:40+00:00,"48.8623615, 2.3595041",Paris,75056,0.6153846153846154,17
20140,Paganini - Davout,OUI,22,20,2,2,0,OUI,OUI,2025-03-13 16:57:43+00:00,"48.85135, 2.412021",Paris,75056,0.09090909090909091,17
31020,Résistance - Parmentier,OUI,33,28,5,2,3,OUI,OUI,2025-03-13 17:02:08+00:00,"48.85965138131299, 2.436705082654953",Montreuil,93048,0.15151515151515152,17
15018,Dutot - Place Alleray,OUI,54,50,4,2,2,OUI,OUI,2025-03-13 17:01:33+00:00,"48.836826091766, 2.3071701095578",Paris,75056,0.07407407407407407,17
28005,Jean Jaurès - Paul Lafargue,OUI,27,6,21,6,15,OUI,OUI,2025-03-13 16:59:34+00:00,"48.884933177666, 2.2484488785267",Puteaux,92062,0.7777777777777778,17
45004,République - Louis Loucheur,OUI,37,2,35,5,30,OUI,OUI,2025-03-13 17:01:54+00:00,"48.823549261189, 2.5101865455508",Champigny-sur-Marne,94017,0.9459459459459459,17
35005,Quai de l'Aisne - Général Leclerc,OUI,25,25,0,0,0,OUI,OUI,2025-03-13 16:54:45+00:00,"48.895713, 2.400571",Pantin,93055,0.0,17
13049,Vincent Auriol - Louise Weiss,OUI,22,12,10,8,2,OUI,OUI,2025-03-13 17:01:02+00:00,"48.834001935501, 2.3703888058662",Paris,75056,0.45454545454545453,17
18112,Arthur Ranc - Hôpital Bichat,OUI,25,24,1,0,1,OUI,OUI,2025-03-13 16:57:48+00:00,"48.8978712500682, 2.333521842956543",Paris,75056,0.04,17
32011,Stade de France - Francis de Pressensé,OUI,43,35,8,2,6,OUI,OUI,2025-03-13 17:01:39+00:00,"48.919141953558, 2.3620655760169",Saint-Denis,93066,0.18604651162790697,17
16139,Suresnes - Muette à Neuilly,OUI,29,21,8,5,3,OUI,OUI,2025-03-13 16:58:56+00:00,"48.868570404348, 2.266000919044",Paris,75056,0.27586206896551724,17
8040,Pierre Charron - Champs-Elysées,OUI,30,19,11,4,7,OUI,OUI,2025-03-13 17:01:33+00:00,"48.870103359864, 2.3043501377106",Paris,75056,0.36666666666666664,17
42028,Verdun - Carnot,OUI,28,27,1,0,1,OUI,OUI,2025-03-13 17:01:08+00:00,"48.808439376064946, 2.373795211315155",Ivry-sur-Seine,94041,0.03571428571428571,17
8018,Saint-Augustin,OUI,30,16,14,9,5,OUI,OUI,2025-03-13 16:59:09+00:00,"48.8762009747008, 2.319786250591278",Paris,75056,0.4666666666666667,17
12166,Parc Floral du Bel Air,OUI,23,16,7,5,2,OUI,OUI,2025-03-13 17:02:21+00:00,"48.839285711865735, 2.438560165464878",Paris,75056,0.30434782608695654,17
12113,Cardinal Lavigerie,OUI,46,11,35,33,2,OUI,OUI,2025-03-13 17:02:10+00:00,"48.832934193699835, 2.402636749399156",Paris,75056,0.7608695652173914,17
20142,Mûriers - Père Lachaise,OUI,20,18,2,1,1,OUI,OUI,2025-03-13 16:57:59+00:00,"48.864130509668044, 2.39164982067019",Paris,75056,0.1,17
21119,Belfort - Victor Hugo,OUI,21,9,12,11,1,OUI,OUI,2025-03-13 17:02:09+00:00,"48.9018492, 2.3172724",Clichy,92024,0.5714285714285714,17
18135,Ney - Porte de Montmartre,OUI,23,20,3,0,3,OUI,OUI,2025-03-13 16:53:59+00:00,"48.897918, 2.3364872",Paris,75056,0.13043478260869565,17
16010,Belles Feuilles - Place de Mexico,OUI,21,20,1,0,1,OUI,OUI,2025-03-13 17:01:50+00:00,"48.865804746474, 2.2829206287861",Paris,75056,0.047619047619047616,17
24101,Place Charles de Gaulle,OUI,23,21,2,0,2,OUI,OUI,2025-03-13 17:00:39+00:00,"48.826073335699, 2.1894485725692",Ville-d'Avray,92077,0.08695652173913043,17
42019,Lampes,OUI,43,4,39,39,0,OUI,OUI,2025-03-13 17:00:40+00:00,"48.81152481985875, 2.4017931148409843",Ivry-sur-Seine,94041,0.9069767441860465,17
34011,Clef des Champs - Albert Dhalenne,OUI,26,23,3,0,3,OUI,OUI,2025-03-13 17:02:28+00:00,"48.914938, 2.330665",Saint-Ouen-sur-Seine,93070,0.11538461538461539,17
1024,Coquillière - Louvre,OUI,17,5,12,6,6,OUI,OUI,2025-03-13 17:01:16+00:00,"48.863795909662, 2.3425736278296",Paris,75056,0.7058823529411765,17
21329,Gare - Aristide Briand,OUI,28,7,21,20,1,OUI,OUI,2025-03-13 17:01:42+00:00,"48.821410564722, 2.2555950104387",Issy-les-Moulineaux,92040,0.75,17
19046,Porte de Pantin.,OUI,33,32,1,0,1,OUI,OUI,2025-03-13 16:56:30+00:00,"48.889199725577, 2.3950181901455",Paris,75056,0.030303030303030304,17
19121,Belleville -  Pré Saint-Gervais,OUI,21,20,1,0,1,OUI,OUI,2025-03-13 17:01:44+00:00,"48.875565910073, 2.3930460959673",Paris,75056,0.047619047619047616,17
2102,Saint-Marc - Feydeau,OUI,35,16,19,14,5,OUI,OUI,2025-03-13 17:01:59+00:00,"48.870326843044, 2.3418715826353",Paris,75056,0.5428571428571428,17
13015,Chevaleret - Louise Weiss,OUI,34,3,31,30,1,OUI,OUI,2025-03-13 17:02:05+00:00,"48.832586513351, 2.37121138812",Paris,75056,0.9117647058823529,17
2020,Danielle Casanova - Opéra,OUI,20,1,19,9,10,OUI,OUI,2025-03-13 17:02:00+00:00,"48.867643242297, 2.3333894088864",Paris,75056,0.95,17
19114,Manin - Secrétan,OUI,19,17,2,0,2,OUI,OUI,2025-03-13 17:02:28+00:00,"48.8791665, 2.3787959",Paris,75056,0.10526315789473684,17
6029,Vaugirard - Monsieur le Prince,OUI,23,16,7,1,6,OUI,OUI,2025-03-13 17:02:26+00:00,"48.848951441614, 2.3411329463124",Paris,75056,0.30434782608695654,17
12123,Château de Vincennes,OUI,49,46,3,1,2,OUI,OUI,2025-03-13 17:02:22+00:00,"48.84423193255657, 2.439209537709179",Paris,75056,0.061224489795918366,17
12016,Saint-Mande - Picpus,OUI,32,28,4,1,3,OUI,OUI,2025-03-13 17:01:22+00:00,"48.845127728278, 2.4015686296482",Paris,75056,0.125,17
21002,Place Denfert-Rochereau,OUI,20,15,5,2,3,OUI,OUI,2025-03-13 16:59:04+00:00,"48.843252536286684, 2.245987951755524",Boulogne-Billancourt,92012,0.25,17
42210,Victor Hugo - Paul Eluard,OUI,31,2,29,25,4,OUI,OUI,2025-03-13 16:57:39+00:00,"48.819602554907, 2.4114319673051",Charenton-le-Pont,94018,0.9354838709677419,17
13024,Bobillot - Tolbiac,OUI,32,26,6,2,4,OUI,OUI,2025-03-13 17:01:12+00:00,"48.8255961335041, 2.350204177200794",Paris,75056,0.1875,17
48012,Stalingrad - Henri Luisette,OUI,25,23,2,1,1,OUI,OUI,2025-03-13 16:59:14+00:00,"48.78363092456589, 2.366935946761926",Villejuif,94076,0.08,17
24004,Paix - Verdun,OUI,31,24,7,2,5,OUI,OUI,2025-03-13 17:02:26+00:00,"48.900504, 2.261173",Courbevoie,92026,0.22580645161290322,17
23303,Gare de Robinson,OUI,29,29,0,0,0,OUI,OUI,2025-03-13 16:56:38+00:00,"48.7799259211605, 2.281828634440899",Sceaux,92071,0.0,17
24005,Edith Cavell - Volta,OUI,32,29,3,2,1,OUI,OUI,2025-03-13 17:00:57+00:00,"48.901616564286975, 2.269354350864887",Courbevoie,92026,0.09375,17
20010,Sorbier - Gasnier-Guy,OUI,34,32,2,0,2,OUI,OUI,2025-03-13 17:01:56+00:00,"48.865217631011, 2.3936596512794",Paris,75056,0.058823529411764705,17
31104,Mairie de Rosny-sous-Bois,OUI,26,12,14,8,6,OUI,OUI,2025-03-13 17:00:23+00:00,"48.871256519012, 2.4865807592869",Rosny-sous-Bois,93064,0.5384615384615384,17
42022,Gare RER - Maurice Grandcoing,OUI,37,12,25,24,1,OUI,OUI,2025-03-13 17:00:23+00:00,"48.813881, 2.392429",Ivry-sur-Seine,94041,0.6756756756756757,17
42024,Danielle Casanova - Ledru-Rollin,OUI,28,0,28,25,3,OUI,OUI,2025-03-13 16:57:52+00:00,"48.815783497876815, 2.383259721100331",Ivry-sur-Seine,94041,1.0,17
26012,Jardin Modèle - Pierre Boudou,OUI,14,4,10,4,6,OUI,OUI,2025-03-13 17:00:29+00:00,"48.914866710946, 2.3057010525935",Asnières-sur-Seine,92004,0.7142857142857143,17
5027,Gobelins - Port-Royal,OUI,36,7,29,27,2,OUI,OUI,2025-03-13 17:02:02+00:00,"48.837135900263, 2.3515201359987",Paris,75056,0.8055555555555556,17
20048,Bagnolet - Place Saint-Blaise,OUI,24,24,0,0,0,OUI,OUI,2025-03-13 17:00:39+00:00,"48.85973, 2.40334",Paris,75056,0.0,17
11111,Léon Frot - Charonne,OUI,18,6,12,10,2,OUI,OUI,2025-03-13 16:59:00+00:00,"48.854963800335234, 2.387217085372007",Paris,75056,0.6666666666666666,17
10166,Strasbourg - Saint-Denis,OUI,16,3,13,9,4,OUI,OUI,2025-03-13 17:02:22+00:00,"48.869601642433, 2.3542908579111",Paris,75056,0.8125,17
15012,Cambronne - Mademoiselle,OUI,65,55,10,7,3,OUI,OUI,2025-03-13 17:01:56+00:00,"48.843277330035214, 2.30230766886348",Paris,75056,0.15384615384615385,17
23202,Henri Barbusse - Gabriel Péri,OUI,16,15,1,0,1,OUI,OUI,2025-03-13 17:00:06+00:00,"48.801773795836, 2.2874166362216",Châtillon,92020,0.0625,17
18016,Francoeur - Caulaincourt,OUI,33,25,8,0,8,OUI,OUI,2025-03-13 17:01:34+00:00,"48.8899944409612, 2.342529706656933",Paris,75056,0.24242424242424243,17
6015,André Mazet - Saint-André des Arts,OUI,54,0,54,43,11,OUI,OUI,2025-03-13 17:01:44+00:00,"48.85375581057431, 2.3390958085656166",Paris,75056,1.0,17
19117,Euryale Dehaynin - Loire,OUI,30,23,7,2,5,OUI,OUI,2025-03-13 17:02:27+00:00,"48.886248917304805, 2.3774591088294987",Paris,75056,0.23333333333333334,17
32605,Mairie,OUI,20,20,0,0,0,OUI,OUI,2025-03-13 17:00:51+00:00,"48.87914304162, 2.4163350908311",Les Lilas,93045,0.0,17
15053,Lecourbe - Convention,OUI,44,23,21,14,7,OUI,OUI,2025-03-13 17:01:59+00:00,"48.83923319241899, 2.2915197908878326",Paris,75056,0.4772727272727273,17
17202,Mariotte - Batignolles,OUI,17,16,1,1,0,OUI,OUI,2025-03-13 16:57:59+00:00,"48.884571659595, 2.321469503475",Paris,75056,0.058823529411764705,17
21022,Dôme - République,OUI,24,4,20,18,2,OUI,OUI,2025-03-13 17:01:51+00:00,"48.832681, 2.250257",Boulogne-Billancourt,92012,0.8333333333333334,17
8202,Londres - Europe,OUI,27,21,6,3,3,OUI,OUI,2025-03-13 17:02:22+00:00,"48.878618556803, 2.3248164693922",Paris,75056,0.2222222222222222,17
41103,Place de la vache noire,OUI,23,21,2,0,2,OUI,OUI,2025-03-13 16:58:27+00:00,"48.81040517059777, 2.327060401439667",Arcueil,94003,0.08695652173913043,17
17020,Jouffroy d'Abbans - Malesherbes,OUI,26,25,1,1,0,OUI,OUI,2025-03-13 17:00:57+00:00,"48.8850134, 2.3070717",Paris,75056,0.038461538461538464,17
41602,Place Charles Digeon,OUI,31,30,1,1,0,OUI,OUI,2025-03-13 17:01:51+00:00,"48.84354203133597, 2.418427169322968",Saint-Mandé,94067,0.03225806451612903,17
12202,Charenton - Wattignies,OUI,40,22,18,15,3,OUI,OUI,2025-03-13 17:02:11+00:00,"48.836919119234, 2.3916775206425",Paris,75056,0.45,17
20012,Buzenval - Vignoles,OUI,17,13,4,1,3,OUI,OUI,2025-03-13 17:00:07+00:00,"48.853858171688, 2.4000040814281",Paris,75056,0.23529411764705882,17
23206,Béranger - Félix Faure,OUI,26,20,6,0,6,OUI,OUI,2025-03-13 17:00:42+00:00,"48.80404828621485, 2.2848263373723436",Châtillon,92020,0.23076923076923078,17
14004,Port Royal - Hôpital Cochin,OUI,20,17,3,2,1,OUI,OUI,2025-03-13 17:00:51+00:00,"48.838608030238, 2.3406994164846",Paris,75056,0.15,17
10202,Bichat - Grange aux Belles,OUI,29,25,4,3,1,OUI,OUI,2025-03-13 16:58:39+00:00,"48.873688, 2.365015",Paris,75056,0.13793103448275862,17
48002,LCL Campus - Place Oscar Niemeyer,OUI,36,32,4,2,2,OUI,OUI,2025-03-13 17:01:54+00:00,"48.805342480621576, 2.363983690738678",Villejuif,94076,0.1111111111111111,17
42030,Stéphanie Bouvard - Gambetta,OUI,29,22,7,7,0,OUI,OUI,2025-03-13 17:01:42+00:00,"48.814548138856, 2.4024386957288",Ivry-sur-Seine,94041,0.2413793103448276,17
41605,Général De Gaulle - Vivien,OUI,21,19,2,0,2,OUI,OUI,2025-03-13 17:01:23+00:00,"48.83607420090204, 2.4189166724681854",Saint-Mandé,94067,0.09523809523809523,17
30003,Moscou - Edouard Vaillant,OUI,29,21,8,4,4,OUI,OUI,2025-03-13 17:00:36+00:00,"48.90755810177, 2.4689837335263",Bobigny,93008,0.27586206896551724,17
48001,Chastenet de Géry - Marcel Paul,OUI,25,20,5,0,5,OUI,OUI,2025-03-13 17:01:45+00:00,"48.800123, 2.3567359",Villejuif,94076,0.2,17
20020,Pyrénées - Charles Renouvier,OUI,29,29,0,0,0,OUI,OUI,2025-03-13 17:00:20+00:00,"48.86095933229224, 2.400421852042113",Paris,75056,0.0,17
51008,Martyrs de Châteaubriant - Jean Grandel,OUI,38,30,8,1,7,OUI,OUI,2025-03-13 17:00:22+00:00,"48.951432, 2.211214",Argenteuil,95018,0.21052631578947367,17
12008,Hector Malot - Daumesnil,OUI,52,0,52,48,4,OUI,OUI,2025-03-13 17:01:54+00:00,"48.84693552991762, 2.3770876228809357",Paris,75056,1.0,17
21704,Place du Maréchal de Lattre de Tassigny,OUI,26,14,12,7,5,OUI,OUI,2025-03-13 17:01:57+00:00,"48.821707715257055, 2.2853431485432423",Vanves,92075,0.46153846153846156,17
13120,Pierre Joseph Desault,OUI,18,9,9,9,0,OUI,OUI,2025-03-13 17:00:42+00:00,"48.82110230800372, 2.378775402903557",Paris,75056,0.5,17
25007,Bons Raisins - Voltaire,OUI,24,22,2,1,1,OUI,OUI,2025-03-13 17:01:15+00:00,"48.87282451461399, 2.1947155570850896",Rueil-Malmaison,92063,0.08333333333333333,17
12119,Dom-Pérignon - Gravelle,OUI,46,30,16,10,6,OUI,OUI,2025-03-13 17:02:25+00:00,"48.825481574435, 2.409880310297",Paris,75056,0.34782608695652173,17
23041,Général Leclerc - Bièvre,OUI,24,22,2,1,1,OUI,OUI,2025-03-13 17:02:29+00:00,"48.782414428747316, 2.3166695237159733",Bourg-la-Reine,92014,0.08333333333333333,17
13006,Duméril - Jeanne d'Arc,OUI,40,30,10,6,4,OUI,OUI,2025-03-13 16:58:18+00:00,"48.838151608087, 2.3571084495564",Paris,75056,0.25,17
15203,Porte de Versailles,OUI,26,19,7,4,3,OUI,OUI,2025-03-13 17:00:35+00:00,"48.832324016657, 2.2875617349045",Paris,75056,0.2692307692307692,17
15050,Dominique Pado - Croix Nivert,OUI,21,10,11,8,3,OUI,OUI,2025-03-13 16:59:13+00:00,"48.83648798164934, 2.2897250577807426",Paris,75056,0.5238095238095238,17
13116,Place du Docteur Yersin,OUI,50,48,2,0,2,OUI,OUI,2025-03-13 16:53:28+00:00,"48.82010494991975, 2.3725583776831627",Paris,75056,0.04,17
13036,Olympiades,OUI,36,31,5,2,3,OUI,OUI,2025-03-13 17:01:57+00:00,"48.826764665199, 2.3650860786438",Paris,75056,0.1388888888888889,17
48006,Maxime Gorki - Paul Vaillant-Couturier,OUI,19,18,1,0,1,OUI,OUI,2025-03-13 16:53:25+00:00,"48.79673508795443, 2.3683342337608337",Villejuif,94076,0.05263157894736842,17
43004,Montreuil - République,OUI,22,19,3,3,0,OUI,OUI,2025-03-13 17:02:21+00:00,"48.85026349463687, 2.4345204234123234",Vincennes,94080,0.13636363636363635,17
20003,Pyrénées - Cours de Vincennes,OUI,19,14,5,1,4,OUI,OUI,2025-03-13 17:01:31+00:00,"48.847796779935, 2.4061721563339",Paris,75056,0.2631578947368421,17
14009,Tombe Issoire - René Coty,OUI,36,29,7,1,6,OUI,OUI,2025-03-13 17:02:28+00:00,"48.830512876709, 2.3343613743782",Paris,75056,0.19444444444444445,17
15041,Franquet - Labrouste,OUI,37,29,8,3,5,OUI,OUI,2025-03-13 17:01:38+00:00,"48.83287705011431, 2.306762784719467",Paris,75056,0.21621621621621623,17
15045,Porte de la Plaine,OUI,35,33,2,0,2,OUI,OUI,2025-03-13 17:00:42+00:00,"48.82805169605981, 2.2924277186393742",Paris,75056,0.05714285714285714,17
10003,Hauteville - Bonne Nouvelle,OUI,17,5,12,10,2,OUI,OUI,2025-03-13 17:01:24+00:00,"48.87077436024, 2.3496496368327",Paris,75056,0.7058823529411765,17
25004,Marcel Pourtout - Édouard Manet,OUI,24,2,22,19,3,OUI,OUI,2025-03-13 17:01:24+00:00,"48.87555620763429, 2.1655967831611638",Rueil-Malmaison,92063,0.9166666666666666,17
11022,Roquette - Auguste Laurent,OUI,15,7,8,8,0,OUI,OUI,2025-03-13 17:00:51+00:00,"48.858001906023354, 2.381797702650783",Paris,75056,0.5333333333333333,17
15027,Duhamel - André Gide,OUI,20,16,4,0,4,OUI,OUI,2025-03-13 17:02:15+00:00,"48.8365662244334, 2.312707121097412",Paris,75056,0.2,17
13028,Gouthière - Poterne des Peupliers,OUI,31,26,5,2,3,OUI,OUI,2025-03-13 17:02:26+00:00,"48.820507, 2.351342",Paris,75056,0.16129032258064516,17
42205,Place Aristide Briand,OUI,35,15,20,10,10,OUI,OUI,2025-03-13 16:59:44+00:00,"48.82189236575831, 2.413003742694855",Charenton-le-Pont,94018,0.5714285714285714,17
15069,Félix Faure - Convention,OUI,43,11,32,19,13,OUI,OUI,2025-03-13 17:02:20+00:00,"48.841249336041, 2.2883866008495",Paris,75056,0.7441860465116279,17
17110,Legendre - Nollet,OUI,29,24,5,3,2,OUI,OUI,2025-03-13 17:01:37+00:00,"48.887742186754224, 2.320293079881375",Paris,75056,0.1724137931034483,17
14027,Gergovie - Alésia,OUI,54,53,1,0,1,OUI,OUI,2025-03-13 17:00:23+00:00,"48.83088717455243, 2.318882101207347",Paris,75056,0.018518518518518517,17
31701,Mairie de Bagnolet,OUI,27,24,3,0,3,OUI,OUI,2025-03-13 17:00:16+00:00,"48.868421318555, 2.4179587885737",Bagnolet,93006,0.1111111111111111,17
42303,Place Eustache Deschamps,OUI,20,5,15,6,9,OUI,OUI,2025-03-13 16:58:59+00:00,"48.793855, 2.336637",Cachan,94016,0.75,17
30004,Jean Jaurès - Place de la Libération,OUI,28,8,20,9,11,OUI,OUI,2025-03-13 16:56:11+00:00,"48.90617751921, 2.4391458057475",Bobigny,93008,0.7142857142857143,17
35013,Guillaume Tell - Parc Henri Barbusse,OUI,19,17,2,0,2,OUI,OUI,2025-03-13 17:00:26+00:00,"48.88958925894009, 2.4198862910270695",Pantin,93055,0.10526315789473684,17
14035,Maine - Jean Zay,OUI,46,33,13,3,10,OUI,OUI,2025-03-13 17:01:52+00:00,"48.837925263898, 2.3225428909063",Paris,75056,0.2826086956521739,17
12102,Bercy - Traversiére,OUI,29,1,28,21,7,OUI,OUI,2025-03-13 17:00:09+00:00,"48.846192642574, 2.3703800886869",Paris,75056,0.9655172413793104,17
8046,Marceau - Président Wilson,OUI,30,13,17,14,3,OUI,OUI,2025-03-13 17:00:37+00:00,"48.8652359, 2.3002513",Paris,75056,0.5666666666666667,17
15024,Suffren - La Motte-Piquet,OUI,21,7,14,13,1,OUI,OUI,2025-03-13 17:02:20+00:00,"48.850881230919, 2.3012199997902",Paris,75056,0.6666666666666666,17
20110,Gambetta - Tourelles,OUI,20,19,1,0,1,OUI,OUI,2025-03-13 17:02:25+00:00,"48.875337902264, 2.4059921130538",Paris,75056,0.05,17
43007,Hôtel de Ville de Vincennes,OUI,26,24,2,1,1,OUI,OUI,2025-03-13 17:02:29+00:00,"48.84827609706963, 2.4398955702781677",Vincennes,94080,0.07692307692307693,17
17006,Guy Môquet - Compoint,OUI,35,29,6,1,5,OUI,OUI,2025-03-13 17:02:20+00:00,"48.89213559044868, 2.32321947813034",Paris,75056,0.17142857142857143,17
16025,Jean de la Fontaine - Boulainvilliers,OUI,65,26,39,37,2,OUI,OUI,2025-03-13 17:02:29+00:00,"48.85264791461651, 2.2758664190769196",Paris,75056,0.6,17
6028,Quatre Vents - Carrefour de l'Odéon,OUI,35,4,31,19,12,OUI,OUI,2025-03-13 17:02:14+00:00,"48.851751374458864, 2.338161695134053",Paris,75056,0.8857142857142857,17
17117,Pereire - Saussure,OUI,31,30,1,1,0,OUI,OUI,2025-03-13 16:59:52+00:00,"48.888229075478, 2.3101296275854",Paris,75056,0.03225806451612903,17
21207,Verdier - République,OUI,29,28,1,1,0,OUI,OUI,2025-03-13 17:01:48+00:00,"48.815403766277, 2.31739372015",Montrouge,92049,0.034482758620689655,17
16017,Siam - La Pompe,OUI,16,15,1,0,1,OUI,OUI,2025-03-13 16:55:10+00:00,"48.861720329027264, 2.275346568555312",Paris,75056,0.0625,17
11016,Philippe-Auguste,OUI,47,46,1,0,1,OUI,OUI,2025-03-13 17:02:12+00:00,"48.851853488265, 2.3932945355773",Paris,75056,0.02127659574468085,17
18021,Marcadet - Ramey,OUI,20,17,3,0,3,OUI,OUI,2025-03-13 17:02:23+00:00,"48.890875, 2.3449019",Paris,75056,0.15,17
15120,Colonel Pierre Avia,OUI,28,10,18,17,1,OUI,OUI,2025-03-13 17:02:15+00:00,"48.8296843300915, 2.275342586850291",Paris,75056,0.6428571428571429,17
16116,George Sand - Jean de La Fontaine,OUI,28,16,12,8,4,OUI,OUI,2025-03-13 17:00:30+00:00,"48.84986918764119, 2.268257387525699",Paris,75056,0.42857142857142855,17
16033,Marché d'Auteuil,OUI,31,19,12,11,1,OUI,OUI,2025-03-13 16:59:13+00:00,"48.84842761367387, 2.265253821160005",Paris,75056,0.3870967741935484,17
20013,Alexandre Dumas - Place de la Réunion,OUI,45,43,2,0,2,OUI,OUI,2025-03-13 16:58:45+00:00,"48.85533710742046, 2.3997703687646292",Paris,75056,0.044444444444444446,17
21205,Arthur Auger - Jean Jaurès,OUI,23,21,2,0,2,OUI,OUI,2025-03-13 17:02:26+00:00,"48.813736445585235, 2.3069277405738835",Montrouge,92049,0.08695652173913043,17
5033,Saint-Séverin - Saint-Michel,OUI,30,3,27,23,4,OUI,OUI,2025-03-13 17:00:13+00:00,"48.852731305488, 2.3440927639604",Paris,75056,0.9,17
6004,Regard - Rennes,OUI,46,34,12,12,0,OUI,OUI,2025-03-13 16:59:44+00:00,"48.847385404956, 2.3268555477262",Paris,75056,0.2608695652173913,17
12022,Sahel - Général Michel Bizot,OUI,29,21,8,3,5,OUI,OUI,2025-03-13 16:59:56+00:00,"48.840872964793355, 2.4044444784522057",Paris,75056,0.27586206896551724,17
15014,Volontaires - Vaugirard,OUI,33,26,7,3,4,OUI,OUI,2025-03-13 17:02:18+00:00,"48.84132050184004, 2.30808901725357",Paris,75056,0.21212121212121213,17
21023,Ancienne Mairie - André Morizet,OUI,24,12,12,9,3,OUI,OUI,2025-03-13 16:59:32+00:00,"48.838311, 2.234077",Boulogne-Billancourt,92012,0.5,17
11028,Guillaume Bertrand - République,OUI,37,33,4,2,2,OUI,OUI,2025-03-13 16:59:22+00:00,"48.863825174341, 2.380906377155",Paris,75056,0.10810810810810811,17
31105,Lavoisier - Missak Manouchian,OUI,15,8,7,3,4,OUI,OUI,2025-03-13 16:59:57+00:00,"48.86286468896063, 2.495676465332508",Rosny-sous-Bois,93064,0.4666666666666667,17
21027,Fief - République,OUI,24,2,22,19,3,OUI,OUI,2025-03-13 17:02:25+00:00,"48.83170888166024, 2.255771979689598",Boulogne-Billancourt,92012,0.9166666666666666,17
22701,Général Leclerc - République,OUI,28,6,22,18,4,OUI,OUI,2025-03-13 17:02:24+00:00,"48.915885074177, 2.2682306702811",Bois-Colombes,92009,0.7857142857142857,17
15044,Dantzig - Lefebvre,OUI,33,30,3,0,3,OUI,OUI,2025-03-13 16:59:41+00:00,"48.83013921586756, 2.295934036374092",Paris,75056,0.09090909090909091,17
22404,Pierre Brossolette - 12 Février 1934,OUI,24,24,0,0,0,OUI,OUI,2025-03-13 16:59:04+00:00,"48.8176962416867, 2.3076123744249344",Malakoff,92046,0.0,17
15113,Arsonval - Falguière,OUI,24,19,5,3,2,OUI,OUI,2025-03-13 16:59:36+00:00,"48.84040040365445, 2.313117867297474",Paris,75056,0.20833333333333334,17
20032,Square des Amandiers,OUI,26,22,4,1,3,OUI,OUI,2025-03-13 17:02:14+00:00,"48.86615630668046, 2.3891324177384377",Paris,75056,0.15384615384615385,17
20011,Pyrénées - Dagorno,OUI,20,18,2,0,2,OUI,OUI,2025-03-13 17:00:50+00:00,"48.855425770695085, 2.4051643162965775",Paris,75056,0.1,17
20014,Charonne - Alexandre Dumas,OUI,34,32,2,0,2,OUI,OUI,2025-03-13 16:58:10+00:00,"48.856077415056, 2.3948693275452",Paris,75056,0.058823529411764705,17
14005,René Coty - Place Denfert-Rochereau,OUI,34,31,3,2,1,OUI,OUI,2025-03-13 17:01:43+00:00,"48.833056477316, 2.3329411447048",Paris,75056,0.08823529411764706,17
13023,Bobillot - Moulin des Prés,OUI,28,26,2,0,2,OUI,OUI,2025-03-13 17:02:23+00:00,"48.828657346203, 2.353020646317",Paris,75056,0.07142857142857142,17
8007,Rome - Provence,OUI,28,5,23,20,3,OUI,OUI,2025-03-13 17:01:03+00:00,"48.874230055580306, 2.325570111724113",Paris,75056,0.8214285714285714,17
12040,Porte de Charenton,OUI,64,55,9,5,4,OUI,OUI,2025-03-13 17:02:21+00:00,"48.831240105856, 2.3989107459784",Paris,75056,0.140625,17
21218,Gabriel Péri - Place de la Libération,OUI,17,17,0,0,0,OUI,OUI,2025-03-13 16:57:31+00:00,"48.819828421929, 2.3117361743705",Montrouge,92049,0.0,17
6020,Place Saint-André des Arts,OUI,32,13,19,14,5,OUI,OUI,2025-03-13 17:02:25+00:00,"48.852886173881, 2.3426544293761",Paris,75056,0.59375,17
18101,Championnet.,OUI,20,16,4,0,4,OUI,OUI,2025-03-13 17:02:13+00:00,"48.8953643, 2.3498166",Paris,75056,0.2,17
21007,Rond-Point Rhin et Danube,OUI,52,42,10,9,1,OUI,OUI,2025-03-13 17:00:20+00:00,"48.840452820991764, 2.2280225157737736",Boulogne-Billancourt,92012,0.19230769230769232,17
20005,Reynaldo Hahn - Lagny,OUI,19,17,2,2,0,OUI,OUI,2025-03-13 17:02:24+00:00,"48.849266043601794, 2.412330328844772",Paris,75056,0.10526315789473684,17
19007,Flandre - Ourcq,OUI,27,23,4,2,2,OUI,OUI,2025-03-13 17:02:04+00:00,"48.89260159189023, 2.3790915682911873",Paris,75056,0.14814814814814814,17
12122,Bois de Vincennes - Polygone,OUI,51,44,7,4,3,OUI,OUI,2025-03-13 17:01:34+00:00,"48.83544491617421, 2.431421081436563",Paris,75056,0.13725490196078433,17
21016,Point du Jour - Jean Jaurès,OUI,39,13,26,20,6,OUI,OUI,2025-03-13 17:02:15+00:00,"48.828753141436465, 2.245911467014621",Boulogne-Billancourt,92012,0.6666666666666666,17
16023,Passy - Place du Costa Rica,OUI,30,25,5,0,5,OUI,OUI,2025-03-13 16:57:31+00:00,"48.8584893, 2.2839655",Paris,75056,0.16666666666666666,17
19123,Metz - Marne,OUI,29,25,4,0,4,OUI,OUI,2025-03-13 16:59:30+00:00,"48.891163, 2.3865705",Paris,75056,0.13793103448275862,17
24007,Jean-Baptiste Charcot - Sainte-Geneviève,OUI,21,18,3,2,1,OUI,OUI,2025-03-13 16:53:26+00:00,"48.90310883721567, 2.278892956674099",Courbevoie,92026,0.14285714285714285,17
21107,Bertrand Sincholle - Henri Barbusse,OUI,17,9,8,8,0,OUI,OUI,2025-03-13 17:02:08+00:00,"48.89925982394349, 2.3042294383049016",Clichy,92024,0.47058823529411764,17
15114,Pasteur - Cotentin,OUI,10,9,1,0,1,OUI,OUI,2025-03-13 16:59:12+00:00,"48.8389284, 2.316356",Paris,75056,0.1,17
22007,Commandant Charcot - Bretteville,OUI,30,6,24,15,9,OUI,OUI,2025-03-13 17:02:22+00:00,"48.87530570765423, 2.2558460757136345",Neuilly-sur-Seine,92051,0.8,17
11029,Ménilmontant - Oberkampf,OUI,38,31,7,2,5,OUI,OUI,2025-03-13 17:02:27+00:00,"48.866617658681, 2.3830134404158",Paris,75056,0.18421052631578946,17
12039,Général Michel Bizot - Claude Decaen,OUI,36,24,12,9,3,OUI,OUI,2025-03-13 17:00:29+00:00,"48.83481262982544, 2.400927788127704",Paris,75056,0.3333333333333333,17
19014,Lorraine - Jean Jaurès,OUI,18,10,8,2,6,OUI,OUI,2025-03-13 17:02:13+00:00,"48.8863865, 2.3825772",Paris,75056,0.4444444444444444,17
13037,Ivry - Baudricourt,OUI,19,17,2,2,0,OUI,OUI,2025-03-13 17:00:08+00:00,"48.824695995415006, 2.363106073577468",Paris,75056,0.10526315789473684,17
13055,M.- A. Lagroua Weill-Hallé -  F. Dolto,OUI,58,32,26,18,8,OUI,OUI,2025-03-13 17:01:57+00:00,"48.828595283857425, 2.380220606266108",Paris,75056,0.4482758620689655,17
12017,Saint-Mandé - Docteur Arnold Netter,OUI,36,33,3,2,1,OUI,OUI,2025-03-13 17:00:18+00:00,"48.84462585769668, 2.404946386814118",Paris,75056,0.08333333333333333,17
22014,Victor Hugo - Bineau,OUI,24,22,2,1,1,OUI,OUI,2025-03-13 16:55:57+00:00,"48.88758225888669, 2.2783890366554265",Neuilly-sur-Seine,92051,0.08333333333333333,17
14025,Jacquier - Didot,OUI,30,29,1,0,1,OUI,OUI,2025-03-13 16:54:59+00:00,"48.82953336292279, 2.318179272115231",Paris,75056,0.03333333333333333,17
25002,Hôtel de Ville de Rueil-Malmaison,OUI,19,4,15,7,8,OUI,OUI,2025-03-13 17:02:03+00:00,"48.878194, 2.181724",Rueil-Malmaison,92063,0.7894736842105263,17
42027,Verdun - Pierre et Marie Curie,OUI,26,25,1,0,1,OUI,OUI,2025-03-13 17:00:49+00:00,"48.812822398263286, 2.3707106709480286",Ivry-sur-Seine,94041,0.038461538461538464,17
6005,Montparnasse -  Square Ozanam,OUI,49,47,2,2,0,OUI,OUI,2025-03-13 17:00:14+00:00,"48.843310567822, 2.3265242949128",Paris,75056,0.04081632653061224,17
20033,Etienne Dolet - Place Maurice Chevalier,OUI,46,43,3,0,3,OUI,OUI,2025-03-13 17:01:37+00:00,"48.86798303359366, 2.3851405311143026",Paris,75056,0.06521739130434782,17
16022,Jean Bologne - Passy,OUI,19,16,3,3,0,OUI,OUI,2025-03-13 17:00:42+00:00,"48.857566889784465, 2.280027395306772",Paris,75056,0.15789473684210525,17
13013,Saint-Marcel - Hôpital,OUI,19,4,15,10,5,OUI,OUI,2025-03-13 17:02:28+00:00,"48.839504424583, 2.3609894170229",Paris,75056,0.7894736842105263,17
19001,Crimée - Ourcq,OUI,56,50,6,3,3,OUI,OUI,2025-03-13 16:59:04+00:00,"48.894104140316, 2.3729460884673",Paris,75056,0.10714285714285714,17
1201,Perrault - Place du Louvre,OUI,28,11,17,12,5,OUI,OUI,2025-03-13 17:00:47+00:00,"48.860273568996, 2.3412468419093",Paris,75056,0.6071428571428571,17
20106,Mairie du 20ème,OUI,27,26,1,0,1,OUI,OUI,2025-03-13 17:00:51+00:00,"48.865302324275, 2.3990669846535",Paris,75056,0.037037037037037035,17
21510,Fontaine du Tertre - Calvaire,OUI,23,22,1,0,1,OUI,OUI,2025-03-13 16:56:27+00:00,"48.8702539, 2.2187778",Suresnes,92073,0.043478260869565216,17
5105,Geoffroy-Saint-Hilaire - Saint-Marcel,OUI,17,10,7,7,0,OUI,OUI,2025-03-13 17:00:53+00:00,"48.83907826424974, 2.356877340669728",Paris,75056,0.4117647058823529,17
51007,Résistance - Romain Rolland,OUI,28,21,7,0,7,OUI,OUI,2025-03-13 17:01:33+00:00,"48.950873482371, 2.2310190077797",Argenteuil,95018,0.25,17
11018,Saint-Maur - République,OUI,35,31,4,2,2,OUI,OUI,2025-03-13 17:02:06+00:00,"48.864185861455, 2.3783174157143",Paris,75056,0.11428571428571428,17
11040,Temple - Jean-Pierre Timbaud,OUI,31,9,22,20,2,OUI,OUI,2025-03-13 17:02:09+00:00,"48.86446597201, 2.3660597205162",Paris,75056,0.7096774193548387,17
5031,Lacépède - Linné,OUI,50,19,31,22,9,OUI,OUI,2025-03-13 17:01:06+00:00,"48.8437035476636, 2.354651279747486",Paris,75056,0.62,17
13008,Place d'Italie - Soeur Rosalie,OUI,50,44,6,1,5,OUI,OUI,2025-03-13 17:02:15+00:00,"48.831908520394, 2.3546943448098",Paris,75056,0.12,17
6009,Guynemer - Jardin du Luxembourg,OUI,34,32,2,0,2,OUI,OUI,2025-03-13 17:01:42+00:00,"48.8466127, 2.3325478",Paris,75056,0.058823529411764705,17
11038,Temple - Charlot,OUI,42,4,38,35,3,OUI,OUI,2025-03-13 17:00:58+00:00,"48.865709343796, 2.3652737250724",Paris,75056,0.9047619047619048,17
16104,Paul Valery - Victor Hugo,OUI,34,25,9,0,9,OUI,OUI,2025-03-13 17:02:00+00:00,"48.87137406080164, 2.2887128591537476",Paris,75056,0.2647058823529412,17
21511,Marcel Monge - Marcel Dassault,OUI,46,15,31,29,2,OUI,OUI,2025-03-13 17:01:56+00:00,"48.86096384533371, 2.2246733296048142",Suresnes,92073,0.6739130434782609,17
30005,Convention - Campus de Bobigny,OUI,28,21,7,4,3,OUI,OUI,2025-03-13 16:56:37+00:00,"48.914920058264, 2.4172238067445",Bobigny,93008,0.25,17
21033,Sèvres - Maréchal Juin,OUI,17,7,10,10,0,OUI,OUI,2025-03-13 17:02:10+00:00,"48.8324305, 2.2292812",Boulogne-Billancourt,92012,0.5882352941176471,17
24010,Charles de Gaulle - Rue de l'Alma,OUI,27,18,9,4,5,OUI,OUI,2025-03-13 17:02:00+00:00,"48.896620592993, 2.252313240191",Courbevoie,92026,0.3333333333333333,17
17050,Batignolles - Abel Truchet,OUI,25,21,4,0,4,OUI,OUI,2025-03-13 17:00:41+00:00,"48.883103904582, 2.3238347490884",Paris,75056,0.16,17
41101,Paul Doumer - Stalingrad,OUI,24,17,7,4,3,OUI,OUI,2025-03-13 17:00:13+00:00,"48.806518992199, 2.3368880152702",Arcueil,94003,0.2916666666666667,17
8044,Alfred de Vigny - Place du Général Brocard,OUI,33,27,6,2,4,OUI,OUI,2025-03-13 16:54:05+00:00,"48.87836138361425, 2.305254448220567",Paris,75056,0.18181818181818182,17
26010,Louis Armand - Bernard Palissy,OUI,16,6,10,6,4,OUI,OUI,2025-03-13 16:58:31+00:00,"48.916974, 2.313384",Asnières-sur-Seine,92004,0.625,17
17036,Place Tristan Bernard,OUI,28,18,10,1,9,OUI,OUI,2025-03-13 17:02:03+00:00,"48.8794936, 2.2915423",Paris,75056,0.35714285714285715,17
20030,Ménilmontant - Père Lachaise,OUI,39,36,3,0,3,OUI,OUI,2025-03-13 17:02:24+00:00,"48.863287291502, 2.3869940266013",Paris,75056,0.07692307692307693,17
21112,Claude Debussy - Marc Bloch,OUI,51,46,5,4,1,OUI,OUI,2025-03-13 17:01:07+00:00,"48.910388180512, 2.3117771744728",Clichy,92024,0.09803921568627451,17
16140,Hippodrome de Longchamp,OUI,23,5,18,15,3,OUI,OUI,2025-03-13 16:55:46+00:00,"48.86413226532, 2.239905372262",Paris,75056,0.782608695652174,17
8003,Galilée - Vernet,OUI,47,28,19,8,11,OUI,OUI,2025-03-13 17:01:38+00:00,"48.871715878697, 2.2985444962978",Paris,75056,0.40425531914893614,17
21508,Georges Pompidou - Verdun,OUI,24,6,18,10,8,OUI,OUI,2025-03-13 17:00:11+00:00,"48.875481, 2.232443",Suresnes,92073,0.75,17
22703,Place Jean Mermoz,OUI,29,13,16,6,10,OUI,OUI,2025-03-13 17:01:52+00:00,"48.9220937, 2.2718348",Bois-Colombes,92009,0.5517241379310345,17
15032,Félix Faure - Lourmel,OUI,53,32,21,18,3,OUI,OUI,2025-03-13 17:01:58+00:00,"48.83868901709515, 2.2818081825971603",Paris,75056,0.39622641509433965,17
25009,Place des Arts - Jean Mermoz,OUI,20,5,15,15,0,OUI,OUI,2025-03-13 16:59:08+00:00,"48.880391139734, 2.1832160452221",Rueil-Malmaison,92063,0.75,17
19045,Macdonald - Césaria Evora,OUI,66,57,9,9,0,OUI,OUI,2025-03-13 16:59:26+00:00,"48.89883, 2.37933",Paris,75056,0.13636363636363635,17
3201,Payenne - Square George Caïn,OUI,22,10,12,10,2,OUI,OUI,2025-03-13 17:01:04+00:00,"48.8578329, 2.3622643",Paris,75056,0.5454545454545454,17
22302,Gare RER - Général de Gaulle,OUI,39,24,15,13,2,OUI,OUI,2025-03-13 17:01:07+00:00,"48.933548439566, 2.3064726536317",Gennevilliers,92036,0.38461538461538464,17
20035,Pyrénées - Ménilmontant,OUI,25,23,2,0,2,OUI,OUI,2025-03-13 16:57:55+00:00,"48.8693268535238, 2.395084574818611",Paris,75056,0.08,17
13053,Chevaleret - Tolbiac,OUI,21,8,13,9,4,OUI,OUI,2025-03-13 17:00:43+00:00,"48.82941, 2.375934",Paris,75056,0.6190476190476191,17
23106,Pavé des Gardes - Charles Vaillant,OUI,20,17,3,3,0,OUI,OUI,2025-03-13 16:57:41+00:00,"48.81168551728, 2.2111820107205",Sèvres,92072,0.15,17
48011,Epi d'Or - Chevilly,OUI,20,17,3,0,3,OUI,OUI,2025-03-13 16:56:23+00:00,"48.781109786782, 2.3549050362061",Villejuif,94076,0.15,17
20037,Gambetta - Saint Fargeau,OUI,24,23,1,0,1,OUI,OUI,2025-03-13 17:01:23+00:00,"48.871244610447015, 2.4039056897163396",Paris,75056,0.041666666666666664,17
34009,Dora Maar - Nadia Guendouz,OUI,28,18,10,8,2,OUI,OUI,2025-03-13 17:02:22+00:00,"48.905452421305, 2.3220406472683",Saint-Ouen-sur-Seine,93070,0.35714285714285715,17
9029,Saint-Lazare - Place d'Estienne d'Orves,OUI,39,18,21,18,3,OUI,OUI,2025-03-13 17:02:07+00:00,"48.8768345, 2.3329067",Paris,75056,0.5384615384615384,17
10151,Gare du Nord - Faubourg Saint-Denis,OUI,28,24,4,0,4,OUI,OUI,2025-03-13 16:56:43+00:00,"48.879612765504, 2.3568402975798",Paris,75056,0.14285714285714285,17
26011,Ménil - Argenteuil,OUI,18,10,8,4,4,OUI,OUI,2025-03-13 17:01:22+00:00,"48.925901818305, 2.2741496502338",Asnières-sur-Seine,92004,0.4444444444444444,17
41212,Nungesser - Santé,OUI,22,16,6,0,6,OUI,OUI,2025-03-13 16:58:17+00:00,"48.852335, 2.448967",Fontenay-sous-Bois,94033,0.2727272727272727,17
45005,Stalingrad - Général de Gaulle,OUI,26,12,14,4,10,OUI,OUI,2025-03-13 17:00:27+00:00,"48.823450589614, 2.4965062363218",Champigny-sur-Marne,94017,0.5384615384615384,17
41304,Port - Maurice Chevalier,OUI,30,3,27,23,4,OUI,OUI,2025-03-13 16:58:56+00:00,"48.832474421632, 2.490257616467",Nogent-sur-Marne,94052,0.9,17
14110,Abbé Carton - Plantes,OUI,25,23,2,0,2,OUI,OUI,2025-03-13 17:02:17+00:00,"48.827673823166, 2.3209181427956",Paris,75056,0.08,17
7007,Musée d'Orsay,OUI,62,16,46,35,11,OUI,OUI,2025-03-13 16:59:47+00:00,"48.859726157909, 2.3258604481816",Paris,75056,0.7419354838709677,17
18018,Carpeaux - Place Jacques Froment,OUI,18,17,1,0,1,OUI,OUI,2025-03-13 17:01:27+00:00,"48.8906542, 2.3309428",Paris,75056,0.05555555555555555,17
8031,Jean Mermoz - Champs-Elysées,OUI,44,16,28,20,8,OUI,OUI,2025-03-13 17:02:16+00:00,"48.869689856852, 2.3107324540615",Paris,75056,0.6363636363636364,17
21954,Val-Fleury,OUI,23,14,9,2,7,OUI,OUI,2025-03-13 17:00:47+00:00,"48.807671407991, 2.2407217696309",Meudon,92048,0.391304347826087,17
22208,Stalingrad - Barbara,OUI,19,19,0,0,0,OUI,OUI,2025-03-13 16:55:01+00:00,"48.809223658808, 2.3175904558822",Bagneux,92007,0.0,17
32023,Guy Môquet - Jean Moulin,OUI,25,13,12,9,3,OUI,OUI,2025-03-13 17:00:12+00:00,"48.940931521020836, 2.363948999931771",Saint-Denis,93066,0.48,17
22209,Verdun - Henri Barbusse,OUI,23,20,3,1,2,OUI,OUI,2025-03-13 17:01:45+00:00,"48.802056061754, 2.3159965061736",Bagneux,92007,0.13043478260869565,17
25010,Maréchal Leclerc de Hauteclocque - Marché Buzenval,OUI,29,25,4,2,2,OUI,OUI,2025-03-13 16:56:50+00:00,"48.858446, 2.192077",Rueil-Malmaison,92063,0.13793103448275862,17
35021,Cartier Bresson - Denis Papin,OUI,31,30,1,0,1,OUI,OUI,2025-03-13 17:01:10+00:00,"48.902616, 2.397814",Pantin,93055,0.03225806451612903,17
12165,Champs de Manoeuvre - Cartoucherie,OUI,31,7,24,13,11,OUI,OUI,2025-03-13 17:02:08+00:00,"48.835261, 2.447974",Paris,75056,0.7741935483870968,17
18045,Pierre Ginier - Clichy,OUI,15,9,6,2,4,OUI,OUI,2025-03-13 17:01:12+00:00,"48.8867667, 2.326228",Paris,75056,0.4,17
11001,Richard Lenoir - Place de la Bastille,OUI,46,25,21,17,4,OUI,OUI,2025-03-13 17:02:13+00:00,"48.8538327, 2.3697222",Paris,75056,0.45652173913043476,17
10025,Jemmapes - Ecluses Saint-Martin,OUI,14,11,3,2,1,OUI,OUI,2025-03-13 16:59:41+00:00,"48.87748519186726, 2.3660067468881607",Paris,75056,0.21428571428571427,17
23203,Division Leclerc - Kléber,OUI,25,23,2,1,1,OUI,OUI,2025-03-13 16:52:29+00:00,"48.798666226364, 2.2833752789972",Châtillon,92020,0.08,17
32305,Saint-Germain - Verdun,OUI,29,24,5,0,5,OUI,OUI,2025-03-13 17:02:22+00:00,"48.882877330093, 2.4331868384644",Romainville,93063,0.1724137931034483,17
17126,Hélène et François Missoffe - Emile Borel,OUI,28,13,15,14,1,OUI,OUI,2025-03-13 17:00:28+00:00,"48.89990653843488, 2.321543991674844",Paris,75056,0.5357142857142857,17
22305,Jean Jaurès - Place du Dr Roux,OUI,34,26,8,6,2,OUI,OUI,2025-03-13 16:59:25+00:00,"48.927567032796, 2.2947337017374",Gennevilliers,92036,0.23529411764705882,17
34005,Adrien Lesesne - Docteur Bauer,OUI,29,25,4,2,2,OUI,OUI,2025-03-13 17:01:24+00:00,"48.90263867304635, 2.348248063431511",Saint-Ouen-sur-Seine,93070,0.13793103448275862,17
22507,Châteaudun - Place de la Liberté,OUI,25,15,10,2,8,OUI,OUI,2025-03-13 16:54:51+00:00,"48.90970830301211, 2.2454486480600626",La Garenne-Colombes,92035,0.4,17
26009,Marceau Delorme - Pierre Brossolette,OUI,26,17,9,2,7,OUI,OUI,2025-03-13 17:00:12+00:00,"48.91206062860357, 2.295897423568745",Asnières-sur-Seine,92004,0.34615384615384615,17
11201,Faubourg St-Antoine - Place de la Nation,OUI,16,11,5,1,4,OUI,OUI,2025-03-13 16:59:43+00:00,"48.8487726, 2.393606",Paris,75056,0.3125,17
34012,Bateliers - Quai de Seine,OUI,22,12,10,9,1,OUI,OUI,2025-03-13 16:51:49+00:00,"48.915817585516, 2.3239533298594",Saint-Ouen-sur-Seine,93070,0.45454545454545453,17
22602,Place Henri Dunant - Gare RER,OUI,31,30,1,0,1,OUI,OUI,2025-03-13 17:00:24+00:00,"48.788093281931, 2.2909234046643",Fontenay-aux-Roses,92032,0.03225806451612903,17
31301,Gare RER,OUI,28,23,5,2,3,OUI,OUI,2025-03-13 17:02:27+00:00,"48.896280181078, 2.4581568985227",Noisy-le-Sec,93053,0.17857142857142858,17
12106,Gare de Lyon - Roland Barthes,OUI,67,12,55,54,1,OUI,OUI,2025-03-13 17:01:20+00:00,"48.84395729494058, 2.3790882155299187",Paris,75056,0.8208955223880597,17
5107,Pontoise - La Tournelle,OUI,21,4,17,12,5,OUI,OUI,2025-03-13 17:02:02+00:00,"48.850458009188, 2.3524542754922",Paris,75056,0.8095238095238095,17
23205,Parc des Pierrettes,OUI,22,22,0,0,0,OUI,OUI,2025-03-13 17:00:46+00:00,"48.7973062, 2.2909969",Châtillon,92020,0.0,17
18023,Ordener - Poissonniers,OUI,34,26,8,2,6,OUI,OUI,2025-03-13 17:02:29+00:00,"48.891213890844654, 2.351288666219873",Paris,75056,0.23529411764705882,17
23201,Avenir,OUI,42,39,3,1,2,OUI,OUI,2025-03-13 17:01:19+00:00,"48.8103438, 2.3003776",Châtillon,92020,0.07142857142857142,17
18026,Ruisseau - Ordener,OUI,34,28,6,1,5,OUI,OUI,2025-03-13 16:59:10+00:00,"48.89299462568024, 2.340144887566567",Paris,75056,0.17647058823529413,17
12001,Bastille - Biscornet,OUI,57,0,57,49,8,OUI,OUI,2025-03-13 17:02:18+00:00,"48.851355779579, 2.369220033288",Paris,75056,1.0,17
18024,Clignancourt - Ordener,OUI,35,34,1,0,1,OUI,OUI,2025-03-13 16:59:23+00:00,"48.891457726153774, 2.348636478060487",Paris,75056,0.02857142857142857,17
22018,Charles de Gaulle - Les Sablons,OUI,35,27,8,7,1,OUI,OUI,2025-03-13 17:02:18+00:00,"48.880987514929, 2.2715748726513",Neuilly-sur-Seine,92051,0.22857142857142856,17
19018,Cité de la Musique,OUI,53,29,24,9,15,OUI,OUI,2025-03-13 17:02:25+00:00,"48.888796556487, 2.3925811931922",Paris,75056,0.4528301886792453,17
21320,Président Roosevelt - Rouget de Lisle,OUI,39,13,26,18,8,OUI,OUI,2025-03-13 16:56:16+00:00,"48.83047518749, 2.2616135525345",Issy-les-Moulineaux,92040,0.6666666666666666,17
15013,Volontaires - Lecourbe,OUI,30,14,16,9,7,OUI,OUI,2025-03-13 17:02:05+00:00,"48.84351378799, 2.3065522313118",Paris,75056,0.5333333333333333,17
21327,Jean Bouin - Gouverneur Général Eboué,OUI,31,4,27,27,0,OUI,OUI,2025-03-13 17:01:47+00:00,"48.824792734266, 2.2651904328524",Issy-les-Moulineaux,92040,0.8709677419354839,17
9035,Gare Saint-Lazare - Place de Budapest,OUI,43,26,17,13,4,OUI,OUI,2025-03-13 17:00:36+00:00,"48.877753, 2.327339",Paris,75056,0.3953488372093023,17
13204,Tolbiac - Boussingault,OUI,40,35,5,4,1,OUI,OUI,2025-03-13 17:00:02+00:00,"48.826177754027, 2.3420378552202",Paris,75056,0.125,17
17127,Porte de Clichy - Place des Nations Unies,OUI,35,15,20,19,1,OUI,OUI,2025-03-13 17:02:28+00:00,"48.896737263309504, 2.310542999196392",Paris,75056,0.5714285714285714,17
15062,Convention - Lourmel,OUI,33,11,22,20,2,OUI,OUI,2025-03-13 17:02:11+00:00,"48.842055041656, 2.2859910875559",Paris,75056,0.6666666666666666,17
26008,Henri Barbusse - Bourguignons,OUI,33,23,10,2,8,OUI,OUI,2025-03-13 16:57:52+00:00,"48.91301722799713, 2.2734212270774417",Asnières-sur-Seine,92004,0.30303030303030304,17
10114,Granges aux Belles - Hôpital Saint-Louis,OUI,59,55,4,1,3,OUI,OUI,2025-03-13 16:53:31+00:00,"48.874794994841, 2.366669436985",Paris,75056,0.06779661016949153,17
34008,Garibaldi - Gabriel Péri,OUI,28,19,9,5,4,OUI,OUI,2025-03-13 17:00:20+00:00,"48.905741911394, 2.3316044208059",Saint-Ouen-sur-Seine,93070,0.32142857142857145,17
13203,Square de Choisy - Eastman,OUI,22,21,1,0,1,OUI,OUI,2025-03-13 17:01:50+00:00,"48.828543456283, 2.3583075090494",Paris,75056,0.045454545454545456,17
23204,Roland Garros - Jean Bouin,OUI,28,26,2,1,1,OUI,OUI,2025-03-13 16:54:47+00:00,"48.809460857173, 2.2853198638301",Châtillon,92020,0.07142857142857142,17
47007,Liberté - Vert-de-Maisons,OUI,20,3,17,14,3,OUI,OUI,2025-03-13 17:00:38+00:00,"48.790147809608, 2.4328628182411",Maisons-Alfort,94046,0.85,17
21514,Place de la Paix - Abbé Saint-Pierre,OUI,24,22,2,1,1,OUI,OUI,2025-03-13 17:00:04+00:00,"48.86462724459225, 2.2047570338469806",Suresnes,92073,0.08333333333333333,17
13051,Halle Freyssinet - Parvis Alan Turing,OUI,23,17,6,5,1,OUI,OUI,2025-03-13 17:02:24+00:00,"48.832846814471, 2.3711421713233",Paris,75056,0.2608695652173913,17
31303,Simone Signoret - Paris,OUI,26,18,8,2,6,OUI,OUI,2025-03-13 17:00:24+00:00,"48.903600624712865, 2.465406596265139",Noisy-le-Sec,93053,0.3076923076923077,17
8038,François 1er - Montaigne,OUI,52,20,32,27,5,OUI,OUI,2025-03-13 17:01:04+00:00,"48.866887649978, 2.3066755757207",Paris,75056,0.6153846153846154,17
10026,Gare de l'Est - Chateau Landon,OUI,55,43,12,3,9,OUI,OUI,2025-03-13 17:01:23+00:00,"48.879305, 2.362424",Paris,75056,0.21818181818181817,17
5201,Saint-Jacques - Soufflot,OUI,16,14,2,1,1,OUI,OUI,2025-03-13 16:59:48+00:00,"48.846280383395, 2.3430785379567",Paris,75056,0.125,17
17010,Jonquière - Docteur Paul Brousse,OUI,37,22,15,11,4,OUI,OUI,2025-03-13 16:58:36+00:00,"48.894799816683985, 2.318705212173216",Paris,75056,0.40540540540540543,17
18041,Rochechouart - Martyrs,OUI,17,17,0,0,0,OUI,OUI,2025-03-13 17:01:49+00:00,"48.882193779572, 2.3405495658517",Paris,75056,0.0,17
16006,Lauriston - Copernic,OUI,18,15,3,1,2,OUI,OUI,2025-03-13 17:02:10+00:00,"48.86926, 2.289918",Paris,75056,0.16666666666666666,17
11020,Belfort - Voltaire,OUI,37,22,15,7,8,OUI,OUI,2025-03-13 17:01:26+00:00,"48.8563358, 2.3829901",Paris,75056,0.40540540540540543,17
8008,Joseph Sansboeuf - Saint Lazare,OUI,31,17,14,9,5,OUI,OUI,2025-03-13 17:00:38+00:00,"48.875315630653, 2.3229019716382",Paris,75056,0.45161290322580644,17
16103,Traktir - Foch,OUI,19,12,7,1,6,OUI,OUI,2025-03-13 17:00:37+00:00,"48.872755334614, 2.2915497802487",Paris,75056,0.3684210526315789,17
13205,Choisy - Pointe d'Ivry,OUI,24,20,4,2,2,OUI,OUI,2025-03-13 17:02:29+00:00,"48.822154170359, 2.3633708034878",Paris,75056,0.16666666666666666,17
21213,Vanne - Général de Gaulle,OUI,24,23,1,0,1,OUI,OUI,2025-03-13 16:58:29+00:00,"48.815007, 2.328318",Montrouge,92049,0.041666666666666664,17
31202,Gabriel Péri - Jules Ferry,OUI,27,13,14,13,1,OUI,OUI,2025-03-13 17:01:54+00:00,"48.926182814311, 2.3912295762525",La Courneuve,93027,0.5185185185185185,17
3004,Place de la République - Temple,OUI,15,1,14,10,4,OUI,OUI,2025-03-13 17:02:24+00:00,"48.867211201859, 2.3635464370545",Paris,75056,0.9333333333333333,17
7201,Place De Fontenoy - Saxe,OUI,18,8,10,8,2,OUI,OUI,2025-03-13 17:01:21+00:00,"48.850270554523, 2.3069813815839",Paris,75056,0.5555555555555556,17
11046,Place de la République - Voltaire,OUI,17,3,14,12,2,OUI,OUI,2025-03-13 16:57:09+00:00,"48.866830968942, 2.3654810339212",Paris,75056,0.8235294117647058,17
31201,Suzanne Masson,OUI,33,6,27,13,14,OUI,OUI,2025-03-13 17:02:07+00:00,"48.923306888013, 2.3847292397611",La Courneuve,93027,0.8181818181818182,17
11009,Boulets - Voltaire,OUI,24,21,3,1,2,OUI,OUI,2025-03-13 17:00:43+00:00,"48.85218705621, 2.3890301585197",Paris,75056,0.125,17
13035,Choisy - Tolbiac,OUI,20,16,4,1,3,OUI,OUI,2025-03-13 16:54:57+00:00,"48.82591155587, 2.3602393269539",Paris,75056,0.2,17
35001,Jean Jaurès - Ouvrières Pivéreuses,OUI,21,15,6,1,5,OUI,OUI,2025-03-13 17:01:27+00:00,"48.910423437526, 2.3995766043663",Pantin,93055,0.2857142857142857,17
15060,Place de la Montagne du Goulet,OUI,20,1,19,16,3,OUI,OUI,2025-03-13 17:00:14+00:00,"48.8443415, 2.2773844",Paris,75056,0.95,17
18134,Ney - Porte de Clignancourt,OUI,24,21,3,1,2,OUI,OUI,2025-03-13 16:57:46+00:00,"48.8978867, 2.3458001",Paris,75056,0.125,17
18205,Mauroy - Cheminots,OUI,27,23,4,1,3,OUI,OUI,2025-03-13 17:02:25+00:00,"48.897715198403, 2.357895075822",Paris,75056,0.14814814814814814,17
13202,Place Farhat Hached,OUI,28,17,11,8,3,OUI,OUI,2025-03-13 17:02:16+00:00,"48.825487045602, 2.3816306985827",Paris,75056,0.39285714285714285,17
4108,Quai de Béthune - Pont de la Tournelle,OUI,25,0,25,21,4,OUI,OUI,2025-03-13 17:01:46+00:00,"48.85097433194, 2.3563072085381",Paris,75056,1.0,17
21501,Pont de Suresnes,OUI,16,9,7,5,2,OUI,OUI,2025-03-13 16:58:43+00:00,"48.867415092322, 2.2258946679617",Suresnes,92073,0.4375,17
40010,Haut du Mont-Mesly,OUI,21,18,3,2,1,OUI,OUI,2025-03-13 16:58:12+00:00,"48.780191921646, 2.4685737495183",Créteil,94028,0.14285714285714285,17
19204,Rampal - Belleville,OUI,19,14,5,0,5,OUI,OUI,2025-03-13 17:00:00+00:00,"48.873114661405, 2.3798409114805",Paris,75056,0.2631578947368421,17
40012,Stade de la Habette,OUI,16,14,2,0,2,OUI,OUI,2025-03-13 16:57:02+00:00,"48.774397033806, 2.4668785263921",Créteil,94028,0.125,17
18042,Place Pigalle,OUI,20,16,4,0,4,OUI,OUI,2025-03-13 16:57:50+00:00,"48.8827555, 2.3361566",Paris,75056,0.2,17
40013,Hôtel de Ville de Créteil,OUI,36,16,20,13,7,OUI,OUI,2025-03-13 16:59:56+00:00,"48.77699496201, 2.4552552404284",Créteil,94028,0.5555555555555556,17
11037,Faubourg Du Temple - Republique,OUI,38,7,31,25,6,OUI,OUI,2025-03-13 17:00:52+00:00,"48.867872484749, 2.3648982158072",Paris,75056,0.8157894736842105,17
40014,Créteil Pointe du Lac,OUI,28,4,24,9,15,OUI,OUI,2025-03-13 17:00:43+00:00,"48.769807356177, 2.4623027310281",Créteil,94028,0.8571428571428571,17
11014,Place de la Nation - Taillebourg,OUI,46,46,0,0,0,OUI,OUI,2025-03-13 16:58:33+00:00,"48.8488408, 2.3973043",Paris,75056,0.0,17
12201,Dugommier,OUI,52,38,14,10,4,OUI,OUI,2025-03-13 17:02:21+00:00,"48.838811048815, 2.3896577954292",Paris,75056,0.2692307692307692,17
35002,Jean Jaurès - Presles,OUI,31,23,8,3,5,OUI,OUI,2025-03-13 16:58:55+00:00,"48.907134414988, 2.3960057280531",Pantin,93055,0.25806451612903225,17
12105,Bercy - Villot,OUI,34,18,16,15,1,OUI,OUI,2025-03-13 17:01:56+00:00,"48.841795009027, 2.3767850184816",Paris,75056,0.47058823529411764,17
8039,Colisée - Champs-Elysées,OUI,16,7,9,5,4,OUI,OUI,2025-03-13 16:59:44+00:00,"48.870475399387, 2.3076190799475",Paris,75056,0.5625,17
40003,Centre Hospitalier Intercommunal de Créteil,OUI,17,16,1,0,1,OUI,OUI,2025-03-13 17:02:28+00:00,"48.797078298909, 2.463801423807",Créteil,94028,0.058823529411764705,17
11102,Alexandre Dumas - Voltaire,OUI,58,55,3,0,3,OUI,OUI,2025-03-13 16:54:42+00:00,"48.852888670365, 2.3891476408096",Paris,75056,0.05172413793103448,17
23801,Place de la Gare,OUI,20,15,5,2,3,OUI,OUI,2025-03-13 17:01:48+00:00,"48.838513582184, 2.1866139007512",Garches,92033,0.25,17
18044,Clichy - Douai,OUI,31,24,7,0,7,OUI,OUI,2025-03-13 17:02:28+00:00,"48.883687771522, 2.328063700029",Paris,75056,0.22580645161290322,17
40008,Créteil Pompadour,OUI,44,10,34,11,23,OUI,OUI,2025-03-13 17:02:08+00:00,"48.773011623355, 2.435166164893",Créteil,94028,0.7727272727272727,17
12157,Fabre d'Eglantine - Place de la Nation,OUI,66,64,2,1,1,OUI,OUI,2025-03-13 17:01:56+00:00,"48.8471116, 2.3956204",Paris,75056,0.030303030303030304,17
14021,Place de la Porte de Châtillon,OUI,58,55,3,0,3,OUI,OUI,2025-03-13 17:01:20+00:00,"48.8242469, 2.3186306",Paris,75056,0.05172413793103448,17
11011,Richard Lenoir - Voltaire,OUI,25,5,20,18,2,OUI,OUI,2025-03-13 17:00:05+00:00,"48.86164273878, 2.3727491497993",Paris,75056,0.8,17
13106,Bobillot - Paulin Mery,OUI,21,19,2,0,2,OUI,OUI,2025-03-13 17:02:19+00:00,"48.829899841747, 2.3543356766749",Paris,75056,0.09523809523809523,17
7111,Ecole Militaire - Place Joffre,OUI,25,6,19,15,4,OUI,OUI,2025-03-13 17:02:21+00:00,"48.852060203583, 2.3017993569374",Paris,75056,0.76,17
11012,Montreuil - Voltaire,OUI,33,30,3,0,3,OUI,OUI,2025-03-13 16:57:36+00:00,"48.850507011842, 2.3930755582745",Paris,75056,0.09090909090909091,17
40015,Iles de Loisirs de Créteil,OUI,24,4,20,11,9,OUI,OUI,2025-03-13 17:01:42+00:00,"48.780258200618, 2.4455094301232",Créteil,94028,0.8333333333333334,17
15105,Fédération - Suffren,OUI,24,13,11,10,1,OUI,OUI,2025-03-13 17:00:00+00:00,"48.852828153442, 2.2978776320815",Paris,75056,0.4583333333333333,17
51005,Yves Farges - Route d'Enghien,OUI,33,15,18,6,12,OUI,OUI,2025-03-13 16:59:48+00:00,"48.95756799268, 2.2834496977978",Argenteuil,95018,0.5454545454545454,17
8057,Hoche - Tilsitt,OUI,32,31,1,1,0,OUI,OUI,2025-03-13 17:00:05+00:00,"48.874836457837, 2.2971323132515",Paris,75056,0.03125,17
7023,Bourdonnais - Tour Eiffel,OUI,55,12,43,39,4,OUI,OUI,2025-03-13 16:59:29+00:00,"48.860897797941, 2.295599598447",Paris,75056,0.7818181818181819,17
10031,Louis Blanc - Aqueduc,OUI,36,24,12,3,9,OUI,OUI,2025-03-13 17:02:27+00:00,"48.882030182599, 2.363561578095",Paris,75056,0.3333333333333333,17
9025,Taitbout - Châteaudun,OUI,53,12,41,40,1,OUI,OUI,2025-03-13 17:01:48+00:00,"48.876383969379, 2.3353566779335",Paris,75056,0.7735849056603774,17
20137,Borrégo - Gambetta,OUI,25,22,3,0,3,OUI,OUI,2025-03-13 16:59:49+00:00,"48.87330497045532, 2.4014145880937576",Paris,75056,0.12,17
7109,Place Joffre - Frédéric le Play,OUI,37,28,9,7,2,OUI,OUI,2025-03-13 17:02:01+00:00,"48.853754486938, 2.3044242337346",Paris,75056,0.24324324324324326,17
31708,Noisy le Sec - Jean-Baptiste Clément,OUI,21,18,3,0,3,OUI,OUI,2025-03-13 16:58:30+00:00,"48.874515389637, 2.4152836203575",Bagnolet,93006,0.14285714285714285,17
7025,Octave Gréard - Tour Eiffel,OUI,31,18,13,7,6,OUI,OUI,2025-03-13 17:01:24+00:00,"48.856502977696, 2.2931787543289",Paris,75056,0.41935483870967744,17
10013,Alibert - Jemmapes,OUI,59,54,5,2,3,OUI,OUI,2025-03-13 16:58:17+00:00,"48.871044051984, 2.3661044619878",Paris,75056,0.0847457627118644,17
40007,Préfecture de Créteil,OUI,27,9,18,13,5,OUI,OUI,2025-03-13 16:59:32+00:00,"48.783680285918, 2.4544713672215",Créteil,94028,0.6666666666666666,17
15026,Bir Hakeim,OUI,31,22,9,6,3,OUI,OUI,2025-03-13 17:01:54+00:00,"48.853844054334, 2.289705348222",Paris,75056,0.2903225806451613,17
12107,Diderot - Pierre Bourdan,OUI,21,21,0,0,0,OUI,OUI,2025-03-13 16:59:06+00:00,"48.847648620797, 2.3902582749724",Paris,75056,0.0,17
1022,Danielle Casanova - Place Vendôme,OUI,35,15,20,18,2,OUI,OUI,2025-03-13 17:00:10+00:00,"48.868266498223, 2.3304839059711",Paris,75056,0.5714285714285714,17
23011,Bineau - Louise Michel,OUI,26,16,10,8,2,OUI,OUI,2025-03-13 16:57:57+00:00,"48.88666162207, 2.2843274474144",Levallois-Perret,92044,0.38461538461538464,17
18043,Clichy - Place Blanche,OUI,18,13,5,3,2,OUI,OUI,2025-03-13 17:01:33+00:00,"48.883601088297, 2.3332237824798",Paris,75056,0.2777777777777778,17
16005,Raymond Poincaré - Place Victor Hugo,OUI,21,15,6,0,6,OUI,OUI,2025-03-13 17:00:43+00:00,"48.87030612437, 2.2850745414202",Paris,75056,0.2857142857142857,17
19203,Pailleron - Bouret,OUI,27,17,10,1,9,OUI,OUI,2025-03-13 17:01:54+00:00,"48.880516995482, 2.3763902374411",Paris,75056,0.37037037037037035,17
26005,Hôtel de Ville d'Asnières sur Seine,OUI,25,12,13,3,10,OUI,OUI,2025-03-13 17:01:45+00:00,"48.90999330025577, 2.288238108158112",Asnières-sur-Seine,92004,0.52,17
34014,Michelet - Dr Bauer,OUI,30,28,2,1,1,OUI,OUI,2025-03-13 16:55:56+00:00,"48.906125424194, 2.3440374449846",Saint-Ouen-sur-Seine,93070,0.06666666666666667,17
40004,Créteil Village,OUI,25,4,21,7,14,OUI,OUI,2025-03-13 17:02:07+00:00,"48.79122395576, 2.4642198533952",Créteil,94028,0.84,17
27004,Gare de la Garenne-Colombes,OUI,26,18,8,7,1,OUI,OUI,2025-03-13 16:53:25+00:00,"48.909752, 2.239145",Colombes,92025,0.3076923076923077,17
23703,Gare de Chaville Rive Gauche,OUI,18,18,0,0,0,OUI,OUI,2025-03-13 16:58:29+00:00,"48.805160304345, 2.188277207315",Chaville,92022,0.0,17
21404,Jean Jaurès - Gare de Clamart,OUI,20,19,1,1,0,OUI,OUI,2025-03-13 16:55:40+00:00,"48.81321981219, 2.2716768079163",Clamart,92023,0.05,17
32004,Wilson - Landy,OUI,36,21,15,12,3,OUI,OUI,2025-03-13 17:01:57+00:00,"48.91516726221354, 2.357633225619793",Saint-Denis,93066,0.4166666666666667,17
32012,Carrefour Pleyel,OUI,64,47,17,8,9,OUI,OUI,2025-03-13 17:00:08+00:00,"48.92034156960326, 2.3438543826341625",Saint-Denis,93066,0.265625,17
1002,Victoria - Place du Chatelet,OUI,19,3,16,11,5,OUI,OUI,2025-03-13 17:01:23+00:00,"48.857992591527, 2.3469167947769",Paris,75056,0.8421052631578947,17
35014,Charles de Gaulle - Jean Lolive,OUI,26,24,2,1,1,OUI,OUI,2025-03-13 17:00:54+00:00,"48.8932644350857, 2.4126765131950383",Pantin,93055,0.07692307692307693,17
17038,Grande Armée - Brunel,OUI,60,52,8,1,7,OUI,OUI,2025-03-13 17:01:57+00:00,"48.876116, 2.288124",Paris,75056,0.13333333333333333,17
1003,Saint-Denis - Rivoli,OUI,44,7,37,26,11,OUI,OUI,2025-03-13 17:02:15+00:00,"48.859059340842, 2.3476943001151",Paris,75056,0.8409090909090909,17
8052,Balzac - Champs Elysées,OUI,29,13,16,8,8,OUI,OUI,2025-03-13 17:02:23+00:00,"48.872699639621, 2.3001953959465",Paris,75056,0.5517241379310345,17
15103,Cauchy - Cévennes,OUI,50,1,49,45,4,OUI,OUI,2025-03-13 17:02:07+00:00,"48.843372571022, 2.2751328349113",Paris,75056,0.98,17
12010,Daumesnil - Picpus,OUI,19,11,8,3,5,OUI,OUI,2025-03-13 17:01:51+00:00,"48.8374688, 2.401765",Paris,75056,0.42105263157894735,17
41301,Bois de Vincennes - Gare,OUI,49,48,1,0,1,OUI,OUI,2025-03-13 17:01:43+00:00,"48.836022242887, 2.470833995083",Nogent-sur-Marne,94052,0.02040816326530612,17
13123,BNF - Bibliothèque Nationale de France,OUI,46,6,40,28,12,OUI,OUI,2025-03-13 17:02:27+00:00,"48.8350268238, 2.3760157451034",Paris,75056,0.8695652173913043,17
17123,Mstislav Rostropovitch - Berthier,OUI,18,16,2,1,1,OUI,OUI,2025-03-13 17:01:21+00:00,"48.892120821173975, 2.309234105050564",Paris,75056,0.1111111111111111,17
21302,Aristide Briand - Place de la Résistance,OUI,34,7,27,25,2,OUI,OUI,2025-03-13 16:59:04+00:00,"48.82124248401006, 2.2511002421379094",Issy-les-Moulineaux,92040,0.7941176470588235,17
6001,Institut de France,OUI,16,8,8,7,1,OUI,OUI,2025-03-13 17:01:54+00:00,"48.857615678565, 2.3358313530377",Paris,75056,0.5,17
4104,Sebastopol - Rambuteau,OUI,15,6,9,6,3,OUI,OUI,2025-03-13 17:01:13+00:00,"48.86181809267, 2.3501381278038",Paris,75056,0.6,17
32001,Proudhon - Président Wilson,OUI,30,23,7,5,2,OUI,OUI,2025-03-13 17:02:26+00:00,"48.906442763495, 2.3584905266762",Saint-Denis,93066,0.23333333333333334,17
40002,Bleuets - Bordières,OUI,21,15,6,3,3,OUI,OUI,2025-03-13 16:59:19+00:00,"48.802117531472, 2.4543687905029",Créteil,94028,0.2857142857142857,17
33019,Madeleine Vionnet,OUI,29,22,7,3,4,OUI,OUI,2025-03-13 17:01:42+00:00,"48.902519074064, 2.3740895837545",Aubervilliers,93001,0.2413793103448276,17
8002,Gare Saint-Lazare - Cour du Havre,OUI,42,15,27,17,10,OUI,OUI,2025-03-13 17:02:07+00:00,"48.875674400851, 2.3265598341823",Paris,75056,0.6428571428571429,17
12127,Tremblay - Lac des Minimes,OUI,52,28,24,6,18,OUI,OUI,2025-03-13 17:01:56+00:00,"48.834131261494, 2.4547516554594",Paris,75056,0.46153846153846156,17
15056,Place Balard,OUI,24,13,11,9,2,OUI,OUI,2025-03-13 17:01:25+00:00,"48.836395736424, 2.2784192115068",Paris,75056,0.4583333333333333,17
21021,Enfants du Paradis - Peupliers,OUI,51,14,37,26,11,OUI,OUI,2025-03-13 17:02:16+00:00,"48.833122686454, 2.2571459412575",Boulogne-Billancourt,92012,0.7254901960784313,17
9104,Caumartin - Provence,OUI,21,6,15,9,6,OUI,OUI,2025-03-13 17:02:22+00:00,"48.874422773426545, 2.3284685611724854",Paris,75056,0.7142857142857143,17
8004,Malesherbes - Place de la Madeleine,OUI,79,27,52,29,23,OUI,OUI,2025-03-13 17:02:04+00:00,"48.870406028483, 2.323243509808",Paris,75056,0.6582278481012658,17
16107,Benjamin Godard - Victor Hugo,OUI,32,29,3,1,2,OUI,OUI,2025-03-13 18:58:18+00:00,"48.865983, 2.275725",Paris,75056,0.09375,19
40001,Hôpital Mondor,OUI,28,10,18,10,8,OUI,OUI,2025-03-13 18:58:31+00:00,"48.798922410229, 2.4537451531298",Créteil,94028,0.6428571428571429,19
44015,Rouget de L'isle - Watteau,OUI,20,7,13,1,12,OUI,OUI,2025-03-13 19:01:58+00:00,"48.778192750803, 2.3963020229163",Vitry-sur-Seine,94081,0.65,19
9020,Toudouze - Clauzel,OUI,21,13,8,6,2,OUI,OUI,2025-03-13 19:01:44+00:00,"48.87929591733507, 2.3373600840568547",Paris,75056,0.38095238095238093,19
32017,Basilique,OUI,18,8,10,4,6,OUI,OUI,2025-03-13 19:00:46+00:00,"48.93626891059109, 2.3588666820200914",Saint-Denis,93066,0.5555555555555556,19
14111,Cassini - Denfert-Rochereau,OUI,22,18,4,2,2,OUI,OUI,2025-03-13 18:59:58+00:00,"48.837525839067, 2.3360354080796",Paris,75056,0.18181818181818182,19
8026,Messine - Place Du Pérou,OUI,12,11,1,0,1,OUI,OUI,2025-03-13 18:46:06+00:00,"48.875448033960744, 2.315508019010038",Paris,75056,0.08333333333333333,19
14014,Jourdan - Stade Charléty,OUI,57,39,18,8,10,OUI,OUI,2025-03-13 19:00:27+00:00,"48.819428333369, 2.3433353751898",Paris,75056,0.3157894736842105,19
7002,Vaneau - Sèvres,OUI,34,22,12,9,3,OUI,OUI,2025-03-13 19:02:27+00:00,"48.848563233059, 2.3204218259346",Paris,75056,0.35294117647058826,19
11104,Charonne - Robert et Sonia Delaunay,OUI,20,15,5,0,5,OUI,OUI,2025-03-13 18:59:13+00:00,"48.855907555969, 2.3925706744194",Paris,75056,0.25,19
6108,Saint-Romain - Cherche-Midi,OUI,16,2,14,10,4,OUI,OUI,2025-03-13 18:59:21+00:00,"48.84708159081946, 2.321374788880348",Paris,75056,0.875,19
13007,Le Brun - Gobelins,OUI,48,21,27,20,7,OUI,OUI,2025-03-13 19:01:42+00:00,"48.835092787824, 2.3534681351338",Paris,75056,0.5625,19
33006,André Karman - République,OUI,29,29,0,0,0,OUI,OUI,2025-03-13 18:59:54+00:00,"48.91039875761846, 2.3851355910301213",Aubervilliers,93001,0.0,19
6003,Saint-Sulpice,OUI,21,9,12,10,2,OUI,OUI,2025-03-13 19:02:33+00:00,"48.85165383178419, 2.3308077827095985",Paris,75056,0.5714285714285714,19
32304,Charcot - Benfleet,OUI,28,27,1,0,1,NON,NON,2025-03-13 18:56:55+00:00,"48.878370277021, 2.440523876268",Romainville,93063,0.03571428571428571,19
5110,Lacépède - Monge,OUI,23,21,2,1,1,OUI,OUI,2025-03-13 19:02:37+00:00,"48.84389286531899, 2.3519663885235786",Paris,75056,0.08695652173913043,19
17026,Jouffroy d'Abbans - Wagram,OUI,39,33,6,2,4,OUI,OUI,2025-03-13 18:57:56+00:00,"48.881973298352, 2.301132157445",Paris,75056,0.15384615384615385,19
42016,Pierre et Marie Curie - Maurice Thorez,OUI,25,20,5,1,4,OUI,OUI,2025-03-13 19:01:10+00:00,"48.81580226360801, 2.376804985105991",Ivry-sur-Seine,94041,0.2,19
15202,Bracion - Périphérique,OUI,30,26,4,0,4,OUI,OUI,2025-03-13 18:56:42+00:00,"48.826103771275, 2.3004549373748",Paris,75056,0.13333333333333333,19
40011,Bas du Mont-Mesly,OUI,26,17,9,7,2,OUI,OUI,2025-03-13 19:00:04+00:00,"48.779035118572, 2.4609763908985",Créteil,94028,0.34615384615384615,19
12109,Mairie du 12ème,OUI,30,23,7,6,1,OUI,OUI,2025-03-13 19:01:54+00:00,"48.840855311763, 2.3875549435616",Paris,75056,0.23333333333333334,19
21010,Silly - Galliéni,OUI,25,13,12,11,1,OUI,OUI,2025-03-13 19:00:20+00:00,"48.835583838706, 2.2325500845909",Boulogne-Billancourt,92012,0.48,19
8050,Boétie - Ponthieu,OUI,40,35,5,1,4,OUI,OUI,2025-03-13 18:59:30+00:00,"48.871417284355, 2.3076787590981",Paris,75056,0.125,19
25006,Place Nelson Mandela,OUI,22,21,1,0,1,OUI,OUI,2025-03-13 18:55:25+00:00,"48.862453313908, 2.1961666225454",Rueil-Malmaison,92063,0.045454545454545456,19
14108,Le Brix et Mesmin - Jourdan,OUI,20,16,4,2,2,OUI,OUI,2025-03-13 19:00:08+00:00,"48.82234096593411, 2.327861653302471",Paris,75056,0.2,19
30002,Jean Rostand - Paul Vaillant Couturier,OUI,39,32,7,6,1,OUI,OUI,2025-03-13 19:00:28+00:00,"48.908168131015, 2.4530601033354",Bobigny,93008,0.1794871794871795,19
31024,Romainville - Vaillant-Couturier,OUI,36,31,5,0,5,OUI,OUI,2025-03-13 19:01:30+00:00,"48.86785, 2.446748",Montreuil,93048,0.1388888888888889,19
7003,Square Boucicaut,OUI,58,48,10,6,4,OUI,OUI,2025-03-13 18:59:51+00:00,"48.851296433665276, 2.325061820447445",Paris,75056,0.1724137931034483,19
2022,Saint-Fiacre - Poissonière,OUI,34,26,8,2,6,OUI,OUI,2025-03-13 19:00:23+00:00,"48.870828911558, 2.3459213599563",Paris,75056,0.23529411764705882,19
17041,Guersant - Gouvion-Saint-Cyr,OUI,33,6,27,17,10,OUI,OUI,2025-03-13 19:01:33+00:00,"48.88287775178599, 2.287667370814871",Paris,75056,0.8181818181818182,19
17025,Chazelles - Courcelles,OUI,32,26,6,5,1,OUI,OUI,2025-03-13 18:58:28+00:00,"48.879406604954, 2.3034455627202988",Paris,75056,0.1875,19
5016,Thouin - Cardinal Lemoine,OUI,15,11,4,0,4,OUI,OUI,2025-03-13 18:59:42+00:00,"48.84504716661511, 2.3494647851273465",Paris,75056,0.26666666666666666,19
44017,Jules Guesde - Pont du Port à l'Anglais,OUI,26,0,26,24,2,OUI,OUI,2025-03-13 19:02:02+00:00,"48.79628807093802, 2.417212128639221",Vitry-sur-Seine,94081,1.0,19
11025,Froment - Bréguet,OUI,41,21,20,15,5,OUI,OUI,2025-03-13 19:02:20+00:00,"48.8570414504784, 2.37289470306807",Paris,75056,0.4878048780487805,19
15047,Morillons - Dantzig,OUI,51,45,6,0,6,OUI,OUI,2025-03-13 19:01:08+00:00,"48.83310149953933, 2.299380004405976",Paris,75056,0.11764705882352941,19
16118,Michel-Ange - Parent de Rosan,OUI,23,12,11,4,7,OUI,OUI,2025-03-13 19:01:06+00:00,"48.840579923690115, 2.2584119439125065",Paris,75056,0.4782608695652174,19
6021,Beaux-Arts - Bonaparte,OUI,19,18,1,0,1,OUI,OUI,2025-03-13 18:49:44+00:00,"48.856451985396, 2.3348518833518",Paris,75056,0.05263157894736842,19
8103,Artois - Berri,OUI,22,21,1,0,1,OUI,OUI,2025-03-13 18:55:34+00:00,"48.87393521240818, 2.3064258322119713",Paris,75056,0.045454545454545456,19
13101,Croulebarde - Corvisart,OUI,33,28,5,4,1,OUI,OUI,2025-03-13 19:02:02+00:00,"48.830981659316855, 2.3481646925210953",Paris,75056,0.15151515151515152,19
8048,Marceau - Chaillot,OUI,21,18,3,1,2,OUI,OUI,2025-03-13 19:02:37+00:00,"48.868834023334, 2.2986030816809",Paris,75056,0.14285714285714285,19
17044,Porte de Saint-Ouen - Bessières,OUI,39,25,14,10,4,OUI,OUI,2025-03-13 19:02:08+00:00,"48.89792240854517, 2.32851451022192",Paris,75056,0.358974358974359,19
14013,Liard - Amiral Mouchez,OUI,26,22,4,3,1,OUI,OUI,2025-03-13 19:02:40+00:00,"48.8214169, 2.342167",Paris,75056,0.15384615384615385,19
19033,Cambrai - Benjamin Constant,OUI,41,34,7,3,4,OUI,OUI,2025-03-13 18:53:39+00:00,"48.89594736851349, 2.381133802246315",Paris,75056,0.17073170731707318,19
10115,Granges aux Belles,OUI,26,21,5,1,4,OUI,OUI,2025-03-13 19:00:38+00:00,"48.8761373390584, 2.3680844979417",Paris,75056,0.19230769230769232,19
21326,Moulin de Pierre - Abbé Grégoire,OUI,20,13,7,0,7,OUI,OUI,2025-03-13 19:00:41+00:00,"48.822036188382, 2.2754641655975",Issy-les-Moulineaux,92040,0.35,19
5022,Boulangers - Cardinal Lemoine,OUI,18,16,2,0,2,OUI,OUI,2025-03-13 18:59:24+00:00,"48.8462904, 2.3521495",Paris,75056,0.1111111111111111,19
20143,Ramponeau - Belleville,OUI,44,29,15,0,15,OUI,OUI,2025-03-13 19:02:22+00:00,"48.871031137596, 2.379056852114",Paris,75056,0.3409090909090909,19
21328,Verger - Colonel Guichard,OUI,29,27,2,0,2,OUI,OUI,2025-03-13 18:55:24+00:00,"48.816376985087, 2.2670380088932",Issy-les-Moulineaux,92040,0.06896551724137931,19
43002,Lagny - Victor Basch,OUI,24,20,4,1,3,OUI,OUI,2025-03-13 19:01:29+00:00,"48.84884147189881, 2.426325418925233",Vincennes,94080,0.16666666666666666,19
13104,Gare d'Austerlitz - Quai Saint-Bernard,OUI,26,4,22,15,7,OUI,OUI,2025-03-13 18:58:25+00:00,"48.84369030864, 2.3657163977623",Paris,75056,0.8461538461538461,19
16138,Saint-Cloud - Hippodrome,OUI,30,23,7,4,3,OUI,OUI,2025-03-13 19:01:02+00:00,"48.85772148887421, 2.2549109905958176",Paris,75056,0.23333333333333334,19
31103,Gare Rosny-Bois-Perrier,OUI,32,13,19,1,18,OUI,OUI,2025-03-13 18:52:46+00:00,"48.88115023337061, 2.480436824262142",Rosny-sous-Bois,93064,0.59375,19
21216,Louis Lejeune - Barbès,OUI,24,24,0,0,0,OUI,OUI,2025-03-13 19:02:05+00:00,"48.81807418981508, 2.3267009854316716",Montrouge,92049,0.0,19
18203,Lamarck - Saint-Ouen,OUI,40,40,0,0,0,NON,NON,2025-03-13 19:01:36+00:00,"48.891334555236, 2.3272445342326",Paris,75056,0.0,19
15068,Général Martial Valin - Pont du Garigliano,OUI,16,15,1,0,1,OUI,OUI,2025-03-13 19:00:28+00:00,"48.83823094269141, 2.270506024360657",Paris,75056,0.0625,19
8053,Place Georges Guillaumin,OUI,27,24,3,1,2,OUI,OUI,2025-03-13 18:59:41+00:00,"48.874750203957, 2.301771435326",Paris,75056,0.1111111111111111,19
22207,Rond-point du Dr Albert Schweitzer,OUI,21,13,8,2,6,OUI,OUI,2025-03-13 19:01:14+00:00,"48.78980918988166, 2.3143940046429634",Bagneux,92007,0.38095238095238093,19
19105,Ambroise Rendu - Porte Brunet,OUI,16,14,2,1,1,OUI,OUI,2025-03-13 19:00:56+00:00,"48.883667, 2.395733",Paris,75056,0.125,19
92002,Théâtre des Amandiers - Palais des sports,OUI,22,9,13,8,5,OUI,OUI,2025-03-13 18:58:54+00:00,"48.892648526839, 2.2136941552162",Nanterre,92050,0.5909090909090909,19
31706,Château - République,OUI,24,14,10,0,10,OUI,OUI,2025-03-13 19:02:25+00:00,"48.862923800596, 2.4155035614967",Bagnolet,93006,0.4166666666666667,19
19027,Serrurier,OUI,18,17,1,0,1,OUI,OUI,2025-03-13 19:02:40+00:00,"48.880493403246, 2.398064173758",Paris,75056,0.05555555555555555,19
19015,Thionville - Ourcq,OUI,23,2,21,9,12,OUI,OUI,2025-03-13 19:00:48+00:00,"48.88917613743794, 2.3833653330802917",Paris,75056,0.9130434782608695,19
31028,Raspail Barbès,OUI,28,17,11,2,9,OUI,OUI,2025-03-13 18:56:28+00:00,"48.8529945, 2.4247387",Montreuil,93048,0.39285714285714285,19
92007,Pesaro - Préfecture,OUI,21,19,2,1,1,OUI,OUI,2025-03-13 19:01:56+00:00,"48.89577046284005, 2.223908342421055",Nanterre,92050,0.09523809523809523,19
17048,De Toqueville - Terrasse,OUI,30,28,2,2,0,OUI,OUI,2025-03-13 18:54:09+00:00,"48.882428, 2.314002",Paris,75056,0.06666666666666667,19
10107,Gare du Nord - Hôpital Lariboisière,OUI,49,46,3,1,2,OUI,OUI,2025-03-13 19:02:04+00:00,"48.881949, 2.352339",Paris,75056,0.061224489795918366,19
2017,Caire - Dussoubs,OUI,40,19,21,17,4,OUI,OUI,2025-03-13 19:01:42+00:00,"48.86785342111862, 2.349364310503006",Paris,75056,0.525,19
26002,Redoute - Les Courtilles,OUI,38,14,24,17,7,OUI,OUI,2025-03-13 19:02:03+00:00,"48.929867194519, 2.2836696356535",Asnières-sur-Seine,92004,0.631578947368421,19
9008,Tour d'Auvergne - Rodier,OUI,17,14,3,0,3,OUI,OUI,2025-03-13 18:57:46+00:00,"48.879161, 2.343698",Paris,75056,0.17647058823529413,19
19026,Place de Rhin et Danube,OUI,14,11,3,0,3,OUI,OUI,2025-03-13 18:57:52+00:00,"48.88192765861766, 2.392586767673493",Paris,75056,0.21428571428571427,19
13118,Regnault - Patay,OUI,62,13,49,41,8,OUI,OUI,2025-03-13 19:01:13+00:00,"48.82435782216384, 2.377065159380436",Paris,75056,0.7903225806451613,19
8034,Berri - Haussmann,OUI,33,30,3,2,1,OUI,OUI,2025-03-13 19:00:28+00:00,"48.874746047357135, 2.3082953318953514",Paris,75056,0.09090909090909091,19
15112,Vigée-Lebrun - Anselme Payen,OUI,23,20,3,0,3,OUI,OUI,2025-03-13 18:56:08+00:00,"48.838683941628375, 2.3110422492027287",Paris,75056,0.13043478260869565,19
11047,Amelot - Saint-Sébastien,OUI,28,1,27,19,8,OUI,OUI,2025-03-13 19:02:23+00:00,"48.861142162761, 2.3677996181077",Paris,75056,0.9642857142857143,19
13030,Italie - Tolbiac,OUI,21,10,11,4,7,OUI,OUI,2025-03-13 19:02:00+00:00,"48.82557229464416, 2.3576171323657036",Paris,75056,0.5238095238095238,19
19043,Delphine Seyrig - Général Leclerc,OUI,52,39,13,6,7,OUI,OUI,2025-03-13 19:01:13+00:00,"48.893923963057865, 2.39790290594101",Pantin,93055,0.25,19
18111,Félix Ziem - Armand Gauthier,OUI,23,15,8,1,7,OUI,OUI,2025-03-13 19:01:48+00:00,"48.88949630486821, 2.333393658804396",Paris,75056,0.34782608695652173,19
20042,Pyrénées - Emmery,OUI,39,33,6,0,6,OUI,OUI,2025-03-13 19:01:27+00:00,"48.872010281270974, 2.392039597034455",Paris,75056,0.15384615384615385,19
9002,Abbeville - Faubourg Poissonnière,OUI,14,9,5,2,3,OUI,OUI,2025-03-13 19:02:06+00:00,"48.879223, 2.349147",Paris,75056,0.35714285714285715,19
11027,Saint-Ambroise - Parmentier,OUI,35,15,20,7,13,OUI,OUI,2025-03-13 19:00:54+00:00,"48.862147844548, 2.3772348091006",Paris,75056,0.5714285714285714,19
48003,Youri Gagarine - Karl Marx,OUI,22,16,6,1,5,OUI,OUI,2025-03-13 19:01:10+00:00,"48.78448485079149, 2.35908430069685",Villejuif,94076,0.2727272727272727,19
8010,Liège - Moscou,OUI,15,12,3,3,0,OUI,OUI,2025-03-13 19:00:38+00:00,"48.8795431, 2.3264628",Paris,75056,0.2,19
16110,Octave Feuillet - Albéric Magnard,OUI,20,17,3,1,2,OUI,OUI,2025-03-13 19:01:33+00:00,"48.86106902949534, 2.2730283066630363",Paris,75056,0.15,19
31022,Mairie de Montreuil,OUI,51,46,5,2,3,OUI,OUI,2025-03-13 18:53:15+00:00,"48.86131452758348, 2.440614402294159",Montreuil,93048,0.09803921568627451,19
43009,Place Jean-Spire-Lemaître,OUI,48,32,16,9,7,OUI,OUI,2025-03-13 19:01:08+00:00,"48.8468428626593, 2.452062070369721",Vincennes,94080,0.3333333333333333,19
46002,Rouget de Lisle,OUI,35,3,32,16,16,OUI,OUI,2025-03-13 18:59:46+00:00,"48.764615483395254, 2.4071189761161804",Choisy-le-Roi,94022,0.9142857142857143,19
9001,Bellefond - Poissonnière,OUI,15,11,4,1,3,OUI,OUI,2025-03-13 18:57:27+00:00,"48.87759897050706, 2.348463758826256",Paris,75056,0.26666666666666666,19
10016,Récollets - Square Villemin,OUI,16,13,3,1,2,OUI,OUI,2025-03-13 19:00:16+00:00,"48.875034655883944, 2.359801238597928",Paris,75056,0.1875,19
17032,Jean Oestreicher - Porte de Champerret,OUI,21,9,12,7,5,OUI,OUI,2025-03-13 19:00:29+00:00,"48.88655580065981, 2.288640439510346",Paris,75056,0.5714285714285714,19
31009,Place Du Général De Gaulle,OUI,25,24,1,1,0,OUI,OUI,2025-03-13 18:53:05+00:00,"48.8687591, 2.4329931",Montreuil,93048,0.04,19
8016,Square Louis XVI,OUI,29,22,7,6,1,OUI,OUI,2025-03-13 19:00:47+00:00,"48.87320440102894, 2.323658830743138",Paris,75056,0.2413793103448276,19
14020,Cimetière de Montrouge,OUI,58,55,3,1,2,OUI,OUI,2025-03-13 18:57:26+00:00,"48.821466904768, 2.3215785772007",Paris,75056,0.05172413793103448,19
10029,Dunkerque - Rocroy,OUI,24,22,2,0,2,OUI,OUI,2025-03-13 19:02:05+00:00,"48.880726, 2.351464",Paris,75056,0.08333333333333333,19
33017,Anatole France - President Roosevelt,OUI,25,22,3,0,3,OUI,OUI,2025-03-13 18:55:37+00:00,"48.9155156, 2.3814103",Aubervilliers,93001,0.12,19
10161,Gare de l'Est - Faubourg-Saint-Martin,OUI,32,24,8,2,6,OUI,OUI,2025-03-13 19:01:24+00:00,"48.875642647477, 2.3594588041306",Paris,75056,0.25,19
18011,Pajol - Place Herbert,OUI,39,36,3,1,2,OUI,OUI,2025-03-13 19:00:53+00:00,"48.8927825, 2.3635598",Paris,75056,0.07692307692307693,19
41303,Gare de Nogent-le-Perreux,OUI,31,18,13,11,2,OUI,OUI,2025-03-13 18:59:09+00:00,"48.83842553348809, 2.493693307042122",Nogent-sur-Marne,94052,0.41935483870967744,19
33102,Gabriel Péri - Francisco Ferrer,OUI,18,10,8,0,8,OUI,OUI,2025-03-13 19:01:20+00:00,"48.88633710236977, 2.407338917255402",Le Pré-Saint-Gervais,93061,0.4444444444444444,19
12031,Gabriel Lamé,OUI,33,21,12,11,1,OUI,OUI,2025-03-13 19:01:58+00:00,"48.8351212784276, 2.385534569621086",Paris,75056,0.36363636363636365,19
42706,Roger Salengro - Fontainebleau,OUI,24,10,14,3,11,OUI,OUI,2025-03-13 19:00:31+00:00,"48.814548697325, 2.3611663654447",Le Kremlin-Bicêtre,94043,0.5833333333333334,19
1001,Quai de l'Horloge - Pont Neuf,OUI,16,0,16,10,6,OUI,OUI,2025-03-13 19:01:07+00:00,"48.857058739111, 2.3417982839439",Paris,75056,1.0,19
21212,Marne - Germain Dardan,OUI,20,18,2,1,1,OUI,OUI,2025-03-13 19:00:50+00:00,"48.81217465201, 2.3035024699104",Montrouge,92049,0.1,19
17040,Pereire - Ternes,OUI,48,33,15,6,9,OUI,OUI,2025-03-13 19:01:53+00:00,"48.87973954830735, 2.288012132048607",Paris,75056,0.3125,19
19120,Carducci - Place Hannah Arendt,OUI,27,26,1,0,1,OUI,OUI,2025-03-13 18:54:53+00:00,"48.877436681515796, 2.3860743641853337",Paris,75056,0.037037037037037035,19
9038,Douai - Bruxelles,OUI,26,19,7,1,6,OUI,OUI,2025-03-13 19:02:33+00:00,"48.88320784122797, 2.3308449949028507",Paris,75056,0.2692307692307692,19
18003,Cimetière de Montmartre,OUI,43,40,3,1,2,OUI,OUI,2025-03-13 18:59:40+00:00,"48.886472466142, 2.3328901827335",Paris,75056,0.06976744186046512,19
8009,Gare Saint-Lazare - Isly,OUI,25,20,5,3,2,OUI,OUI,2025-03-13 18:56:06+00:00,"48.874777677621296, 2.326515804784655",Paris,75056,0.2,19
14003,Schoelcher - Raspail,OUI,47,41,6,3,3,OUI,OUI,2025-03-13 19:02:36+00:00,"48.83681733526843, 2.3312794080411474",Paris,75056,0.1276595744680851,19
17008,Porte Pouchet-Bessières,OUI,23,5,18,12,6,OUI,OUI,2025-03-13 19:02:00+00:00,"48.8978765, 2.3230632",Paris,75056,0.782608695652174,19
19103,Manin - Carrières d'Amérique,OUI,16,6,10,0,10,OUI,OUI,2025-03-13 19:02:08+00:00,"48.88467214209463, 2.3919698596000676",Paris,75056,0.625,19
7018,Ségur - d'Estrées,OUI,18,15,3,2,1,OUI,OUI,2025-03-13 18:59:50+00:00,"48.851419978983, 2.3097044974566",Paris,75056,0.16666666666666666,19
14008,Mouton Duvernet - Général Leclerc,OUI,25,22,3,1,2,OUI,OUI,2025-03-13 19:00:23+00:00,"48.831632518293, 2.3293121159077",Paris,75056,0.12,19
5005,Gay Lussac - Saint-Jacques,OUI,22,15,7,2,5,OUI,OUI,2025-03-13 19:02:34+00:00,"48.844730256132, 2.3419239448664",Paris,75056,0.3181818181818182,19
15054,Lecourbe - Jean Maridor,OUI,18,6,12,6,6,OUI,OUI,2025-03-13 18:56:10+00:00,"48.83796366147599, 2.2877392172813416",Paris,75056,0.6666666666666666,19
21323,Charlot - Stade Gabriel Voisin,OUI,31,1,30,27,3,OUI,OUI,2025-03-13 19:02:17+00:00,"48.827228120536, 2.268122527474",Issy-les-Moulineaux,92040,0.967741935483871,19
14106,Marc Sangnier - Porte de Vanves,OUI,20,19,1,0,1,OUI,OUI,2025-03-13 18:56:05+00:00,"48.825218683556734, 2.3107116669416428",Paris,75056,0.05,19
9014,Faubourg Montmartre - La Fayette,OUI,33,17,16,12,4,OUI,OUI,2025-03-13 19:01:48+00:00,"48.875254549053, 2.3408536612988",Paris,75056,0.48484848484848486,19
18046,Etienne Jodelle - Saint Ouen,OUI,32,30,2,1,1,OUI,OUI,2025-03-13 19:02:35+00:00,"48.88794016394694, 2.326124420314341",Paris,75056,0.0625,19
9106,Boudreau - Auber,OUI,27,25,2,2,0,OUI,OUI,2025-03-13 18:57:20+00:00,"48.87219, 2.329423",Paris,75056,0.07407407407407407,19
22406,Guy Môquet - Etienne Dolet,OUI,22,19,3,1,2,OUI,OUI,2025-03-13 19:02:33+00:00,"48.81527009991819, 2.298078276995073",Malakoff,92046,0.13636363636363635,19
22409,Henri Barbusse - Stalingrad,OUI,16,4,12,0,12,OUI,OUI,2025-03-13 19:02:34+00:00,"48.814183748660554, 2.2872862592339516",Malakoff,92046,0.75,19
2111,Chabanais - Petits Champs,OUI,27,1,26,20,6,OUI,OUI,2025-03-13 18:59:47+00:00,"48.86703740186721, 2.336716018617153",Paris,75056,0.9629629629629629,19
9022,Rossini - Laffitte,OUI,33,28,5,4,1,OUI,OUI,2025-03-13 18:55:12+00:00,"48.87334627510507, 2.337980867701675",Paris,75056,0.15151515151515152,19
8054,Bertie Albrecht - Hoche,OUI,32,30,2,0,2,OUI,OUI,2025-03-13 19:01:11+00:00,"48.87614039826388, 2.301303138307601",Paris,75056,0.0625,19
26003,Argenteuil - Voltaire,OUI,15,0,15,5,10,OUI,OUI,2025-03-13 18:54:03+00:00,"48.91864865955558, 2.2814112156629562",Asnières-sur-Seine,92004,1.0,19
15109,Cevennes - Bergers,OUI,27,5,22,20,2,OUI,OUI,2025-03-13 19:01:34+00:00,"48.84240765130395, 2.281037718057633",Paris,75056,0.8148148148148148,19
17004,Legendre - Clichy,OUI,38,32,6,1,5,OUI,OUI,2025-03-13 19:01:59+00:00,"48.88896161855884, 2.322528975094376",Paris,75056,0.15789473684210525,19
10042,Enghien - Faubourg Poissonnière,OUI,32,9,23,22,1,OUI,OUI,2025-03-13 19:02:07+00:00,"48.872420063053, 2.3483952362828",Paris,75056,0.71875,19
19003,Quai de la Seine,OUI,23,3,20,8,12,OUI,OUI,2025-03-13 19:02:25+00:00,"48.884492238407525, 2.3703941702842717",Paris,75056,0.8695652173913043,19
4016,Lobau - Hôtel de Ville,OUI,58,5,53,48,5,OUI,OUI,2025-03-13 19:02:15+00:00,"48.8562118, 2.3532536",Paris,75056,0.9137931034482759,19
12151,Gare de Lyon - Place Louis Armand,OUI,56,9,47,33,14,OUI,OUI,2025-03-13 19:02:04+00:00,"48.845515089794, 2.3726498446286",Paris,75056,0.8392857142857143,19
8045,Place de la Reine Astrid,OUI,56,35,21,19,2,OUI,OUI,2025-03-13 19:02:07+00:00,"48.864920982538, 2.3025491823859",Paris,75056,0.375,19
5020,Institut du Monde Arabe - Saint-Germain,OUI,39,5,34,28,6,OUI,OUI,2025-03-13 19:02:25+00:00,"48.849063299501, 2.3558086529374",Paris,75056,0.8717948717948718,19
15133,Saint Lambert - Blomet,OUI,26,17,9,5,4,OUI,OUI,2025-03-13 19:02:05+00:00,"48.83659148147257, 2.2930556908249855",Paris,75056,0.34615384615384615,19
16026,Ranelagh - Mozart,OUI,7,1,6,2,4,OUI,OUI,2025-03-13 19:01:15+00:00,"48.8554439, 2.2704418",Paris,75056,0.8571428571428571,19
21006,Marcelin Berthelot,OUI,27,16,11,8,3,OUI,OUI,2025-03-13 18:56:55+00:00,"48.8415473058801, 2.233161628246308",Boulogne-Billancourt,92012,0.4074074074074074,19
9028,Moncey - Blanche,OUI,17,16,1,1,0,OUI,OUI,2025-03-13 18:56:48+00:00,"48.88006587474148, 2.3310810327529907",Paris,75056,0.058823529411764705,19
44003,Gabriel Péri - Danielle Casanova,OUI,20,10,10,8,2,OUI,OUI,2025-03-13 19:02:26+00:00,"48.790114, 2.4025777",Vitry-sur-Seine,94081,0.5,19
17043,Belidor - Gouvion-Saint-Cyr,OUI,38,27,11,10,1,OUI,OUI,2025-03-13 18:56:16+00:00,"48.88022154052015, 2.2854680567979813",Paris,75056,0.2894736842105263,19
22203,Tertres - Fontaine,OUI,27,16,11,1,10,OUI,OUI,2025-03-13 19:00:22+00:00,"48.787553654715644, 2.306235730648041",Bagneux,92007,0.4074074074074074,19
16039,Exelmans - Versailles,OUI,47,10,37,32,5,OUI,OUI,2025-03-13 19:02:27+00:00,"48.84097491091973, 2.264390252530575",Paris,75056,0.7872340425531915,19
41202,Gare Rer de Fontenay sous Bois,OUI,60,59,1,0,1,OUI,OUI,2025-03-13 19:02:09+00:00,"48.8436279, 2.4630465",Fontenay-sous-Bois,94033,0.016666666666666666,19
11023,Saint-Maur - Roquette,OUI,45,25,20,14,6,OUI,OUI,2025-03-13 19:02:29+00:00,"48.858688774062955, 2.383553994571467",Paris,75056,0.4444444444444444,19
42021,Raspail - Manufacture des Oeillets,OUI,30,13,17,15,2,OUI,OUI,2025-03-13 19:02:22+00:00,"48.8094458, 2.3903009",Ivry-sur-Seine,94041,0.5666666666666667,19
45003,11 Novembre 1918 - 8 Mai 1945,OUI,36,13,23,14,9,OUI,OUI,2025-03-13 18:59:36+00:00,"48.80889533774377, 2.5382421165704727",Champigny-sur-Marne,94017,0.6388888888888888,19
1020,Cambon - Rivoli,OUI,35,22,13,8,5,OUI,OUI,2025-03-13 18:55:33+00:00,"48.866143390992, 2.3251800647137",Paris,75056,0.37142857142857144,19
11002,Roquette - Thiéré,OUI,20,1,19,19,0,OUI,OUI,2025-03-13 19:00:59+00:00,"48.85507930579506, 2.3733686318721463",Paris,75056,0.95,19
20115,Louis Lumière - Porte de Bagnolet,OUI,20,16,4,1,3,OUI,OUI,2025-03-13 19:01:43+00:00,"48.86431136000005, 2.4105210229754443",Paris,75056,0.2,19
12111,Claude Decaen - Cannebière,OUI,27,19,8,3,5,OUI,OUI,2025-03-13 19:01:20+00:00,"48.83761417037952, 2.397253782195704",Paris,75056,0.2962962962962963,19
31003,Paris - Emile Zola,OUI,29,24,5,3,2,OUI,OUI,2025-03-13 19:01:34+00:00,"48.854898095789295, 2.4186685681343083",Montreuil,93048,0.1724137931034483,19
5032,Panthéon - Valette,OUI,39,38,1,1,0,OUI,OUI,2025-03-13 19:01:08+00:00,"48.847020571652, 2.3464982619671",Paris,75056,0.02564102564102564,19
11030,Oberkampf - République,OUI,20,1,19,9,10,OUI,OUI,2025-03-13 19:01:48+00:00,"48.86531608707, 2.37611478491",Paris,75056,0.95,19
18107,Chartres - La Charbonnière,OUI,34,32,2,1,1,OUI,OUI,2025-03-13 19:02:09+00:00,"48.8847601, 2.3534657",Paris,75056,0.058823529411764705,19
11039,Richard Lenoir - Jean-Pierre Timbaud,OUI,35,7,28,23,5,OUI,OUI,2025-03-13 19:01:40+00:00,"48.865804276686, 2.3693370749669",Paris,75056,0.8,19
15067,Desaix - Edgar Faure,OUI,11,1,10,7,3,OUI,OUI,2025-03-13 19:02:34+00:00,"48.852804604940296, 2.293077029857222",Paris,75056,0.9090909090909091,19
32604,Square du Théâtre du Garde-Chasse,OUI,50,46,4,1,3,OUI,OUI,2025-03-13 18:56:32+00:00,"48.881287375060616, 2.420119643211365",Les Lilas,93045,0.08,19
17030,Pereire - Rennequin,OUI,22,17,5,3,2,OUI,OUI,2025-03-13 19:02:36+00:00,"48.88364782887555, 2.2952447086572647",Paris,75056,0.22727272727272727,19
19024,Botzaris - Parc des Buttes Chaumont,OUI,20,18,2,0,2,OUI,OUI,2025-03-13 19:00:32+00:00,"48.877951, 2.381464",Paris,75056,0.1,19
6006,Notre-Dame-des-Champs - Stanislas,OUI,18,17,1,0,1,OUI,OUI,2025-03-13 19:01:37+00:00,"48.84479928858768, 2.329337755887181",Paris,75056,0.05555555555555555,19
41601,Général De Gaulle - Alouette,OUI,23,13,10,1,9,OUI,OUI,2025-03-13 19:02:18+00:00,"48.839109, 2.4175664",Saint-Mandé,94067,0.43478260869565216,19
12128,Pyramide - Ecole du Breuil,OUI,33,27,6,1,5,OUI,OUI,2025-03-13 19:00:44+00:00,"48.82237977153955, 2.4586871266365056",Paris,75056,0.18181818181818182,19
15021,Joseph Liouville - Croix Nivert,OUI,62,33,29,23,6,OUI,OUI,2025-03-13 19:01:44+00:00,"48.844835471244416, 2.297508493065834",Paris,75056,0.46774193548387094,19
41302,Charles de Gaulle - Beauté,OUI,48,37,11,0,11,OUI,OUI,2025-03-13 18:57:03+00:00,"48.83649602312711, 2.479562651149885",Nogent-sur-Marne,94052,0.22916666666666666,19
9010,Rochechouart lamartine,OUI,24,7,17,5,12,OUI,OUI,2025-03-13 19:02:27+00:00,"48.876719895109, 2.344393021854",Paris,75056,0.7083333333333334,19
15042,Henry Farman,OUI,15,12,3,3,0,OUI,OUI,2025-03-13 18:58:39+00:00,"48.83372430280548, 2.2713854536414146",Paris,75056,0.2,19
16108,Sablons - Georges Mandel,OUI,38,35,3,1,2,OUI,OUI,2025-03-13 18:58:51+00:00,"48.863875, 2.28189",Paris,75056,0.07894736842105263,19
44006,Concorde - Stalingrad,OUI,35,18,17,7,10,OUI,OUI,2025-03-13 19:01:24+00:00,"48.7985844, 2.3821302",Vitry-sur-Seine,94081,0.4857142857142857,19
43005,Gare RER de Vincennes,OUI,49,47,2,0,2,OUI,OUI,2025-03-13 18:59:05+00:00,"48.847563015126106, 2.433383166790009",Vincennes,94080,0.04081632653061224,19
11113,Richard Lenoir - Republique,OUI,56,18,38,31,7,OUI,OUI,2025-03-13 19:02:17+00:00,"48.8667175, 2.3692541",Paris,75056,0.6785714285714286,19
16136,Théophile Gautier - François Millet,OUI,27,5,22,20,2,OUI,OUI,2025-03-13 19:02:26+00:00,"48.85034821320644, 2.273029983043671",Paris,75056,0.8148148148148148,19
15104,Hôpital Européen Georges Pompidou,OUI,62,35,27,25,2,OUI,OUI,2025-03-13 19:01:40+00:00,"48.837695319163, 2.2753742337227",Paris,75056,0.43548387096774194,19
19032,Villette - Belleville,OUI,38,6,32,7,25,OUI,OUI,2025-03-13 19:02:34+00:00,"48.8726877314, 2.376461327076",Paris,75056,0.8421052631578947,19
43008,Fontenay - Libération,OUI,24,14,10,4,6,OUI,OUI,2025-03-13 18:59:39+00:00,"48.847803063647, 2.4451419711113",Vincennes,94080,0.4166666666666667,19
19022,Marché Secrétan,OUI,25,5,20,13,7,OUI,OUI,2025-03-13 19:02:09+00:00,"48.88125496379482, 2.373463287949562",Paris,75056,0.8,19
5018,Mutualité,OUI,37,4,33,31,2,OUI,OUI,2025-03-13 19:02:18+00:00,"48.848225572724, 2.3502873256803",Paris,75056,0.8918918918918919,19
21701,Larmeroux - Baudelaire,OUI,28,10,18,3,15,OUI,OUI,2025-03-13 19:01:41+00:00,"48.816939911292, 2.2809894804846",Vanves,92075,0.6428571428571429,19
19101,Square Simon Bolivar,OUI,22,16,6,2,4,OUI,OUI,2025-03-13 19:00:41+00:00,"48.875089888322, 2.3826304078102",Paris,75056,0.2727272727272727,19
16008,Galilée - Kléber,OUI,29,26,3,0,3,OUI,OUI,2025-03-13 19:00:27+00:00,"48.867411865714, 2.2907813801148",Paris,75056,0.10344827586206896,19
14138,Porte de Vanves,OUI,29,24,5,3,2,OUI,OUI,2025-03-13 18:57:58+00:00,"48.828012849445, 2.3056878894567",Paris,75056,0.1724137931034483,19
20134,Lieutenant Chauré - Etienne Marey,OUI,19,18,1,0,1,OUI,OUI,2025-03-13 18:54:46+00:00,"48.86746195408435, 2.405970990657807",Paris,75056,0.05263157894736842,19
12114,Victor Hugo - Jeanne Jugan,OUI,27,20,7,0,7,OUI,OUI,2025-03-13 18:58:04+00:00,"48.843949064031825, 2.415081394834419",Paris,75056,0.25925925925925924,19
14136,Auguste Cain - Jean Moulin,OUI,40,38,2,1,1,OUI,OUI,2025-03-13 19:01:56+00:00,"48.82577028927573, 2.3210415244102482",Paris,75056,0.05,19
46003,Conservatoire de Musique,OUI,24,0,24,19,5,OUI,OUI,2025-03-13 19:00:40+00:00,"48.77093586667601, 2.4034014344215398",Choisy-le-Roi,94022,1.0,19
42010,Mairie d'Ivry-sur-Seine,OUI,51,23,28,26,2,OUI,OUI,2025-03-13 19:02:09+00:00,"48.81057120969284, 2.3842826485633855",Ivry-sur-Seine,94041,0.5490196078431373,19
41209,Cimetière de Fontenay-sous-Bois,OUI,15,9,6,0,6,OUI,OUI,2025-03-13 19:00:54+00:00,"48.84706173362218, 2.4787822365760808",Fontenay-sous-Bois,94033,0.4,19
15046,Parc Georges Brassens - Brancion,OUI,28,17,11,6,5,OUI,OUI,2025-03-13 19:01:45+00:00,"48.83227829269761, 2.3022570088505745",Paris,75056,0.39285714285714285,19
21312,Lucie Aubrac - Fort,OUI,29,19,10,1,9,OUI,OUI,2025-03-13 19:00:25+00:00,"48.818144834008976, 2.271184623241425",Issy-les-Moulineaux,92040,0.3448275862068966,19
46001,Place Paul Eluard,OUI,19,5,14,8,6,OUI,OUI,2025-03-13 19:01:51+00:00,"48.7672039733195, 2.4144977331161503",Choisy-le-Roi,94022,0.7368421052631579,19
13001,Port-Royal - Hôpital du Val-de-Grâce,OUI,17,10,7,2,5,OUI,OUI,2025-03-13 19:01:59+00:00,"48.837668272811, 2.3448138346607",Paris,75056,0.4117647058823529,19
16040,Exelmans - Michel-Ange,OUI,30,14,16,11,5,OUI,OUI,2025-03-13 19:00:29+00:00,"48.84309486651855, 2.2597770800669053",Paris,75056,0.5333333333333333,19
18028,Championnet - Vauvenargues,OUI,31,25,6,1,5,OUI,OUI,2025-03-13 19:02:34+00:00,"48.89401874744574, 2.3319872841238976",Paris,75056,0.1935483870967742,19
21301,Saint-Vincent - Verdun,OUI,33,22,11,7,4,OUI,OUI,2025-03-13 19:00:32+00:00,"48.819211549234495, 2.254007756710053",Issy-les-Moulineaux,92040,0.3333333333333333,19
8017,Rocher - Laborde,OUI,64,59,5,4,1,OUI,OUI,2025-03-13 18:59:46+00:00,"48.87590240712654, 2.322616316378116",Paris,75056,0.078125,19
42302,Aristide Briand - Gare de Bagneux,OUI,20,12,8,4,4,OUI,OUI,2025-03-13 19:02:12+00:00,"48.79387269664978, 2.321148812770844",Cachan,94016,0.4,19
15106,Grenelle - Violet,OUI,33,9,24,19,5,OUI,OUI,2025-03-13 19:02:32+00:00,"48.84993035512154, 2.294612042605877",Paris,75056,0.7272727272727273,19
19029,Seine - Flandre,OUI,19,15,4,1,3,OUI,OUI,2025-03-13 19:01:58+00:00,"48.886785741479684, 2.3746193200349808",Paris,75056,0.21052631578947367,19
5124,Erasme - Ulm,OUI,21,19,2,1,1,OUI,OUI,2025-03-13 19:02:19+00:00,"48.84264375274712, 2.3445946723222733",Paris,75056,0.09523809523809523,19
9032,Mathurins - Auber,OUI,35,30,5,3,2,OUI,OUI,2025-03-13 19:01:56+00:00,"48.872988840744, 2.3294984212276",Paris,75056,0.14285714285714285,19
31102,Boissière - Etienne Dolet,OUI,20,15,5,1,4,OUI,OUI,2025-03-13 19:01:28+00:00,"48.876111, 2.4677312",Montreuil,93048,0.25,19
11042,Grand Prieuré - Crussol,OUI,45,8,37,25,12,OUI,OUI,2025-03-13 18:59:36+00:00,"48.864660627935, 2.3692265531829",Paris,75056,0.8222222222222222,19
18022,Marcadet - Barbès,OUI,34,31,3,0,3,OUI,OUI,2025-03-13 19:02:31+00:00,"48.890451120965, 2.3490573929687",Paris,75056,0.08823529411764706,19
32026,Leroy des Barres - Médiathèque,OUI,26,5,21,9,12,OUI,OUI,2025-03-13 19:02:19+00:00,"48.928253687082, 2.3681719727966",Saint-Denis,93066,0.8076923076923077,19
21209,Molière - République,OUI,30,27,3,0,3,OUI,OUI,2025-03-13 19:02:34+00:00,"48.81111581390707, 2.3145738624448158",Montrouge,92049,0.1,19
9005,Square d'Anvers,OUI,32,10,22,2,20,OUI,OUI,2025-03-13 19:00:38+00:00,"48.882633484311, 2.3448844062122",Paris,75056,0.6875,19
14012,Sibelle - Alésia,OUI,37,37,0,0,0,OUI,OUI,2025-03-13 18:57:59+00:00,"48.826701758539215, 2.3384983465075493",Paris,75056,0.0,19
8025,Miromesnil - La Boétie,OUI,32,31,1,0,1,OUI,OUI,2025-03-13 19:02:31+00:00,"48.873722412917, 2.3158480972052",Paris,75056,0.03125,19
21005,Hôtel de Ville de Boulogne Billancourt,OUI,26,9,17,15,2,OUI,OUI,2025-03-13 19:00:06+00:00,"48.83495885166784, 2.2416803240776066",Boulogne-Billancourt,92012,0.6538461538461539,19
13002,Arago - Glacière,OUI,26,19,7,5,2,OUI,OUI,2025-03-13 18:57:06+00:00,"48.83486054775774, 2.3445770524322067",Paris,75056,0.2692307692307692,19
35010,Hoche - Jean Lolive,OUI,20,11,9,1,8,OUI,OUI,2025-03-13 19:01:44+00:00,"48.89110239200789, 2.402843534946442",Pantin,93055,0.45,19
17203,Place de la Porte de Champeret,OUI,27,6,21,18,3,OUI,OUI,2025-03-13 18:56:35+00:00,"48.886062068226, 2.2917001576821",Paris,75056,0.7777777777777778,19
19013,Laumière - Petit,OUI,32,15,17,7,10,OUI,OUI,2025-03-13 19:01:55+00:00,"48.88467368538326, 2.380039058625698",Paris,75056,0.53125,19
42014,Place Marcel Cachin,OUI,32,9,23,21,2,OUI,OUI,2025-03-13 19:00:02+00:00,"48.81411442356866, 2.39090770483017",Ivry-sur-Seine,94041,0.71875,19
42301,Gare Arcueil - Cachan,OUI,25,23,2,0,2,OUI,OUI,2025-03-13 19:02:32+00:00,"48.799824, 2.328171",Arcueil,94003,0.08,19
14124,David Weill - Parc Montsouris,OUI,22,22,0,0,0,OUI,OUI,2025-03-13 19:01:35+00:00,"48.821092374256104, 2.333725690841675",Paris,75056,0.0,19
26013,Quai du docteur Dervaux,OUI,26,16,10,9,1,OUI,OUI,2025-03-13 19:02:00+00:00,"48.910482, 2.297998",Asnières-sur-Seine,92004,0.38461538461538464,19
15110,Place Robert Guillemard,OUI,21,10,11,6,5,OUI,OUI,2025-03-13 18:59:59+00:00,"48.836191728066666, 2.2811267160086417",Paris,75056,0.5238095238095238,19
20043,Charonne - Avron,OUI,25,12,13,7,6,OUI,OUI,2025-03-13 18:58:51+00:00,"48.851602665222, 2.3984030470379",Paris,75056,0.52,19
42015,Place Jean Ferrat,OUI,24,15,9,4,5,OUI,OUI,2025-03-13 19:00:34+00:00,"48.8184945213025, 2.3744174838066106",Ivry-sur-Seine,94041,0.375,19
44013,Edouard Tremblay - Julian Grimaux,OUI,30,29,1,0,1,OUI,OUI,2025-03-13 18:59:31+00:00,"48.781383825117, 2.3723508417606",Vitry-sur-Seine,94081,0.03333333333333333,19
15201,Place Amédée Gordini - Lefebvre,OUI,35,30,5,1,4,OUI,OUI,2025-03-13 18:59:45+00:00,"48.83061737745, 2.2920634208276",Paris,75056,0.14285714285714285,19
20131,Repos - Cimetière du Père Lachaise,OUI,33,28,5,2,3,OUI,OUI,2025-03-13 18:58:13+00:00,"48.859358523593, 2.3896131366845",Paris,75056,0.15151515151515152,19
31010,Stalingrad - Désiré Chevalier,OUI,42,33,9,2,7,OUI,OUI,2025-03-13 19:02:37+00:00,"48.85670169739857, 2.445072233676911",Montreuil,93048,0.21428571428571427,19
6025,Assas - Rennes,OUI,32,16,16,14,2,OUI,OUI,2025-03-13 19:01:04+00:00,"48.8492084999386, 2.32851454623001",Paris,75056,0.5,19
11004,Charonne - Faubourg Saint-Antoine,OUI,32,2,30,26,4,OUI,OUI,2025-03-13 19:01:48+00:00,"48.852191909696, 2.3740932717919",Paris,75056,0.9375,19
21015,Nationale - Place Jules Guesde,OUI,22,12,10,8,2,OUI,OUI,2025-03-13 19:02:31+00:00,"48.82753962462998, 2.2416052222251897",Boulogne-Billancourt,92012,0.45454545454545453,19
18201,Tristan Tzara -  Tchaïkovski,OUI,33,28,5,2,3,OUI,OUI,2025-03-13 19:02:14+00:00,"48.89490221746837, 2.3648490384221077",Paris,75056,0.15151515151515152,19
15034,Lakanal - Commerce,OUI,45,3,42,36,6,OUI,OUI,2025-03-13 19:01:22+00:00,"48.84442462786544, 2.294059172272682",Paris,75056,0.9333333333333333,19
41402,Victor Hugo - Ecoles,OUI,22,3,19,11,8,OUI,OUI,2025-03-13 19:00:26+00:00,"48.80476007936134, 2.4180373930262093",Alfortville,94002,0.8636363636363636,19
5028,Censier - Jardin des Plantes,OUI,27,9,18,15,3,OUI,OUI,2025-03-13 18:59:51+00:00,"48.84107178161383, 2.355475388467312",Paris,75056,0.6666666666666666,19
18012,Stephenson - Doudeauville,OUI,36,24,12,4,8,OUI,OUI,2025-03-13 19:02:30+00:00,"48.888537048944826, 2.3561610281467438",Paris,75056,0.3333333333333333,19
48010,Karl Marx,OUI,16,5,11,2,9,OUI,OUI,2025-03-13 18:58:28+00:00,"48.784527937293184, 2.3646667979455587",Villejuif,94076,0.6875,19
19125,Place de l'Édit de Nantes,OUI,28,16,12,7,5,OUI,OUI,2025-03-13 19:02:40+00:00,"48.88879, 2.3785",Paris,75056,0.42857142857142855,19
1119,Cossonnerie - Sébastopol,OUI,23,4,19,13,6,OUI,OUI,2025-03-13 19:02:14+00:00,"48.86132665908402, 2.349419631063938",Paris,75056,0.8260869565217391,19
14036,Boulard - Daguerre,OUI,43,34,9,2,7,OUI,OUI,2025-03-13 19:02:32+00:00,"48.83446472680611, 2.3293386027216907",Paris,75056,0.20930232558139536,19
35020,Marcelle - Thalie,OUI,20,18,2,0,2,OUI,OUI,2025-03-13 18:55:31+00:00,"48.8835462, 2.4137883",Pantin,93055,0.1,19
25003,Henri Ste-Claire Déville - Paul Héroult,OUI,20,11,9,5,4,OUI,OUI,2025-03-13 19:02:24+00:00,"48.892663, 2.172411",Rueil-Malmaison,92063,0.45,19
5123,Saint-Germain - Thenard,OUI,29,11,18,15,3,OUI,OUI,2025-03-13 19:00:27+00:00,"48.850571, 2.3471015",Paris,75056,0.6206896551724138,19
22402,Jean Jaurès - Salvador Allende,OUI,42,37,5,3,2,OUI,OUI,2025-03-13 19:02:20+00:00,"48.821475594736775, 2.3026576638221745",Malakoff,92046,0.11904761904761904,19
23009,Anatole France - Louise Michel,OUI,47,31,16,8,8,OUI,OUI,2025-03-13 19:02:14+00:00,"48.88873214926474, 2.2881576418876652",Levallois-Perret,92044,0.3404255319148936,19
9116,Victoire - Chaussée d'Antin,OUI,24,23,1,1,0,OUI,OUI,2025-03-13 18:53:40+00:00,"48.875065791004396, 2.3316738009452824",Paris,75056,0.041666666666666664,19
12027,Montgallet - Charenton,OUI,15,0,15,15,0,OUI,OUI,2025-03-13 19:02:08+00:00,"48.842647778701, 2.3861649278137",Paris,75056,1.0,19
17013,Legendre - Dulong,OUI,23,14,9,2,7,OUI,OUI,2025-03-13 19:02:33+00:00,"48.885325169402904, 2.316423766314984",Paris,75056,0.391304347826087,19
42029,Stalingrad - Germaine Tailleferre,OUI,28,24,4,0,4,OUI,OUI,2025-03-13 18:56:25+00:00,"48.80257200481316, 2.3786691203713417",Ivry-sur-Seine,94041,0.14285714285714285,19
11026,Chemin Vert - Saint-Maur,OUI,44,33,11,2,9,OUI,OUI,2025-03-13 19:02:21+00:00,"48.86112461407359, 2.381299026310444",Paris,75056,0.25,19
8035,Bienfaisance - Place de Narvik,OUI,34,33,1,0,1,OUI,OUI,2025-03-13 19:00:33+00:00,"48.87660163459077, 2.3129771277308464",Paris,75056,0.029411764705882353,19
23006,Jules Guesde - Alsace,OUI,24,19,5,2,3,OUI,OUI,2025-03-13 18:58:32+00:00,"48.890566275506, 2.2950777411461",Levallois-Perret,92044,0.20833333333333334,19
21313,Guynemer - Séverine,OUI,23,12,11,8,3,OUI,OUI,2025-03-13 18:57:50+00:00,"48.83091743371036, 2.2790706530213356",Issy-les-Moulineaux,92040,0.4782608695652174,19
17105,Place Madeleine Daniélou,OUI,42,31,11,10,1,OUI,OUI,2025-03-13 19:01:08+00:00,"48.883498, 2.282015",Paris,75056,0.2619047619047619,19
26007,Square Gilbert Thomain,OUI,19,16,3,0,3,OUI,OUI,2025-03-13 18:57:04+00:00,"48.90717373809284, 2.2695400938391685",Asnières-sur-Seine,92004,0.15789473684210525,19
18009,Jean-François Lépine - Stephenson,OUI,19,17,2,0,2,OUI,OUI,2025-03-13 18:57:54+00:00,"48.88611466796807, 2.356855627529275",Paris,75056,0.10526315789473684,19
11007,Jean Macé - Faidherbe,OUI,56,25,31,20,11,OUI,OUI,2025-03-13 19:02:32+00:00,"48.85337548426, 2.3828620836139",Paris,75056,0.5535714285714286,19
11105,Parmentier - République,OUI,21,5,16,4,12,OUI,OUI,2025-03-13 18:59:50+00:00,"48.8644954, 2.3750124",Paris,75056,0.7619047619047619,19
15025,Dupleix - du Guesclin,OUI,45,3,42,36,6,OUI,OUI,2025-03-13 19:00:22+00:00,"48.85147910413369, 2.296709530055523",Paris,75056,0.9333333333333333,19
17125,Marie-Georges Picquart - Pereire,OUI,32,29,3,2,1,OUI,OUI,2025-03-13 18:59:47+00:00,"48.88863669349711, 2.3111706599593163",Paris,75056,0.09375,19
35018,Ancien Canal - Hélène Brion,OUI,23,19,4,2,2,OUI,OUI,2025-03-13 19:00:43+00:00,"48.89484799296163, 2.4188338592648506",Pantin,93055,0.17391304347826086,19
22003,Beffroy,OUI,26,25,1,1,0,OUI,OUI,2025-03-13 19:01:44+00:00,"48.886591074488, 2.2613945603371",Neuilly-sur-Seine,92051,0.038461538461538464,19
18110,Departement - Pajol,OUI,16,9,7,3,4,OUI,OUI,2025-03-13 19:02:06+00:00,"48.886674849730184, 2.3613611608743668",Paris,75056,0.4375,19
11024,Mairie du 11ème,OUI,49,5,44,32,12,OUI,OUI,2025-03-13 19:02:14+00:00,"48.858925, 2.3789759",Paris,75056,0.8979591836734694,19
19005,Flandre - Riquet,OUI,20,12,8,3,5,OUI,OUI,2025-03-13 19:00:36+00:00,"48.888013281448, 2.3737595955229",Paris,75056,0.4,19
13050,Quai Panhard et Levassor,OUI,56,55,1,1,0,OUI,OUI,2025-03-13 19:02:35+00:00,"48.828374828097, 2.3842737458056",Paris,75056,0.017857142857142856,19
41606,Pasteur - Gambetta,OUI,19,18,1,1,0,OUI,OUI,2025-03-13 19:00:18+00:00,"48.84572797384512, 2.4236011505126953",Saint-Mandé,94067,0.05263157894736842,19
12013,Montgallet - Reuilly,OUI,14,7,7,0,7,OUI,OUI,2025-03-13 19:02:31+00:00,"48.844291, 2.3896481",Paris,75056,0.5,19
21008,Victor Hugo - Galliéni,OUI,33,4,29,18,11,OUI,OUI,2025-03-13 19:01:48+00:00,"48.838020154411, 2.2460845112801",Boulogne-Billancourt,92012,0.8787878787878788,19
21305,Place Jacques Madaule,OUI,22,3,19,16,3,OUI,OUI,2025-03-13 19:02:34+00:00,"48.823933787309, 2.2606918215752",Issy-les-Moulineaux,92040,0.8636363636363636,19
24001,Arche - Léonard de Vinci,OUI,27,26,1,0,1,OUI,OUI,2025-03-13 19:02:37+00:00,"48.89790972494496, 2.2383723043644914",Courbevoie,92026,0.037037037037037035,19
7015,Varenne,OUI,43,22,21,14,7,OUI,OUI,2025-03-13 19:02:33+00:00,"48.857202661803, 2.3152771219611",Paris,75056,0.4883720930232558,19
22016,Charles de Gaulle - Sablonville,OUI,26,24,2,0,2,OUI,OUI,2025-03-13 19:01:33+00:00,"48.87991924860035, 2.2763770446181297",Neuilly-sur-Seine,92051,0.07692307692307693,19
5021,Jussieu - Fossés Saint-Bernard,OUI,34,31,3,2,1,OUI,OUI,2025-03-13 19:02:21+00:00,"48.847185510023, 2.3534858599305",Paris,75056,0.08823529411764706,19
32302,Chemin Vert - Fraternité,OUI,20,14,6,0,6,OUI,OUI,2025-03-13 19:02:37+00:00,"48.877141208359035, 2.4461565166711807",Romainville,93063,0.3,19
12115,Porte de Vincennes,OUI,32,28,4,0,4,OUI,OUI,2025-03-13 18:53:04+00:00,"48.846454, 2.415514",Paris,75056,0.125,19
10014,Marseille - Beaurepaire,OUI,49,11,38,26,12,OUI,OUI,2025-03-13 19:02:27+00:00,"48.871624306962985, 2.3639265082738348",Paris,75056,0.7755102040816326,19
41102,Gare de Laplace,OUI,43,42,1,0,1,OUI,OUI,2025-03-13 18:59:11+00:00,"48.80893199114179, 2.3349460959434514",Arcueil,94003,0.023255813953488372,19
11035,Parmentier - Abel Rabaud,OUI,51,33,18,11,7,OUI,OUI,2025-03-13 19:00:33+00:00,"48.86921273836114, 2.371688821240712",Paris,75056,0.35294117647058826,19
17037,Bayen - Pereire,OUI,21,11,10,10,0,OUI,OUI,2025-03-13 19:00:45+00:00,"48.881804409079656, 2.2921088710427284",Paris,75056,0.47619047619047616,19
22006,Pierret - Madrid,OUI,26,22,4,2,2,OUI,OUI,2025-03-13 19:02:15+00:00,"48.882976576876565, 2.260125767248034",Neuilly-sur-Seine,92051,0.15384615384615385,19
18141,Clignancourt - Sofia,OUI,19,4,15,3,12,OUI,OUI,2025-03-13 19:02:06+00:00,"48.88511992309783, 2.34719488842051",Paris,75056,0.7894736842105263,19
17028,Reims - Raymond Pitet,OUI,36,12,24,18,6,OUI,OUI,2025-03-13 19:01:52+00:00,"48.8888, 2.296319",Paris,75056,0.6666666666666666,19
33003,Bordier - Félix Faure,OUI,45,28,17,7,10,OUI,OUI,2025-03-13 19:02:00+00:00,"48.90390751882016, 2.3830059170722966",Aubervilliers,93001,0.37777777777777777,19
19016,Hautpoul - Jean Jaurès,OUI,29,23,6,2,4,OUI,OUI,2025-03-13 19:02:14+00:00,"48.886393679436, 2.3865414544355",Paris,75056,0.20689655172413793,19
33009,Félix Faure - Sadi Carnot,OUI,32,16,16,8,8,OUI,OUI,2025-03-13 19:01:02+00:00,"48.90812110228388, 2.378623187541962",Aubervilliers,93001,0.5,19
32003,Wilson - Métallurgie,OUI,28,14,14,7,7,OUI,OUI,2025-03-13 19:02:27+00:00,"48.909423010092326, 2.3584435880184174",Saint-Denis,93066,0.5,19
5106,Cujas - Saint-Michel,OUI,19,19,0,0,0,OUI,OUI,2025-03-13 19:01:35+00:00,"48.848191348584, 2.341831654854",Paris,75056,0.0,19
21104,Madame de Sanzillon - Mozart,OUI,22,18,4,2,2,OUI,OUI,2025-03-13 19:01:25+00:00,"48.90379820774301, 2.3187401890754704",Clichy,92024,0.18181818181818182,19
25005,18 juin 1940 - Buzenval,OUI,25,14,11,3,8,OUI,OUI,2025-03-13 19:00:06+00:00,"48.868807, 2.185428",Rueil-Malmaison,92063,0.44,19
1013,Place du Palais Royal,OUI,64,37,27,26,1,OUI,OUI,2025-03-13 19:00:29+00:00,"48.862382970647, 2.3384822532535",Paris,75056,0.421875,19
13045,Jean Colly - Tolbiac,OUI,35,32,3,3,0,OUI,OUI,2025-03-13 19:01:25+00:00,"48.827817291597846, 2.3705490678548813",Paris,75056,0.08571428571428572,19
7102,Mairie du 7ème,OUI,47,29,18,14,4,OUI,OUI,2025-03-13 19:02:33+00:00,"48.8577967, 2.3192664",Paris,75056,0.3829787234042553,19
14034,Ouest - Château,OUI,23,5,18,5,13,OUI,OUI,2025-03-13 19:02:36+00:00,"48.83617286014242, 2.319392143923804",Paris,75056,0.782608695652174,19
20121,Boyer - Ménilmontant,OUI,19,11,8,0,8,OUI,OUI,2025-03-13 19:01:03+00:00,"48.868895162679, 2.3919824145635",Paris,75056,0.42105263157894735,19
32010,Place aux Étoiles,OUI,37,34,3,0,3,OUI,OUI,2025-03-13 18:55:00+00:00,"48.91835629408464, 2.3523425683379173",Saint-Denis,93066,0.08108108108108109,19
42504,Gare RER de Gentilly,OUI,30,20,10,1,9,OUI,OUI,2025-03-13 19:01:09+00:00,"48.814280450380224, 2.3410347104072575",Gentilly,94037,0.3333333333333333,19
16018,Flandrin - Henri Martin,OUI,17,16,1,0,1,OUI,OUI,2025-03-13 18:58:56+00:00,"48.8643275, 2.2724174",Paris,75056,0.058823529411764705,19
20111,Villiers de l'Isle Adam - Pyrénées,OUI,20,15,5,0,5,OUI,OUI,2025-03-13 19:01:41+00:00,"48.867362, 2.396222",Paris,75056,0.25,19
12034,Pirogues de Bercy - Libourne,OUI,48,43,5,3,2,OUI,OUI,2025-03-13 19:01:37+00:00,"48.832308, 2.38637",Paris,75056,0.10416666666666667,19
32016,Place de la Porte de Paris,OUI,35,30,5,2,3,OUI,OUI,2025-03-13 18:57:33+00:00,"48.93009363207303, 2.3564037680625916",Saint-Denis,93066,0.14285714285714285,19
15033,Place Violet,OUI,27,4,23,17,6,OUI,OUI,2025-03-13 19:01:40+00:00,"48.84487893836502, 2.2905756533145905",Paris,75056,0.8518518518518519,19
19008,Flandre - Alphonse Karr,OUI,26,22,4,0,4,OUI,OUI,2025-03-13 19:02:13+00:00,"48.89465, 2.381868",Paris,75056,0.15384615384615385,19
25008,Place du 8 Mai 1945,OUI,18,13,5,4,1,OUI,OUI,2025-03-13 19:00:28+00:00,"48.871552174017, 2.2025031970585",Rueil-Malmaison,92063,0.2777777777777778,19
92008,Hôtel de Ville de Nanterre,OUI,35,16,19,11,8,OUI,OUI,2025-03-13 19:02:24+00:00,"48.892371898250424, 2.205548956990242",Nanterre,92050,0.5428571428571428,19
19044,Grands Moulins de Pantin,OUI,50,47,3,1,2,OUI,OUI,2025-03-13 19:01:09+00:00,"48.89738369720229, 2.3959985375404362",Paris,75056,0.06,19
51004,Général Delambre - Prebuard,OUI,28,19,9,3,6,OUI,OUI,2025-03-13 18:59:39+00:00,"48.93870344444, 2.2234171606307",Argenteuil,95018,0.32142857142857145,19
33001,Victor Hugo - Magasins Généraux,OUI,33,32,1,0,1,OUI,OUI,2025-03-13 19:01:22+00:00,"48.903281401126755, 2.368072383105755",Aubervilliers,93001,0.030303030303030304,19
12009,Charenton - Diderot,OUI,18,0,18,14,4,OUI,OUI,2025-03-13 19:02:36+00:00,"48.846171461187, 2.3793068155646",Paris,75056,1.0,19
16034,Porte d'Auteuil,OUI,31,22,9,3,6,OUI,OUI,2025-03-13 18:57:08+00:00,"48.8479394142243, 2.2608396783471107",Paris,75056,0.2903225806451613,19
19205,Simon Bolivar - Henri Turot,OUI,23,14,9,0,9,OUI,OUI,2025-03-13 19:02:33+00:00,"48.877475489801, 2.3739709492211",Paris,75056,0.391304347826087,19
41404,Carnot - Pâquerettes,OUI,23,5,18,16,2,OUI,OUI,2025-03-13 19:02:15+00:00,"48.79592939432515, 2.4261841177940373",Alfortville,94002,0.782608695652174,19
11036,Jules Ferry - Faubourg du Temple Paris,OUI,55,20,35,30,5,OUI,OUI,2025-03-13 19:02:05+00:00,"48.868397, 2.3678933",Paris,75056,0.6363636363636364,19
15122,Place Charles Vallin,OUI,25,19,6,2,4,OUI,OUI,2025-03-13 19:01:09+00:00,"48.835523812041, 2.3025986552238",Paris,75056,0.24,19
43003,Hôpital Bégin,OUI,26,26,0,0,0,NON,NON,2025-03-13 19:02:34+00:00,"48.84571672113, 2.4272462725639",Vincennes,94080,0.0,19
42707,Place Jean-Baptiste Clément,OUI,24,15,9,5,4,OUI,OUI,2025-03-13 19:02:22+00:00,"48.81240466867336, 2.3617091774940495",Le Kremlin-Bicêtre,94043,0.375,19
9021,Saint Georges - d'Aumale,OUI,23,19,4,4,0,OUI,OUI,2025-03-13 18:57:34+00:00,"48.87778639599673, 2.337429821491241",Paris,75056,0.17391304347826086,19
92003,Chanzy - Sud-Est,OUI,25,15,10,3,7,OUI,OUI,2025-03-13 19:02:22+00:00,"48.888912037698766, 2.195632159709931",Nanterre,92050,0.4,19
17102,Alfred Roll - Berthier,OUI,28,26,2,1,1,OUI,OUI,2025-03-13 18:57:23+00:00,"48.887808570529, 2.3000952981763",Paris,75056,0.07142857142857142,19
5119,Jussieu - Guy de la Brosse,OUI,39,37,2,1,1,OUI,OUI,2025-03-13 18:59:01+00:00,"48.845665, 2.355653",Paris,75056,0.05128205128205128,19
28001,Richard Wallace - Place du 8 Mai 1945,OUI,28,5,23,16,7,OUI,OUI,2025-03-13 19:02:34+00:00,"48.87866794788021, 2.2420343756675725",Puteaux,92062,0.8214285714285714,19
35009,Jean Lolive - Parc Stalingrad,OUI,21,17,4,2,2,OUI,OUI,2025-03-13 19:00:58+00:00,"48.89206174403158, 2.4091735482215886",Pantin,93055,0.19047619047619047,19
16111,Faustin Hélie - Desbordes-Valmore,OUI,27,27,0,0,0,OUI,OUI,2025-03-13 18:57:44+00:00,"48.859403, 2.276522",Paris,75056,0.0,19
8055,Courcelles - Place des Ternes,OUI,28,26,2,1,1,OUI,OUI,2025-03-13 18:59:00+00:00,"48.878199928923124, 2.2992860188665043",Paris,75056,0.07142857142857142,19
10113,Parmentier - Hôpital Saint-Louis,OUI,40,31,9,3,6,OUI,OUI,2025-03-13 19:01:17+00:00,"48.871379874257, 2.3698963836667",Paris,75056,0.225,19
21109,Guichet - Jean Jaurès,OUI,23,4,19,15,4,OUI,OUI,2025-03-13 19:01:07+00:00,"48.905169868129036, 2.3023840785026555",Clichy,92024,0.8260869565217391,19
17011,Fragonard - Porte de Clichy,OUI,52,16,36,27,9,OUI,OUI,2025-03-13 19:01:25+00:00,"48.894155633419, 2.3143893107772",Paris,75056,0.6923076923076923,19
21502,Verdun - Place Henri IV,OUI,25,11,14,10,4,OUI,OUI,2025-03-13 19:01:07+00:00,"48.870797375639214, 2.2277003154158592",Suresnes,92073,0.56,19
17045,Place des Ternes.,OUI,45,39,6,1,5,OUI,OUI,2025-03-13 19:00:40+00:00,"48.878438631226516, 2.297727763652802",Paris,75056,0.13333333333333333,19
16129,Ceinture du Lac Inferieure - Saint-Cloud,OUI,40,40,0,0,0,OUI,OUI,2025-03-13 18:58:48+00:00,"48.86218070933143, 2.2617871686816216",Paris,75056,0.0,19
43402,Place de Verdun,OUI,40,19,21,18,3,OUI,OUI,2025-03-13 19:02:07+00:00,"48.8202823, 2.473775",Joinville-le-Pont,94042,0.525,19
35019,Anatole France - Jean Lolive,OUI,28,23,5,1,4,OUI,OUI,2025-03-13 18:53:03+00:00,"48.8949922, 2.4253764",Pantin,93055,0.17857142857142858,19
33018,Edouard Poisson - Victor Hugo,OUI,27,20,7,3,4,OUI,OUI,2025-03-13 19:01:35+00:00,"48.91118557052621, 2.379864752692811",Aubervilliers,93001,0.25925925925925924,19
20113,Piat - Parc de Belleville,OUI,20,13,7,0,7,OUI,OUI,2025-03-13 19:02:01+00:00,"48.87195626635528, 2.384981390278095",Paris,75056,0.35,19
11115,Montreuil - Gonnet,OUI,24,11,13,10,3,OUI,OUI,2025-03-13 19:02:30+00:00,"48.850500564921, 2.3890856287864",Paris,75056,0.5416666666666666,19
6030,Assas - Vaugirard,OUI,33,31,2,2,0,OUI,OUI,2025-03-13 18:58:40+00:00,"48.848274111398, 2.3292413726449",Paris,75056,0.06060606060606061,19
12126,Gravelle - Route du Bac,OUI,48,36,12,7,5,OUI,OUI,2025-03-13 19:02:21+00:00,"48.824407, 2.418455",Paris,75056,0.25,19
6013,Jacques Callot - Mazarine,OUI,27,4,23,22,1,OUI,OUI,2025-03-13 19:02:08+00:00,"48.855280175332, 2.3375743255019",Paris,75056,0.8518518518518519,19
20036,Ménilmontant - Pelleport,OUI,31,29,2,0,2,OUI,OUI,2025-03-13 19:01:28+00:00,"48.870682633845, 2.3989596023316",Paris,75056,0.06451612903225806,19
8033,Commandant Rivière,OUI,39,34,5,3,2,OUI,OUI,2025-03-13 19:01:28+00:00,"48.872933, 2.309796",Paris,75056,0.1282051282051282,19
41604,Lagny - Joffre,OUI,30,30,0,0,0,OUI,OUI,2025-03-13 19:01:40+00:00,"48.84930687084088, 2.417949736118317",Saint-Mandé,94067,0.0,19
16121,Jardin d'Acclimatation,OUI,30,26,4,1,3,OUI,OUI,2025-03-13 19:00:01+00:00,"48.878772242510465, 2.270772233605385",Paris,75056,0.13333333333333333,19
18005,Tardieu - Chappe,OUI,16,12,4,0,4,OUI,OUI,2025-03-13 18:58:50+00:00,"48.884146759782, 2.341845408082",Paris,75056,0.25,19
23001,Paul Vaillant Couturier - Chaptal,OUI,35,33,2,2,0,OUI,OUI,2025-03-13 19:02:36+00:00,"48.893479576183, 2.2775253653526",Levallois-Perret,92044,0.05714285714285714,19
26001,Gare d'Asnières sur Seine,OUI,21,2,19,12,7,OUI,OUI,2025-03-13 19:01:14+00:00,"48.90636459217474, 2.2835066914558415",Asnières-sur-Seine,92004,0.9047619047619048,19
15010,Square Cambronne,OUI,58,1,57,51,6,OUI,OUI,2025-03-13 19:01:41+00:00,"48.84756654526, 2.3025691509247",Paris,75056,0.9827586206896551,19
43006,Vignerons - Minimes,OUI,28,26,2,1,1,OUI,OUI,2025-03-13 19:01:59+00:00,"48.841486, 2.430793",Vincennes,94080,0.07142857142857142,19
16124,Route de Sèvres - Porte de Bagatelle,OUI,66,4,62,55,7,OUI,OUI,2025-03-13 19:00:52+00:00,"48.87525984132485, 2.249415814876557",Paris,75056,0.9393939393939394,19
5002,Sommerard - Saint-Jacques,OUI,33,21,12,10,2,OUI,OUI,2025-03-13 19:02:19+00:00,"48.850310432924466, 2.345015835298588",Paris,75056,0.36363636363636365,19
22505,Mairie de La Garenne Colombes,OUI,22,5,17,7,10,OUI,OUI,2025-03-13 19:01:52+00:00,"48.90663823468682, 2.24679596722126",La Garenne-Colombes,92035,0.7727272727272727,19
8102,Lamennais - Washington,OUI,25,25,0,0,0,OUI,OUI,2025-03-13 18:53:38+00:00,"48.87352990026496, 2.303444892168045",Paris,75056,0.0,19
19115,Porte de la Villette,OUI,26,21,5,2,3,OUI,OUI,2025-03-13 19:00:04+00:00,"48.89835196548483, 2.386150136590004",Paris,75056,0.19230769230769232,19
31702,Pierre et Marie Curie - Julien Grimau,OUI,18,17,1,0,1,OUI,OUI,2025-03-13 18:59:26+00:00,"48.870714014863225, 2.424097023904324",Bagnolet,93006,0.05555555555555555,19
24002,Gare de Courbevoie,OUI,31,23,8,1,7,OUI,OUI,2025-03-13 19:02:22+00:00,"48.8993867, 2.2506506",Courbevoie,92026,0.25806451612903225,19
7004,Raspail - Varenne,OUI,15,14,1,0,1,OUI,OUI,2025-03-13 19:02:07+00:00,"48.853147816545, 2.3263905197382",Paris,75056,0.06666666666666667,19
7009,Assemblée Nationale,OUI,73,44,29,21,8,OUI,OUI,2025-03-13 19:01:14+00:00,"48.861411014652, 2.3201214185208",Paris,75056,0.3972602739726027,19
21013,Pierre Grenier - Pont de Billancourt,OUI,21,3,18,11,7,OUI,OUI,2025-03-13 18:59:28+00:00,"48.8258020742942, 2.2487989068031315",Boulogne-Billancourt,92012,0.8571428571428571,19
20132,Réunion - Avron,OUI,26,24,2,1,1,OUI,OUI,2025-03-13 18:56:59+00:00,"48.852566752033766, 2.403928068708116",Paris,75056,0.07692307692307693,19
5116,Place Valhubert,OUI,51,2,49,44,5,OUI,OUI,2025-03-13 19:01:56+00:00,"48.844182577315, 2.3640366643667",Paris,75056,0.9607843137254902,19
19019,Petit - Manin,OUI,22,22,0,0,0,NON,NON,2025-03-13 18:59:14+00:00,"48.886506875343, 2.3938155401308",Paris,75056,0.0,19
8012,Batignolles - Place de Clichy,OUI,47,39,8,3,5,OUI,OUI,2025-03-13 19:02:33+00:00,"48.883474535757, 2.326493114233",Paris,75056,0.1702127659574468,19
27002,Parc Pierre Lagravère,OUI,30,5,25,10,15,OUI,OUI,2025-03-13 19:01:33+00:00,"48.92650488131725, 2.239069678491417",Colombes,92025,0.8333333333333334,19
10023,Gare de l'Est - Verdun,OUI,12,10,2,2,0,OUI,OUI,2025-03-13 18:56:29+00:00,"48.876156054271, 2.3609149083206",Paris,75056,0.16666666666666666,19
23701,Parvis Robert Schuman - Roger Salengro,OUI,24,14,10,4,6,OUI,OUI,2025-03-13 18:58:06+00:00,"48.812657470558754, 2.1921751275658607",Chaville,92022,0.4166666666666667,19
11101,Charles Delescluze,OUI,48,0,48,33,15,OUI,OUI,2025-03-13 19:01:37+00:00,"48.85242200848887, 2.380632497370243",Paris,75056,1.0,19
17007,Navier - Epinettes,OUI,36,29,7,5,2,OUI,OUI,2025-03-13 19:00:56+00:00,"48.89587780769155, 2.3226776719093327",Paris,75056,0.19444444444444445,19
10015,Lucien Sampaix - Récollets,OUI,40,34,6,2,4,OUI,OUI,2025-03-13 19:02:36+00:00,"48.874330377560476, 2.3621229082345963",Paris,75056,0.15,19
31012,Place Carnot,OUI,21,14,7,1,6,OUI,OUI,2025-03-13 19:00:06+00:00,"48.85593932186797, 2.441531717777252",Montreuil,93048,0.3333333333333333,19
19037,Belleville - Porte des Lilas,OUI,28,24,4,0,4,OUI,OUI,2025-03-13 18:57:56+00:00,"48.87660391892763, 2.404769691129476",Paris,75056,0.14285714285714285,19
12024,Gare de Bercy,OUI,34,5,29,25,4,OUI,OUI,2025-03-13 19:00:58+00:00,"48.839794573906, 2.3826066032052",Paris,75056,0.8529411764705882,19
6103,Mézières - Rennes,OUI,53,51,2,0,2,OUI,OUI,2025-03-13 19:00:41+00:00,"48.85023459321703, 2.3303819820284843",Paris,75056,0.03773584905660377,19
14104,Boyer-Barret - Raymond Losserand,OUI,22,20,2,1,1,OUI,OUI,2025-03-13 18:57:01+00:00,"48.83329880233322, 2.3173383995890617",Paris,75056,0.09090909090909091,19
21032,Sèvres-Gallieni,OUI,24,10,14,10,4,OUI,OUI,2025-03-13 19:01:50+00:00,"48.837809408957, 2.2281519323587",Boulogne-Billancourt,92012,0.5833333333333334,19
20119,Square des Saint-Simoniens,OUI,25,21,4,1,3,OUI,OUI,2025-03-13 19:01:30+00:00,"48.8701796, 2.3967273",Paris,75056,0.16,19
6018,Michelet - Assas,OUI,17,14,3,0,3,OUI,OUI,2025-03-13 19:01:31+00:00,"48.842741502832, 2.3350211977959",Paris,75056,0.17647058823529413,19
31705,Champeaux - Gallieni,OUI,47,41,6,3,3,OUI,OUI,2025-03-13 19:00:47+00:00,"48.864459134684644, 2.4161778017878532",Bagnolet,93006,0.1276595744680851,19
32014,Place du Cornillon - Stade de France,OUI,33,11,22,15,7,OUI,OUI,2025-03-13 19:01:58+00:00,"48.92540695835961, 2.3644426837563515",Saint-Denis,93066,0.6666666666666666,19
23802,Raymond Poincaré - Allée de la Marche,OUI,22,17,5,5,0,OUI,OUI,2025-03-13 19:02:25+00:00,"48.838634069623, 2.1724102640451",Garches,92033,0.22727272727272727,19
18032,Porte de Clignancourt.,OUI,53,40,13,6,7,OUI,OUI,2025-03-13 18:58:03+00:00,"48.897488, 2.343996",Paris,75056,0.24528301886792453,19
15017,Place Falguière,OUI,23,16,7,1,6,OUI,OUI,2025-03-13 18:59:53+00:00,"48.83629973941847, 2.3104464635252953",Paris,75056,0.30434782608695654,19
17124,Porte de Saint-Ouen - Henri Huchard,OUI,26,12,14,14,0,OUI,OUI,2025-03-13 19:02:24+00:00,"48.898708366365064, 2.3295360803604126",Paris,75056,0.5384615384615384,19
15029,Emeriau - Place de Brazzaville,OUI,51,26,25,21,4,OUI,OUI,2025-03-13 19:01:21+00:00,"48.850785261674964, 2.2871585190296173",Paris,75056,0.49019607843137253,19
31016,Lucie Aubrac - Franklin,OUI,35,29,6,2,4,OUI,OUI,2025-03-13 19:01:40+00:00,"48.86223916006812, 2.4435862898826604",Montreuil,93048,0.17142857142857143,19
17018,Parc Monceau,OUI,18,16,2,2,0,OUI,OUI,2025-03-13 19:01:08+00:00,"48.881077914129, 2.3095492646098",Paris,75056,0.1111111111111111,19
51003,Hôtel de Ville d'Argenteuil,OUI,29,11,18,11,7,OUI,OUI,2025-03-13 18:55:11+00:00,"48.946504, 2.2496396",Argenteuil,95018,0.6206896551724138,19
10005,Petites Ecuries - Faubourg Poissonnière,OUI,17,2,15,14,1,OUI,OUI,2025-03-13 18:58:02+00:00,"48.87397217237368, 2.348388757504776",Paris,75056,0.8823529411764706,19
8051,Batignolles - Rome,OUI,12,10,2,1,1,OUI,OUI,2025-03-13 19:02:16+00:00,"48.881823370566806, 2.3202589899301524",Paris,75056,0.16666666666666666,19
92004,Nanterre - Université,OUI,19,11,8,7,1,OUI,OUI,2025-03-13 19:01:41+00:00,"48.901365, 2.212693",Nanterre,92050,0.42105263157894735,19
44102,Verdun - Adrien Damalix,OUI,26,16,10,5,5,OUI,OUI,2025-03-13 18:59:34+00:00,"48.8222334178559, 2.4215328320860863",Saint-Maurice,94069,0.38461538461538464,19
18020,Francoeur - Marcadet,OUI,20,14,6,2,4,OUI,OUI,2025-03-13 19:00:39+00:00,"48.89104123261663, 2.340014585442034",Paris,75056,0.3,19
19039,Edouard Pailleron - Simon Bolivar,OUI,22,21,1,0,1,OUI,OUI,2025-03-13 19:02:17+00:00,"48.87979886049996, 2.374839261174202",Paris,75056,0.045454545454545456,19
20136,Henri Chevreau - Couronnes,OUI,26,18,8,0,8,OUI,OUI,2025-03-13 18:58:05+00:00,"48.87033205312931, 2.388777695596218",Paris,75056,0.3076923076923077,19
21003,Jean Jaurès - Jean Baptiste Clément,OUI,39,15,24,11,13,OUI,OUI,2025-03-13 19:02:05+00:00,"48.84576261454011, 2.2369650006294255",Boulogne-Billancourt,92012,0.6153846153846154,19
5026,Pascal - Claude Bernard,OUI,45,17,28,16,12,OUI,OUI,2025-03-13 19:00:30+00:00,"48.839061952159746, 2.3499782010912895",Paris,75056,0.6222222222222222,19
22001,Château - Bineau,OUI,20,3,17,15,2,OUI,OUI,2025-03-13 19:00:50+00:00,"48.890404028589806, 2.270106375217438",Neuilly-sur-Seine,92051,0.85,19
15028,Grenelle - Dr Finlay,OUI,69,1,68,63,5,OUI,OUI,2025-03-13 19:01:58+00:00,"48.851315406715976, 2.2919502854347233",Paris,75056,0.9855072463768116,19
9023,Laffitte - Italiens,OUI,31,30,1,0,1,OUI,OUI,2025-03-13 19:00:12+00:00,"48.871815737396, 2.3372015478451",Paris,75056,0.03225806451612903,19
14018,Porte d'Orléans,OUI,44,38,6,2,4,OUI,OUI,2025-03-13 19:02:34+00:00,"48.8227639, 2.3249313",Paris,75056,0.13636363636363635,19
14122,Colonel Monteil - Brune,OUI,19,14,5,3,2,OUI,OUI,2025-03-13 18:49:59+00:00,"48.82650293311, 2.3092747998272",Paris,75056,0.2631578947368421,19
42503,Vladimir Ilitch Lénine - Andrée Chedid,OUI,31,29,2,0,2,OUI,OUI,2025-03-13 18:53:31+00:00,"48.813240124373, 2.3319716067039",Gentilly,94037,0.06451612903225806,19
6016,Danton - Serpente,OUI,20,2,18,17,1,OUI,OUI,2025-03-13 18:59:31+00:00,"48.852297362582, 2.3414132371545",Paris,75056,0.9,19
21111,Professeur René Leriche - Général Leclerc,OUI,50,41,9,2,7,OUI,OUI,2025-03-13 19:02:39+00:00,"48.90782845483013, 2.307887971401215",Clichy,92024,0.18,19
41204,République - Danton,OUI,19,12,7,1,6,OUI,OUI,2025-03-13 18:56:28+00:00,"48.85249172181667, 2.462034523487091",Fontenay-sous-Bois,94033,0.3684210526315789,19
2010,Uzès - Montmartre,OUI,25,21,4,2,2,OUI,OUI,2025-03-13 18:58:38+00:00,"48.870790980240706, 2.3431010171771054",Paris,75056,0.16,19
17121,Square des Epinettes,OUI,20,15,5,4,1,OUI,OUI,2025-03-13 19:02:12+00:00,"48.89383909781389, 2.325953990221024",Paris,75056,0.25,19
11114,Ledru-Rollin - Charonne,OUI,32,0,32,26,6,OUI,OUI,2025-03-13 18:59:04+00:00,"48.85345855607243, 2.3772463581947094",Paris,75056,1.0,19
18109,Pajol - Riquet,OUI,44,39,5,1,4,OUI,OUI,2025-03-13 19:02:39+00:00,"48.88960028134536, 2.3628534749150276",Paris,75056,0.11363636363636363,19
7006,Quai Voltaire,OUI,32,16,16,11,5,OUI,OUI,2025-03-13 19:01:34+00:00,"48.858942986179, 2.3314182047146",Paris,75056,0.5,19
18029,Emile Blemont - Poteau,OUI,38,34,4,0,4,OUI,OUI,2025-03-13 19:02:38+00:00,"48.8943782, 2.3415122",Paris,75056,0.10526315789473684,19
7014,Saint-François-Xavier,OUI,42,32,10,5,5,OUI,OUI,2025-03-13 19:01:48+00:00,"48.85154484769, 2.3146149516106",Paris,75056,0.23809523809523808,19
20118,Orteaux - Mouraud,OUI,24,20,4,1,3,OUI,OUI,2025-03-13 19:01:07+00:00,"48.85558642847872, 2.408762907764669",Paris,75056,0.16666666666666666,19
20040,Parc de Belleville - Julien Lacroix,OUI,26,22,4,1,3,OUI,OUI,2025-03-13 19:00:12+00:00,"48.8703459, 2.3842214",Paris,75056,0.15384615384615385,19
9117,Bellefond - Maubeuge,OUI,27,21,6,0,6,OUI,OUI,2025-03-13 19:01:29+00:00,"48.878255397645, 2.3452642187476",Paris,75056,0.2222222222222222,19
17017,Gare de Pont-Cardinet,OUI,32,27,5,1,4,OUI,OUI,2025-03-13 19:01:12+00:00,"48.88713901475306, 2.314494143994255",Paris,75056,0.15625,19
15035,Place Etienne Pernet,OUI,43,5,38,34,4,OUI,OUI,2025-03-13 19:02:11+00:00,"48.84243457133779, 2.2921819612383847",Paris,75056,0.8837209302325582,19
34002,Capitaine Glarner - Gabriel Péri,OUI,24,14,10,3,7,OUI,OUI,2025-03-13 19:02:36+00:00,"48.902449900418745, 2.3304807533425724",Saint-Ouen-sur-Seine,93070,0.4166666666666667,19
10020,Chabrol - d'Hauteville,OUI,10,5,5,4,1,OUI,OUI,2025-03-13 19:02:40+00:00,"48.877018388033, 2.3513179644942",Paris,75056,0.5,19
13026,Place Jean Delay,OUI,33,22,11,7,4,OUI,OUI,2025-03-13 19:01:12+00:00,"48.823316, 2.354336",Paris,75056,0.3333333333333333,19
23002,Pont de Levallois-bécon,OUI,49,45,4,4,0,OUI,OUI,2025-03-13 19:01:30+00:00,"48.8984179, 2.2791311",Levallois-Perret,92044,0.08163265306122448,19
11041,Square Saint-Ambroise,OUI,38,4,34,22,12,OUI,OUI,2025-03-13 19:00:04+00:00,"48.860934, 2.375841",Paris,75056,0.8947368421052632,19
14139,Pierre Larousse - Raymond Losserand,OUI,30,25,5,3,2,OUI,OUI,2025-03-13 18:57:43+00:00,"48.83059564231877, 2.3119183257222176",Paris,75056,0.16666666666666666,19
5121,Square René Viviani - Montebello,OUI,32,6,26,25,1,OUI,OUI,2025-03-13 19:02:22+00:00,"48.851904891406, 2.3478421568871",Paris,75056,0.8125,19
13102,Pitié-Salpêtrière,OUI,50,43,7,4,3,OUI,OUI,2025-03-13 19:02:22+00:00,"48.83748810318667, 2.365213818848133",Paris,75056,0.14,19
47005,Ecole Vétérinaire,OUI,34,11,23,16,7,OUI,OUI,2025-03-13 19:02:32+00:00,"48.81488859822486, 2.4224362157778994",Maisons-Alfort,94046,0.6764705882352942,19
15055,Vasco de Gama,OUI,52,24,28,26,2,OUI,OUI,2025-03-13 19:01:43+00:00,"48.83671783466264, 2.283664085650799",Paris,75056,0.5384615384615384,19
19127,Aubervilliers - Curial,OUI,23,21,2,1,1,OUI,OUI,2025-03-13 19:02:36+00:00,"48.89088305227546, 2.3688579350709915",Paris,75056,0.08695652173913043,19
14130,Jonquoy - Didot,OUI,28,13,15,8,7,OUI,OUI,2025-03-13 18:58:10+00:00,"48.82890454823947, 2.31648076325655",Paris,75056,0.5357142857142857,19
16015,Bassano -  Iéna,OUI,14,13,1,0,1,OUI,OUI,2025-03-13 19:00:21+00:00,"48.868144510482075, 2.296149600985935",Paris,75056,0.07142857142857142,19
41207,Place du Général de Gaulle,OUI,28,23,5,0,5,OUI,OUI,2025-03-13 18:58:53+00:00,"48.8525288, 2.4877332",Fontenay-sous-Bois,94033,0.17857142857142858,19
14112,Méchain - Faubourg Saint-Jacques,OUI,14,12,2,1,1,OUI,OUI,2025-03-13 19:02:29+00:00,"48.83586772099485, 2.33798034198275",Paris,75056,0.14285714285714285,19
12011,Charenton - Place du Col Bourgoin,OUI,35,1,34,28,6,OUI,OUI,2025-03-13 19:02:37+00:00,"48.844867319554, 2.3825789350545",Paris,75056,0.9714285714285714,19
9026,Jean-Baptiste Pigalle - La Bruyere,OUI,17,13,4,3,1,OUI,OUI,2025-03-13 19:02:39+00:00,"48.87939826447722, 2.333709173337285",Paris,75056,0.23529411764705882,19
21308,Bara - Henri Farman,OUI,57,39,18,13,5,OUI,OUI,2025-03-13 19:02:34+00:00,"48.833218027457846, 2.2677567601203923",Issy-les-Moulineaux,92040,0.3157894736842105,19
21001,Transvaal - Charles de Gaulle,OUI,27,15,12,7,5,OUI,OUI,2025-03-13 19:01:27+00:00,"48.848280403628806, 2.2373420120857195",Boulogne-Billancourt,92012,0.4444444444444444,19
12032,Porte Dorée,OUI,34,8,26,15,11,OUI,OUI,2025-03-13 18:59:08+00:00,"48.8354337, 2.4077132",Paris,75056,0.7647058823529411,19
18033,Belliard - Damrémont,OUI,34,26,8,2,6,OUI,OUI,2025-03-13 18:59:46+00:00,"48.89669238777841, 2.338023450388167",Paris,75056,0.23529411764705882,19
15038,Place Adolphe Cherioux - Vaugirard,OUI,62,50,12,8,4,OUI,OUI,2025-03-13 19:02:37+00:00,"48.83959442800459, 2.3010657727718353",Paris,75056,0.1935483870967742,19
15002,Maine - Antoine Bourdelle,OUI,17,8,9,8,1,OUI,OUI,2025-03-13 18:53:54+00:00,"48.84308531746595, 2.320263946784738",Paris,75056,0.5294117647058824,19
20021,Indre - Prairies,OUI,38,34,4,0,4,OUI,OUI,2025-03-13 19:00:16+00:00,"48.86254398506782, 2.403290458023548",Paris,75056,0.10526315789473684,19
21310,Kléber - Gouverneur Général Eboué,OUI,20,12,8,8,0,OUI,OUI,2025-03-13 18:58:15+00:00,"48.826885843069796, 2.2723413258790965",Issy-les-Moulineaux,92040,0.4,19
7005,Raspail - Bac,OUI,51,47,4,2,2,OUI,OUI,2025-03-13 19:01:19+00:00,"48.855628721101, 2.3256602883339",Paris,75056,0.0784313725490196,19
23007,Président Wilson - Jean Jaures,OUI,25,3,22,17,5,OUI,OUI,2025-03-13 19:02:23+00:00,"48.89034054052266, 2.2920683026313786",Levallois-Perret,92044,0.88,19
21019,Edouard Vaillant - Paul-Adolphe Souriau,OUI,26,8,18,18,0,OUI,OUI,2025-03-13 19:01:01+00:00,"48.834845858829, 2.2479459643364",Boulogne-Billancourt,92012,0.6923076923076923,19
20016,Pyrénées - Maraîchers,OUI,31,27,4,1,3,OUI,OUI,2025-03-13 18:59:31+00:00,"48.85714001395299, 2.4043509364128113",Paris,75056,0.12903225806451613,19
21105,Morice - Général Leclerc,OUI,25,10,15,11,4,OUI,OUI,2025-03-13 18:58:41+00:00,"48.90245471981591, 2.3128929734230046",Clichy,92024,0.6,19
16043,Place de Passy,OUI,12,10,2,1,1,OUI,OUI,2025-03-13 19:02:08+00:00,"48.85780291711202, 2.277500546942199",Paris,75056,0.16666666666666666,19
19109,Tanger - Place du Maroc,OUI,18,17,1,0,1,OUI,OUI,2025-03-13 18:59:14+00:00,"48.8862524447104, 2.3689296841621403",Paris,75056,0.05555555555555555,19
20116,Haies - Réunion,OUI,20,16,4,2,2,OUI,OUI,2025-03-13 18:59:41+00:00,"48.85386896766491, 2.402426162238911",Paris,75056,0.2,19
31019,Vincennes - Douy-Delcupe,OUI,37,29,8,4,4,OUI,OUI,2025-03-13 18:59:52+00:00,"48.85493692155721, 2.436049282550812",Montreuil,93048,0.21621621621621623,19
6107,Place Alphonse Deville,OUI,21,14,7,7,0,OUI,OUI,2025-03-13 18:59:08+00:00,"48.850188262662, 2.3275961726904",Paris,75056,0.3333333333333333,19
44012,Génie - Mozart,OUI,18,15,3,2,1,OUI,OUI,2025-03-13 18:56:36+00:00,"48.794902381218904, 2.3734183609485626",Vitry-sur-Seine,94081,0.16666666666666666,19
16029,Maison de Radio - France,OUI,41,1,40,39,1,OUI,OUI,2025-03-13 19:02:38+00:00,"48.85132886434057, 2.277785539627075",Paris,75056,0.975609756097561,19
17027,Place du Maréchal Juin - Péreire,OUI,44,28,16,15,1,OUI,OUI,2025-03-13 19:01:55+00:00,"48.885263, 2.298286",Paris,75056,0.36363636363636365,19
9017,Lallier - Trudaine,OUI,28,12,16,5,11,OUI,OUI,2025-03-13 19:02:26+00:00,"48.88109246617963, 2.3408224806189537",Paris,75056,0.5714285714285714,19
22101,Gare Routière de Saint Cloud,OUI,29,16,13,9,4,OUI,OUI,2025-03-13 19:00:59+00:00,"48.84288183896324, 2.222245037555695",Saint-Cloud,92064,0.4482758620689655,19
18008,Square Léon,OUI,33,24,9,4,5,OUI,OUI,2025-03-13 19:01:27+00:00,"48.88667396788626, 2.353205569088459",Paris,75056,0.2727272727272727,19
13016,Primo Levi - Frigos,OUI,33,24,9,8,1,OUI,OUI,2025-03-13 18:59:42+00:00,"48.83094844846017, 2.37965351592796",Paris,75056,0.2727272727272727,19
16112,Chernoviz - Raynouard,OUI,36,33,3,1,2,OUI,OUI,2025-03-13 19:02:16+00:00,"48.8569864146289, 2.282173218142987",Paris,75056,0.08333333333333333,19
13043,Dunois - Clisson,OUI,48,32,16,2,14,OUI,OUI,2025-03-13 19:01:51+00:00,"48.832294, 2.3674523",Paris,75056,0.3333333333333333,19
15003,Gare Montparnasse - Vaugirard,OUI,65,49,16,4,12,OUI,OUI,2025-03-13 19:01:05+00:00,"48.8418071798797, 2.31951002690117",Paris,75056,0.24615384615384617,19
2009,Filles Saint-Thomas - Place de la Bourse,OUI,57,41,16,12,4,OUI,OUI,2025-03-13 19:00:41+00:00,"48.868899890853, 2.3397543845203",Paris,75056,0.2807017543859649,19
23304,Mairie de Sceaux,OUI,33,30,3,2,1,OUI,OUI,2025-03-13 18:53:51+00:00,"48.778916905132, 2.2887361764861",Sceaux,92071,0.09090909090909091,19
9115,Milton - Manuel,OUI,21,16,5,1,4,OUI,OUI,2025-03-13 19:01:34+00:00,"48.878249, 2.341181",Paris,75056,0.23809523809523808,19
6017,Sénat - Condé,OUI,30,14,16,11,5,OUI,OUI,2025-03-13 18:55:26+00:00,"48.84954227788459, 2.337939441204071",Paris,75056,0.5333333333333333,19
16032,Eglise d'Auteuil,OUI,20,3,17,10,7,OUI,OUI,2025-03-13 19:01:13+00:00,"48.84749841771691, 2.26848387135299",Paris,75056,0.85,19
15107,Palais des Sports,OUI,20,5,15,13,2,OUI,OUI,2025-03-13 19:01:44+00:00,"48.833468517426, 2.2858720645308",Paris,75056,0.75,19
18025,Mairie du 18ème,OUI,40,33,7,6,1,OUI,OUI,2025-03-13 19:02:14+00:00,"48.892939296937605, 2.3445510864257812",Paris,75056,0.175,19
18017,Caulaincourt - Place Constantin Pecqueur,OUI,41,38,3,1,2,OUI,OUI,2025-03-13 19:02:35+00:00,"48.889677905028, 2.3381787144261",Paris,75056,0.07317073170731707,19
17122,Bridaine - Lamandé,OUI,28,20,8,1,7,OUI,OUI,2025-03-13 18:55:37+00:00,"48.8862074, 2.3206239",Paris,75056,0.2857142857142857,19
19041,Belleville - Pyrénées,OUI,38,34,4,0,4,OUI,OUI,2025-03-13 19:00:49+00:00,"48.8741908, 2.3860039",Paris,75056,0.10526315789473684,19
20027,Porte de Ménilmontant,OUI,15,12,3,0,3,OUI,OUI,2025-03-13 19:02:09+00:00,"48.8691543609174, 2.40932246879487",Paris,75056,0.2,19
11043,Place Pasdeloup,OUI,20,0,20,15,5,OUI,OUI,2025-03-13 19:01:47+00:00,"48.862654215631, 2.3670325062844",Paris,75056,1.0,19
16123,Mahatma Gandhi,OUI,24,10,14,12,2,OUI,OUI,2025-03-13 18:59:22+00:00,"48.876356, 2.264205",Paris,75056,0.5833333333333334,19
1117,Pont Neuf - Rivoli,OUI,25,3,22,18,4,OUI,OUI,2025-03-13 19:01:59+00:00,"48.860089892617, 2.344057559967",Paris,75056,0.88,19
31007,Paris - Désiré Préaux,OUI,45,41,4,0,4,OUI,OUI,2025-03-13 19:00:39+00:00,"48.85742876694898, 2.4323049187660217",Montreuil,93048,0.08888888888888889,19
17201,Porte Maillot - Perreire,OUI,49,35,14,5,9,OUI,OUI,2025-03-13 19:02:35+00:00,"48.878021154637, 2.2842371277102",Paris,75056,0.2857142857142857,19
15108,Lourmel - Marie Skobtsov,OUI,22,8,14,5,9,OUI,OUI,2025-03-13 19:01:01+00:00,"48.844974, 2.287283",Paris,75056,0.6363636363636364,19
21311,Parvis Corentin Celton,OUI,51,5,46,44,2,OUI,OUI,2025-03-13 19:02:28+00:00,"48.82747252522725, 2.2784319519996648",Issy-les-Moulineaux,92040,0.9019607843137255,19
19040,Belleville - Télégraphe,OUI,40,40,0,0,0,OUI,OUI,2025-03-13 18:58:14+00:00,"48.8756045, 2.3995549",Paris,75056,0.0,19
23403,Chateau,OUI,20,12,8,1,7,OUI,OUI,2025-03-13 19:02:21+00:00,"48.774661399959, 2.3135878035462",Bourg-la-Reine,92014,0.4,19
17047,Courcelles - Pierre Demours,OUI,24,11,13,10,3,OUI,OUI,2025-03-13 19:02:13+00:00,"48.883769733273496, 2.29858466343129",Paris,75056,0.5416666666666666,19
4013,Vieille du Temple - Francs Bourgeois,OUI,27,0,27,25,2,OUI,OUI,2025-03-13 19:02:34+00:00,"48.858256413365815, 2.35821794718504",Paris,75056,1.0,19
17046,Mac-Mahon - Brey,OUI,23,20,3,2,1,OUI,OUI,2025-03-13 19:00:24+00:00,"48.877532084130166, 2.294512536052928",Paris,75056,0.13043478260869565,19
45001,Hôtel de Ville de Champigny sur Marne,OUI,21,3,18,9,9,OUI,OUI,2025-03-13 19:02:39+00:00,"48.813810628405, 2.5096759200096",Champigny-sur-Marne,94017,0.8571428571428571,19
19009,Cité des Sciences et de l'Industrie,OUI,27,17,10,1,9,OUI,OUI,2025-03-13 19:02:34+00:00,"48.89659571178903, 2.384599149227142",Paris,75056,0.37037037037037035,19
10163,Gare du Nord - Demarquay,OUI,28,27,1,0,1,OUI,OUI,2025-03-13 19:02:02+00:00,"48.881154, 2.358411",Paris,75056,0.03571428571428571,19
19038,Lassus - Delouvain,OUI,19,17,2,0,2,OUI,OUI,2025-03-13 19:02:21+00:00,"48.8755044846, 2.3890327325519",Paris,75056,0.10526315789473684,19
19023,Manin - Simon Bolivar,OUI,22,18,4,0,4,OUI,OUI,2025-03-13 19:00:58+00:00,"48.876499654127, 2.3794073625991",Paris,75056,0.18181818181818182,19
21703,Square du Carrefour de l'Insurrection,OUI,19,17,2,1,1,OUI,OUI,2025-03-13 19:00:59+00:00,"48.820864559770676, 2.291113436222077",Vanves,92075,0.10526315789473684,19
7101,Raspail - Chomel,OUI,48,36,12,7,5,OUI,OUI,2025-03-13 19:02:39+00:00,"48.852233164303, 2.3266580700874",Paris,75056,0.25,19
35017,Toffier Decaux - Cartier Bresson,OUI,18,7,11,4,7,OUI,OUI,2025-03-13 19:01:06+00:00,"48.90165072551549, 2.4017545580863957",Pantin,93055,0.6111111111111112,19
8056,Beaujon - Wagram,OUI,28,27,1,1,0,OUI,OUI,2025-03-13 18:54:13+00:00,"48.875352455985, 2.2964416444302",Paris,75056,0.03571428571428571,19
16021,François Ponsard - La Muette,OUI,23,21,2,1,1,OUI,OUI,2025-03-13 19:01:01+00:00,"48.8583666, 2.2744515",Paris,75056,0.08695652173913043,19
17116,Reims - Porte d'Asnières,OUI,25,22,3,0,3,OUI,OUI,2025-03-13 18:55:26+00:00,"48.891834448210986, 2.300144659954865",Paris,75056,0.12,19
9031,Provence - Chaussée d'Antin,OUI,24,6,18,18,0,OUI,OUI,2025-03-13 19:02:37+00:00,"48.87428447542072, 2.332976511564311",Paris,75056,0.75,19
18138,Station Paris Basketball - Ney - Charles Hermite,OUI,19,13,6,1,5,OUI,OUI,2025-03-13 19:01:21+00:00,"48.898748039775, 2.3645754531026",Paris,75056,0.3157894736842105,19
20023,Pelleport - Belgrand,OUI,14,13,1,0,1,OUI,OUI,2025-03-13 19:01:39+00:00,"48.86500081847653, 2.403980836377493",Paris,75056,0.07142857142857142,19
13041,Porte d'Ivry,OUI,50,46,4,2,2,OUI,OUI,2025-03-13 19:02:03+00:00,"48.821768747596, 2.3688706755638",Paris,75056,0.08,19
14002,Edgar Quinet - Raspail,OUI,44,37,7,5,2,OUI,OUI,2025-03-13 19:01:58+00:00,"48.83940266673835, 2.32971478253603",Paris,75056,0.1590909090909091,19
4011,Hôtel de Ville - Pont-Marie,OUI,31,4,27,24,3,OUI,OUI,2025-03-13 19:02:18+00:00,"48.853899645527, 2.3569472506642",Paris,75056,0.8709677419354839,19
18049,Porte d'Aubervilliers,OUI,53,44,9,2,7,OUI,OUI,2025-03-13 19:00:46+00:00,"48.89859661942376, 2.3689722642302513",Paris,75056,0.16981132075471697,19
12041,Bois de Vincennes.,OUI,58,40,18,7,11,OUI,OUI,2025-03-13 19:00:46+00:00,"48.8338064, 2.4132221",Saint-Mandé,94067,0.3103448275862069,19
18113,Lepic - Armée d'Orient,OUI,24,23,1,0,1,OUI,OUI,2025-03-13 18:59:00+00:00,"48.887536403814, 2.3343077301979",Paris,75056,0.041666666666666664,19
12108,Bercy.,OUI,62,24,38,34,4,OUI,OUI,2025-03-13 19:02:15+00:00,"48.839966914994, 2.3788625746965",Paris,75056,0.6129032258064516,19
31703,Sadi Carnot - François Mitterrand,OUI,26,21,5,1,4,OUI,OUI,2025-03-13 18:59:22+00:00,"48.87532687671517, 2.4241617321968083",Bagnolet,93006,0.19230769230769232,19
14006,Saint-Jacques - Tombe Issoire,OUI,20,16,4,2,2,OUI,OUI,2025-03-13 19:02:03+00:00,"48.833206330538864, 2.3369108140468597",Paris,75056,0.2,19
35003,Gabrielle Josserand - Edouard Vaillant,OUI,24,11,13,4,9,OUI,OUI,2025-03-13 19:01:59+00:00,"48.90271566255436, 2.3933270573616032",Pantin,93055,0.5416666666666666,19
21114,Gustave Eiffel - Parc des Impressionnistes,OUI,30,15,15,13,2,OUI,OUI,2025-03-13 18:59:56+00:00,"48.90390619651018, 2.2946908324956894",Clichy,92024,0.5,19
15031,Théâtre - Lourmel,OUI,51,4,47,43,4,OUI,OUI,2025-03-13 19:01:27+00:00,"48.8482070397636, 2.2898658737540245",Paris,75056,0.9215686274509803,19
31013,Centenaire - Sorins,OUI,40,36,4,0,4,OUI,OUI,2025-03-13 18:56:23+00:00,"48.85853523359734, 2.4273508787155156",Montreuil,93048,0.1,19
21014,Hameau Fleuri - Marché,OUI,20,2,18,16,2,OUI,OUI,2025-03-13 18:59:32+00:00,"48.831448892608314, 2.2412404417991643",Boulogne-Billancourt,92012,0.9,19
32018,Franciade - Gabriel Péri,OUI,25,15,10,5,5,OUI,OUI,2025-03-13 19:00:32+00:00,"48.93261499331498, 2.355954498052597",Saint-Denis,93066,0.4,19
11006,Ledru-Rollin - Place du Père Chaillet,OUI,35,3,32,28,4,OUI,OUI,2025-03-13 19:00:35+00:00,"48.856433706943704, 2.379020587761426",Paris,75056,0.9142857142857143,19
15070,Balard - Montagne de la Fage,OUI,34,3,31,26,5,OUI,OUI,2025-03-13 18:58:20+00:00,"48.83850740333351, 2.2782871127128606",Paris,75056,0.9117647058823529,19
11034,Parmentier - Fontaine au Roi,OUI,46,28,18,10,8,OUI,OUI,2025-03-13 19:01:51+00:00,"48.86787670551736, 2.372705978671471",Paris,75056,0.391304347826087,19
1120,Lavandieres Sainte Opportune - Rivoli,OUI,25,2,23,16,7,OUI,OUI,2025-03-13 19:01:28+00:00,"48.859279702476, 2.3466217517853",Paris,75056,0.92,19
9012,Rougemont - Poissonnière,OUI,30,21,9,6,3,OUI,OUI,2025-03-13 18:56:47+00:00,"48.871611569354755, 2.345873080193996",Paris,75056,0.3,19
47004,Stade Auguste Delaune,OUI,21,0,21,21,0,OUI,OUI,2025-03-13 19:00:17+00:00,"48.80896378683884, 2.4345204234123234",Maisons-Alfort,94046,1.0,19
41206,Place des Larris,OUI,34,28,6,1,5,OUI,OUI,2025-03-13 19:01:25+00:00,"48.8568363, 2.4780236",Fontenay-sous-Bois,94033,0.17647058823529413,19
11010,Boulets - Faubourg Saint-Antoine,OUI,42,18,24,16,8,OUI,OUI,2025-03-13 18:58:14+00:00,"48.849259262115, 2.3917546141943",Paris,75056,0.5714285714285714,19
19031,Manin - Crimée,OUI,20,14,6,0,6,OUI,OUI,2025-03-13 19:01:37+00:00,"48.8831217743719, 2.3863670602440834",Paris,75056,0.3,19
16122,Route de la Muette - Porte de Neuilly,OUI,48,37,11,8,3,OUI,OUI,2025-03-13 18:58:50+00:00,"48.8798926, 2.2587671",Paris,75056,0.22916666666666666,19
6014,Pont de Lodi - Dauphine,OUI,21,2,19,17,2,OUI,OUI,2025-03-13 19:01:56+00:00,"48.855296898603285, 2.339947307565249",Paris,75056,0.9047619047619048,19
32015,Gare RER de Saint-Denis,OUI,37,27,10,7,3,OUI,OUI,2025-03-13 19:01:42+00:00,"48.93554324248177, 2.3471488058567047",Saint-Denis,93066,0.2702702702702703,19
14116,Romain Rolland,OUI,25,20,5,0,5,OUI,OUI,2025-03-13 19:01:37+00:00,"48.820215229662765, 2.3234144234418346",Montrouge,92049,0.2,19
10010,Place Jacques Bonsergent,OUI,31,6,25,22,3,OUI,OUI,2025-03-13 19:02:07+00:00,"48.870948218595, 2.3612049221992",Paris,75056,0.8064516129032258,19
2110,Jeûneurs - Mulhouse,OUI,28,15,13,9,4,OUI,OUI,2025-03-13 19:02:15+00:00,"48.868997, 2.346925",Paris,75056,0.4642857142857143,19
16027,Mozart - Jasmin,OUI,62,53,9,7,2,OUI,OUI,2025-03-13 19:02:08+00:00,"48.85286124871689, 2.268483570651513",Paris,75056,0.14516129032258066,19
7026,Place de Finlande,OUI,24,6,18,16,2,OUI,OUI,2025-03-13 18:58:34+00:00,"48.862408335967, 2.3113624379039",Paris,75056,0.75,19
8019,Naples - Rome,OUI,25,23,2,0,2,OUI,OUI,2025-03-13 19:01:28+00:00,"48.879960700846226, 2.321358695626259",Paris,75056,0.08,19
9113,Bleue - Trévise,OUI,22,12,10,4,6,OUI,OUI,2025-03-13 19:02:34+00:00,"48.87578906564573, 2.347289621829987",Paris,75056,0.45454545454545453,19
7008,Villersexel - Saint-Germain,OUI,16,10,6,4,2,OUI,OUI,2025-03-13 19:02:03+00:00,"48.858297001218, 2.3237934708595",Paris,75056,0.375,19
2014,Daunou - Louis le Grand,OUI,31,17,14,11,3,OUI,OUI,2025-03-13 19:01:38+00:00,"48.869113, 2.332515",Paris,75056,0.45161290322580644,19
42703,Fontainebleau - Edmond Michelet,OUI,45,43,2,0,2,OUI,OUI,2025-03-13 18:59:52+00:00,"48.80956436844049, 2.3626908659935",Le Kremlin-Bicêtre,94043,0.044444444444444446,19
3101,Porte Saint-Martin,OUI,30,3,27,24,3,OUI,OUI,2025-03-13 19:00:23+00:00,"48.86860172112996, 2.35570102930069",Paris,75056,0.9,19
14030,Pernety - Raymond Losserand,OUI,31,26,5,2,3,OUI,OUI,2025-03-13 19:01:52+00:00,"48.834254627953, 2.317609339387",Paris,75056,0.16129032258064516,19
8105,François 1er - Lincoln,OUI,28,27,1,0,1,OUI,OUI,2025-03-13 18:53:12+00:00,"48.869517979344, 2.3024262188416",Paris,75056,0.03571428571428571,19
20201,Eugène Reisz - Davout,OUI,19,11,8,2,6,OUI,OUI,2025-03-13 18:57:28+00:00,"48.85631874632638, 2.410396970808506",Paris,75056,0.42105263157894735,19
11048,Place Mireille Havet,OUI,39,0,39,32,7,OUI,OUI,2025-03-13 19:01:19+00:00,"48.850533, 2.383756",Paris,75056,1.0,19
13046,Eugène Oudiné - Dessous Des Berges,OUI,42,21,21,16,5,OUI,OUI,2025-03-13 19:00:25+00:00,"48.8256423, 2.3750226",Paris,75056,0.5,19
8049,Georges V - François 1er,OUI,22,20,2,2,0,OUI,OUI,2025-03-13 18:59:53+00:00,"48.87034, 2.30082",Paris,75056,0.09090909090909091,19
22102,Mont Valérien - Michel Salles,OUI,24,9,15,13,2,OUI,OUI,2025-03-13 18:59:47+00:00,"48.8561915, 2.2152966",Saint-Cloud,92064,0.625,19
22017,Charles de Gaulle - Louis Philippe,OUI,26,20,6,2,4,OUI,OUI,2025-03-13 19:00:12+00:00,"48.881742142181, 2.2710045335353",Neuilly-sur-Seine,92051,0.23076923076923078,19
4110,Neuve Saint-Pierre - Beautreillis,OUI,19,3,16,15,1,OUI,OUI,2025-03-13 19:01:50+00:00,"48.85355351439652, 2.3639122769236565",Paris,75056,0.8421052631578947,19
19030,Melun - Jean Jaurès,OUI,27,17,10,3,7,OUI,OUI,2025-03-13 18:57:23+00:00,"48.8837796723475, 2.376477420330048",Paris,75056,0.37037037037037035,19
6032,Sabot - Rennes,OUI,24,12,12,10,2,OUI,OUI,2025-03-13 19:01:26+00:00,"48.852575112948415, 2.331552766263485",Paris,75056,0.5,19
35008,Place de l'Eglise - Pantin,OUI,28,28,0,0,0,OUI,OUI,2025-03-13 18:58:22+00:00,"48.892809461520265, 2.4124351143836975",Pantin,93055,0.0,19
17022,Pereire - Place de Wagram,OUI,44,36,8,6,2,OUI,OUI,2025-03-13 19:02:32+00:00,"48.887070607581215, 2.304111124531457",Paris,75056,0.18181818181818182,19
5030,Sorbonne - Ecoles,OUI,46,44,2,1,1,OUI,OUI,2025-03-13 19:02:15+00:00,"48.849686566191, 2.3434996604919",Paris,75056,0.043478260869565216,19
7020,Champ de Mars - Cler,OUI,40,9,31,28,3,OUI,OUI,2025-03-13 19:01:11+00:00,"48.856691550115315, 2.306646779179573",Paris,75056,0.775,19
21952,Place Tony de Graaff,OUI,42,7,35,26,9,OUI,OUI,2025-03-13 18:57:36+00:00,"48.8181645, 2.2458109",Meudon,92048,0.8333333333333334,19
10036,Aqueduc - Villette,OUI,24,13,11,1,10,OUI,OUI,2025-03-13 19:00:45+00:00,"48.883886063895, 2.367198803315",Paris,75056,0.4583333333333333,19
9015,Lamartine - Faubourg Montmartre,OUI,29,11,18,10,8,OUI,OUI,2025-03-13 19:00:42+00:00,"48.876613982891, 2.3397656902671",Paris,75056,0.6206896551724138,19
13103,Hôpital Pitié Salpêtrière,OUI,47,41,6,3,3,OUI,OUI,2025-03-13 19:01:43+00:00,"48.8377016, 2.3604946",Paris,75056,0.1276595744680851,19
11110,Roquette - Folie Regnault,OUI,49,45,4,1,3,OUI,OUI,2025-03-13 19:02:39+00:00,"48.859246959155485, 2.386553623578705",Paris,75056,0.08163265306122448,19
12161,Diderot - Reuilly,OUI,43,1,42,32,10,OUI,OUI,2025-03-13 19:01:58+00:00,"48.847208456061, 2.3861273378134",Paris,75056,0.9767441860465116,19
21017,Place Marcel Sembat,OUI,53,19,34,34,0,OUI,OUI,2025-03-13 19:02:07+00:00,"48.83328865030686, 2.2441747784614567",Boulogne-Billancourt,92012,0.6415094339622641,19
9101,Cadet - La Fayette,OUI,18,0,18,16,2,OUI,OUI,2025-03-13 19:02:04+00:00,"48.875601632672, 2.3435704037547",Paris,75056,1.0,19
14127,Odessa - Départ,OUI,39,25,14,5,9,OUI,OUI,2025-03-13 18:55:49+00:00,"48.842885590081, 2.3244281485677",Paris,75056,0.358974358974359,19
23903,Stade Gaston Bouillant,OUI,29,17,12,6,6,OUI,OUI,2025-03-13 19:00:22+00:00,"48.939958667023, 2.3279571813836",Villeneuve-la-Garenne,92078,0.41379310344827586,19
14016,René Coty - Parc Montsouris,OUI,53,50,3,2,1,OUI,OUI,2025-03-13 19:02:19+00:00,"48.82479134498032, 2.336124926805496",Paris,75056,0.05660377358490566,19
13010,Place d'Italie - Vincent Auriol,OUI,39,34,5,1,4,OUI,OUI,2025-03-13 18:59:50+00:00,"48.831481874467, 2.3567550292319",Paris,75056,0.1282051282051282,19
22012,Madeleine Michelis - Roule,OUI,23,21,2,2,0,OUI,OUI,2025-03-13 18:57:34+00:00,"48.88260431301364, 2.2773634269833565",Neuilly-sur-Seine,92051,0.08695652173913043,19
31704,Jeanne Hornet - Girardot,OUI,28,24,4,0,4,OUI,OUI,2025-03-13 18:55:12+00:00,"48.873802681432146, 2.427820265293122",Bagnolet,93006,0.14285714285714285,19
18142,Jessaint - Marx Dormoy,OUI,30,26,4,2,2,OUI,OUI,2025-03-13 18:59:20+00:00,"48.88484543106364, 2.358930408954621",Paris,75056,0.13333333333333333,19
32603,Calmette,OUI,31,28,3,1,2,OUI,OUI,2025-03-13 19:02:35+00:00,"48.88104925098552, 2.424993216991425",Les Lilas,93045,0.0967741935483871,19
18035,René Binet - Porte de Montmartre,OUI,36,34,2,0,2,OUI,OUI,2025-03-13 19:00:03+00:00,"48.89905109950848, 2.3365534096956253",Paris,75056,0.05555555555555555,19
15059,Parc André Citroën,OUI,64,2,62,57,5,OUI,OUI,2025-03-13 19:02:33+00:00,"48.840639944296655, 2.2780618071556096",Paris,75056,0.96875,19
13110,Moulin de la Pointe,OUI,21,13,8,3,5,OUI,OUI,2025-03-13 19:01:23+00:00,"48.82092946051445, 2.3563179373741145",Paris,75056,0.38095238095238093,19
31023,Place François Mitterand,OUI,34,30,4,0,4,OUI,OUI,2025-03-13 18:57:52+00:00,"48.86492782016328, 2.442958317697048",Montreuil,93048,0.11764705882352941,19
15009,Suffren - Pérignon,OUI,44,15,29,27,2,OUI,OUI,2025-03-13 19:02:13+00:00,"48.84717561492764, 2.307052147596786",Paris,75056,0.6590909090909091,19
9118,Faubourg Poissonniere - Delta,OUI,36,35,1,0,1,OUI,OUI,2025-03-13 19:02:22+00:00,"48.882555807626765, 2.3497482016682625",Paris,75056,0.027777777777777776,19
23005,Gare de Clichy-Levallois,OUI,24,7,17,15,2,OUI,OUI,2025-03-13 19:02:20+00:00,"48.89679827481989, 2.2984680533409123",Levallois-Perret,92044,0.7083333333333334,19
21024,Billancourt - Général Leclerc,OUI,22,15,7,5,2,OUI,OUI,2025-03-13 18:58:38+00:00,"48.8322649, 2.2380413",Boulogne-Billancourt,92012,0.3181818181818182,19
21120,Docteur Calmette - Martre,OUI,30,27,3,1,2,OUI,OUI,2025-03-13 19:02:27+00:00,"48.898969358483, 2.3086513252383",Clichy,92024,0.1,19
2001,Greneta - Sebastopol,OUI,32,5,27,23,4,OUI,OUI,2025-03-13 19:02:34+00:00,"48.865242333228, 2.3516669869423",Paris,75056,0.84375,19
31017,Jean Moulin - Paul Doumer,OUI,17,13,4,1,3,OUI,OUI,2025-03-13 18:59:47+00:00,"48.8622179854695, 2.45533436536789",Montreuil,93048,0.23529411764705882,19
20019,Place du Maquis du Vercors,OUI,30,28,2,1,1,OUI,OUI,2025-03-13 18:59:30+00:00,"48.877321579493575, 2.4083782732486725",Paris,75056,0.06666666666666667,19
18114,Véron - Lepic,OUI,23,20,3,0,3,OUI,OUI,2025-03-13 18:53:37+00:00,"48.88526123395252, 2.334559857845307",Paris,75056,0.13043478260869565,19
18137,Poissonniers - Nord,OUI,27,27,0,0,0,OUI,OUI,2025-03-13 18:58:17+00:00,"48.892511213520656, 2.3522228747606277",Paris,75056,0.0,19
4107,Beaumarchais - Pas de la Mule,OUI,17,2,15,10,5,OUI,OUI,2025-03-13 19:01:15+00:00,"48.855580507049, 2.3684333673431",Paris,75056,0.8823529411764706,19
7016,Surcouf - Université,OUI,56,21,35,30,5,OUI,OUI,2025-03-13 19:02:10+00:00,"48.861273016278, 2.3094535509142",Paris,75056,0.625,19
42011,Quai Marcel Boyer - Victor Hugo,OUI,28,4,24,16,8,OUI,OUI,2025-03-13 19:02:38+00:00,"48.822556366667, 2.3920395970345",Ivry-sur-Seine,94041,0.8571428571428571,19
7013,Duroc - Place de Breteuil,OUI,43,28,15,12,3,OUI,OUI,2025-03-13 19:01:50+00:00,"48.847460641142, 2.3126140236855",Paris,75056,0.3488372093023256,19
20047,Cours de Vincennes - Davout,OUI,48,42,6,3,3,OUI,OUI,2025-03-13 18:59:30+00:00,"48.847238029966, 2.4107042336225",Paris,75056,0.125,19
17016,Brochant - Square des Batignolles,OUI,31,21,10,6,4,OUI,OUI,2025-03-13 19:02:33+00:00,"48.88818698581028, 2.316861143151153",Paris,75056,0.3225806451612903,19
9013,Mairie du 9ème,OUI,24,16,8,4,4,OUI,OUI,2025-03-13 19:00:19+00:00,"48.873267137583, 2.3407534480528",Paris,75056,0.3333333333333333,19
20202,Dupont de l'Eure - Gambetta,OUI,29,27,2,0,2,OUI,OUI,2025-03-13 19:01:13+00:00,"48.8679385, 2.4003649",Paris,75056,0.06896551724137931,19
42004,Westermeyer - Paul Vaillant-Couturier,OUI,26,8,18,15,3,OUI,OUI,2025-03-13 19:00:51+00:00,"48.819116181578764, 2.3966637253761296",Ivry-sur-Seine,94041,0.6923076923076923,19
18019,Square Raymond Souplex,OUI,51,49,2,0,2,OUI,OUI,2025-03-13 19:02:17+00:00,"48.89183721478911, 2.335426103165901",Paris,75056,0.0392156862745098,19
92005,Gare de Nanterre Ville,OUI,42,23,19,18,1,OUI,OUI,2025-03-13 19:02:23+00:00,"48.8950295, 2.1957932",Nanterre,92050,0.4523809523809524,19
11003,Keller - La Roquette,OUI,33,7,26,18,8,OUI,OUI,2025-03-13 19:02:39+00:00,"48.8555508, 2.3752778",Paris,75056,0.7878787878787878,19
22103,Senard - Charles Blum,OUI,24,14,10,6,4,OUI,OUI,2025-03-13 18:57:33+00:00,"48.857315824799, 2.221091687679291",Saint-Cloud,92064,0.4166666666666667,19
15020,Mairie du 15ème,OUI,31,14,17,16,1,OUI,OUI,2025-03-13 19:00:29+00:00,"48.8417762, 2.2986539",Paris,75056,0.5483870967741935,19
10039,Sambre et Meuse - Villette,OUI,24,8,16,2,14,OUI,OUI,2025-03-13 19:01:37+00:00,"48.874405666217, 2.3738072379951",Paris,75056,0.6666666666666666,19
13113,Vistule - Choisy,OUI,33,29,4,1,3,OUI,OUI,2025-03-13 19:02:35+00:00,"48.82365543660611, 2.3615723848342896",Paris,75056,0.12121212121212122,19
19036,Hôpital Robert Debré,OUI,33,31,2,0,2,OUI,OUI,2025-03-13 19:00:33+00:00,"48.88005222200894, 2.4008650346327003",Paris,75056,0.06060606060606061,19
13114,Nationale - Marcel Duchamp,OUI,23,19,4,2,2,OUI,OUI,2025-03-13 19:02:39+00:00,"48.82463749337136, 2.3678014799952507",Paris,75056,0.17391304347826086,19
31101,Jules Guesde - Laennec,OUI,19,14,5,0,5,OUI,OUI,2025-03-13 18:58:56+00:00,"48.87628983900398, 2.5006942078471184",Rosny-sous-Bois,93064,0.2631578947368421,19
15061,Square Desnouettes,OUI,22,5,17,8,9,OUI,OUI,2025-03-13 19:02:05+00:00,"48.83476837934194, 2.284142297394666",Paris,75056,0.7727272727272727,19
31026,Demi-Lune - Aristide Briand,OUI,20,17,3,0,3,OUI,OUI,2025-03-13 19:01:53+00:00,"48.87626381919953, 2.4562818557024",Montreuil,93048,0.15,19
20017,Saint-Blaise - Mouraud,OUI,27,26,1,0,1,OUI,OUI,2025-03-13 18:54:19+00:00,"48.85696177597818, 2.40869477391243",Paris,75056,0.037037037037037035,19
35004,Place du Président Salvador Allende,OUI,59,58,1,0,1,OUI,OUI,2025-03-13 18:58:06+00:00,"48.897307310356055, 2.40079153681279",Pantin,93055,0.01694915254237288,19
11019,Charonne - Philippe-Auguste,OUI,30,20,10,4,6,OUI,OUI,2025-03-13 18:59:37+00:00,"48.855603162026, 2.39054639062",Paris,75056,0.3333333333333333,19
31707,Edouard Vaillant - Galliéni,OUI,48,47,1,0,1,OUI,OUI,2025-03-13 18:58:27+00:00,"48.858462881661, 2.4147954583168",Bagnolet,93006,0.020833333333333332,19
23008,Hôtel de Ville de Levallois Perret,OUI,25,3,22,18,4,OUI,OUI,2025-03-13 18:58:48+00:00,"48.89314451997415, 2.2888818383216862",Levallois-Perret,92044,0.88,19
7010,Constantine - Université,OUI,59,42,17,15,2,OUI,OUI,2025-03-13 18:57:29+00:00,"48.860680473738, 2.3148481955842",Paris,75056,0.288135593220339,19
8015,Roquépine - Malesherbes,OUI,51,45,6,4,2,OUI,OUI,2025-03-13 18:58:42+00:00,"48.87345073390807, 2.320404499769211",Paris,75056,0.11764705882352941,19
14113,Santé - Arago,OUI,37,36,1,1,0,OUI,OUI,2025-03-13 18:57:57+00:00,"48.83507657562064, 2.3415737262044938",Paris,75056,0.02702702702702703,19
21108,Mairie de Clichy,OUI,43,31,12,10,2,OUI,OUI,2025-03-13 19:00:13+00:00,"48.903653634661, 2.3059353232384",Clichy,92024,0.27906976744186046,19
35015,Averroès - Aimé Césaire,OUI,18,8,10,1,9,OUI,OUI,2025-03-13 18:58:25+00:00,"48.91405323432864, 2.412636950612068",Pantin,93055,0.5555555555555556,19
31018,Gambetta - Michelet,OUI,30,22,8,3,5,OUI,OUI,2025-03-13 18:56:33+00:00,"48.85273792380526, 2.429966032505036",Montreuil,93048,0.26666666666666666,19
32021,Place du Front Populaire - George Sand,OUI,64,59,5,4,1,OUI,OUI,2025-03-13 18:58:21+00:00,"48.90680713698062, 2.364541214992642",Saint-Denis,93066,0.078125,19
47002,Les Juilliottes,OUI,21,2,19,11,8,OUI,OUI,2025-03-13 18:58:31+00:00,"48.8043072, 2.4437362",Maisons-Alfort,94046,0.9047619047619048,19
7024,Rapp - Place du Général Gouraud,OUI,29,26,3,0,3,OUI,OUI,2025-03-13 19:02:21+00:00,"48.858102885107, 2.3004072904587",Paris,75056,0.10344827586206896,19
33005,République - Henri Barbusse,OUI,32,25,7,1,6,OUI,OUI,2025-03-13 18:58:08+00:00,"48.90661553626751, 2.389432489871979",Aubervilliers,93001,0.21875,19
20004,Commandant l'Herminier - Gallieni,OUI,17,17,0,0,0,OUI,OUI,2025-03-13 18:56:26+00:00,"48.847040552603, 2.4160453677177",Paris,75056,0.0,19
5019,Poissy - Saint-Germain,OUI,23,11,12,11,1,OUI,OUI,2025-03-13 19:00:55+00:00,"48.84969649427, 2.3529685288668",Paris,75056,0.5217391304347826,19
12125,Pyramide - Parc Floral,OUI,50,27,23,11,12,OUI,OUI,2025-03-13 19:02:25+00:00,"48.837442, 2.440452",Paris,75056,0.46,19
1016,Thérèse - Opéra,OUI,24,4,20,16,4,OUI,OUI,2025-03-13 19:01:37+00:00,"48.866483514509, 2.3344334212238",Paris,75056,0.8333333333333334,19
10152,Gare du Nord - Place de Valenciennes,OUI,23,17,6,4,2,OUI,OUI,2025-03-13 19:02:11+00:00,"48.879089, 2.354235",Paris,75056,0.2608695652173913,19
17033,Carnot - Général Lanrezac,OUI,29,25,4,2,2,OUI,OUI,2025-03-13 19:01:22+00:00,"48.875443870736, 2.2938242935036",Paris,75056,0.13793103448275862,19
15131,Charles Lecocq - Lecourbe,OUI,28,3,25,15,10,OUI,OUI,2025-03-13 19:01:48+00:00,"48.84044, 2.294867",Paris,75056,0.8928571428571429,19
14007,Ferrus - Saint-Jacques,OUI,32,30,2,1,1,OUI,OUI,2025-03-13 18:55:21+00:00,"48.8313878, 2.3408563",Paris,75056,0.0625,19
13117,Stade Georges Carpentier,OUI,40,27,13,2,11,OUI,OUI,2025-03-13 19:00:44+00:00,"48.820482438381, 2.3668321967125",Paris,75056,0.325,19
10164,Claude Vellefaux - Sambre et Meuse,OUI,32,18,14,7,7,OUI,OUI,2025-03-13 19:02:16+00:00,"48.875022, 2.370478",Paris,75056,0.4375,19
10004,Metz - Faubourg Saint-Denis,OUI,44,2,42,30,12,OUI,OUI,2025-03-13 19:02:34+00:00,"48.870893, 2.353521",Paris,75056,0.9545454545454546,19
11107,Faidherbe - Dahomey,OUI,41,4,37,28,9,OUI,OUI,2025-03-13 19:00:43+00:00,"48.851358329771806, 2.383823134795429",Paris,75056,0.9024390243902439,19
11103,Pelée - Alphonse Baudin,OUI,35,6,29,19,10,OUI,OUI,2025-03-13 19:01:36+00:00,"48.8600265, 2.3710541",Paris,75056,0.8285714285714286,19
20103,Le Vau - Maurice Bertaux,OUI,23,22,1,0,1,OUI,OUI,2025-03-13 18:57:16+00:00,"48.86803439043193, 2.411030612453627",Paris,75056,0.043478260869565216,19
5034,Censier - Santeuil,OUI,65,41,24,20,4,OUI,OUI,2025-03-13 19:01:15+00:00,"48.840658921385234, 2.3537524044513702",Paris,75056,0.36923076923076925,19
4109,Mornay - Sully,OUI,13,0,13,5,8,OUI,OUI,2025-03-13 19:00:16+00:00,"48.84970399548416, 2.364460788667202",Paris,75056,1.0,19
10017,Gare de l'Est - Fidélité,OUI,12,0,12,8,4,OUI,OUI,2025-03-13 19:02:08+00:00,"48.874575, 2.356796",Paris,75056,1.0,19
2101,Bachaumont - Montmartre,OUI,31,2,29,26,3,OUI,OUI,2025-03-13 19:01:59+00:00,"48.86617395079137, 2.3449775576591496",Paris,75056,0.9354838709677419,19
21316,Cimetière d'Issy-les-Moulineaux,OUI,24,22,2,0,2,OUI,OUI,2025-03-13 18:55:16+00:00,"48.817699773925, 2.2609312087297",Issy-les-Moulineaux,92040,0.08333333333333333,19
12154,Square Georges Melies,OUI,38,17,21,9,12,OUI,OUI,2025-03-13 18:59:37+00:00,"48.84070239213081, 2.409667745232582",Paris,75056,0.5526315789473685,19
10153,Gare du Nord - Denain,OUI,19,15,4,0,4,OUI,OUI,2025-03-13 19:00:42+00:00,"48.879595787608, 2.3544725775719",Paris,75056,0.21052631578947367,19
19021,Mairie du 19ème,OUI,24,23,1,1,0,OUI,OUI,2025-03-13 18:59:06+00:00,"48.88256264247959, 2.3812624812126164",Paris,75056,0.041666666666666664,19
16003,André Maurois - Joseph et Marie Hackin,OUI,27,15,12,10,2,OUI,OUI,2025-03-13 18:59:59+00:00,"48.8778983, 2.2789591",Paris,75056,0.4444444444444444,19
17104,Jardin Marguerite Long,OUI,21,12,9,4,5,OUI,OUI,2025-03-13 19:00:36+00:00,"48.8816985773914, 2.2836575657129288",Paris,75056,0.42857142857142855,19
15072,Place Fernand Forest,OUI,27,2,25,18,7,OUI,OUI,2025-03-13 19:01:17+00:00,"48.849269143836, 2.281863167882",Paris,75056,0.9259259259259259,19
21004,Jean Jaurès - Reine,OUI,31,1,30,27,3,OUI,OUI,2025-03-13 18:59:53+00:00,"48.84009622558849, 2.239872515201569",Boulogne-Billancourt,92012,0.967741935483871,19
12006,Gare de Lyon - Van Gogh,OUI,41,34,7,6,1,OUI,OUI,2025-03-13 18:59:52+00:00,"48.843839785643, 2.3704450240357",Paris,75056,0.17073170731707318,19
22002,Argenson - Château,OUI,24,9,15,11,4,OUI,OUI,2025-03-13 18:58:53+00:00,"48.888559314669514, 2.2642001509666447",Neuilly-sur-Seine,92051,0.625,19
21708,Marcel Yol - Jullien,OUI,28,25,3,2,1,OUI,OUI,2025-03-13 18:50:22+00:00,"48.82537611802588, 2.287235018058929",Vanves,92075,0.10714285714285714,19
13022,Butte aux Cailles - Esperance,OUI,30,19,11,2,9,OUI,OUI,2025-03-13 19:02:10+00:00,"48.82758774190948, 2.3492151126265526",Paris,75056,0.36666666666666664,19
13048,Wurtz - Tolbiac,OUI,28,28,0,0,0,NON,NON,2025-03-13 18:57:30+00:00,"48.82631195621, 2.344585955143",Paris,75056,0.0,19
20045,Louis Ganne - Davout,OUI,28,27,1,1,0,OUI,OUI,2025-03-13 19:01:10+00:00,"48.86338720692607, 2.409725748002529",Paris,75056,0.03571428571428571,19
15052,Convention - Vaugirard,OUI,44,13,31,21,10,OUI,OUI,2025-03-13 19:01:29+00:00,"48.83767682233156, 2.295586926020252",Paris,75056,0.7045454545454546,19
13019,Fernand Braudel - Vincent Auriol,OUI,36,19,17,14,3,OUI,OUI,2025-03-13 19:01:10+00:00,"48.83637852318147, 2.3723404482007027",Paris,75056,0.4722222222222222,19
31021,Résistance - Hoche,OUI,28,21,7,1,6,OUI,OUI,2025-03-13 18:57:59+00:00,"48.864273423741956, 2.435784414410591",Montreuil,93048,0.25,19
11044,Square du Bataclan,OUI,16,0,16,15,1,OUI,OUI,2025-03-13 19:01:50+00:00,"48.8633762, 2.3711327",Paris,75056,1.0,19
44002,Paul Vaillant-Couturier - Gare RER,OUI,25,2,23,18,5,OUI,OUI,2025-03-13 18:56:55+00:00,"48.80108159069614, 2.402097210288048",Vitry-sur-Seine,94081,0.92,19
16041,Versailles - Claude Terrasse,OUI,44,5,39,31,8,OUI,OUI,2025-03-13 19:01:13+00:00,"48.840219338074, 2.263834191153",Paris,75056,0.8863636363636364,19
16115,Raffet - Montmorency,OUI,40,29,11,6,5,OUI,OUI,2025-03-13 19:02:29+00:00,"48.85258670812, 2.2629252456151954",Paris,75056,0.275,19
8029,Place du Canada,OUI,54,36,18,15,3,OUI,OUI,2025-03-13 19:01:13+00:00,"48.865346269363, 2.3101937879648",Paris,75056,0.3333333333333333,19
13039,Ivry - Simone Weil,OUI,18,18,0,0,0,OUI,OUI,2025-03-13 18:52:40+00:00,"48.823283932030755, 2.3659095168113713",Paris,75056,0.0,19
16031,Vignes - Boulainvilliers,OUI,20,13,7,1,6,OUI,OUI,2025-03-13 19:00:32+00:00,"48.856399483950504, 2.275240458548069",Paris,75056,0.35,19
21030,Fessart - Château,OUI,20,7,13,10,3,OUI,OUI,2025-03-13 19:02:16+00:00,"48.84245, 2.23989",Boulogne-Billancourt,92012,0.65,19
12153,Terroirs de France - Lheureux,OUI,53,45,8,7,1,OUI,OUI,2025-03-13 19:02:22+00:00,"48.83212027074841, 2.388618104159832",Paris,75056,0.1509433962264151,19
21031,Cimetière de Boulogne-Billancourt,OUI,38,6,32,31,1,OUI,OUI,2025-03-13 19:01:58+00:00,"48.830764, 2.252024",Boulogne-Billancourt,92012,0.8421052631578947,19
17005,Brochant - Clichy,OUI,51,44,7,5,2,OUI,OUI,2025-03-13 19:02:04+00:00,"48.89032998912038, 2.319730559929781",Paris,75056,0.13725490196078433,19
16024,Ranelagh - Maison de la Radio,OUI,21,6,15,12,3,OUI,OUI,2025-03-13 19:02:28+00:00,"48.85293603169479, 2.280449643731117",Paris,75056,0.7142857142857143,19
12033,François Truffaut - Saint Emilion,OUI,66,29,37,37,0,OUI,OUI,2025-03-13 19:02:28+00:00,"48.83372354344807, 2.386601903271428",Paris,75056,0.5606060606060606,19
15043,Brancion - Lefebvre,OUI,10,6,4,2,2,OUI,OUI,2025-03-13 19:00:20+00:00,"48.82900222785569, 2.301431038163409",Paris,75056,0.4,19
12120,Lac Daumesnil - Saint-Maurice,OUI,49,42,7,4,3,OUI,OUI,2025-03-13 18:59:52+00:00,"48.82774555743318, 2.4183654785156246",Paris,75056,0.14285714285714285,19
17039,Place Saint-Ferdinand,OUI,38,31,7,1,6,OUI,OUI,2025-03-13 19:01:49+00:00,"48.87815529789739, 2.288518047864942",Paris,75056,0.18421052631578946,19
23105,Sèvres Rive Gauche,OUI,33,22,11,11,0,OUI,OUI,2025-03-13 18:58:09+00:00,"48.821443218278, 2.2150785306885",Sèvres,92072,0.3333333333333333,19
11032,Jean-Pierre Timbaud - Vaucouleurs,OUI,45,6,39,20,19,OUI,OUI,2025-03-13 19:01:26+00:00,"48.867937, 2.377885",Paris,75056,0.8666666666666667,19
20117,Saint-Fargeau - Mortier,OUI,31,30,1,0,1,OUI,OUI,2025-03-13 18:57:11+00:00,"48.87266656122256, 2.407912909984589",Paris,75056,0.03225806451612903,19
21955,Vaugirard - Verrerie,OUI,24,3,21,18,3,OUI,OUI,2025-03-13 19:00:05+00:00,"48.820881336842, 2.2367222622987",Meudon,92048,0.875,19
48009,République - Auguste Perret,OUI,30,26,4,2,2,OUI,OUI,2025-03-13 19:00:29+00:00,"48.78695280952244, 2.3518594354391094",Villejuif,94076,0.13333333333333333,19
16101,Malakoff - Place de la Porte Maillot,OUI,25,24,1,0,1,OUI,OUI,2025-03-13 18:57:49+00:00,"48.876733496638, 2.2834577411413",Paris,75056,0.04,19
14125,Dareau - Broussais,OUI,21,15,6,3,3,OUI,OUI,2025-03-13 19:02:15+00:00,"48.8307758, 2.3361804",Paris,75056,0.2857142857142857,19
8001,Petit Palais,OUI,43,19,24,21,3,OUI,OUI,2025-03-13 19:00:33+00:00,"48.8667692, 2.3157655",Paris,75056,0.5581395348837209,19
21009,Le Corbusier - Jean Jaurès,OUI,44,26,18,16,2,OUI,OUI,2025-03-13 19:00:54+00:00,"48.83780830557548, 2.2408381104469304",Boulogne-Billancourt,92012,0.4090909090909091,19
10012,Vinaigriers - Magenta,OUI,23,4,19,10,9,OUI,OUI,2025-03-13 19:02:28+00:00,"48.8731167, 2.3593052",Paris,75056,0.8260869565217391,19
13047,Boutroux - Porte de Vitry,OUI,49,33,16,14,2,OUI,OUI,2025-03-13 18:59:58+00:00,"48.822632, 2.377738",Paris,75056,0.32653061224489793,19
21028,Pierre Lefaucheux - Traversière,OUI,33,20,13,8,5,OUI,OUI,2025-03-13 19:02:13+00:00,"48.82435208303827, 2.2417913004755974",Boulogne-Billancourt,92012,0.3939393939393939,19
44103,Pont De Charenton,OUI,18,2,16,15,1,OUI,OUI,2025-03-13 19:00:09+00:00,"48.8179685, 2.4199531",Saint-Maurice,94069,0.8888888888888888,19
4003,Quai aux Fleurs - Pont Saint-Louis,OUI,21,0,21,17,4,OUI,OUI,2025-03-13 19:00:55+00:00,"48.852915956209, 2.3521957173944",Paris,75056,1.0,19
22403,Pierre Brossolette - Adolphe Pinard,OUI,23,11,12,1,11,OUI,OUI,2025-03-13 19:00:43+00:00,"48.821772279548, 2.3131558299065",Malakoff,92046,0.5217391304347826,19
10018,Square Alban Satragne,OUI,29,16,13,3,10,OUI,OUI,2025-03-13 19:01:18+00:00,"48.875388227727, 2.3559567333359",Paris,75056,0.4482758620689655,19
21951,Place Centrale,OUI,22,20,2,0,2,OUI,OUI,2025-03-13 18:56:08+00:00,"48.78740167690531, 2.2278830409049992",Meudon,92048,0.09090909090909091,19
20108,Jardin de l'Hospice Debrousse,OUI,23,21,2,0,2,OUI,OUI,2025-03-13 18:57:15+00:00,"48.861451061938, 2.40568600595",Paris,75056,0.08695652173913043,19
19113,Pré Saint-Gervais - Lilas,OUI,27,25,2,1,1,OUI,OUI,2025-03-13 19:02:15+00:00,"48.877870626988, 2.3959073424339",Paris,75056,0.07407407407407407,19
31025,Paul Signac - Aristide Briand,OUI,33,30,3,0,3,OUI,OUI,2025-03-13 18:57:06+00:00,"48.86950262156371, 2.4502260982990265",Montreuil,93048,0.09090909090909091,19
14128,Gergovie - Vercingétorix,OUI,29,25,4,1,3,OUI,OUI,2025-03-13 19:02:24+00:00,"48.83453413883994, 2.313154547426182",Paris,75056,0.13793103448275862,19
5014,Jean Calvin - Tournefort,OUI,28,26,2,0,2,OUI,OUI,2025-03-13 18:57:01+00:00,"48.84158856925782, 2.348489575088024",Paris,75056,0.07142857142857142,19
17001,Guy Môquet - Saint-Ouen,OUI,44,36,8,1,7,OUI,OUI,2025-03-13 19:01:03+00:00,"48.892777719023975, 2.3270335793495183",Paris,75056,0.18181818181818182,19
8549,George V - Christophe Colomb,OUI,22,21,1,0,1,OUI,OUI,2025-03-13 19:01:40+00:00,"48.87046, 2.30104",Paris,75056,0.045454545454545456,19
12129,Bois de Vincennes - Porte Jaune,OUI,35,30,5,4,1,OUI,OUI,2025-03-13 18:57:38+00:00,"48.838751246689455, 2.4605489149689674",Paris,75056,0.14285714285714285,19
23902,Gallieni - Lycée Charles Petitet,OUI,43,20,23,17,6,OUI,OUI,2025-03-13 19:01:20+00:00,"48.927640283627, 2.3308986340524",Villeneuve-la-Garenne,92078,0.5348837209302325,19
8011,Clapeyron - Moscou,OUI,15,12,3,1,2,OUI,OUI,2025-03-13 18:54:28+00:00,"48.88078819514121, 2.324815057218075",Paris,75056,0.2,19
20007,Buzenval - Avron,OUI,49,34,15,10,5,OUI,OUI,2025-03-13 19:00:01+00:00,"48.851617204999, 2.4015135973077",Paris,75056,0.30612244897959184,19
13020,Paul Klee - Place Augusta Holmes,OUI,43,40,3,2,1,OUI,OUI,2025-03-13 19:02:38+00:00,"48.838946417408025, 2.3704235663952966",Paris,75056,0.06976744186046512,19
13033,Porte d'Italie,OUI,13,9,4,2,2,OUI,OUI,2025-03-13 19:00:31+00:00,"48.817161987718954, 2.360236309468746",Paris,75056,0.3076923076923077,19
19124,Alexander Fleming - Belvédère,OUI,31,28,3,0,3,OUI,OUI,2025-03-13 18:57:23+00:00,"48.88179064200294, 2.4030599377642674",Paris,75056,0.0967741935483871,19
20122,Vitruve - Davout,OUI,23,14,9,0,9,OUI,OUI,2025-03-13 19:01:14+00:00,"48.86053161154489, 2.4091592812626543",Paris,75056,0.391304347826087,19
15019,Paul Barruel - Vaugirard,OUI,36,28,8,3,5,OUI,OUI,2025-03-13 19:01:50+00:00,"48.84014918546239, 2.3044332861900334",Paris,75056,0.2222222222222222,19
13126,Place Nationale - Château-des-Rentiers,OUI,18,12,6,4,2,OUI,OUI,2025-03-13 19:01:59+00:00,"48.829268, 2.365212",Paris,75056,0.3333333333333333,19
20203,Evariste Galois,OUI,20,14,6,0,6,OUI,OUI,2025-03-13 18:55:26+00:00,"48.873341356228, 2.4133544409574",Paris,75056,0.3,19
14101,Gare Montparnasse - Edgar Quinet,OUI,33,22,11,4,7,OUI,OUI,2025-03-13 19:02:32+00:00,"48.841487851079, 2.3233232282801",Paris,75056,0.3333333333333333,19
12150,Bastille - Quai de la Rapée,OUI,25,3,22,21,1,OUI,OUI,2025-03-13 18:57:45+00:00,"48.84682410855, 2.3669364675879",Paris,75056,0.88,19
15023,La Motte-Picquet - Grenelle,OUI,34,2,32,23,9,OUI,OUI,2025-03-13 19:00:08+00:00,"48.84858321339195, 2.299347817897797",Paris,75056,0.9411764705882353,19
11031,Jacquard - Ternaux,OUI,39,13,26,24,2,OUI,OUI,2025-03-13 19:01:58+00:00,"48.8646605, 2.373162",Paris,75056,0.6666666666666666,19
4001,Arcole - Notre-Dame,OUI,28,13,15,11,4,OUI,OUI,2025-03-13 19:02:12+00:00,"48.853883541328, 2.3493797332048",Paris,75056,0.5357142857142857,19
13515,Auguste Blanqui - Glacière,OUI,60,54,6,4,2,OUI,OUI,2025-03-13 19:01:41+00:00,"48.831151602964, 2.343822196126",Paris,75056,0.1,19
12043,Daumesnil - Hébrard,OUI,39,5,34,34,0,OUI,OUI,2025-03-13 19:02:32+00:00,"48.8429, 2.38474",Paris,75056,0.8717948717948718,19
9016,Choron - Martyrs,OUI,16,11,5,4,1,OUI,OUI,2025-03-13 19:00:50+00:00,"48.877851443503, 2.3396701365709",Paris,75056,0.3125,19
14131,Jourdan - Monticelli,OUI,30,24,6,3,3,OUI,OUI,2025-03-13 19:00:52+00:00,"48.822032, 2.329095",Paris,75056,0.2,19
10037,Quai de Valmy,OUI,24,5,19,3,16,OUI,OUI,2025-03-13 19:01:04+00:00,"48.88126951579429, 2.368186041712761",Paris,75056,0.7916666666666666,19
19108,Gaston Tessier - Rosa Parks RER,OUI,37,28,9,2,7,OUI,OUI,2025-03-13 19:02:17+00:00,"48.8963765, 2.3743692",Paris,75056,0.24324324324324326,19
9036,Athènes - Clichy,OUI,18,15,3,2,1,OUI,OUI,2025-03-13 18:56:33+00:00,"48.878113787876, 2.32956021945824",Paris,75056,0.16666666666666666,19
10105,Mazagran - Bonne Nouvelle,OUI,25,5,20,13,7,OUI,OUI,2025-03-13 19:01:29+00:00,"48.870047123655, 2.3511248454452",Paris,75056,0.8,19
15125,Parc Suzanne Lenglen,OUI,50,18,32,31,1,OUI,OUI,2025-03-13 19:02:24+00:00,"48.833250690537874, 2.2765403240919113",Paris,75056,0.64,19
17003,Jacques Kellner - Saint-Ouen,OUI,43,24,19,13,6,OUI,OUI,2025-03-13 19:00:51+00:00,"48.895809485802886, 2.327897409164145",Paris,75056,0.4418604651162791,19
13027,Mazagran - Pierre de Coubertin,OUI,15,11,4,2,2,OUI,OUI,2025-03-13 19:00:10+00:00,"48.816218640260445, 2.344226874411106",Paris,75056,0.26666666666666666,19
43001,Paris - Laitières,OUI,22,15,7,1,6,OUI,OUI,2025-03-13 18:58:21+00:00,"48.84630274151258, 2.4207553267478947",Vincennes,94080,0.3181818181818182,19
17029,Pierre Demours - Laugier,OUI,36,29,7,4,3,OUI,OUI,2025-03-13 19:02:24+00:00,"48.8813072, 2.294846",Paris,75056,0.19444444444444445,19
22206,Louis Pasteur - Albert Petit,OUI,30,23,7,2,5,OUI,OUI,2025-03-13 19:01:55+00:00,"48.796261, 2.317289",Bagneux,92007,0.23333333333333334,19
21118,Neuilly - Petit,OUI,14,9,5,4,1,OUI,OUI,2025-03-13 18:59:51+00:00,"48.898965361341254, 2.29627937078476",Clichy,92024,0.35714285714285715,19
11021,Charonne - Pierre Bayle,OUI,23,10,13,7,6,OUI,OUI,2025-03-13 19:02:07+00:00,"48.858445054262, 2.3903981223891",Paris,75056,0.5652173913043478,19
20039,Belleville - Couronnes,OUI,48,32,16,9,7,OUI,OUI,2025-03-13 19:02:07+00:00,"48.868831082877, 2.3809862136841",Paris,75056,0.3333333333333333,19
21217,Louis Rolland - République,OUI,26,26,0,0,0,OUI,OUI,2025-03-13 19:01:54+00:00,"48.81710889740748, 2.3193106434955717",Montrouge,92049,0.0,19
21203,Place Jules Ferry,OUI,28,25,3,0,3,OUI,OUI,2025-03-13 19:01:51+00:00,"48.812107928414775, 2.325837314128876",Montrouge,92049,0.10714285714285714,19
9114,Faubourg Poissonnière - Dunkerque,OUI,29,26,3,1,2,OUI,OUI,2025-03-13 18:58:47+00:00,"48.880883445404436, 2.349934279918671",Paris,75056,0.10344827586206896,19
22013,Mairie de Neuilly sur Seine,OUI,31,23,8,8,0,OUI,OUI,2025-03-13 19:02:34+00:00,"48.88494728765838, 2.2677031159400944",Neuilly-sur-Seine,92051,0.25806451612903225,19
12007,Gare de Lyon - Chalon,OUI,45,1,44,24,20,OUI,OUI,2025-03-13 19:02:32+00:00,"48.845666194202, 2.3741452395916",Paris,75056,0.9777777777777777,19
19025,Botzaris - Crimée,OUI,20,9,11,3,8,OUI,OUI,2025-03-13 19:00:42+00:00,"48.87959698690176, 2.3887913337477067",Paris,75056,0.55,19
14010,Jean Moulin - Place Victor et Hélène Basch,OUI,37,35,2,0,2,OUI,OUI,2025-03-13 18:57:56+00:00,"48.82764910241, 2.3261967301369",Paris,75056,0.05405405405405406,19
16009,Saint-Didier - Raymond Poincaré,OUI,17,16,1,0,1,OUI,OUI,2025-03-13 18:59:30+00:00,"48.86642312020962, 2.285863497192411",Paris,75056,0.058823529411764705,19
22303,Lucien Lanternier - Le Luth,OUI,25,9,16,12,4,OUI,OUI,2025-03-13 19:01:18+00:00,"48.93159430558871, 2.2889783978462224",Gennevilliers,92036,0.64,19
21029,Cours de l'Ile Seguin - Parc Billancourt,OUI,27,8,19,15,4,OUI,OUI,2025-03-13 19:01:14+00:00,"48.82714055843935, 2.234234511852265",Boulogne-Billancourt,92012,0.7037037037037037,19
92001,Mairie de quartier du Plateau - Mont-Valérien,OUI,20,9,11,4,7,OUI,OUI,2025-03-13 18:57:36+00:00,"48.8799933, 2.2072437",Nanterre,92050,0.55,19
16014,Eylau - Trocadéro,OUI,22,16,6,3,3,OUI,OUI,2025-03-13 19:01:23+00:00,"48.863354122371, 2.2864209115505",Paris,75056,0.2727272727272727,19
43010,La Jarry - Place Diderot,OUI,25,16,9,3,6,OUI,OUI,2025-03-13 18:59:40+00:00,"48.849726940367326, 2.452013790607453",Vincennes,94080,0.36,19
16007,Longchamp - Place d'Iéna,OUI,22,22,0,0,0,OUI,OUI,2025-03-13 19:01:18+00:00,"48.864917233434, 2.2926748171449",Paris,75056,0.0,19
17107,Berthier - Place Stuart Merril,OUI,34,11,23,7,16,OUI,OUI,2025-03-13 19:00:33+00:00,"48.885927922355044, 2.2933450341224675",Paris,75056,0.6764705882352942,19
10110,Louis Blanc - Jemmapes,OUI,31,16,15,3,12,OUI,OUI,2025-03-13 19:01:40+00:00,"48.879330755297, 2.3684485629201",Paris,75056,0.4838709677419355,19
15004,Vaugirard - Pasteur,OUI,21,16,5,1,4,OUI,OUI,2025-03-13 18:59:08+00:00,"48.84040868803496, 2.3154367133975033",Paris,75056,0.23809523809523808,19
21115,Chancé Milly - Cimetière Communal Sud,OUI,32,5,27,26,1,OUI,OUI,2025-03-13 19:02:29+00:00,"48.89687189382465, 2.303922325372696",Clichy,92024,0.84375,19
18007,Goutte d'or - Barbès,OUI,19,12,7,2,5,OUI,OUI,2025-03-13 19:01:58+00:00,"48.885124323627, 2.3496962338686",Paris,75056,0.3684210526315789,19
41210,Hôtel de ville de Fontenay-sous-Bois,OUI,19,18,1,0,1,OUI,OUI,2025-03-13 18:56:59+00:00,"48.84949749106274, 2.4750164151191716",Fontenay-sous-Bois,94033,0.05263157894736842,19
21401,Mairie de Clamart,OUI,31,28,3,0,3,OUI,OUI,2025-03-13 18:53:57+00:00,"48.800612, 2.262151",Clamart,92023,0.0967741935483871,19
21702,Gare SNCF Vanves-Malakoff,OUI,49,46,3,1,2,OUI,OUI,2025-03-13 18:57:10+00:00,"48.819002163836444, 2.292150005103606",Vanves,92075,0.061224489795918366,19
13044,Place Jeanne d'Arc,OUI,34,24,10,7,3,OUI,OUI,2025-03-13 18:57:04+00:00,"48.829575, 2.369126",Paris,75056,0.29411764705882354,19
42304,Marc Sangnier - Division Leclerc,OUI,21,3,18,13,5,OUI,OUI,2025-03-13 19:02:40+00:00,"48.78599652305309, 2.329955510795116",Cachan,94016,0.8571428571428571,19
9027,Douai - Pierre Fontaine,OUI,21,12,9,2,7,OUI,OUI,2025-03-13 19:02:33+00:00,"48.88229101148092, 2.33324121683836",Paris,75056,0.42857142857142855,19
11109,Pierre Levée - Fontaine Timbaud,OUI,21,7,14,6,8,OUI,OUI,2025-03-13 19:01:46+00:00,"48.86632723374305, 2.3711163550615306",Paris,75056,0.6666666666666666,19
17108,Bessières - Porte de Clichy,OUI,30,20,10,7,3,OUI,OUI,2025-03-13 19:02:33+00:00,"48.89611762451474, 2.31790903955698",Paris,75056,0.3333333333333333,19
15123,Commerce - Letellier,OUI,42,12,30,17,13,OUI,OUI,2025-03-13 19:02:20+00:00,"48.84797660373612, 2.2966245196598805",Paris,75056,0.7142857142857143,19
22604,Hôtel de Ville de Fontenay-aux-Roses,OUI,32,25,7,1,6,OUI,OUI,2025-03-13 19:02:32+00:00,"48.790844603480856, 2.2871455930319455",Fontenay-aux-Roses,92032,0.21875,19
4020,Place Edmond Michelet,OUI,23,3,20,18,2,OUI,OUI,2025-03-13 19:02:24+00:00,"48.860134890542, 2.3500636965036",Paris,75056,0.8695652173913043,19
20009,Docteurs Déjérine - Pte de Montreuil,OUI,20,17,3,2,1,OUI,OUI,2025-03-13 18:59:49+00:00,"48.85398448133697, 2.41208288897222",Paris,75056,0.15,19
23004,Paul Vaillant-Couturier - Victor Hugo,OUI,34,10,24,23,1,OUI,OUI,2025-03-13 18:59:54+00:00,"48.89819702263572, 2.293848017974069",Levallois-Perret,92044,0.7058823529411765,19
42305,Vanne - Saussaies,OUI,19,14,5,1,4,OUI,OUI,2025-03-13 18:56:16+00:00,"48.786404, 2.338848",Cachan,94016,0.2631578947368421,19
22408,Place du 14 Juillet,OUI,22,18,4,1,3,OUI,OUI,2025-03-13 18:59:45+00:00,"48.819266959525, 2.3011998832226",Malakoff,92046,0.18181818181818182,19
13121,Bruneseau - Quai d'Ivry,OUI,46,6,40,39,1,OUI,OUI,2025-03-13 19:02:29+00:00,"48.824945637583, 2.3885661363602",Ivry-sur-Seine,94041,0.8695652173913043,19
21306,Place Lafayette,OUI,61,31,30,25,5,OUI,OUI,2025-03-13 18:59:52+00:00,"48.829654975522, 2.2638675570488",Issy-les-Moulineaux,92040,0.4918032786885246,19
21307,Victor Cresson - Telles de la Poterie,OUI,29,9,20,14,6,OUI,OUI,2025-03-13 18:56:54+00:00,"48.822698842979, 2.2686498274964",Issy-les-Moulineaux,92040,0.6896551724137931,19
15311,Quai du Président Roosevelt - Pont Aval,OUI,30,12,18,18,0,OUI,OUI,2025-03-13 19:02:16+00:00,"48.8343883676388, 2.2656820714473724",Paris,75056,0.6,19
32301,Mairie de Romainville,OUI,17,17,0,0,0,OUI,OUI,2025-03-13 18:57:50+00:00,"48.885109, 2.435679",Romainville,93063,0.0,19
35006,Delizy - Louis Nadot,OUI,21,16,5,3,2,OUI,OUI,2025-03-13 19:01:42+00:00,"48.896212845581346, 2.4094578623771667",Pantin,93055,0.23809523809523808,19
21219,Amaury Duval - Gabriel Péri,OUI,36,33,3,3,0,OUI,OUI,2025-03-13 19:02:13+00:00,"48.81718759671675, 2.323841750621796",Montrouge,92049,0.08333333333333333,19
41205,Maréchal Joffre - Verdun,OUI,20,20,0,0,0,OUI,OUI,2025-03-13 18:55:06+00:00,"48.85385, 2.470307",Fontenay-sous-Bois,94033,0.0,19
13011,Hôpital - Campo-Formio,OUI,11,8,3,1,2,OUI,OUI,2025-03-13 19:00:52+00:00,"48.835405, 2.358218",Paris,75056,0.2727272727272727,19
12018,Saint-Mandé - Fabre d'Eglantine,OUI,34,29,5,1,4,OUI,OUI,2025-03-13 19:02:27+00:00,"48.8453579, 2.3965022",Paris,75056,0.14705882352941177,19
42701,Charles Gide - Fort de Bicêtre,OUI,29,20,9,1,8,OUI,OUI,2025-03-13 19:01:29+00:00,"48.8071937956922, 2.353984415531159",Le Kremlin-Bicêtre,94043,0.3103448275862069,19
44005,Place Saint-Just,OUI,22,13,9,3,6,OUI,OUI,2025-03-13 19:01:08+00:00,"48.790379518724265, 2.3895226791501045",Vitry-sur-Seine,94081,0.4090909090909091,19
16020,Place de la Porte de Passy,OUI,34,24,10,7,3,OUI,OUI,2025-03-13 19:00:00+00:00,"48.857341095470794, 2.2644165538827115",Paris,75056,0.29411764705882354,19
17119,Toqueville - Cardinet,OUI,29,19,10,7,3,OUI,OUI,2025-03-13 19:01:54+00:00,"48.88490187110713, 2.3109393194317818",Paris,75056,0.3448275862068966,19
8020,Batignolles - Beudant,OUI,43,34,9,5,4,OUI,OUI,2025-03-13 19:01:56+00:00,"48.88216401466375, 2.319852970540523",Paris,75056,0.20930232558139536,19
51002,Placette Grégoire Collas,OUI,25,14,11,4,7,OUI,OUI,2025-03-13 18:58:06+00:00,"48.94342014002797, 2.2487476095557213",Argenteuil,95018,0.44,19
17015,Place de Lévis,OUI,48,45,3,1,2,OUI,OUI,2025-03-13 19:02:24+00:00,"48.883546851533254, 2.3131933808326726",Paris,75056,0.0625,19
32601,Porte des Lilas - Faidherbe,OUI,39,36,3,1,2,OUI,OUI,2025-03-13 18:57:25+00:00,"48.87861855668978, 2.4120327830314636",Les Lilas,93045,0.07692307692307693,19
22501,Théâtre de La Garenne,OUI,20,9,11,2,9,OUI,OUI,2025-03-13 19:01:52+00:00,"48.905658361454, 2.2345951981176",La Garenne-Colombes,92035,0.55,19
33016,Fort d'Aubervilliers,OUI,22,11,11,5,6,OUI,OUI,2025-03-13 19:01:27+00:00,"48.91502382370325, 2.4035281687974925",Aubervilliers,93001,0.5,19
42003,Place de l'Insurrection d'Août 1944,OUI,28,1,27,25,2,OUI,OUI,2025-03-13 18:58:35+00:00,"48.81477852751594, 2.398074567317963",Ivry-sur-Seine,94041,0.9642857142857143,19
15058,Place du Moulin de Javel,OUI,47,30,17,16,1,OUI,OUI,2025-03-13 19:01:39+00:00,"48.84021670922, 2.2716060653329",Paris,75056,0.3617021276595745,19
4010,Saint-Antoine Sévigné,OUI,31,2,29,21,8,OUI,OUI,2025-03-13 19:00:56+00:00,"48.8550222, 2.3612322",Paris,75056,0.9354838709677419,19
10162,Alexandre Parodi - Quai de Valmy,OUI,24,20,4,2,2,OUI,OUI,2025-03-13 19:00:51+00:00,"48.879359419425, 2.3665961623192",Paris,75056,0.16666666666666666,19
40009,Lycée Saint Exupéry - Juliette Savar,OUI,29,17,12,8,4,OUI,OUI,2025-03-13 18:53:54+00:00,"48.783021513972, 2.4637357216879",Créteil,94028,0.41379310344827586,19
13009,Auguste Blanqui - Corvisart,OUI,23,21,2,2,0,OUI,OUI,2025-03-13 18:58:41+00:00,"48.8300989, 2.3502726",Paris,75056,0.08695652173913043,19
27005,Gare du Stade,OUI,18,16,2,2,0,OUI,OUI,2025-03-13 18:58:21+00:00,"48.9312676, 2.2603778",Colombes,92025,0.1111111111111111,19
23003,Président Wilson - Baudin,OUI,27,17,10,8,2,OUI,OUI,2025-03-13 19:02:20+00:00,"48.89826887103676, 2.2849336266517644",Levallois-Perret,92044,0.37037037037037035,19
9024,Taitbout - La Fayette,OUI,51,44,7,6,1,OUI,OUI,2025-03-13 19:02:27+00:00,"48.8733298892, 2.3352625966072",Paris,75056,0.13725490196078433,19
17023,Porte d'Asnières,OUI,33,24,9,2,7,OUI,OUI,2025-03-13 19:01:06+00:00,"48.89035817610495, 2.3036286234855656",Paris,75056,0.2727272727272727,19
8201,Arsène Houssaye - Friedland,OUI,29,29,0,0,0,OUI,OUI,2025-03-13 18:59:05+00:00,"48.874510616163, 2.2994716674148",Paris,75056,0.0,19
44007,Camille Groult - Guy Môquet,OUI,22,4,18,13,5,OUI,OUI,2025-03-13 19:00:02+00:00,"48.787482746521306, 2.3976725712418556",Vitry-sur-Seine,94081,0.8181818181818182,19
9006,Dunkerque - Trudaine,OUI,16,13,3,2,1,OUI,OUI,2025-03-13 19:01:21+00:00,"48.88215166773376, 2.3463253676891327",Paris,75056,0.1875,19
4002,Marché aux fleurs,OUI,20,4,16,11,5,OUI,OUI,2025-03-13 19:01:25+00:00,"48.855258115391, 2.3473754525185",Paris,75056,0.8,19
92006,Place Nelson Mandela,OUI,30,25,5,2,3,OUI,OUI,2025-03-13 19:02:30+00:00,"48.897874318180556, 2.2182820737361912",Nanterre,92050,0.16666666666666666,19
42501,Raspail - Albert Schweitzer,OUI,27,6,21,17,4,OUI,OUI,2025-03-13 19:02:03+00:00,"48.81031545, 2.34395871",Gentilly,94037,0.7777777777777778,19
31005,Square Denise Buisson,OUI,45,43,2,0,2,OUI,OUI,2025-03-13 19:00:45+00:00,"48.8562322730982, 2.426436245441437",Montreuil,93048,0.044444444444444446,19
6008,Assas - Luxembourg,OUI,33,32,1,1,0,OUI,OUI,2025-03-13 19:02:19+00:00,"48.843734468779, 2.3334283818759",Paris,75056,0.030303030303030304,19
9034,Godot de Mauroy - Madeleine,OUI,21,13,8,3,5,OUI,OUI,2025-03-13 19:02:13+00:00,"48.869789, 2.326347",Paris,75056,0.38095238095238093,19
13109,Brillat-Savarin - Küss,OUI,21,9,12,8,4,OUI,OUI,2025-03-13 19:02:13+00:00,"48.822203, 2.350422",Paris,75056,0.5714285714285714,19
12035,Madagascar - Meuniers,OUI,32,14,18,10,8,OUI,OUI,2025-03-13 19:00:23+00:00,"48.83460464474706, 2.3970650508999825",Paris,75056,0.5625,19
21204,Estienne d'Orves - Henri Ginoux,OUI,30,29,1,1,0,OUI,OUI,2025-03-13 19:01:01+00:00,"48.815388220397274, 2.320886790760933",Montrouge,92049,0.03333333333333333,19
10021,Marché Saint-Quentin,OUI,13,10,3,1,2,OUI,OUI,2025-03-13 19:01:04+00:00,"48.877356057652, 2.3545114456374",Paris,75056,0.23076923076923078,19
42209,Place de l'Europe - Quai de Bercy,OUI,15,1,14,11,3,OUI,OUI,2025-03-13 19:02:22+00:00,"48.82529858840266, 2.3945679143071175",Charenton-le-Pont,94018,0.9333333333333333,19
5115,Buffon - Jardin des Plantes,OUI,30,11,19,15,4,OUI,OUI,2025-03-13 19:02:10+00:00,"48.842668466104875, 2.3618587106466293",Paris,75056,0.6333333333333333,19
15030,Emeriau - Beaugrenelle,OUI,70,11,59,55,4,OUI,OUI,2025-03-13 19:02:10+00:00,"48.84791249714942, 2.2843059897422795",Paris,75056,0.8428571428571429,19
44011,Lebrun - Colonel Fabien,OUI,27,20,7,0,7,OUI,OUI,2025-03-13 18:54:44+00:00,"48.78266870733145, 2.381317801773548",Vitry-sur-Seine,94081,0.25925925925925924,19
16011,Victor Hugo - La Pompe,OUI,39,39,0,0,0,OUI,OUI,2025-03-13 18:59:21+00:00,"48.86795222470859, 2.28146318346262",Paris,75056,0.0,19
2108,Vivienne - Montmartre,OUI,36,20,16,9,7,OUI,OUI,2025-03-13 19:02:28+00:00,"48.871347597383, 2.3414588347077",Paris,75056,0.4444444444444444,19
25001,Colmar - Victor Hugo,OUI,32,22,10,7,3,OUI,OUI,2025-03-13 19:00:10+00:00,"48.88652251096166, 2.173960916697979",Rueil-Malmaison,92063,0.3125,19
15129,Hôpital Necker,OUI,35,30,5,4,1,OUI,OUI,2025-03-13 19:00:45+00:00,"48.846043490118454, 2.313245013356209",Paris,75056,0.14285714285714285,19
35007,Benjamin Delessert - Jean Lolive,OUI,21,19,2,0,2,OUI,OUI,2025-03-13 19:00:30+00:00,"48.89392043619345, 2.417981922626496",Pantin,93055,0.09523809523809523,19
51001,Gare d'Argenteuil,OUI,37,19,18,3,15,OUI,OUI,2025-03-13 19:01:22+00:00,"48.947022436806705, 2.256898172199726",Argenteuil,95018,0.4864864864864865,19
47001,Place de la Gare,OUI,45,11,34,33,1,OUI,OUI,2025-03-13 19:02:32+00:00,"48.80253358011283, 2.4275037646293645",Maisons-Alfort,94046,0.7555555555555555,19
15039,Abbé Groult - Convention,OUI,12,11,1,0,1,OUI,OUI,2025-03-13 19:01:29+00:00,"48.83596927866069, 2.302064039509349",Paris,75056,0.08333333333333333,19
44101,Place Mongolfier,OUI,37,18,19,12,7,OUI,OUI,2025-03-13 19:01:16+00:00,"48.815160030060376, 2.4592879414558415",Saint-Maurice,94069,0.5135135135135135,19
23102,Hôtel de Ville de Sèvres,OUI,31,14,17,15,2,OUI,OUI,2025-03-13 18:54:30+00:00,"48.824363561289, 2.2131047397852",Sèvres,92072,0.5483870967741935,19
13032,Italie - Jardin Joan Miro,OUI,23,15,8,3,5,OUI,OUI,2025-03-13 19:01:08+00:00,"48.81990914045756, 2.3592948541045193",Paris,75056,0.34782608695652173,19
15036,Croix Nivert - Square Saint-Lambert,OUI,47,47,0,0,0,NON,NON,2025-03-03 09:03:43+00:00,"48.843051521591, 2.2952004522085",Paris,75056,0.0,9
10165,Gare de l'Est - Place du 11 Novembre 1918,OUI,39,17,22,11,11,OUI,OUI,2025-03-13 19:02:02+00:00,"48.876327, 2.3585464",Paris,75056,0.5641025641025641,19
6022,Marché Saint-Germain,OUI,19,3,16,13,3,OUI,OUI,2025-03-13 19:02:39+00:00,"48.85165625855281, 2.335500307381153",Paris,75056,0.8421052631578947,19
15064,Javel - André Citroën,OUI,41,13,28,24,4,OUI,OUI,2025-03-13 19:01:21+00:00,"48.846276485475, 2.2786368057132",Paris,75056,0.6829268292682927,19
15006,Cherche-Midi - Hôpital Necker,OUI,37,31,6,1,5,OUI,OUI,2025-03-13 19:01:59+00:00,"48.84461063309956, 2.317914068698883",Paris,75056,0.16216216216216217,19
13128,Quai de la Gare - Pont de Bercy,OUI,29,1,28,25,3,OUI,OUI,2025-03-13 19:00:14+00:00,"48.83730787972, 2.3740861260598",Paris,75056,0.9655172413793104,19
21402,Place Aimé Césaire,OUI,27,25,2,0,2,OUI,OUI,2025-03-13 18:56:31+00:00,"48.783194713067815, 2.2429127991199493",Clamart,92023,0.07407407407407407,19
15057,Lucien Bossoutrot - Général Martial Vallin,OUI,36,34,2,2,0,OUI,OUI,2025-03-13 18:59:08+00:00,"48.836956046311, 2.2741072252393",Paris,75056,0.05555555555555555,19
41403,Gare RER - Malleret-Joinville,OUI,19,1,18,15,3,OUI,OUI,2025-03-13 19:02:08+00:00,"48.802936, 2.42531",Alfortville,94002,0.9473684210526315,19
16002,Pergolèse - Malakoff,OUI,36,33,3,2,1,OUI,OUI,2025-03-13 19:00:49+00:00,"48.87521088779225, 2.2842781618237495",Paris,75056,0.08333333333333333,19
21303,Jean Monnet - Iles,OUI,31,10,21,19,2,OUI,OUI,2025-03-13 19:02:39+00:00,"48.823393984057304, 2.2497073194874866",Issy-les-Moulineaux,92040,0.6774193548387096,19
23010,Voltaire - Anatole France,OUI,25,8,17,16,1,OUI,OUI,2025-03-13 19:01:30+00:00,"48.891999360256904, 2.284262739121914",Levallois-Perret,92044,0.68,19
33014,Parc Eli Lotar,OUI,19,9,10,7,3,OUI,OUI,2025-03-13 18:53:10+00:00,"48.91844993053703, 2.3727085813879967",Aubervilliers,93001,0.5263157894736842,19
6027,Blaise-Desgoffe - Vaugirard,OUI,31,27,4,4,0,OUI,OUI,2025-03-13 19:02:12+00:00,"48.846128877747, 2.3242672160268",Paris,75056,0.12903225806451613,19
13052,Leredde - Tolbiac,OUI,41,33,8,7,1,OUI,OUI,2025-03-13 18:58:28+00:00,"48.82887629664, 2.3744382709265",Paris,75056,0.1951219512195122,19
19128,Quai de l'Oise - Aisne,OUI,28,20,8,1,7,OUI,OUI,2025-03-13 19:01:12+00:00,"48.8906231, 2.3833701",Paris,75056,0.2857142857142857,19
17024,Villiers - Batignolles,OUI,23,19,4,2,2,OUI,OUI,2025-03-13 19:02:28+00:00,"48.88125253846116, 2.31653843075037",Paris,75056,0.17391304347826086,19
15005,Place Jacques et Thérèse Tréfouël,OUI,43,41,2,1,1,OUI,OUI,2025-03-13 19:01:49+00:00,"48.842726498317, 2.3125657439232",Paris,75056,0.046511627906976744,19
14011,Place des Droits de l'Enfant,OUI,39,30,9,2,7,OUI,OUI,2025-03-13 19:02:32+00:00,"48.8274804, 2.3319217",Paris,75056,0.23076923076923078,19
18006,Square Louise Michel,OUI,35,31,4,2,2,OUI,OUI,2025-03-13 18:59:40+00:00,"48.884687354509, 2.3441386967897",Paris,75056,0.11428571428571428,19
41401,Marne - Charles de Gaulle,OUI,25,0,25,14,11,OUI,OUI,2025-03-13 19:02:20+00:00,"48.815071719544434, 2.4121668934822087",Alfortville,94002,1.0,19
15022,Emile Zola - Fondary,OUI,40,0,40,36,4,OUI,OUI,2025-03-13 19:02:29+00:00,"48.847051143113745, 2.2953405976295476",Paris,75056,1.0,19
6002,Saint-Benoît - Jacob,OUI,20,14,6,4,2,OUI,OUI,2025-03-13 19:02:40+00:00,"48.85545136013941, 2.3334722220897675",Paris,75056,0.3,19
5012,Estrapade - Ulm,OUI,16,13,3,2,1,OUI,OUI,2025-03-13 18:54:16+00:00,"48.84512772828, 2.3454568170362",Paris,75056,0.1875,19
20044,Davout - Volga,OUI,27,19,8,3,5,OUI,OUI,2025-03-13 19:02:04+00:00,"48.852919679957296, 2.410522909779111",Paris,75056,0.2962962962962963,19
8037,Monceau - Malesherbes,OUI,37,36,1,0,1,OUI,OUI,2025-03-13 19:01:06+00:00,"48.8795079, 2.3145456",Paris,75056,0.02702702702702703,19
16019,Porte de la Muette,OUI,34,34,0,0,0,OUI,OUI,2025-03-13 18:58:17+00:00,"48.86302317841182, 2.2687188170157406",Paris,75056,0.0,19
11017,Charonne - Bureau,OUI,44,29,15,7,8,OUI,OUI,2025-03-13 19:02:15+00:00,"48.854176, 2.396093",Paris,75056,0.3409090909090909,19
2013,Favart - Italiens,OUI,16,10,6,3,3,OUI,OUI,2025-03-13 19:02:15+00:00,"48.871446353921, 2.3382901058508",Paris,75056,0.375,19
1021,Halles - Bourdonnais,OUI,17,1,16,12,4,OUI,OUI,2025-03-13 18:55:56+00:00,"48.860448992575, 2.3460162431002",Paris,75056,0.9411764705882353,19
3102,Bourg l'Abbé - Saint-Martin,OUI,37,3,34,23,11,OUI,OUI,2025-03-13 19:01:30+00:00,"48.86393331949257, 2.352406270802021",Paris,75056,0.918918918918919,19
33015,Charles Tillon - Cimetière Communal,OUI,27,2,25,7,18,OUI,OUI,2025-03-13 19:00:14+00:00,"48.91844023641836, 2.3935630917549138",Aubervilliers,93001,0.9259259259259259,19
10019,Paradis - Hauteville,OUI,31,21,10,5,5,OUI,OUI,2025-03-13 19:02:08+00:00,"48.874999954666755, 2.3522757401923404",Paris,75056,0.3225806451612903,19
7017,La Motte-Picquet - La Tour Maubourg,OUI,40,30,10,4,6,OUI,OUI,2025-03-13 19:01:53+00:00,"48.856926701847, 2.3096215831203",Paris,75056,0.25,19
11033,Bréguet - Sabin,OUI,30,2,28,20,8,OUI,OUI,2025-03-13 19:02:08+00:00,"48.856931678257, 2.3706749462105",Paris,75056,0.9333333333333333,19
22015,Île de la Jatte,OUI,22,10,12,7,5,OUI,OUI,2025-03-13 19:00:21+00:00,"48.894036161302104, 2.2666339203715324",Neuilly-sur-Seine,92051,0.5454545454545454,19
10033,Gare du Nord - Saint-Vincent de Paul,OUI,24,24,0,0,0,OUI,OUI,2025-03-13 19:01:54+00:00,"48.880955741648, 2.3524305148385",Paris,75056,0.0,19
44016,Balzac - Olympes de Gouges,OUI,28,4,24,9,15,OUI,OUI,2025-03-13 18:58:52+00:00,"48.77850332486751, 2.4006786569952965",Vitry-sur-Seine,94081,0.8571428571428571,19
15011,Cambronne - Villa Croix Nivert,OUI,59,32,27,19,8,OUI,OUI,2025-03-13 19:01:39+00:00,"48.845847561366, 2.3017574474216",Paris,75056,0.4576271186440678,19
10008,Cité Riverin - Château d'Eau,OUI,18,2,16,14,2,OUI,OUI,2025-03-13 19:01:01+00:00,"48.870702423554306, 2.358739863900845",Paris,75056,0.8888888888888888,19
9004,Gérando - Rochechouart,OUI,21,14,7,1,6,OUI,OUI,2025-03-13 19:02:23+00:00,"48.88294340845, 2.3464846238494",Paris,75056,0.3333333333333333,19
16036,Porte Molitor,OUI,57,23,34,23,11,OUI,OUI,2025-03-13 19:01:42+00:00,"48.84524763511433, 2.2569015249609947",Paris,75056,0.5964912280701754,19
12026,Place Ginette Hamelin,OUI,49,25,24,22,2,OUI,OUI,2025-03-13 19:02:13+00:00,"48.837853, 2.382064",Paris,75056,0.4897959183673469,19
42505,Charles Frérot - Albert Guilpin,OUI,28,20,8,5,3,OUI,OUI,2025-03-13 19:02:38+00:00,"48.8155839183714, 2.3505029082298283",Gentilly,94037,0.2857142857142857,19
6012,Saint-Germain - Ciseaux,OUI,18,1,17,15,2,OUI,OUI,2025-03-13 19:02:27+00:00,"48.853305277595, 2.3344654618827",Paris,75056,0.9444444444444444,19
8117,Place de la Madeleine - Royale,OUI,40,31,9,6,3,OUI,OUI,2025-03-13 19:02:31+00:00,"48.869228052648, 2.324421107769",Paris,75056,0.225,19
15071,Suffren - Champ de Mars,OUI,23,14,9,7,2,OUI,OUI,2025-03-13 19:02:35+00:00,"48.8547194, 2.2952168",Paris,75056,0.391304347826087,19
10032,Claude Vellefaux - Hôpital Saint-Louis,OUI,32,24,8,5,3,OUI,OUI,2025-03-13 18:57:07+00:00,"48.872859139003, 2.3700717069851",Paris,75056,0.25,19
17111,Lemercier - Cardinet,OUI,24,17,7,6,1,OUI,OUI,2025-03-13 19:02:12+00:00,"48.890097168851746, 2.317377626895905",Paris,75056,0.2916666666666667,19
12015,Place de la Nation - Picpus,OUI,36,33,3,0,3,OUI,OUI,2025-03-13 19:01:09+00:00,"48.846821681548, 2.4001130461693",Paris,75056,0.08333333333333333,19
21319,Esplanade du Foncet - Camille Desmoulins,OUI,27,0,27,22,5,OUI,OUI,2025-03-13 19:01:37+00:00,"48.827090233494964, 2.2606857866048813",Issy-les-Moulineaux,92040,1.0,19
14001,Edgar Quinet - Gaité,OUI,26,14,12,7,5,OUI,OUI,2025-03-13 18:59:41+00:00,"48.841160928966, 2.324595451355",Paris,75056,0.46153846153846156,19
9102,Londres - Place d'Estienne d'Orves,OUI,22,17,5,5,0,OUI,OUI,2025-03-13 18:57:14+00:00,"48.876693805756986, 2.3305362090468407",Paris,75056,0.22727272727272727,19
16042,Murat - Porte de Saint-Cloud,OUI,37,2,35,33,2,OUI,OUI,2025-03-13 19:00:55+00:00,"48.83750862621299, 2.2577651962637906",Paris,75056,0.9459459459459459,19
8116,Champs-Elysees - Bassano,OUI,25,25,0,0,0,NON,NON,2021-02-21 19:09:18+00:00,"48.871811807816, 2.300238981843",Paris,75056,0.0,19
15001,Gare Montparnasse - Arrivée,OUI,41,18,23,15,8,OUI,OUI,2025-03-13 19:02:21+00:00,"48.843827994315, 2.3225811123848",Paris,75056,0.5609756097560976,19
18030,Joseph Dijon - Ornano,OUI,36,28,8,1,7,OUI,OUI,2025-03-13 19:00:33+00:00,"48.89374453351521, 2.3476678133010864",Paris,75056,0.2222222222222222,19
15008,Sèvres - Lecourbe,OUI,61,55,6,4,2,OUI,OUI,2025-03-13 19:00:46+00:00,"48.8447677, 2.3110086",Paris,75056,0.09836065573770492,19
5024,Place Monge,OUI,21,17,4,2,2,OUI,OUI,2025-03-13 19:00:31+00:00,"48.842761803051, 2.3524079471827",Paris,75056,0.19047619047619047,19
19110,Square Claude Bernard,OUI,27,24,3,2,1,OUI,OUI,2025-03-13 18:55:53+00:00,"48.89876016219984, 2.375325746834278",Paris,75056,0.1111111111111111,19
21314,Chemin de Bretagne,OUI,28,6,22,20,2,OUI,OUI,2025-03-13 18:57:23+00:00,"48.824753068884, 2.2588385956052",Issy-les-Moulineaux,92040,0.7857142857142857,19
11112,Jules Vallès - Charonne,OUI,22,1,21,15,6,OUI,OUI,2025-03-13 19:01:07+00:00,"48.854284379935, 2.3847674578428",Paris,75056,0.9545454545454546,19
12038,Picpus - Louis Braille,OUI,43,34,9,3,6,OUI,OUI,2025-03-13 18:58:14+00:00,"48.839988788912, 2.4005256685521",Paris,75056,0.20930232558139536,19
16105,Crevaux - Bugeaud,OUI,31,29,2,0,2,OUI,OUI,2025-03-13 19:00:18+00:00,"48.87080942867, 2.2811490076919",Paris,75056,0.06451612903225806,19
12005,Crozatier - Faubourg Saint-Antoine,OUI,40,3,37,33,4,OUI,OUI,2025-03-13 19:02:13+00:00,"48.850440013405, 2.378901366211",Paris,75056,0.925,19
18202,Diane Arbus,OUI,37,31,6,5,1,OUI,OUI,2025-03-13 19:01:53+00:00,"48.898800717199, 2.3524022474885",Paris,75056,0.16216216216216217,19
13516,Glacière - Soeur Catherine Marie,OUI,40,35,5,3,2,OUI,OUI,2025-03-13 19:02:25+00:00,"48.829522989420596, 2.343570403754711",Paris,75056,0.125,19
5015,Epée de Bois - Mouffetard,OUI,61,52,9,7,2,OUI,OUI,2025-03-13 18:59:47+00:00,"48.841508690388835, 2.350066713988781",Paris,75056,0.14754098360655737,19
12155,Rottembourg - Général Michel Bizot,OUI,41,27,14,8,6,OUI,OUI,2025-03-13 19:02:30+00:00,"48.83787825992554, 2.4044052511453633",Paris,75056,0.34146341463414637,19
44014,Camille Risch - Paul Armangot,OUI,25,20,5,4,1,OUI,OUI,2025-03-13 18:57:05+00:00,"48.774703, 2.373685",Vitry-sur-Seine,94081,0.2,19
9011,Geoffroy - Marie,OUI,17,12,5,5,0,OUI,OUI,2025-03-13 19:02:08+00:00,"48.873781940593325, 2.344513876337893",Paris,75056,0.29411764705882354,19
1007,Turbigo - Française,OUI,15,8,7,5,2,OUI,OUI,2025-03-13 18:58:01+00:00,"48.86358858111446, 2.3477794602513313",Paris,75056,0.4666666666666667,19
12028,Vivaldi - Antoine-Julien Hénard,OUI,27,18,9,4,5,OUI,OUI,2025-03-13 18:59:44+00:00,"48.841923663276546, 2.389728979467376",Paris,75056,0.3333333333333333,19
47003,Charentonneau - Maisons Alfort,OUI,20,3,17,10,7,OUI,OUI,2025-03-13 19:02:28+00:00,"48.809932980484355, 2.443288456496946",Maisons-Alfort,94046,0.85,19
41211,Louis Xavier de Ricard - Ancienne Mairie,OUI,34,26,8,3,5,OUI,OUI,2025-03-13 19:01:55+00:00,"48.84629899065091, 2.472420372068882",Fontenay-sous-Bois,94033,0.23529411764705882,19
20008,Pyrénées - Avron,OUI,32,29,3,2,1,OUI,OUI,2025-03-13 19:01:55+00:00,"48.853246898211985, 2.405871044529538",Paris,75056,0.09375,19
12101,Charenton - Prague,OUI,28,0,28,14,14,OUI,OUI,2025-03-13 19:02:36+00:00,"48.848175129981, 2.3763584494312",Paris,75056,1.0,19
12019,Gare de Reuilly - Picpus,OUI,26,12,14,6,8,OUI,OUI,2025-03-13 19:00:59+00:00,"48.84267354116789, 2.3972943797707558",Paris,75056,0.5384615384615384,19
21707,Square Etienne Jarousse,OUI,22,18,4,1,3,OUI,OUI,2025-03-13 19:02:33+00:00,"48.82485182597129, 2.2925933450460434",Vanves,92075,0.18181818181818182,19
20104,Louis Lumière.,OUI,22,19,3,1,2,OUI,OUI,2025-03-13 19:00:27+00:00,"48.86216198070008, 2.41112578185621",Paris,75056,0.13636363636363635,19
4019,Cloître Saint-Merri - Renard,OUI,30,5,25,22,3,OUI,OUI,2025-03-13 18:55:33+00:00,"48.858835448898, 2.3518279194832",Paris,75056,0.8333333333333334,19
20024,Gambetta - Père Lachaise,OUI,27,10,17,1,16,OUI,OUI,2025-03-13 19:01:31+00:00,"48.864295696165875, 2.398228667282044",Paris,75056,0.6296296296296297,19
5001,Harpe - Saint-Germain,OUI,40,23,17,16,1,OUI,OUI,2025-03-13 19:02:40+00:00,"48.851518815017, 2.3436703160405",Paris,75056,0.425,19
3010,Beaubourg - Michel-le-Comte,OUI,14,2,12,9,3,OUI,OUI,2025-03-13 19:00:42+00:00,"48.862534941806, 2.3543103039265",Paris,75056,0.8571428571428571,19
8027,Mairie du 8ème,OUI,14,14,0,0,0,OUI,OUI,2025-03-13 18:54:39+00:00,"48.877932, 2.318264",Paris,75056,0.0,19
21309,Mairie d'Issy,OUI,39,12,27,18,9,OUI,OUI,2025-03-13 19:00:42+00:00,"48.823767792468, 2.2723111510277",Issy-les-Moulineaux,92040,0.6923076923076923,19
21315,Jules Guesdes - Général de Gaulle,OUI,24,19,5,0,5,OUI,OUI,2025-03-13 19:02:32+00:00,"48.81930581291959, 2.278934195637703",Issy-les-Moulineaux,92040,0.20833333333333334,19
4021,Centre Georges Pompidou,OUI,26,4,22,15,7,OUI,OUI,2025-03-13 19:00:51+00:00,"48.861419, 2.352581",Paris,75056,0.8461538461538461,19
13018,Bruant - Vincent Auriol,OUI,25,21,4,1,3,OUI,OUI,2025-03-13 19:02:15+00:00,"48.834848452929, 2.3668264996271",Paris,75056,0.16,19
13005,Cordelières - Arago,OUI,44,5,39,33,6,OUI,OUI,2025-03-13 19:00:59+00:00,"48.83548071896613, 2.348572461702221",Paris,75056,0.8863636363636364,19
9007,Condorcet - Turgot,OUI,19,10,9,1,8,OUI,OUI,2025-03-13 19:02:19+00:00,"48.87985155789093, 2.345232367515564",Paris,75056,0.47368421052631576,19
19002,Centquatre,OUI,36,29,7,4,3,NON,NON,2025-03-13 19:01:53+00:00,"48.889333538455, 2.3707854375243",Paris,75056,0.19444444444444445,19
15127,Place Charles Michels,OUI,35,4,31,25,6,OUI,OUI,2025-03-13 18:59:01+00:00,"48.846401, 2.28502",Paris,75056,0.8857142857142857,19
17019,Phalsbourg - Villiers,OUI,19,17,2,0,2,OUI,OUI,2025-03-13 18:57:46+00:00,"48.88242307900951, 2.3090453445911407",Paris,75056,0.10526315789473684,19
20105,Benoît Frachon - République,OUI,29,28,1,1,0,OUI,OUI,2025-03-13 19:02:10+00:00,"48.85230729014318, 2.415605485439301",Paris,75056,0.034482758620689655,19
19201,Petit - Georges Thill,OUI,23,7,16,6,10,OUI,OUI,2025-03-13 19:01:12+00:00,"48.88603131999171, 2.3895753175020222",Paris,75056,0.6956521739130435,19
33103,Jean Jaurès - Jules Jacquemin,OUI,22,21,1,0,1,OUI,OUI,2025-03-13 18:59:27+00:00,"48.88433053604843, 2.4082902455152104",Le Pré-Saint-Gervais,93061,0.045454545454545456,19
10009,Mairie du 10ème,OUI,18,2,16,11,5,OUI,OUI,2025-03-13 19:02:08+00:00,"48.872089449907, 2.3575825989246",Paris,75056,0.8888888888888888,19
14032,Mairie du 14ème,OUI,31,25,6,0,6,OUI,OUI,2025-03-13 19:00:55+00:00,"48.83254578123, 2.3254923149943",Paris,75056,0.1935483870967742,19
22301,Chausson - Gabriel Péri,OUI,21,10,11,8,3,OUI,OUI,2025-03-13 19:02:35+00:00,"48.921891003481115, 2.2952306270599365",Gennevilliers,92036,0.5238095238095238,19
14031,Didot - Place de Moro-Giafferi,OUI,19,3,16,3,13,OUI,OUI,2025-03-13 19:01:23+00:00,"48.8337, 2.3215",Paris,75056,0.8421052631578947,19
41405,Place de l'Europe - Alfortville,OUI,24,4,20,17,3,OUI,OUI,2025-03-13 19:00:10+00:00,"48.78913702405837, 2.4284800887107854",Alfortville,94002,0.8333333333333334,19
33012,Landy - Heurtault,OUI,29,26,3,1,2,OUI,OUI,2025-03-13 19:01:43+00:00,"48.915096534520316, 2.375951372087002",Aubervilliers,93001,0.10344827586206896,19
8028,Arsène Houssaye - Champs-Elysées,OUI,28,24,4,2,2,OUI,OUI,2025-03-13 19:02:09+00:00,"48.873409276267, 2.2977904602885",Paris,75056,0.14285714285714285,19
41203,Stalingrad - Rigollots,OUI,50,41,9,1,8,OUI,OUI,2025-03-13 19:01:31+00:00,"48.84997403844251, 2.45557576417923",Fontenay-sous-Bois,94033,0.18,19
14019,Sarrette - Général Leclerc,OUI,22,19,3,0,3,OUI,OUI,2025-03-13 19:00:20+00:00,"48.825030852925, 2.3264128693982",Paris,75056,0.13636363636363635,19
18039,Jardins d'Eole,OUI,19,14,5,2,3,OUI,OUI,2025-03-13 18:57:36+00:00,"48.8869703, 2.3668488",Paris,75056,0.2631578947368421,19
3011,Turbigo - Réaumur,OUI,28,3,25,17,8,OUI,OUI,2025-03-13 19:02:03+00:00,"48.865574047531, 2.3564198613167",Paris,75056,0.8928571428571429,19
10027,Dunkerque - Alsace,OUI,20,20,0,0,0,OUI,OUI,2025-03-13 18:58:11+00:00,"48.879355, 2.358379",Paris,75056,0.0,19
20022,Porte de Bagnolet,OUI,33,27,6,1,5,OUI,OUI,2025-03-13 18:54:18+00:00,"48.864707139122984, 2.408344637349607",Paris,75056,0.18181818181818182,19
12002,Lacuée - Lyon,OUI,15,2,13,11,2,OUI,OUI,2025-03-13 19:01:44+00:00,"48.849268481958, 2.3704585433006",Paris,75056,0.8666666666666667,19
12036,Reuilly - Place Felix Eboue,OUI,41,35,6,3,3,OUI,OUI,2025-03-13 19:00:53+00:00,"48.84030274499962, 2.394630398715453",Paris,75056,0.14634146341463414,19
21506,Maurice Payret-Dortail,OUI,22,20,2,0,2,OUI,OUI,2025-03-13 19:00:54+00:00,"48.87811957063342, 2.2233625128865246",Suresnes,92073,0.09090909090909091,19
14026,Plantes - Moulin Vert,OUI,45,40,5,2,3,OUI,OUI,2025-03-13 19:02:31+00:00,"48.83005755305626, 2.3232302069664006",Paris,75056,0.1111111111111111,19
4103,Archives - Rivoli,OUI,21,2,19,13,6,OUI,OUI,2025-03-13 19:02:30+00:00,"48.857346707443, 2.3539767041802",Paris,75056,0.9047619047619048,19
16012,Flandrin - Longchamp,OUI,38,30,8,0,8,OUI,OUI,2025-03-13 19:02:06+00:00,"48.86877849178477, 2.274354539176829",Paris,75056,0.21052631578947367,19
9037,Parme - Clichy,OUI,23,20,3,1,2,OUI,OUI,2025-03-13 19:00:24+00:00,"48.881266424227, 2.3281970934506",Paris,75056,0.13043478260869565,19
48004,Maxime Gorki - Louis Aragon,OUI,20,20,0,0,0,OUI,OUI,2025-03-13 18:55:46+00:00,"48.78909814728443, 2.368387877941132",Villejuif,94076,0.0,19
2015,Louis le Grand - Italiens,OUI,33,30,3,2,1,OUI,OUI,2025-03-13 18:53:42+00:00,"48.870508937204, 2.3340544619393",Paris,75056,0.09090909090909091,19
26004,Gare RER les Grésillons,OUI,22,18,4,1,3,OUI,OUI,2025-03-13 19:01:47+00:00,"48.919898633572764, 2.31458459136273",Asnières-sur-Seine,92004,0.18181818181818182,19
21026,Sèvres - Général Leclerc,OUI,29,21,8,8,0,OUI,OUI,2025-03-13 18:57:13+00:00,"48.830121559055, 2.2314262390137",Boulogne-Billancourt,92012,0.27586206896551724,19
18139,Poissonniers - Championnet,OUI,28,25,3,2,1,OUI,OUI,2025-03-13 18:55:36+00:00,"48.89543299733937, 2.3530178144574165",Paris,75056,0.10714285714285714,19
19129,Solitaires - Place des Fêtes,OUI,29,29,0,0,0,NON,NON,2025-02-23 09:26:05+00:00,"48.876601, 2.391769",Paris,75056,0.0,9
1006,Grande Truanderie - Saint-Denis,OUI,27,3,24,17,7,OUI,OUI,2025-03-13 19:02:08+00:00,"48.8626302, 2.3498075",Paris,75056,0.8888888888888888,19
32013,Saint-Denis - Université,OUI,18,18,0,0,0,OUI,OUI,2025-03-13 19:02:11+00:00,"48.94563430946964, 2.3638297989964485",Saint-Denis,93066,0.0,19
22201,Henri Ravera - Gabriel Péri,OUI,28,14,14,1,13,OUI,OUI,2025-03-13 19:00:30+00:00,"48.79722273833844, 2.302115857601166",Bagneux,92007,0.5,19
13017,Nationale - Vincent Auriol,OUI,33,18,15,8,7,OUI,OUI,2025-03-13 19:01:51+00:00,"48.83252708397293, 2.362354410392119",Paris,75056,0.45454545454545453,19
5007,Ecoles - Carmes,OUI,33,22,11,5,6,OUI,OUI,2025-03-13 19:00:59+00:00,"48.848904447989405, 2.3473486304283147",Paris,75056,0.3333333333333333,19
15111,Olivier de Serres - Leriche,OUI,24,19,5,2,3,OUI,OUI,2025-03-13 19:02:33+00:00,"48.83460221715206, 2.2957482933998112",Paris,75056,0.20833333333333334,19
4006,Bourdon - Pont Morland,OUI,50,12,38,34,4,OUI,OUI,2025-03-13 19:02:40+00:00,"48.8478103, 2.3659356",Paris,75056,0.76,19
2021,Cléry - Montmartre,OUI,56,34,22,12,10,OUI,OUI,2025-03-13 19:01:10+00:00,"48.867458, 2.3445211",Paris,75056,0.39285714285714285,19
3008,Perle - Vieille du Temple,OUI,33,12,21,20,1,OUI,OUI,2025-03-13 19:02:26+00:00,"48.8601346, 2.3611206",Paris,75056,0.6363636363636364,19
14132,Bézout - Général Leclerc,OUI,28,24,4,0,4,OUI,OUI,2025-03-13 19:01:40+00:00,"48.82884804502439, 2.3285973072052",Paris,75056,0.14285714285714285,19
6010,Chevreuse - Montparnasse,OUI,14,5,9,5,4,OUI,OUI,2025-03-13 19:00:16+00:00,"48.841739161231, 2.3315522167367",Paris,75056,0.6428571428571429,19
23702,Hôtel de Ville de Chaville,OUI,20,17,3,1,2,OUI,OUI,2025-03-13 19:01:03+00:00,"48.80887149094033, 2.188134044408798",Chaville,92022,0.15,19
45002,Roger Salengro - Général de Gaulle,OUI,27,14,13,6,7,OUI,OUI,2025-03-13 18:59:52+00:00,"48.820029010376956, 2.4846760556101803",Champigny-sur-Marne,94017,0.48148148148148145,19
14022,Didot - Mariniers,OUI,34,24,10,2,8,OUI,OUI,2025-03-13 18:59:04+00:00,"48.82650543613106, 2.313136198271666",Paris,75056,0.29411764705882354,19
15128,Cadix - Hameau,OUI,36,18,18,13,5,OUI,OUI,2025-03-13 19:00:29+00:00,"48.8340107632249, 2.289516180753708",Paris,75056,0.5,19
19012,Lally-Tollendal - Armand Carrel,OUI,26,18,8,6,2,OUI,OUI,2025-03-13 18:58:52+00:00,"48.88270066221072, 2.374717555940151",Paris,75056,0.3076923076923077,19
12037,Reuilly - Daumesnil,OUI,36,29,7,4,3,OUI,OUI,2025-03-13 18:58:03+00:00,"48.8395385, 2.3972516",Paris,75056,0.19444444444444445,19
21507,Gardenat-Lapostol - Velettes,OUI,20,16,4,0,4,OUI,OUI,2025-03-13 18:58:00+00:00,"48.87387, 2.224185",Suresnes,92073,0.2,19
18004,Place des Abbesses,OUI,12,4,8,4,4,OUI,OUI,2025-03-13 19:00:46+00:00,"48.884542726149725, 2.3386867716908455",Paris,75056,0.6666666666666666,19
14023,Adolphe Pinard - Victor Hugo,OUI,50,42,8,3,5,OUI,OUI,2025-03-13 19:02:26+00:00,"48.8236825874564, 2.3077843710780144",Malakoff,92046,0.16,19
16013,Mairie du 16ème,OUI,35,33,2,1,1,OUI,OUI,2025-03-13 19:02:04+00:00,"48.863936848471994, 2.2765953093767166",Paris,75056,0.05714285714285714,19
3006,Mairie du 3ème,OUI,25,1,24,20,4,OUI,OUI,2025-03-13 19:00:03+00:00,"48.86446178139141, 2.361762821674347",Paris,75056,0.96,19
7012,Cité Vaneau,OUI,24,21,3,2,1,OUI,OUI,2025-03-13 18:56:52+00:00,"48.8542210666207, 2.319614924490452",Paris,75056,0.125,19
20001,Place de la Nation - Charonne,OUI,35,34,1,0,1,OUI,OUI,2025-03-13 19:01:56+00:00,"48.848364667777, 2.3997623859813",Paris,75056,0.02857142857142857,19
19111,Cesaria Evora - Rosa Parks,OUI,35,33,2,2,0,OUI,OUI,2025-03-13 19:01:27+00:00,"48.89717672825043, 2.3745173960924144",Paris,75056,0.05714285714285714,19
18034,Leibniz - Jean Dollfus,OUI,32,30,2,1,1,OUI,OUI,2025-03-13 19:01:13+00:00,"48.896328348515986, 2.333390423834684",Paris,75056,0.0625,19
4012,Tiron - Rivoli,OUI,27,0,27,23,4,OUI,OUI,2025-03-13 19:02:14+00:00,"48.855692253233, 2.3579058051109",Paris,75056,1.0,19
14135,Jourdan - Cité Universitaire,OUI,39,35,4,2,2,OUI,OUI,2025-03-13 19:02:17+00:00,"48.819897343156676, 2.3397007964124366",Paris,75056,0.10256410256410256,19
1014,Rivoli - Musée du Louvre,OUI,17,0,17,12,5,OUI,OUI,2025-03-13 19:01:52+00:00,"48.86364636851945, 2.33409583568573",Paris,75056,1.0,19
8110,Gare Saint-Lazare - Stockholm,OUI,31,29,2,1,1,OUI,OUI,2025-03-13 18:57:05+00:00,"48.877127316667654, 2.322417162358761",Paris,75056,0.06451612903225806,19
42211,Séminaire de Conflans - Liberté,OUI,24,24,0,0,0,OUI,OUI,2025-03-13 18:57:36+00:00,"48.823194, 2.404179",Charenton-le-Pont,94018,0.0,19
12156,Niger - Soult,OUI,23,14,9,1,8,OUI,OUI,2025-03-13 19:02:21+00:00,"48.84369906369085, 2.410361237220498",Paris,75056,0.391304347826087,19
2012,Choiseul - Quatre Septembre,OUI,43,35,8,4,4,OUI,OUI,2025-03-13 19:01:25+00:00,"48.8699355331869, 2.3359975218772893",Paris,75056,0.18604651162790697,19
18140,Porte de Clignancourt - Ney,OUI,39,33,6,1,5,OUI,OUI,2025-03-13 19:02:31+00:00,"48.899641123987095, 2.344321422278881",Paris,75056,0.15384615384615385,19
12163,Hippodrome Paris-Vincennes,OUI,42,42,0,0,0,OUI,OUI,2025-03-13 19:02:18+00:00,"48.82048387758518, 2.446271181106568",Paris,75056,0.0,19
3002,Saint-Gilles - Turenne,OUI,14,10,4,1,3,OUI,OUI,2025-03-13 19:01:05+00:00,"48.858158956779, 2.3647149920992",Paris,75056,0.2857142857142857,19
9009,Square Montholon,OUI,16,8,8,5,3,OUI,OUI,2025-03-13 19:02:11+00:00,"48.876620377545024, 2.3457641154527664",Paris,75056,0.5,19
21509,Gardenat Lapostol - Franklin Roosevelt,OUI,24,23,1,0,1,OUI,OUI,2025-03-13 19:00:09+00:00,"48.871839, 2.222505",Suresnes,92073,0.041666666666666664,19
10034,Louis Blanc - La Chapelle,OUI,21,14,7,2,5,OUI,OUI,2025-03-13 18:57:42+00:00,"48.884008964514, 2.3599335551262",Paris,75056,0.3333333333333333,19
2004,Square Pierre Lazareff,OUI,17,0,17,12,5,OUI,OUI,2025-03-13 19:02:37+00:00,"48.867141720746, 2.3483933508396",Paris,75056,1.0,19
6104,Herschel - Observatoire,OUI,35,27,8,4,4,OUI,OUI,2025-03-13 19:00:09+00:00,"48.84342376221923, 2.3376645147800446",Paris,75056,0.22857142857142856,19
19130,Place Paul Delouvrier,OUI,26,16,10,2,8,OUI,OUI,2025-03-13 18:59:30+00:00,"48.89197621431365, 2.3851288855075836",Paris,75056,0.38461538461538464,19
16102,Pergolèse - Marbeau,OUI,26,23,3,2,1,OUI,OUI,2025-03-13 18:57:45+00:00,"48.873568706869, 2.2815125225299",Paris,75056,0.11538461538461539,19
35012,Candale - Mehul,OUI,25,13,12,0,12,OUI,OUI,2025-03-13 18:57:16+00:00,"48.8893935006175, 2.414379715919495",Pantin,93055,0.48,19
20034,Sorbier - Ménilmontant,OUI,24,20,4,2,2,OUI,OUI,2025-03-13 18:57:20+00:00,"48.868542395661, 2.3897721245885",Paris,75056,0.16666666666666666,19
21505,Édouard Vaillant - Place Jean Jaurès,OUI,21,12,9,3,6,OUI,OUI,2025-03-13 18:59:13+00:00,"48.86265537999924, 2.2089037319128613",Suresnes,92073,0.42857142857142855,19
19010,Emile Reynaud - Porte de la Villette,OUI,22,11,11,4,7,OUI,OUI,2025-03-13 19:01:11+00:00,"48.90098953630053, 2.3887022584676743",Paris,75056,0.5,19
4018,Saint-Bon - Rivoli,OUI,15,0,15,10,5,OUI,OUI,2025-03-13 19:00:53+00:00,"48.857999643315, 2.3502172809763",Paris,75056,1.0,19
15132,Bargue -  Dutot,OUI,21,15,6,3,3,OUI,OUI,2025-03-13 19:01:42+00:00,"48.837884, 2.308876",Paris,75056,0.2857142857142857,19
16044,Porte de Saint Cloud - Parc des Princes,OUI,31,6,25,21,4,OUI,OUI,2025-03-13 19:02:22+00:00,"48.838662757066, 2.2525164484978",Paris,75056,0.8064516129032258,19
20006,Pyrénées - Plaine,OUI,12,11,1,0,1,OUI,OUI,2025-03-13 18:55:27+00:00,"48.85026702458, 2.4062821269035",Paris,75056,0.08333333333333333,19
44001,Quai Jules Guesde - Saint-Simon,OUI,30,3,27,26,1,OUI,OUI,2025-03-13 19:01:49+00:00,"48.80391487219, 2.4089661620274",Vitry-sur-Seine,94081,0.9,19
10011,Bourse du Travail,OUI,17,3,14,12,2,OUI,OUI,2025-03-13 19:01:02+00:00,"48.868976638826, 2.3623438552022",Paris,75056,0.8235294117647058,19
4007,Place de la Bastille - Bourdon,OUI,29,3,26,20,6,OUI,OUI,2025-03-13 19:02:01+00:00,"48.852364355271, 2.3681089282036",Paris,75056,0.896551724137931,19
21953,Gare de Bellevue,OUI,20,18,2,0,2,OUI,OUI,2025-03-13 19:00:27+00:00,"48.8192404685572, 2.2295309230685234",Meudon,92048,0.1,19
5004,Saint-Jacques - Val de Grâce,OUI,19,15,4,0,4,OUI,OUI,2025-03-13 19:02:13+00:00,"48.8417514, 2.3413893",Paris,75056,0.21052631578947367,19
14137,Maurice d'Ocagne - General Maudhuy,OUI,28,25,3,1,2,OUI,OUI,2025-03-13 19:00:55+00:00,"48.82414282524159, 2.3158789426088333",Paris,75056,0.10714285714285714,19
4009,Village Saint-Paul,OUI,27,1,26,18,8,OUI,OUI,2025-03-13 18:58:02+00:00,"48.852639866625, 2.3607301712036",Paris,75056,0.9629629629629629,19
31709,Place de la Fraternité,OUI,22,18,4,1,3,OUI,OUI,2025-03-13 18:59:02+00:00,"48.85716405838368, 2.422847449779511",Montreuil,93048,0.18181818181818182,19
33020,Waldeck Rochet - Germaine Tillon,OUI,30,26,4,3,1,OUI,OUI,2025-03-13 18:58:48+00:00,"48.91105960199651, 2.3676301538944244",Aubervilliers,93001,0.13333333333333333,19
10006,Petites Ecuries - Faubourg Saint-Denis,OUI,27,1,26,19,7,OUI,OUI,2025-03-13 19:02:20+00:00,"48.87287120589831, 2.3542150855064397",Paris,75056,0.9629629629629629,19
32019,Place du 8 mai 1945.,OUI,28,14,14,5,9,OUI,OUI,2025-03-13 19:00:44+00:00,"48.938882272105, 2.3566243797541",Saint-Denis,93066,0.5,19
22401,Charles de Gaulle - Plateau de Vanves,OUI,32,30,2,0,2,OUI,OUI,2025-03-13 18:55:09+00:00,"48.82233088973263, 2.298571803412886",Malakoff,92046,0.0625,19
22506,Gare des Vallées,OUI,18,11,7,2,5,OUI,OUI,2025-03-13 19:02:10+00:00,"48.913179, 2.257726",La Garenne-Colombes,92035,0.3888888888888889,19
14103,Maine - Liancourt,OUI,25,20,5,1,4,OUI,OUI,2025-03-13 19:01:16+00:00,"48.835064363954, 2.323731449974",Paris,75056,0.2,19
1025,Oratoire - Rivoli,OUI,16,6,10,9,1,OUI,OUI,2025-03-13 19:02:32+00:00,"48.861342760889, 2.3400047421455",Paris,75056,0.625,19
3001,Beaumarchais - Saint-Gilles,OUI,44,31,13,8,5,OUI,OUI,2025-03-13 19:01:47+00:00,"48.8580378, 2.3679352",Paris,75056,0.29545454545454547,19
1026,Place du Lieutenant Henri Karcher,OUI,28,11,17,12,5,OUI,OUI,2025-03-13 19:02:25+00:00,"48.863490871724466, 2.3400671035051346",Paris,75056,0.6071428571428571,19
7021,Bosquet - Saint-Dominique,OUI,27,18,9,6,3,OUI,OUI,2025-03-13 18:59:43+00:00,"48.858651709526, 2.3037165802346",Paris,75056,0.3333333333333333,19
18015,Custine - Ramey,OUI,41,19,22,4,18,OUI,OUI,2025-03-13 19:00:40+00:00,"48.888735896947, 2.3469526693225",Paris,75056,0.5365853658536586,19
20029,Frères Flavien - Porte des Lilas,OUI,23,23,0,0,0,OUI,OUI,2025-03-13 19:00:52+00:00,"48.8780992764359, 2.41104629853209",Paris,75056,0.0,19
1017,Saint-Honoré - 29 juillet,OUI,19,12,7,5,2,OUI,OUI,2025-03-13 18:59:06+00:00,"48.86557114282421, 2.330567417577153",Paris,75056,0.3684210526315789,19
2003,Saint-Denis - Réaumur,OUI,32,4,28,23,5,OUI,OUI,2025-03-13 19:02:16+00:00,"48.8661116315789, 2.3507790675507594",Paris,75056,0.875,19
15040,Saint-Amand - Labrouste,OUI,34,21,13,4,9,OUI,OUI,2025-03-13 18:57:22+00:00,"48.834097274832295, 2.3087677359581",Paris,75056,0.38235294117647056,19
22503,Joffre - Aigle,OUI,19,12,7,6,1,OUI,OUI,2025-03-13 19:02:34+00:00,"48.904033, 2.245096",La Garenne-Colombes,92035,0.3684210526315789,19
23107,Gare de Sèvres - Ville d'Avray,OUI,22,21,1,0,1,OUI,OUI,2025-03-13 18:58:09+00:00,"48.826262366227, 2.2001516849313",Sèvres,92072,0.045454545454545456,19
1102,Française - Etienne Marcel,OUI,34,11,23,21,2,OUI,OUI,2025-03-13 19:00:47+00:00,"48.864053304653766, 2.347587011754513",Paris,75056,0.6764705882352942,19
6201,Saint Pères - Saint Germain,OUI,20,15,5,3,2,OUI,OUI,2025-03-13 19:00:37+00:00,"48.853729675265, 2.3300181032703",Paris,75056,0.25,19
12020,Cours de Vincennes - Soult,OUI,44,32,12,4,8,OUI,OUI,2025-03-13 18:59:10+00:00,"48.846918761569, 2.4105220288038",Paris,75056,0.2727272727272727,19
6026,Saint-Placide - Cherche Midi,OUI,65,64,1,0,1,OUI,OUI,2025-03-13 18:59:45+00:00,"48.8490535919234, 2.325317971408367",Paris,75056,0.015384615384615385,19
24006,Adolphe Lalyre - Armand Silvestre,OUI,38,32,6,3,3,OUI,OUI,2025-03-13 19:00:22+00:00,"48.90406266961591, 2.273416221141815",Courbevoie,92026,0.15789473684210525,19
22601,Marx Dormoy - Château Sainte-Barbe,OUI,20,15,5,1,4,OUI,OUI,2025-03-13 18:58:16+00:00,"48.791782341055324, 2.297856844961643",Fontenay-aux-Roses,92032,0.25,19
3009,Temple - Haudriettes,OUI,19,1,18,14,4,OUI,OUI,2025-03-13 19:00:34+00:00,"48.861636880212, 2.3566960206458",Paris,75056,0.9473684210526315,19
42018,Amédée Huon - Fort d'Ivry,OUI,30,24,6,1,5,OUI,OUI,2025-03-13 19:02:27+00:00,"48.805131376899986, 2.388489693403244",Ivry-sur-Seine,94041,0.2,19
4014,Blancs-Manteaux - Archives,OUI,28,5,23,21,2,OUI,OUI,2025-03-13 19:01:24+00:00,"48.85941800703, 2.3559471219778",Paris,75056,0.8214285714285714,19
48008,Guy Môquet - Parvis Georges Marchais,OUI,30,28,2,0,2,OUI,OUI,2025-03-13 18:53:52+00:00,"48.79518840095975, 2.35943466424942",Villejuif,94076,0.06666666666666667,19
2005,Montmartre - Etienne Marcel,OUI,16,3,13,10,3,OUI,OUI,2025-03-13 19:02:22+00:00,"48.86502194581, 2.3450684401448",Paris,75056,0.8125,19
5003,Le Goff - Gay-Lussac,OUI,34,30,4,1,3,OUI,OUI,2025-03-13 19:00:09+00:00,"48.846102400979, 2.3412207886577",Paris,75056,0.11764705882352941,19
3012,Square Emile - Chautemps,OUI,23,0,23,16,7,OUI,OUI,2025-03-13 19:00:30+00:00,"48.867433724231, 2.3536357283592",Paris,75056,1.0,19
2002,Etienne Marcel - Montorgueil,OUI,25,2,23,23,0,OUI,OUI,2025-03-13 19:02:34+00:00,"48.86450567259199, 2.3461959511041637",Paris,75056,0.92,19
3007,Archives - Pastourelle,OUI,26,10,16,10,6,OUI,OUI,2025-03-13 19:02:25+00:00,"48.8623615, 2.3595041",Paris,75056,0.6153846153846154,19
31001,Lagny - Auguste Blanqui,OUI,26,25,1,0,1,OUI,OUI,2025-03-13 18:59:16+00:00,"48.84922568052601, 2.4218603968620305",Montreuil,93048,0.038461538461538464,19
35005,Quai de l'Aisne - Général Leclerc,OUI,25,21,4,2,2,OUI,OUI,2025-03-13 19:02:40+00:00,"48.895713, 2.400571",Pantin,93055,0.16,19
22306,Place du 17 Octobre,OUI,15,9,6,3,3,OUI,OUI,2025-03-13 19:02:07+00:00,"48.91962690034779, 2.2978286134199792",Gennevilliers,92036,0.4,19
21119,Belfort - Victor Hugo,OUI,21,12,9,8,1,OUI,OUI,2025-03-13 19:01:14+00:00,"48.9018492, 2.3172724",Clichy,92024,0.42857142857142855,19
22502,Kléber - National,OUI,20,19,1,0,1,OUI,OUI,2025-03-13 19:01:28+00:00,"48.906333898712234, 2.2393910586833954",La Garenne-Colombes,92035,0.05,19
16010,Belles Feuilles - Place de Mexico,OUI,21,18,3,1,2,OUI,OUI,2025-03-13 18:56:00+00:00,"48.865804746474, 2.2829206287861",Paris,75056,0.14285714285714285,19
4015,Mairie du 4ème,OUI,40,4,36,34,2,OUI,OUI,2025-03-13 19:02:19+00:00,"48.855949910497, 2.3563823103905",Paris,75056,0.9,19
16201,Porte Dauphine,OUI,59,55,4,1,3,OUI,OUI,2025-03-13 18:59:53+00:00,"48.871139344351, 2.2749781616017",Paris,75056,0.06779661016949153,19
3003,Fille du Calvaire - Turenne,OUI,25,6,19,14,5,OUI,OUI,2025-03-13 19:01:49+00:00,"48.86210505412563, 2.3649600148200993",Paris,75056,0.76,19
23042,André Theuriet - Blagis,OUI,30,28,2,1,1,OUI,OUI,2025-03-13 19:01:05+00:00,"48.77977325745441, 2.3130525648593903",Bourg-la-Reine,92014,0.06666666666666667,19
9111,Victoire - Laffitte,OUI,19,17,2,2,0,OUI,OUI,2025-03-13 19:00:09+00:00,"48.87514373494672, 2.338118505144376",Paris,75056,0.10526315789473684,19
42019,Lampes,OUI,43,12,31,30,1,OUI,OUI,2025-03-13 19:01:36+00:00,"48.81152481985875, 2.4017931148409843",Ivry-sur-Seine,94041,0.7209302325581395,19
5122,Saint-Michel - Luxembourg,OUI,28,25,3,2,1,OUI,OUI,2025-03-13 18:58:22+00:00,"48.84501507626, 2.3394941166043",Paris,75056,0.10714285714285714,19
13125,Gare d'Austerlitz - Pont Charles de Gaulle,OUI,54,25,29,25,4,OUI,OUI,2025-03-13 19:02:26+00:00,"48.842319830109, 2.3670300096273",Paris,75056,0.5370370370370371,19
27006,Victor Hugo - Gare,OUI,19,0,19,11,8,OUI,OUI,2025-03-13 19:01:05+00:00,"48.923133952658, 2.2600970417261",Colombes,92025,1.0,19
21110,Parc Roger Salengro,OUI,31,15,16,13,3,OUI,OUI,2025-03-13 19:02:26+00:00,"48.905303858642, 2.31055945158",Clichy,92024,0.5161290322580645,19
1008,Les Halles - Saint-Eustache,OUI,32,13,19,16,3,OUI,OUI,2025-03-13 19:02:25+00:00,"48.86362695901683, 2.342623919248581",Paris,75056,0.59375,19
8036,Lisbonne - Monceau,OUI,46,45,1,0,1,OUI,OUI,2025-03-13 19:00:07+00:00,"48.877455676814, 2.3096942214195",Paris,75056,0.021739130434782608,19
2006,Place des Victoires,OUI,22,14,8,4,4,OUI,OUI,2025-03-13 19:01:53+00:00,"48.8660354, 2.3420333",Paris,75056,0.36363636363636365,19
6031,Pierre Sarrazin - Saint-Michel,OUI,31,25,6,5,1,OUI,OUI,2025-03-13 19:00:54+00:00,"48.850908146398, 2.342130728066",Paris,75056,0.1935483870967742,19
19046,Porte de Pantin.,OUI,33,8,25,3,22,OUI,OUI,2025-03-13 18:59:04+00:00,"48.889199725577, 2.3950181901455",Paris,75056,0.7575757575757576,19
48005,Eugène Varlin - Place de la Paix,OUI,23,22,1,1,0,OUI,OUI,2025-03-13 19:02:23+00:00,"48.792862, 2.363093",Villejuif,94076,0.043478260869565216,19
14133,Froidevaux - Boulard,OUI,34,21,13,0,13,OUI,OUI,2025-03-13 18:59:55+00:00,"48.835147319625, 2.3294411972165",Paris,75056,0.38235294117647056,19
10201,Magenta - Chabrol,OUI,23,16,7,3,4,OUI,OUI,2025-03-13 19:02:03+00:00,"48.876495350882, 2.3560990020633",Paris,75056,0.30434782608695654,19
21215,Verdier - Jean Jaurès,OUI,33,28,5,1,4,OUI,OUI,2025-03-13 18:58:52+00:00,"48.81614048711214, 2.3123561963438988",Montrouge,92049,0.15151515151515152,19
23301,Les Blagis,OUI,24,9,15,9,6,OUI,OUI,2025-03-13 19:02:09+00:00,"48.785205, 2.302526",Sceaux,92071,0.625,19
41208,Alouettes - Maréchal de Lattre de Tassigny,OUI,21,18,3,1,2,OUI,OUI,2025-03-13 18:54:17+00:00,"48.85511009293948, 2.4930700287222862",Fontenay-sous-Bois,94033,0.14285714285714285,19
42210,Victor Hugo - Paul Eluard,OUI,30,1,29,26,3,OUI,OUI,2025-03-13 18:57:56+00:00,"48.819602554907, 2.4114319673051",Charenton-le-Pont,94018,0.9666666666666667,19
42704,Mairie du Kremlin-Bicêtre,OUI,25,18,7,4,3,OUI,OUI,2025-03-13 19:00:06+00:00,"48.81191981537702, 2.3570189997553825",Le Kremlin-Bicêtre,94043,0.28,19
34013,Blanqui - Docteur Bauer,OUI,20,18,2,1,1,OUI,OUI,2025-03-13 19:02:00+00:00,"48.907735489085, 2.3407192814591",Saint-Ouen-sur-Seine,93070,0.1,19
21706,Jean Bleuzen - Square du 11 Novembre,OUI,45,41,4,4,0,OUI,OUI,2025-03-13 19:01:16+00:00,"48.8232579, 2.2965213",Vanves,92075,0.08888888888888889,19
44008,Youri Gagarine - Commune de Paris,OUI,32,8,24,11,13,OUI,OUI,2025-03-13 19:01:06+00:00,"48.782427463041, 2.3939734697342",Vitry-sur-Seine,94081,0.75,19
4017,Place de l'Hôtel de Ville,OUI,13,3,10,7,3,OUI,OUI,2025-03-13 19:02:09+00:00,"48.8573314, 2.351458",Paris,75056,0.7692307692307693,19
20140,Paganini - Davout,OUI,22,20,2,0,2,OUI,OUI,2025-03-13 19:00:12+00:00,"48.85135, 2.412021",Paris,75056,0.09090909090909091,19
26006,Bas - Gabriel Péri,OUI,30,11,19,15,4,OUI,OUI,2025-03-13 18:58:50+00:00,"48.91585580539625, 2.2948095202445984",Asnières-sur-Seine,92004,0.6333333333333333,19
20048,Bagnolet - Place Saint-Blaise,OUI,24,13,11,1,10,OUI,OUI,2025-03-13 19:00:24+00:00,"48.85973, 2.40334",Paris,75056,0.4583333333333333,19
42026,Barbès - Monique Maunoury,OUI,40,37,3,0,3,OUI,OUI,2025-03-13 19:02:25+00:00,"48.81552718820216, 2.3687169334905405",Ivry-sur-Seine,94041,0.075,19
10166,Strasbourg - Saint-Denis,OUI,16,1,15,11,4,OUI,OUI,2025-03-13 19:02:40+00:00,"48.869601642433, 2.3542908579111",Paris,75056,0.9375,19
13054,Pau Casals - Neuve Tolbiac,OUI,53,43,10,5,5,OUI,OUI,2025-03-13 19:02:15+00:00,"48.8311602, 2.3774395",Paris,75056,0.18867924528301888,19
23202,Henri Barbusse - Gabriel Péri,OUI,16,15,1,1,0,OUI,OUI,2025-03-13 19:01:25+00:00,"48.801773795836, 2.2874166362216",Châtillon,92020,0.0625,19
1012,Jean-Jacques Rousseau - Deux Ecus,OUI,20,6,14,12,2,OUI,OUI,2025-03-13 19:01:34+00:00,"48.86297805972131, 2.3414635285735126",Paris,75056,0.7,19
13049,Vincent Auriol - Louise Weiss,OUI,22,20,2,2,0,OUI,OUI,2025-03-13 19:02:10+00:00,"48.834001935501, 2.3703888058662",Paris,75056,0.09090909090909091,19
2016,Aboukir - Alexandrie,OUI,21,10,11,7,4,OUI,OUI,2025-03-13 19:02:13+00:00,"48.86868344444473, 2.3502043269474897",Paris,75056,0.5238095238095238,19
6015,André Mazet - Saint-André des Arts,OUI,54,6,48,42,6,OUI,OUI,2025-03-13 19:00:30+00:00,"48.85375581057431, 2.3390958085656166",Paris,75056,0.8888888888888888,19
10041,Gare du Nord - La Chapelle,OUI,18,15,3,2,1,OUI,OUI,2025-03-13 18:59:55+00:00,"48.884178287286, 2.3561057075858",Paris,75056,0.16666666666666666,19
12202,Charenton - Wattignies,OUI,40,2,38,28,10,OUI,OUI,2025-03-13 19:02:33+00:00,"48.836919119234, 2.3916775206425",Paris,75056,0.95,19
4101,Bastille - Beaumarchais,OUI,20,0,20,17,3,OUI,OUI,2025-03-13 19:01:57+00:00,"48.853833463852, 2.3685702681541",Paris,75056,1.0,19
23206,Béranger - Félix Faure,OUI,26,22,4,0,4,OUI,OUI,2025-03-13 19:01:03+00:00,"48.80404828621485, 2.2848263373723436",Châtillon,92020,0.15384615384615385,19
9039,Chaussée d'Antin - Haussmann,OUI,22,17,5,4,1,OUI,OUI,2025-03-13 19:02:01+00:00,"48.87243, 2.33359",Paris,75056,0.22727272727272727,19
8040,Pierre Charron - Champs-Elysées,OUI,29,28,1,0,1,OUI,OUI,2025-03-13 19:00:52+00:00,"48.870103359864, 2.3043501377106",Paris,75056,0.034482758620689655,19
1018,Alger - Rivoli,OUI,16,9,7,3,4,OUI,OUI,2025-03-13 19:01:07+00:00,"48.864773553495, 2.3294493936128",Paris,75056,0.4375,19
2008,Mairie du 2ème,OUI,28,24,4,2,2,OUI,OUI,2025-03-13 19:00:34+00:00,"48.8672190355135, 2.3404625437747044",Paris,75056,0.14285714285714285,19
20142,Mûriers - Père Lachaise,OUI,20,15,5,1,4,OUI,OUI,2025-03-13 19:00:00+00:00,"48.864130509668044, 2.39164982067019",Paris,75056,0.25,19
23101,Grande Rue - Europe,OUI,25,10,15,9,6,OUI,OUI,2025-03-13 19:02:33+00:00,"48.8218104687602, 2.205879874527455",Sèvres,92072,0.6,19
51008,Martyrs de Châteaubriant - Jean Grandel,OUI,38,31,7,1,6,OUI,OUI,2025-03-13 19:01:41+00:00,"48.951432, 2.211214",Argenteuil,95018,0.18421052631578946,19
17106,Berthier - Porte de Clichy,OUI,24,12,12,9,3,OUI,OUI,2025-03-13 19:01:59+00:00,"48.894222687781, 2.3125872006816",Paris,75056,0.5,19
34011,Clef des Champs - Albert Dhalenne,OUI,26,19,7,1,6,OUI,OUI,2025-03-13 19:02:21+00:00,"48.914938, 2.330665",Saint-Ouen-sur-Seine,93070,0.2692307692307692,19
1116,Ventadour - Opéra,OUI,26,15,11,6,5,OUI,OUI,2025-03-13 19:01:36+00:00,"48.866810653323, 2.3343884482519",Paris,75056,0.4230769230769231,19
21704,Place du Maréchal de Lattre de Tassigny,OUI,26,1,25,14,11,OUI,OUI,2025-03-13 19:01:26+00:00,"48.821707715257055, 2.2853431485432423",Vanves,92075,0.9615384615384616,19
32024,Port - Confluence,OUI,23,16,7,4,3,OUI,OUI,2025-03-13 19:02:30+00:00,"48.936093926526, 2.3436167797955",Saint-Denis,93066,0.30434782608695654,19
19121,Belleville -  Pré Saint-Gervais,OUI,21,18,3,0,3,OUI,OUI,2025-03-13 19:01:04+00:00,"48.875565910073, 2.3930460959673",Paris,75056,0.14285714285714285,19
12164,Stade Pershing,OUI,26,26,0,0,0,NON,NON,2025-02-26 05:58:32+00:00,"48.829107826857, 2.4583535268903",Paris,75056,0.0,6
12123,Château de Vincennes,OUI,49,45,4,3,1,OUI,OUI,2025-03-13 18:59:05+00:00,"48.84423193255657, 2.439209537709179",Paris,75056,0.08163265306122448,19
1023,Saint-Honoré - Musée du Louvre,OUI,21,4,17,12,5,OUI,OUI,2025-03-13 19:01:58+00:00,"48.863443132848, 2.3348781846405",Paris,75056,0.8095238095238095,19
21002,Place Denfert-Rochereau,OUI,20,11,9,7,2,OUI,OUI,2025-03-13 19:02:01+00:00,"48.843252536286684, 2.245987951755524",Boulogne-Billancourt,92012,0.45,19
19202,Marseillaise - Grenade,OUI,44,37,7,2,5,OUI,OUI,2025-03-13 19:01:07+00:00,"48.889371092747, 2.3979396821544",Paris,75056,0.1590909090909091,19
13024,Bobillot - Tolbiac,OUI,33,24,9,2,7,OUI,OUI,2025-03-13 19:02:34+00:00,"48.8255961335041, 2.350204177200794",Paris,75056,0.2727272727272727,19
14201,Decrès - Alésia,OUI,30,28,2,0,2,OUI,OUI,2025-03-13 18:58:07+00:00,"48.832200060759, 2.3139070151575",Paris,75056,0.06666666666666667,19
24004,Paix - Verdun,OUI,32,25,7,4,3,OUI,OUI,2025-03-13 19:02:11+00:00,"48.900504, 2.261173",Courbevoie,92026,0.21875,19
27001,Square Victor Basch,OUI,18,5,13,11,2,OUI,OUI,2025-03-13 19:00:00+00:00,"48.914304862261, 2.2289156913757",Colombes,92025,0.7222222222222222,19
24005,Edith Cavell - Volta,OUI,32,32,0,0,0,OUI,OUI,2025-03-13 19:00:16+00:00,"48.901616564286975, 2.269354350864887",Courbevoie,92026,0.0,19
17021,Jouffroy d'Abbans - Villiers,OUI,31,27,4,1,3,OUI,OUI,2025-03-13 18:54:10+00:00,"48.884215547037, 2.3056533560157",Paris,75056,0.12903225806451613,19
31104,Mairie de Rosny-sous-Bois,OUI,26,12,14,8,6,OUI,OUI,2025-03-13 19:00:42+00:00,"48.871256519012, 2.4865807592869",Rosny-sous-Bois,93064,0.5384615384615384,19
31020,Résistance - Parmentier,OUI,33,28,5,0,5,OUI,OUI,2025-03-13 19:01:52+00:00,"48.85965138131299, 2.436705082654953",Montreuil,93048,0.15151515151515152,19
42024,Danielle Casanova - Ledru-Rollin,OUI,28,0,28,27,1,OUI,OUI,2025-03-13 18:58:31+00:00,"48.815783497876815, 2.383259721100331",Ivry-sur-Seine,94041,1.0,19
28005,Jean Jaurès - Paul Lafargue,OUI,26,18,8,1,7,OUI,OUI,2025-03-13 19:01:17+00:00,"48.884933177666, 2.2484488785267",Puteaux,92062,0.3076923076923077,19
15203,Porte de Versailles,OUI,27,22,5,2,3,OUI,OUI,2025-03-13 19:02:16+00:00,"48.832324016657, 2.2875617349045",Paris,75056,0.18518518518518517,19
18112,Arthur Ranc - Hôpital Bichat,OUI,24,23,1,0,1,OUI,OUI,2025-03-13 18:58:59+00:00,"48.8978712500682, 2.333521842956543",Paris,75056,0.041666666666666664,19
11111,Léon Frot - Charonne,OUI,18,0,18,15,3,OUI,OUI,2025-03-13 18:56:34+00:00,"48.854963800335234, 2.387217085372007",Paris,75056,1.0,19
16139,Suresnes - Muette à Neuilly,OUI,29,25,4,2,2,OUI,OUI,2025-03-13 19:00:03+00:00,"48.868570404348, 2.266000919044",Paris,75056,0.13793103448275862,19
48006,Maxime Gorki - Paul Vaillant-Couturier,OUI,19,17,2,0,2,OUI,OUI,2025-03-13 18:54:37+00:00,"48.79673508795443, 2.3683342337608337",Villejuif,94076,0.10526315789473684,19
6007,Bréa - Raspail,OUI,24,20,4,3,1,OUI,OUI,2025-03-13 19:02:24+00:00,"48.842738478258, 2.3297942217634",Paris,75056,0.16666666666666666,19
18016,Francoeur - Caulaincourt,OUI,33,19,14,2,12,OUI,OUI,2025-03-13 19:02:09+00:00,"48.8899944409612, 2.342529706656933",Paris,75056,0.42424242424242425,19
42028,Verdun - Carnot,OUI,28,21,7,0,7,OUI,OUI,2025-03-13 19:02:02+00:00,"48.808439376064946, 2.373795211315155",Ivry-sur-Seine,94041,0.25,19
15053,Lecourbe - Convention,OUI,44,25,19,14,5,OUI,OUI,2025-03-13 19:01:14+00:00,"48.83923319241899, 2.2915197908878326",Paris,75056,0.4318181818181818,19
12166,Parc Floral du Bel Air,OUI,22,17,5,3,2,OUI,OUI,2025-03-13 18:59:24+00:00,"48.839285711865735, 2.438560165464878",Paris,75056,0.22727272727272727,19
21022,Dôme - République,OUI,24,16,8,5,3,OUI,OUI,2025-03-13 18:56:18+00:00,"48.832681, 2.250257",Boulogne-Billancourt,92012,0.3333333333333333,19
22603,Place de la Division Leclerc,OUI,33,31,2,1,1,OUI,OUI,2025-03-13 19:01:48+00:00,"48.793824988636516, 2.2731140430551027",Fontenay-aux-Roses,92032,0.06060606060606061,19
15041,Franquet - Labrouste,OUI,37,34,3,2,1,OUI,OUI,2025-03-13 19:00:22+00:00,"48.83287705011431, 2.306762784719467",Paris,75056,0.08108108108108109,19
12113,Cardinal Lavigerie,OUI,46,8,38,32,6,OUI,OUI,2025-03-13 19:02:28+00:00,"48.832934193699835, 2.402636749399156",Paris,75056,0.8260869565217391,19
13028,Gouthière - Poterne des Peupliers,OUI,31,23,8,4,4,OUI,OUI,2025-03-13 19:01:12+00:00,"48.820507, 2.351342",Paris,75056,0.25806451612903225,19
32020,Jules Guesdes - Carnot,OUI,14,11,3,1,2,OUI,OUI,2025-03-13 18:58:44+00:00,"48.93828169931872, 2.3508992046117783",Saint-Denis,93066,0.21428571428571427,19
15069,Félix Faure - Convention,OUI,44,12,32,28,4,OUI,OUI,2025-03-13 19:02:14+00:00,"48.841249336041, 2.2883866008495",Paris,75056,0.7272727272727273,19
1015,Place André Malraux,OUI,15,2,13,11,2,OUI,OUI,2025-03-13 19:01:43+00:00,"48.863925158727, 2.3356226831675",Paris,75056,0.8666666666666667,19
20012,Buzenval - Vignoles,OUI,17,7,10,4,6,OUI,OUI,2025-03-13 19:01:04+00:00,"48.853858171688, 2.4000040814281",Paris,75056,0.5882352941176471,19
9019,Victor Massé - Jean-Baptiste Pigalle,OUI,17,7,10,4,6,OUI,OUI,2025-03-13 19:01:53+00:00,"48.8811043724, 2.3366955667734",Paris,75056,0.5882352941176471,19
14004,Port Royal - Hôpital Cochin,OUI,20,18,2,0,2,OUI,OUI,2025-03-13 19:02:24+00:00,"48.838608030238, 2.3406994164846",Paris,75056,0.1,19
44004,Place de l'Eglise - Vitry-sur-Seine,OUI,28,1,27,25,2,OUI,OUI,2025-03-13 18:58:59+00:00,"48.791922819921815, 2.395057752728462",Vitry-sur-Seine,94081,0.9642857142857143,19
42303,Place Eustache Deschamps,OUI,20,4,16,7,9,OUI,OUI,2025-03-13 19:01:06+00:00,"48.793855, 2.336637",Cachan,94016,0.8,19
1024,Coquillière - Louvre,OUI,18,8,10,9,1,OUI,OUI,2025-03-13 19:02:27+00:00,"48.863795909662, 2.3425736278296",Paris,75056,0.5555555555555556,19
30003,Moscou - Edouard Vaillant,OUI,29,21,8,5,3,OUI,OUI,2025-03-13 19:00:57+00:00,"48.90755810177, 2.4689837335263",Bobigny,93008,0.27586206896551724,19
2102,Saint-Marc - Feydeau,OUI,34,26,8,7,1,OUI,OUI,2025-03-13 19:01:30+00:00,"48.870326843044, 2.3418715826353",Paris,75056,0.23529411764705882,19
35013,Guillaume Tell - Parc Henri Barbusse,OUI,19,14,5,0,5,OUI,OUI,2025-03-13 19:01:34+00:00,"48.88958925894009, 2.4198862910270695",Pantin,93055,0.2631578947368421,19
2020,Danielle Casanova - Opéra,OUI,20,6,14,12,2,OUI,OUI,2025-03-13 19:02:30+00:00,"48.867643242297, 2.3333894088864",Paris,75056,0.7,19
20020,Pyrénées - Charles Renouvier,OUI,29,27,2,1,1,OUI,OUI,2025-03-13 19:01:59+00:00,"48.86095933229224, 2.400421852042113",Paris,75056,0.06896551724137931,19
6029,Vaugirard - Monsieur le Prince,OUI,24,23,1,1,0,OUI,OUI,2025-03-13 18:59:13+00:00,"48.848951441614, 2.3411329463124",Paris,75056,0.041666666666666664,19
13120,Pierre Joseph Desault,OUI,18,7,11,9,2,OUI,OUI,2025-03-13 19:00:59+00:00,"48.82110230800372, 2.378775402903557",Paris,75056,0.6111111111111112,19
12016,Saint-Mande - Picpus,OUI,32,21,11,6,5,OUI,OUI,2025-03-13 19:02:34+00:00,"48.845127728278, 2.4015686296482",Paris,75056,0.34375,19
43007,Hôtel de Ville de Vincennes,OUI,26,25,1,1,0,OUI,OUI,2025-03-13 19:02:39+00:00,"48.84827609706963, 2.4398955702781677",Vincennes,94080,0.038461538461538464,19
23104,Quai de Sèvres - Manufacture Nationale,OUI,27,18,9,5,4,OUI,OUI,2025-03-13 18:49:52+00:00,"48.828688, 2.22499",Sèvres,92072,0.3333333333333333,19
15050,Dominique Pado - Croix Nivert,OUI,21,6,15,12,3,OUI,OUI,2025-03-13 19:00:06+00:00,"48.83648798164934, 2.2897250577807426",Paris,75056,0.7142857142857143,19
21011,Silly - Louis Blériot,OUI,23,17,6,4,2,OUI,OUI,2025-03-13 19:01:05+00:00,"48.83219045374266, 2.2340199351310734",Boulogne-Billancourt,92012,0.2608695652173913,19
13036,Olympiades,OUI,36,30,6,3,3,OUI,OUI,2025-03-13 19:02:36+00:00,"48.826764665199, 2.3650860786438",Paris,75056,0.16666666666666666,19
48012,Stalingrad - Henri Luisette,OUI,25,24,1,0,1,OUI,OUI,2025-03-13 18:55:41+00:00,"48.78363092456589, 2.366935946761926",Villejuif,94076,0.04,19
43004,Montreuil - République,OUI,22,22,0,0,0,OUI,OUI,2025-03-13 18:54:53+00:00,"48.85026349463687, 2.4345204234123234",Vincennes,94080,0.0,19
23303,Gare de Robinson,OUI,29,25,4,2,2,OUI,OUI,2025-03-13 19:02:06+00:00,"48.7799259211605, 2.281828634440899",Sceaux,92071,0.13793103448275862,19
14009,Tombe Issoire - René Coty,OUI,35,30,5,2,3,OUI,OUI,2025-03-13 19:00:29+00:00,"48.830512876709, 2.3343613743782",Paris,75056,0.14285714285714285,19
20010,Sorbier - Gasnier-Guy,OUI,34,32,2,0,2,OUI,OUI,2025-03-13 19:02:27+00:00,"48.865217631011, 2.3936596512794",Paris,75056,0.058823529411764705,19
17117,Pereire - Saussure,OUI,30,26,4,4,0,OUI,OUI,2025-03-13 19:01:41+00:00,"48.888229075478, 2.3101296275854",Paris,75056,0.13333333333333333,19
42022,Gare RER - Maurice Grandcoing,OUI,37,4,33,29,4,OUI,OUI,2025-03-13 19:01:14+00:00,"48.813881, 2.392429",Ivry-sur-Seine,94041,0.8918918918918919,19
18021,Marcadet - Ramey,OUI,20,9,11,3,8,OUI,OUI,2025-03-13 19:02:26+00:00,"48.890875, 2.3449019",Paris,75056,0.55,19
15018,Dutot - Place Alleray,OUI,54,50,4,1,3,OUI,OUI,2025-03-13 19:02:26+00:00,"48.836826091766, 2.3071701095578",Paris,75056,0.07407407407407407,19
16116,George Sand - Jean de La Fontaine,OUI,28,9,19,12,7,OUI,OUI,2025-03-13 19:02:09+00:00,"48.84986918764119, 2.268257387525699",Paris,75056,0.6785714285714286,19
26012,Jardin Modèle - Pierre Boudou,OUI,14,8,6,2,4,OUI,OUI,2025-03-13 19:00:28+00:00,"48.914866710946, 2.3057010525935",Asnières-sur-Seine,92004,0.42857142857142855,19
20013,Alexandre Dumas - Place de la Réunion,OUI,45,27,18,2,16,OUI,OUI,2025-03-13 19:02:34+00:00,"48.85533710742046, 2.3997703687646292",Paris,75056,0.4,19
45004,République - Louis Loucheur,OUI,37,4,33,4,29,OUI,OUI,2025-03-13 19:02:13+00:00,"48.823549261189, 2.5101865455508",Champigny-sur-Marne,94017,0.8918918918918919,19
5033,Saint-Séverin - Saint-Michel,OUI,30,12,18,15,3,OUI,OUI,2025-03-13 18:57:08+00:00,"48.852731305488, 2.3440927639604",Paris,75056,0.6,19
32605,Mairie,OUI,20,17,3,0,3,OUI,OUI,2025-03-13 18:59:57+00:00,"48.87914304162, 2.4163350908311",Les Lilas,93045,0.15,19
25004,Marcel Pourtout - Édouard Manet,OUI,24,5,19,19,0,OUI,OUI,2025-03-13 19:00:21+00:00,"48.87555620763429, 2.1655967831611638",Rueil-Malmaison,92063,0.7916666666666666,19
17202,Mariotte - Batignolles,OUI,17,14,3,1,2,OUI,OUI,2025-03-13 19:00:17+00:00,"48.884571659595, 2.321469503475",Paris,75056,0.17647058823529413,19
21023,Ancienne Mairie - André Morizet,OUI,24,13,11,9,2,OUI,OUI,2025-03-13 18:59:54+00:00,"48.838311, 2.234077",Boulogne-Billancourt,92012,0.4583333333333333,19
8202,Londres - Europe,OUI,27,26,1,0,1,OUI,OUI,2025-03-13 19:01:47+00:00,"48.878618556803, 2.3248164693922",Paris,75056,0.037037037037037035,19
31105,Lavoisier - Missak Manouchian,OUI,15,4,11,2,9,OUI,OUI,2025-03-13 19:00:52+00:00,"48.86286468896063, 2.495676465332508",Rosny-sous-Bois,93064,0.7333333333333333,19
32011,Stade de France - Francis de Pressensé,OUI,43,40,3,1,2,OUI,OUI,2025-03-13 19:00:28+00:00,"48.919141953558, 2.3620655760169",Saint-Denis,93066,0.06976744186046512,19
42205,Place Aristide Briand,OUI,35,7,28,17,11,OUI,OUI,2025-03-13 18:59:59+00:00,"48.82189236575831, 2.413003742694855",Charenton-le-Pont,94018,0.8,19
17020,Jouffroy d'Abbans - Malesherbes,OUI,26,20,6,6,0,OUI,OUI,2025-03-13 19:00:40+00:00,"48.8850134, 2.3070717",Paris,75056,0.23076923076923078,19
22701,Général Leclerc - République,OUI,28,1,27,20,7,OUI,OUI,2025-03-13 19:00:47+00:00,"48.915885074177, 2.2682306702811",Bois-Colombes,92009,0.9642857142857143,19
10202,Bichat - Grange aux Belles,OUI,29,29,0,0,0,OUI,OUI,2025-03-13 18:59:01+00:00,"48.873688, 2.365015",Paris,75056,0.0,19
22404,Pierre Brossolette - 12 Février 1934,OUI,24,23,1,0,1,OUI,OUI,2025-03-13 18:59:59+00:00,"48.8176962416867, 2.3076123744249344",Malakoff,92046,0.041666666666666664,19
42030,Stéphanie Bouvard - Gambetta,OUI,29,7,22,13,9,OUI,OUI,2025-03-13 19:00:59+00:00,"48.814548138856, 2.4024386957288",Ivry-sur-Seine,94041,0.7586206896551724,19
30004,Jean Jaurès - Place de la Libération,OUI,28,3,25,9,16,OUI,OUI,2025-03-13 18:59:51+00:00,"48.90617751921, 2.4391458057475",Bobigny,93008,0.8928571428571429,19
8018,Saint-Augustin,OUI,30,28,2,1,1,OUI,OUI,2025-03-13 19:00:06+00:00,"48.8762009747008, 2.319786250591278",Paris,75056,0.06666666666666667,19
8007,Rome - Provence,OUI,27,11,16,14,2,OUI,OUI,2025-03-13 19:01:44+00:00,"48.874230055580306, 2.325570111724113",Paris,75056,0.5925925925925926,19
21218,Gabriel Péri - Place de la Libération,OUI,17,15,2,1,1,OUI,OUI,2025-03-13 18:58:00+00:00,"48.819828421929, 2.3117361743705",Montrouge,92049,0.11764705882352941,19
48001,Chastenet de Géry - Marcel Paul,OUI,25,21,4,1,3,OUI,OUI,2025-03-13 18:57:15+00:00,"48.800123, 2.3567359",Villejuif,94076,0.16,19
17006,Guy Môquet - Compoint,OUI,33,22,11,6,5,OUI,OUI,2025-03-13 19:02:24+00:00,"48.89213559044868, 2.32321947813034",Paris,75056,0.3333333333333333,19
18135,Ney - Porte de Montmartre,OUI,23,19,4,0,4,OUI,OUI,2025-03-13 18:53:30+00:00,"48.897918, 2.3364872",Paris,75056,0.17391304347826086,19
18101,Championnet.,OUI,20,11,9,3,6,OUI,OUI,2025-03-13 18:55:09+00:00,"48.8953643, 2.3498166",Paris,75056,0.45,19
24101,Place Charles de Gaulle,OUI,23,16,7,0,7,OUI,OUI,2025-03-13 19:02:33+00:00,"48.826073335699, 2.1894485725692",Ville-d'Avray,92077,0.30434782608695654,19
6028,Quatre Vents - Carrefour de l'Odéon,OUI,35,3,32,25,7,OUI,OUI,2025-03-13 19:00:10+00:00,"48.851751374458864, 2.338161695134053",Paris,75056,0.9142857142857143,19
21329,Gare - Aristide Briand,OUI,28,0,28,20,8,OUI,OUI,2025-03-13 19:02:00+00:00,"48.821410564722, 2.2555950104387",Issy-les-Moulineaux,92040,1.0,19
21207,Verdier - République,OUI,29,28,1,1,0,OUI,OUI,2025-03-13 18:52:38+00:00,"48.815403766277, 2.31739372015",Montrouge,92049,0.034482758620689655,19
13015,Chevaleret - Louise Weiss,OUI,35,5,30,28,2,OUI,OUI,2025-03-13 19:02:21+00:00,"48.832586513351, 2.37121138812",Paris,75056,0.8571428571428571,19
15120,Colonel Pierre Avia,OUI,28,10,18,13,5,OUI,OUI,2025-03-13 19:02:01+00:00,"48.8296843300915, 2.275342586850291",Paris,75056,0.6428571428571429,19
25007,Bons Raisins - Voltaire,OUI,24,22,2,0,2,OUI,OUI,2025-03-13 18:54:17+00:00,"48.87282451461399, 2.1947155570850896",Rueil-Malmaison,92063,0.08333333333333333,19
24007,Jean-Baptiste Charcot - Sainte-Geneviève,OUI,21,19,2,2,0,OUI,OUI,2025-03-13 18:55:02+00:00,"48.90310883721567, 2.278892956674099",Courbevoie,92026,0.09523809523809523,19
19114,Manin - Secrétan,OUI,19,19,0,0,0,OUI,OUI,2025-03-13 18:57:04+00:00,"48.8791665, 2.3787959",Paris,75056,0.0,19
6004,Regard - Rennes,OUI,46,40,6,3,3,OUI,OUI,2025-03-13 19:01:53+00:00,"48.847385404956, 2.3268555477262",Paris,75056,0.13043478260869565,19
23041,Général Leclerc - Bièvre,OUI,24,19,5,3,2,OUI,OUI,2025-03-13 19:02:28+00:00,"48.782414428747316, 2.3166695237159733",Bourg-la-Reine,92014,0.20833333333333334,19
11028,Guillaume Bertrand - République,OUI,37,27,10,2,8,OUI,OUI,2025-03-13 18:57:52+00:00,"48.863825174341, 2.380906377155",Paris,75056,0.2702702702702703,19
5027,Gobelins - Port-Royal,OUI,35,3,32,30,2,OUI,OUI,2025-03-13 19:01:46+00:00,"48.837135900263, 2.3515201359987",Paris,75056,0.9142857142857143,19
13055,M.- A. Lagroua Weill-Hallé -  F. Dolto,OUI,59,50,9,9,0,OUI,OUI,2025-03-13 19:02:34+00:00,"48.828595283857425, 2.380220606266108",Paris,75056,0.15254237288135594,19
13116,Place du Docteur Yersin,OUI,50,48,2,0,2,OUI,OUI,2025-03-13 18:54:20+00:00,"48.82010494991975, 2.3725583776831627",Paris,75056,0.04,19
15044,Dantzig - Lefebvre,OUI,33,30,3,1,2,OUI,OUI,2025-03-13 19:00:35+00:00,"48.83013921586756, 2.295934036374092",Paris,75056,0.09090909090909091,19
15012,Cambronne - Mademoiselle,OUI,67,32,35,31,4,OUI,OUI,2025-03-13 19:02:15+00:00,"48.843277330035214, 2.30230766886348",Paris,75056,0.5223880597014925,19
20011,Pyrénées - Dagorno,OUI,20,13,7,3,4,OUI,OUI,2025-03-13 18:58:25+00:00,"48.855425770695085, 2.4051643162965775",Paris,75056,0.35,19
19117,Euryale Dehaynin - Loire,OUI,30,18,12,2,10,OUI,OUI,2025-03-13 19:01:44+00:00,"48.886248917304805, 2.3774591088294987",Paris,75056,0.4,19
20003,Pyrénées - Cours de Vincennes,OUI,19,15,4,2,2,OUI,OUI,2025-03-13 18:59:54+00:00,"48.847796779935, 2.4061721563339",Paris,75056,0.21052631578947367,19
13023,Bobillot - Moulin des Prés,OUI,28,20,8,0,8,OUI,OUI,2025-03-13 19:02:30+00:00,"48.828657346203, 2.353020646317",Paris,75056,0.2857142857142857,19
10003,Hauteville - Bonne Nouvelle,OUI,17,4,13,13,0,OUI,OUI,2025-03-13 19:01:28+00:00,"48.87077436024, 2.3496496368327",Paris,75056,0.7647058823529411,19
20106,Mairie du 20ème,OUI,27,18,9,1,8,OUI,OUI,2025-03-13 18:59:49+00:00,"48.865302324275, 2.3990669846535",Paris,75056,0.3333333333333333,19
11022,Roquette - Auguste Laurent,OUI,16,0,16,13,3,OUI,OUI,2025-03-13 18:57:42+00:00,"48.858001906023354, 2.381797702650783",Paris,75056,1.0,19
6020,Place Saint-André des Arts,OUI,32,6,26,20,6,OUI,OUI,2025-03-13 19:02:37+00:00,"48.852886173881, 2.3426544293761",Paris,75056,0.8125,19
41103,Place de la vache noire,OUI,23,22,1,0,1,OUI,OUI,2025-03-13 18:54:07+00:00,"48.81040517059777, 2.327060401439667",Arcueil,94003,0.043478260869565216,19
21007,Rond-Point Rhin et Danube,OUI,52,43,9,8,1,OUI,OUI,2025-03-13 19:01:20+00:00,"48.840452820991764, 2.2280225157737736",Boulogne-Billancourt,92012,0.17307692307692307,19
41602,Place Charles Digeon,OUI,31,26,5,1,4,OUI,OUI,2025-03-13 19:02:24+00:00,"48.84354203133597, 2.418427169322968",Saint-Mandé,94067,0.16129032258064516,19
11018,Saint-Maur - République,OUI,35,17,18,5,13,OUI,OUI,2025-03-13 19:01:13+00:00,"48.864185861455, 2.3783174157143",Paris,75056,0.5142857142857142,19
14027,Gergovie - Alésia,OUI,54,52,2,1,1,OUI,OUI,2025-03-13 19:00:01+00:00,"48.83088717455243, 2.318882101207347",Paris,75056,0.037037037037037035,19
19123,Metz - Marne,OUI,28,1,27,5,22,OUI,OUI,2025-03-13 19:02:19+00:00,"48.891163, 2.3865705",Paris,75056,0.9642857142857143,19
48002,LCL Campus - Place Oscar Niemeyer,OUI,37,31,6,3,3,OUI,OUI,2025-03-13 18:59:51+00:00,"48.805342480621576, 2.363983690738678",Villejuif,94076,0.16216216216216217,19
21107,Bertrand Sincholle - Henri Barbusse,OUI,16,10,6,6,0,OUI,OUI,2025-03-13 19:01:50+00:00,"48.89925982394349, 2.3042294383049016",Clichy,92024,0.375,19
41605,Général De Gaulle - Vivien,OUI,21,19,2,0,2,OUI,OUI,2025-03-13 19:00:26+00:00,"48.83607420090204, 2.4189166724681854",Saint-Mandé,94067,0.09523809523809523,19
12017,Saint-Mandé - Docteur Arnold Netter,OUI,35,26,9,3,6,OUI,OUI,2025-03-13 18:59:15+00:00,"48.84462585769668, 2.404946386814118",Paris,75056,0.2571428571428571,19
12008,Hector Malot - Daumesnil,OUI,52,0,52,48,4,OUI,OUI,2025-03-13 19:02:18+00:00,"48.84693552991762, 2.3770876228809357",Paris,75056,1.0,19
14025,Jacquier - Didot,OUI,30,25,5,1,4,OUI,OUI,2025-03-13 18:56:01+00:00,"48.82953336292279, 2.318179272115231",Paris,75056,0.16666666666666666,19
12102,Bercy - Traversiére,OUI,29,1,28,23,5,OUI,OUI,2025-03-13 19:00:27+00:00,"48.846192642574, 2.3703800886869",Paris,75056,0.9655172413793104,19
6009,Guynemer - Jardin du Luxembourg,OUI,32,30,2,0,2,OUI,OUI,2025-03-13 19:02:02+00:00,"48.8466127, 2.3325478",Paris,75056,0.0625,19
15024,Suffren - La Motte-Piquet,OUI,21,7,14,14,0,OUI,OUI,2025-03-13 19:02:29+00:00,"48.850881230919, 2.3012199997902",Paris,75056,0.6666666666666666,19
30005,Convention - Campus de Bobigny,OUI,29,26,3,1,2,OUI,OUI,2025-03-13 18:57:44+00:00,"48.914920058264, 2.4172238067445",Bobigny,93008,0.10344827586206896,19
12119,Dom-Pérignon - Gravelle,OUI,46,28,18,9,9,OUI,OUI,2025-03-13 19:02:27+00:00,"48.825481574435, 2.409880310297",Paris,75056,0.391304347826087,19
8044,Alfred de Vigny - Place du Général Brocard,OUI,32,26,6,1,5,OUI,OUI,2025-03-13 19:02:33+00:00,"48.87836138361425, 2.305254448220567",Paris,75056,0.1875,19
13006,Duméril - Jeanne d'Arc,OUI,40,28,12,9,3,OUI,OUI,2025-03-13 19:01:05+00:00,"48.838151608087, 2.3571084495564",Paris,75056,0.3,19
1201,Perrault - Place du Louvre,OUI,28,5,23,20,3,OUI,OUI,2025-03-13 18:59:18+00:00,"48.860273568996, 2.3412468419093",Paris,75056,0.8214285714285714,19
16025,Jean de la Fontaine - Boulainvilliers,OUI,65,14,51,42,9,OUI,OUI,2025-03-13 19:02:29+00:00,"48.85264791461651, 2.2758664190769196",Paris,75056,0.7846153846153846,19
21510,Fontaine du Tertre - Calvaire,OUI,23,22,1,0,1,OUI,OUI,2025-03-13 18:57:32+00:00,"48.8702539, 2.2187778",Suresnes,92073,0.043478260869565216,19
16017,Siam - La Pompe,OUI,16,15,1,0,1,OUI,OUI,2025-03-13 18:59:09+00:00,"48.861720329027264, 2.275346568555312",Paris,75056,0.0625,19
51007,Résistance - Romain Rolland,OUI,28,19,9,0,9,OUI,OUI,2025-03-13 19:01:59+00:00,"48.950873482371, 2.2310190077797",Argenteuil,95018,0.32142857142857145,19
15045,Porte de la Plaine,OUI,35,29,6,1,5,OUI,OUI,2025-03-13 19:01:25+00:00,"48.82805169605981, 2.2924277186393742",Paris,75056,0.17142857142857143,19
21511,Marcel Monge - Marcel Dassault,OUI,46,18,28,27,1,OUI,OUI,2025-03-13 19:02:14+00:00,"48.86096384533371, 2.2246733296048142",Suresnes,92073,0.6086956521739131,19
12022,Sahel - Général Michel Bizot,OUI,29,22,7,5,2,OUI,OUI,2025-03-13 19:01:54+00:00,"48.840872964793355, 2.4044444784522057",Paris,75056,0.2413793103448276,19
22703,Place Jean Mermoz,OUI,29,5,24,7,17,OUI,OUI,2025-03-13 19:02:10+00:00,"48.9220937, 2.2718348",Bois-Colombes,92009,0.8275862068965517,19
15027,Duhamel - André Gide,OUI,20,17,3,0,3,OUI,OUI,2025-03-13 18:59:34+00:00,"48.8365662244334, 2.312707121097412",Paris,75056,0.15,19
24010,Charles de Gaulle - Rue de l'Alma,OUI,26,17,9,4,5,OUI,OUI,2025-03-13 18:57:26+00:00,"48.896620592993, 2.252313240191",Courbevoie,92026,0.34615384615384615,19
17110,Legendre - Nollet,OUI,29,28,1,0,1,OUI,OUI,2025-03-13 19:00:49+00:00,"48.887742186754224, 2.320293079881375",Paris,75056,0.034482758620689655,19
41101,Paul Doumer - Stalingrad,OUI,24,16,8,8,0,OUI,OUI,2025-03-13 18:59:57+00:00,"48.806518992199, 2.3368880152702",Arcueil,94003,0.3333333333333333,19
31701,Mairie de Bagnolet,OUI,27,23,4,0,4,OUI,OUI,2025-03-13 19:01:01+00:00,"48.868421318555, 2.4179587885737",Bagnolet,93006,0.14814814814814814,19
20030,Ménilmontant - Père Lachaise,OUI,38,35,3,0,3,OUI,OUI,2025-03-13 18:59:52+00:00,"48.863287291502, 2.3869940266013",Paris,75056,0.07894736842105263,19
20032,Square des Amandiers,OUI,26,22,4,0,4,OUI,OUI,2025-03-13 18:57:44+00:00,"48.86615630668046, 2.3891324177384377",Paris,75056,0.15384615384615385,19
3201,Payenne - Square George Caïn,OUI,22,14,8,6,2,OUI,OUI,2025-03-13 19:00:27+00:00,"48.8578329, 2.3622643",Paris,75056,0.36363636363636365,19
20014,Charonne - Alexandre Dumas,OUI,34,19,15,7,8,OUI,OUI,2025-03-13 19:00:25+00:00,"48.856077415056, 2.3948693275452",Paris,75056,0.4411764705882353,19
20035,Pyrénées - Ménilmontant,OUI,25,20,5,0,5,OUI,OUI,2025-03-13 19:01:33+00:00,"48.8693268535238, 2.395084574818611",Paris,75056,0.2,19
14035,Maine - Jean Zay,OUI,46,29,17,7,10,OUI,OUI,2025-03-13 19:01:05+00:00,"48.837925263898, 2.3225428909063",Paris,75056,0.3695652173913043,19
23106,Pavé des Gardes - Charles Vaillant,OUI,20,20,0,0,0,OUI,OUI,2025-03-13 18:57:40+00:00,"48.81168551728, 2.2111820107205",Sèvres,92072,0.0,19
8046,Marceau - Président Wilson,OUI,30,22,8,4,4,OUI,OUI,2025-03-13 19:01:28+00:00,"48.8652359, 2.3002513",Paris,75056,0.26666666666666666,19
19045,Macdonald - Césaria Evora,OUI,65,61,4,3,1,OUI,OUI,2025-03-13 18:57:05+00:00,"48.89883, 2.37933",Paris,75056,0.06153846153846154,19
20110,Gambetta - Tourelles,OUI,20,20,0,0,0,OUI,OUI,2025-03-13 18:57:42+00:00,"48.875337902264, 2.4059921130538",Paris,75056,0.0,19
22302,Gare RER - Général de Gaulle,OUI,38,25,13,12,1,OUI,OUI,2025-03-13 18:59:18+00:00,"48.933548439566, 2.3064726536317",Gennevilliers,92036,0.34210526315789475,19
14005,René Coty - Place Denfert-Rochereau,OUI,35,25,10,3,7,OUI,OUI,2025-03-13 19:02:35+00:00,"48.833056477316, 2.3329411447048",Paris,75056,0.2857142857142857,19
9029,Saint-Lazare - Place d'Estienne d'Orves,OUI,37,28,9,8,1,OUI,OUI,2025-03-13 19:01:42+00:00,"48.8768345, 2.3329067",Paris,75056,0.24324324324324326,19
20005,Reynaldo Hahn - Lagny,OUI,19,17,2,0,2,OUI,OUI,2025-03-13 18:59:15+00:00,"48.849266043601794, 2.412330328844772",Paris,75056,0.10526315789473684,19
41304,Port - Maurice Chevalier,OUI,30,2,28,24,4,OUI,OUI,2025-03-13 18:59:14+00:00,"48.832474421632, 2.490257616467",Nogent-sur-Marne,94052,0.9333333333333333,19
11016,Philippe-Auguste,OUI,47,43,4,0,4,OUI,OUI,2025-03-13 19:01:37+00:00,"48.851853488265, 2.3932945355773",Paris,75056,0.0851063829787234,19
7007,Musée d'Orsay,OUI,61,21,40,35,5,OUI,OUI,2025-03-13 19:01:19+00:00,"48.859726157909, 2.3258604481816",Paris,75056,0.6557377049180327,19
12122,Bois de Vincennes - Polygone,OUI,51,42,9,2,7,OUI,OUI,2025-03-13 19:02:10+00:00,"48.83544491617421, 2.431421081436563",Paris,75056,0.17647058823529413,19
8031,Jean Mermoz - Champs-Elysées,OUI,44,31,13,9,4,OUI,OUI,2025-03-13 19:01:51+00:00,"48.869689856852, 2.3107324540615",Paris,75056,0.29545454545454547,19
16033,Marché d'Auteuil,OUI,31,21,10,10,0,OUI,OUI,2025-03-13 19:00:12+00:00,"48.84842761367387, 2.265253821160005",Paris,75056,0.3225806451612903,19
26011,Ménil - Argenteuil,OUI,18,3,15,6,9,OUI,OUI,2025-03-13 19:01:37+00:00,"48.925901818305, 2.2741496502338",Asnières-sur-Seine,92004,0.8333333333333334,19
21205,Arthur Auger - Jean Jaurès,OUI,23,22,1,0,1,OUI,OUI,2025-03-13 18:55:30+00:00,"48.813736445585235, 2.3069277405738835",Montrouge,92049,0.043478260869565216,19
35021,Cartier Bresson - Denis Papin,OUI,30,23,7,0,7,OUI,OUI,2025-03-13 19:01:28+00:00,"48.902616, 2.397814",Pantin,93055,0.23333333333333334,19
16023,Passy - Place du Costa Rica,OUI,30,25,5,1,4,OUI,OUI,2025-03-13 19:02:11+00:00,"48.8584893, 2.2839655",Paris,75056,0.16666666666666666,19
14110,Abbé Carton - Plantes,OUI,25,23,2,0,2,OUI,OUI,2025-03-13 19:02:16+00:00,"48.827673823166, 2.3209181427956",Paris,75056,0.08,19
15114,Pasteur - Cotentin,OUI,10,8,2,0,2,OUI,OUI,2025-03-13 18:54:06+00:00,"48.8389284, 2.316356",Paris,75056,0.2,19
10025,Jemmapes - Ecluses Saint-Martin,OUI,14,7,7,3,4,OUI,OUI,2025-03-13 18:59:59+00:00,"48.87748519186726, 2.3660067468881607",Paris,75056,0.5,19
11029,Ménilmontant - Oberkampf,OUI,38,1,37,9,28,OUI,OUI,2025-03-13 18:53:48+00:00,"48.866617658681, 2.3830134404158",Paris,75056,0.9736842105263158,19
21954,Val-Fleury,OUI,23,16,7,1,6,OUI,OUI,2025-03-13 19:01:42+00:00,"48.807671407991, 2.2407217696309",Meudon,92048,0.30434782608695654,19
19014,Lorraine - Jean Jaurès,OUI,19,7,12,5,7,OUI,OUI,2025-03-13 19:02:12+00:00,"48.8863865, 2.3825772",Paris,75056,0.631578947368421,19
22507,Châteaudun - Place de la Liberté,OUI,25,14,11,2,9,OUI,OUI,2025-03-13 19:00:11+00:00,"48.90970830301211, 2.2454486480600626",La Garenne-Colombes,92035,0.44,19
15014,Volontaires - Vaugirard,OUI,33,12,21,10,11,OUI,OUI,2025-03-13 19:00:43+00:00,"48.84132050184004, 2.30808901725357",Paris,75056,0.6363636363636364,19
22602,Place Henri Dunant - Gare RER,OUI,31,28,3,0,3,OUI,OUI,2025-03-13 19:01:39+00:00,"48.788093281931, 2.2909234046643",Fontenay-aux-Roses,92032,0.0967741935483871,19
22014,Victor Hugo - Bineau,OUI,24,20,4,4,0,OUI,OUI,2025-03-13 18:56:44+00:00,"48.88758225888669, 2.2783890366554265",Neuilly-sur-Seine,92051,0.16666666666666666,19
12106,Gare de Lyon - Roland Barthes,OUI,67,14,53,47,6,OUI,OUI,2025-03-13 19:02:36+00:00,"48.84395729494058, 2.3790882155299187",Paris,75056,0.7910447761194029,19
21027,Fief - République,OUI,24,20,4,2,2,OUI,OUI,2025-03-13 18:57:36+00:00,"48.83170888166024, 2.255771979689598",Boulogne-Billancourt,92012,0.16666666666666666,19
23205,Parc des Pierrettes,OUI,22,19,3,0,3,OUI,OUI,2025-03-13 19:01:53+00:00,"48.7973062, 2.2909969",Châtillon,92020,0.13636363636363635,19
25002,Hôtel de Ville de Rueil-Malmaison,OUI,19,2,17,10,7,OUI,OUI,2025-03-13 19:02:17+00:00,"48.878194, 2.181724",Rueil-Malmaison,92063,0.8947368421052632,19
23201,Avenir,OUI,42,42,0,0,0,OUI,OUI,2025-03-13 19:00:19+00:00,"48.8103438, 2.3003776",Châtillon,92020,0.0,19
15113,Arsonval - Falguière,OUI,24,23,1,1,0,OUI,OUI,2025-03-13 19:00:45+00:00,"48.84040040365445, 2.313117867297474",Paris,75056,0.041666666666666664,19
25010,Maréchal Leclerc de Hauteclocque - Marché Buzenval,OUI,29,25,4,2,2,OUI,OUI,2025-03-13 18:57:45+00:00,"48.858446, 2.192077",Rueil-Malmaison,92063,0.13793103448275862,19
6005,Montparnasse -  Square Ozanam,OUI,49,42,7,0,7,OUI,OUI,2025-03-13 19:02:32+00:00,"48.843310567822, 2.3265242949128",Paris,75056,0.14285714285714285,19
11001,Richard Lenoir - Place de la Bastille,OUI,47,1,46,29,17,OUI,OUI,2025-03-13 19:02:39+00:00,"48.8538327, 2.3697222",Paris,75056,0.9787234042553191,19
16022,Jean Bologne - Passy,OUI,19,17,2,1,1,OUI,OUI,2025-03-13 19:01:39+00:00,"48.857566889784465, 2.280027395306772",Paris,75056,0.10526315789473684,19
9035,Gare Saint-Lazare - Place de Budapest,OUI,43,40,3,1,2,OUI,OUI,2025-03-13 18:57:02+00:00,"48.877753, 2.327339",Paris,75056,0.06976744186046512,19
19001,Crimée - Ourcq,OUI,56,51,5,1,4,OUI,OUI,2025-03-13 19:01:48+00:00,"48.894104140316, 2.3729460884673",Paris,75056,0.08928571428571429,19
17126,Hélène et François Missoffe - Emile Borel,OUI,28,15,13,9,4,OUI,OUI,2025-03-13 19:01:31+00:00,"48.89990653843488, 2.321543991674844",Paris,75056,0.4642857142857143,19
12040,Porte de Charenton,OUI,64,37,27,10,17,OUI,OUI,2025-03-13 19:02:16+00:00,"48.831240105856, 2.3989107459784",Paris,75056,0.421875,19
26008,Henri Barbusse - Bourguignons,OUI,33,16,17,3,14,OUI,OUI,2025-03-13 19:02:28+00:00,"48.91301722799713, 2.2734212270774417",Asnières-sur-Seine,92004,0.5151515151515151,19
19007,Flandre - Ourcq,OUI,28,16,12,3,9,OUI,OUI,2025-03-13 18:57:39+00:00,"48.89260159189023, 2.3790915682911873",Paris,75056,0.42857142857142855,19
26009,Marceau Delorme - Pierre Brossolette,OUI,26,12,14,6,8,OUI,OUI,2025-03-13 19:00:14+00:00,"48.91206062860357, 2.295897423568745",Asnières-sur-Seine,92004,0.5384615384615384,19
21016,Point du Jour - Jean Jaurès,OUI,39,11,28,24,4,OUI,OUI,2025-03-13 19:02:18+00:00,"48.828753141436465, 2.245911467014621",Boulogne-Billancourt,92012,0.717948717948718,19
23204,Roland Garros - Jean Bouin,OUI,28,25,3,2,1,OUI,OUI,2025-03-13 18:56:08+00:00,"48.809460857173, 2.2853198638301",Châtillon,92020,0.10714285714285714,19
5105,Geoffroy-Saint-Hilaire - Saint-Marcel,OUI,17,7,10,9,1,OUI,OUI,2025-03-13 19:02:05+00:00,"48.83907826424974, 2.356877340669728",Paris,75056,0.5882352941176471,19
21514,Place de la Paix - Abbé Saint-Pierre,OUI,24,20,4,1,3,OUI,OUI,2025-03-13 19:01:01+00:00,"48.86462724459225, 2.2047570338469806",Suresnes,92073,0.16666666666666666,19
22007,Commandant Charcot - Bretteville,OUI,30,4,26,16,10,OUI,OUI,2025-03-13 19:01:54+00:00,"48.87530570765423, 2.2558460757136345",Neuilly-sur-Seine,92051,0.8666666666666667,19
31303,Simone Signoret - Paris,OUI,27,16,11,4,7,OUI,OUI,2025-03-13 19:01:27+00:00,"48.903600624712865, 2.465406596265139",Noisy-le-Sec,93053,0.4074074074074074,19
12039,Général Michel Bizot - Claude Decaen,OUI,36,11,25,14,11,OUI,OUI,2025-03-13 19:02:26+00:00,"48.83481262982544, 2.400927788127704",Paris,75056,0.6944444444444444,19
10026,Gare de l'Est - Chateau Landon,OUI,55,44,11,6,5,OUI,OUI,2025-03-13 19:00:40+00:00,"48.879305, 2.362424",Paris,75056,0.2,19
13037,Ivry - Baudricourt,OUI,20,17,3,1,2,OUI,OUI,2025-03-13 19:00:45+00:00,"48.824695995415006, 2.363106073577468",Paris,75056,0.15,19
17010,Jonquière - Docteur Paul Brousse,OUI,37,10,27,21,6,OUI,OUI,2025-03-13 19:01:10+00:00,"48.894799816683985, 2.318705212173216",Paris,75056,0.7297297297297297,19
5031,Lacépède - Linné,OUI,50,47,3,1,2,OUI,OUI,2025-03-13 19:02:26+00:00,"48.8437035476636, 2.354651279747486",Paris,75056,0.06,19
18023,Ordener - Poissonniers,OUI,34,30,4,2,2,OUI,OUI,2025-03-13 19:01:13+00:00,"48.891213890844654, 2.351288666219873",Paris,75056,0.11764705882352941,19
42027,Verdun - Pierre et Marie Curie,OUI,26,24,2,0,2,OUI,OUI,2025-03-13 19:00:39+00:00,"48.812822398263286, 2.3707106709480286",Ivry-sur-Seine,94041,0.07692307692307693,19
18026,Ruisseau - Ordener,OUI,33,29,4,3,1,OUI,OUI,2025-03-13 18:59:11+00:00,"48.89299462568024, 2.340144887566567",Paris,75056,0.12121212121212122,19
16104,Paul Valery - Victor Hugo,OUI,32,30,2,0,2,OUI,OUI,2025-03-13 19:01:58+00:00,"48.87137406080164, 2.2887128591537476",Paris,75056,0.0625,19
18024,Clignancourt - Ordener,OUI,35,29,6,3,3,OUI,OUI,2025-03-13 19:00:58+00:00,"48.891457726153774, 2.348636478060487",Paris,75056,0.17142857142857143,19
20033,Etienne Dolet - Place Maurice Chevalier,OUI,45,32,13,9,4,OUI,OUI,2025-03-13 19:00:26+00:00,"48.86798303359366, 2.3851405311143026",Paris,75056,0.28888888888888886,19
19018,Cité de la Musique,OUI,61,2,59,16,43,OUI,OUI,2025-03-13 19:02:31+00:00,"48.888796556487, 2.3925811931922",Paris,75056,0.9672131147540983,19
8008,Joseph Sansboeuf - Saint Lazare,OUI,31,15,16,13,3,OUI,OUI,2025-03-13 18:59:45+00:00,"48.875315630653, 2.3229019716382",Paris,75056,0.5161290322580645,19
17050,Batignolles - Abel Truchet,OUI,25,18,7,4,3,OUI,OUI,2025-03-13 18:59:58+00:00,"48.883103904582, 2.3238347490884",Paris,75056,0.28,19
13205,Choisy - Pointe d'Ivry,OUI,24,18,6,3,3,OUI,OUI,2025-03-13 18:58:07+00:00,"48.822154170359, 2.3633708034878",Paris,75056,0.25,19
13013,Saint-Marcel - Hôpital,OUI,18,12,6,3,3,OUI,OUI,2025-03-13 19:02:14+00:00,"48.839504424583, 2.3609894170229",Paris,75056,0.3333333333333333,19
31202,Gabriel Péri - Jules Ferry,OUI,27,11,16,14,2,OUI,OUI,2025-03-13 19:02:11+00:00,"48.926182814311, 2.3912295762525",La Courneuve,93027,0.5925925925925926,19
17036,Place Tristan Bernard,OUI,28,25,3,2,1,OUI,OUI,2025-03-13 19:00:15+00:00,"48.8794936, 2.2915423",Paris,75056,0.10714285714285714,19
11040,Temple - Jean-Pierre Timbaud,OUI,30,0,30,29,1,OUI,OUI,2025-03-13 19:00:29+00:00,"48.86446597201, 2.3660597205162",Paris,75056,1.0,19
15062,Convention - Lourmel,OUI,32,9,23,21,2,OUI,OUI,2025-03-13 19:02:15+00:00,"48.842055041656, 2.2859910875559",Paris,75056,0.71875,19
13008,Place d'Italie - Soeur Rosalie,OUI,50,43,7,2,5,OUI,OUI,2025-03-13 18:59:47+00:00,"48.831908520394, 2.3546943448098",Paris,75056,0.14,19
10114,Granges aux Belles - Hôpital Saint-Louis,OUI,59,53,6,2,4,OUI,OUI,2025-03-13 18:54:42+00:00,"48.874794994841, 2.366669436985",Paris,75056,0.1016949152542373,19
11038,Temple - Charlot,OUI,42,0,42,39,3,OUI,OUI,2025-03-13 19:01:15+00:00,"48.865709343796, 2.3652737250724",Paris,75056,1.0,19
47007,Liberté - Vert-de-Maisons,OUI,20,1,19,15,4,OUI,OUI,2025-03-13 19:00:57+00:00,"48.790147809608, 2.4328628182411",Maisons-Alfort,94046,0.95,19
21033,Sèvres - Maréchal Juin,OUI,17,4,13,13,0,OUI,OUI,2025-03-13 19:01:35+00:00,"48.8324305, 2.2292812",Boulogne-Billancourt,92012,0.7647058823529411,19
13051,Halle Freyssinet - Parvis Alan Turing,OUI,23,21,2,0,2,OUI,OUI,2025-03-13 19:00:00+00:00,"48.832846814471, 2.3711421713233",Paris,75056,0.08695652173913043,19
21112,Claude Debussy - Marc Bloch,OUI,50,48,2,1,1,OUI,OUI,2025-03-13 19:02:35+00:00,"48.910388180512, 2.3117771744728",Clichy,92024,0.04,19
21501,Pont de Suresnes,OUI,16,1,15,10,5,OUI,OUI,2025-03-13 18:59:39+00:00,"48.867415092322, 2.2258946679617",Suresnes,92073,0.9375,19
8003,Galilée - Vernet,OUI,47,46,1,0,1,OUI,OUI,2025-03-13 19:02:36+00:00,"48.871715878697, 2.2985444962978",Paris,75056,0.02127659574468085,19
11014,Place de la Nation - Taillebourg,OUI,46,45,1,0,1,OUI,OUI,2025-03-13 19:02:18+00:00,"48.8488408, 2.3973043",Paris,75056,0.021739130434782608,19
25009,Place des Arts - Jean Mermoz,OUI,20,0,20,18,2,OUI,OUI,2025-03-13 19:01:03+00:00,"48.880391139734, 2.1832160452221",Rueil-Malmaison,92063,1.0,19
35002,Jean Jaurès - Presles,OUI,31,27,4,2,2,OUI,OUI,2025-03-13 18:57:36+00:00,"48.907134414988, 2.3960057280531",Pantin,93055,0.12903225806451613,19
26010,Louis Armand - Bernard Palissy,OUI,16,3,13,11,2,OUI,OUI,2025-03-13 18:59:43+00:00,"48.916974, 2.313384",Asnières-sur-Seine,92004,0.8125,19
8039,Colisée - Champs-Elysées,OUI,16,10,6,5,1,OUI,OUI,2025-03-13 19:00:34+00:00,"48.870475399387, 2.3076190799475",Paris,75056,0.375,19
16140,Hippodrome de Longchamp,OUI,24,5,19,17,2,OUI,OUI,2025-03-13 19:02:14+00:00,"48.86413226532, 2.239905372262",Paris,75056,0.7916666666666666,19
11102,Alexandre Dumas - Voltaire,OUI,59,46,13,8,5,OUI,OUI,2025-03-13 18:59:56+00:00,"48.852888670365, 2.3891476408096",Paris,75056,0.22033898305084745,19
21508,Georges Pompidou - Verdun,OUI,24,7,17,12,5,OUI,OUI,2025-03-13 19:02:39+00:00,"48.875481, 2.232443",Suresnes,92073,0.7083333333333334,19
16103,Traktir - Foch,OUI,19,18,1,0,1,OUI,OUI,2025-03-13 18:59:42+00:00,"48.872755334614, 2.2915497802487",Paris,75056,0.05263157894736842,19
15032,Félix Faure - Lourmel,OUI,53,26,27,24,3,OUI,OUI,2025-03-13 19:02:16+00:00,"48.83868901709515, 2.2818081825971603",Paris,75056,0.5094339622641509,19
21213,Vanne - Général de Gaulle,OUI,24,21,3,0,3,OUI,OUI,2025-03-13 18:59:24+00:00,"48.815007, 2.328318",Montrouge,92049,0.125,19
20037,Gambetta - Saint Fargeau,OUI,24,13,11,1,10,OUI,OUI,2025-03-13 19:02:28+00:00,"48.871244610447015, 2.4039056897163396",Paris,75056,0.4583333333333333,19
11009,Boulets - Voltaire,OUI,24,4,20,6,14,OUI,OUI,2025-03-13 19:01:11+00:00,"48.85218705621, 2.3890301585197",Paris,75056,0.8333333333333334,19
13053,Chevaleret - Tolbiac,OUI,21,10,11,10,1,OUI,OUI,2025-03-13 19:00:37+00:00,"48.82941, 2.375934",Paris,75056,0.5238095238095238,19
35001,Jean Jaurès - Ouvrières Pivéreuses,OUI,21,12,9,3,6,OUI,OUI,2025-03-13 19:02:19+00:00,"48.910423437526, 2.3995766043663",Pantin,93055,0.42857142857142855,19
48011,Epi d'Or - Chevilly,OUI,20,18,2,0,2,OUI,OUI,2025-03-13 18:57:23+00:00,"48.781109786782, 2.3549050362061",Villejuif,94076,0.1,19
15060,Place de la Montagne du Goulet,OUI,20,1,19,18,1,OUI,OUI,2025-03-13 19:01:57+00:00,"48.8443415, 2.2773844",Paris,75056,0.95,19
7111,Ecole Militaire - Place Joffre,OUI,25,5,20,18,2,OUI,OUI,2025-03-13 19:00:13+00:00,"48.852060203583, 2.3017993569374",Paris,75056,0.8,19
41212,Nungesser - Santé,OUI,22,20,2,1,1,OUI,OUI,2025-03-13 18:57:35+00:00,"48.852335, 2.448967",Fontenay-sous-Bois,94033,0.09090909090909091,19
18205,Mauroy - Cheminots,OUI,27,19,8,3,5,OUI,OUI,2025-03-13 19:01:50+00:00,"48.897715198403, 2.357895075822",Paris,75056,0.2962962962962963,19
34009,Dora Maar - Nadia Guendouz,OUI,27,23,4,2,2,OUI,OUI,2025-03-13 18:57:52+00:00,"48.905452421305, 2.3220406472683",Saint-Ouen-sur-Seine,93070,0.14814814814814814,19
9025,Taitbout - Châteaudun,OUI,53,27,26,25,1,OUI,OUI,2025-03-13 19:02:17+00:00,"48.876383969379, 2.3353566779335",Paris,75056,0.49056603773584906,19
10151,Gare du Nord - Faubourg Saint-Denis,OUI,28,22,6,1,5,OUI,OUI,2025-03-13 19:02:31+00:00,"48.879612765504, 2.3568402975798",Paris,75056,0.21428571428571427,19
4108,Quai de Béthune - Pont de la Tournelle,OUI,25,3,22,20,2,OUI,OUI,2025-03-13 19:02:40+00:00,"48.85097433194, 2.3563072085381",Paris,75056,0.88,19
22208,Stalingrad - Barbara,OUI,19,19,0,0,0,OUI,OUI,2025-03-13 18:56:06+00:00,"48.809223658808, 2.3175904558822",Bagneux,92007,0.0,19
40010,Haut du Mont-Mesly,OUI,21,19,2,1,1,OUI,OUI,2025-03-13 18:59:27+00:00,"48.780191921646, 2.4685737495183",Créteil,94028,0.09523809523809523,19
22209,Verdun - Henri Barbusse,OUI,23,21,2,0,2,OUI,OUI,2025-03-13 19:02:33+00:00,"48.802056061754, 2.3159965061736",Bagneux,92007,0.08695652173913043,19
12201,Dugommier,OUI,52,31,21,12,9,OUI,OUI,2025-03-13 19:00:41+00:00,"48.838811048815, 2.3896577954292",Paris,75056,0.40384615384615385,19
45005,Stalingrad - Général de Gaulle,OUI,26,11,15,4,11,OUI,OUI,2025-03-13 19:02:22+00:00,"48.823450589614, 2.4965062363218",Champigny-sur-Marne,94017,0.5769230769230769,19
12105,Bercy - Villot,OUI,33,23,10,5,5,OUI,OUI,2025-03-13 19:01:54+00:00,"48.841795009027, 2.3767850184816",Paris,75056,0.30303030303030304,19
18045,Pierre Ginier - Clichy,OUI,15,15,0,0,0,OUI,OUI,2025-03-13 19:02:16+00:00,"48.8867667, 2.326228",Paris,75056,0.0,19
26005,Hôtel de Ville d'Asnières sur Seine,OUI,25,3,22,8,14,OUI,OUI,2025-03-13 19:00:55+00:00,"48.90999330025577, 2.288238108158112",Asnières-sur-Seine,92004,0.88,19
18018,Carpeaux - Place Jacques Froment,OUI,19,14,5,0,5,OUI,OUI,2025-03-13 19:01:27+00:00,"48.8906542, 2.3309428",Paris,75056,0.2631578947368421,19
40003,Centre Hospitalier Intercommunal de Créteil,OUI,17,15,2,0,2,OUI,OUI,2025-03-13 18:53:13+00:00,"48.797078298909, 2.463801423807",Créteil,94028,0.11764705882352941,19
32305,Saint-Germain - Verdun,OUI,29,28,1,0,1,OUI,OUI,2025-03-13 18:58:53+00:00,"48.882877330093, 2.4331868384644",Romainville,93063,0.034482758620689655,19
40004,Créteil Village,OUI,25,3,22,7,15,OUI,OUI,2025-03-13 19:02:20+00:00,"48.79122395576, 2.4642198533952",Créteil,94028,0.88,19
22305,Jean Jaurès - Place du Dr Roux,OUI,34,24,10,5,5,OUI,OUI,2025-03-13 19:00:29+00:00,"48.927567032796, 2.2947337017374",Gennevilliers,92036,0.29411764705882354,19
23703,Gare de Chaville Rive Gauche,OUI,18,17,1,0,1,OUI,OUI,2025-03-13 18:59:19+00:00,"48.805160304345, 2.188277207315",Chaville,92022,0.05555555555555555,19
11201,Faubourg St-Antoine - Place de la Nation,OUI,16,8,8,4,4,OUI,OUI,2025-03-13 18:58:46+00:00,"48.8487726, 2.393606",Paris,75056,0.5,19
32023,Guy Môquet - Jean Moulin,OUI,25,12,13,8,5,OUI,OUI,2025-03-13 19:00:45+00:00,"48.940931521020836, 2.363948999931771",Saint-Denis,93066,0.52,19
40015,Iles de Loisirs de Créteil,OUI,24,3,21,12,9,OUI,OUI,2025-03-13 19:02:02+00:00,"48.780258200618, 2.4455094301232",Créteil,94028,0.875,19
12165,Champs de Manoeuvre - Cartoucherie,OUI,31,0,31,15,16,OUI,OUI,2025-03-13 18:58:38+00:00,"48.835261, 2.447974",Paris,75056,1.0,19
51005,Yves Farges - Route d'Enghien,OUI,33,15,18,6,12,OUI,OUI,2025-03-13 19:00:12+00:00,"48.95756799268, 2.2834496977978",Argenteuil,95018,0.5454545454545454,19
12001,Bastille - Biscornet,OUI,57,1,56,52,4,OUI,OUI,2025-03-13 19:02:38+00:00,"48.851355779579, 2.369220033288",Paris,75056,0.9824561403508771,19
22018,Charles de Gaulle - Les Sablons,OUI,35,32,3,0,3,OUI,OUI,2025-03-13 19:00:15+00:00,"48.880987514929, 2.2715748726513",Neuilly-sur-Seine,92051,0.08571428571428572,19
20137,Borrégo - Gambetta,OUI,25,25,0,0,0,OUI,OUI,2025-03-13 19:01:39+00:00,"48.87330497045532, 2.4014145880937576",Paris,75056,0.0,19
21320,Président Roosevelt - Rouget de Lisle,OUI,39,27,12,12,0,OUI,OUI,2025-03-13 18:59:32+00:00,"48.83047518749, 2.2616135525345",Issy-les-Moulineaux,92040,0.3076923076923077,19
1003,Saint-Denis - Rivoli,OUI,44,4,40,25,15,OUI,OUI,2025-03-13 19:00:04+00:00,"48.859059340842, 2.3476943001151",Paris,75056,0.9090909090909091,19
21327,Jean Bouin - Gouverneur Général Eboué,OUI,31,1,30,29,1,OUI,OUI,2025-03-13 19:02:07+00:00,"48.824792734266, 2.2651904328524",Issy-les-Moulineaux,92040,0.967741935483871,19
41301,Bois de Vincennes - Gare,OUI,49,46,3,2,1,OUI,OUI,2025-03-13 19:02:36+00:00,"48.836022242887, 2.470833995083",Nogent-sur-Marne,94052,0.061224489795918366,19
23203,Division Leclerc - Kléber,OUI,25,23,2,1,1,OUI,OUI,2025-03-13 19:02:40+00:00,"48.798666226364, 2.2833752789972",Châtillon,92020,0.08,19
18043,Clichy - Place Blanche,OUI,18,12,6,4,2,OUI,OUI,2025-03-13 19:01:50+00:00,"48.883601088297, 2.3332237824798",Paris,75056,0.3333333333333333,19
34005,Adrien Lesesne - Docteur Bauer,OUI,29,20,9,4,5,OUI,OUI,2025-03-13 19:02:22+00:00,"48.90263867304635, 2.348248063431511",Saint-Ouen-sur-Seine,93070,0.3103448275862069,19
19203,Pailleron - Bouret,OUI,27,24,3,1,2,OUI,OUI,2025-03-13 18:55:30+00:00,"48.880516995482, 2.3763902374411",Paris,75056,0.1111111111111111,19
17127,Porte de Clichy - Place des Nations Unies,OUI,34,19,15,12,3,OUI,OUI,2025-03-13 19:02:39+00:00,"48.896737263309504, 2.310542999196392",Paris,75056,0.4411764705882353,19
34014,Michelet - Dr Bauer,OUI,30,22,8,7,1,OUI,OUI,2025-03-13 19:02:40+00:00,"48.906125424194, 2.3440374449846",Saint-Ouen-sur-Seine,93070,0.26666666666666666,19
34008,Garibaldi - Gabriel Péri,OUI,28,15,13,4,9,OUI,OUI,2025-03-13 19:02:09+00:00,"48.905741911394, 2.3316044208059",Saint-Ouen-sur-Seine,93070,0.4642857142857143,19
27004,Gare de la Garenne-Colombes,OUI,26,18,8,4,4,OUI,OUI,2025-03-13 18:53:58+00:00,"48.909752, 2.239145",Colombes,92025,0.3076923076923077,19
34012,Bateliers - Quai de Seine,OUI,21,15,6,5,1,OUI,OUI,2025-03-13 19:00:12+00:00,"48.915817585516, 2.3239533298594",Saint-Ouen-sur-Seine,93070,0.2857142857142857,19
32012,Carrefour Pleyel,OUI,64,63,1,1,0,OUI,OUI,2025-03-13 19:00:43+00:00,"48.92034156960326, 2.3438543826341625",Saint-Denis,93066,0.015625,19
31301,Gare RER,OUI,28,24,4,1,3,OUI,OUI,2025-03-13 18:53:32+00:00,"48.896280181078, 2.4581568985227",Noisy-le-Sec,93053,0.14285714285714285,19
1002,Victoria - Place du Chatelet,OUI,19,2,17,12,5,OUI,OUI,2025-03-13 18:59:49+00:00,"48.857992591527, 2.3469167947769",Paris,75056,0.8947368421052632,19
5107,Pontoise - La Tournelle,OUI,21,1,20,16,4,OUI,OUI,2025-03-13 19:01:24+00:00,"48.850458009188, 2.3524542754922",Paris,75056,0.9523809523809523,19
17038,Grande Armée - Brunel,OUI,60,59,1,1,0,OUI,OUI,2025-03-13 19:02:03+00:00,"48.876116, 2.288124",Paris,75056,0.016666666666666666,19
16006,Lauriston - Copernic,OUI,18,17,1,0,1,OUI,OUI,2025-03-13 19:02:32+00:00,"48.86926, 2.289918",Paris,75056,0.05555555555555555,19
13123,BNF - Bibliothèque Nationale de France,OUI,42,13,29,27,2,OUI,OUI,2025-03-13 19:02:37+00:00,"48.8350268238, 2.3760157451034",Paris,75056,0.6904761904761905,19
7201,Place De Fontenoy - Saxe,OUI,18,15,3,1,2,OUI,OUI,2025-03-13 18:57:25+00:00,"48.850270554523, 2.3069813815839",Paris,75056,0.16666666666666666,19
12010,Daumesnil - Picpus,OUI,20,5,15,10,5,OUI,OUI,2025-03-13 19:01:04+00:00,"48.8374688, 2.401765",Paris,75056,0.75,19
31201,Suzanne Masson,OUI,33,3,30,15,15,OUI,OUI,2025-03-13 19:02:22+00:00,"48.923306888013, 2.3847292397611",La Courneuve,93027,0.9090909090909091,19
32001,Proudhon - Président Wilson,OUI,30,27,3,1,2,OUI,OUI,2025-03-13 19:02:27+00:00,"48.906442763495, 2.3584905266762",Saint-Denis,93066,0.1,19
15013,Volontaires - Lecourbe,OUI,30,5,25,13,12,OUI,OUI,2025-03-13 19:01:30+00:00,"48.84351378799, 2.3065522313118",Paris,75056,0.8333333333333334,19
40002,Bleuets - Bordières,OUI,21,15,6,3,3,OUI,OUI,2025-03-13 18:59:36+00:00,"48.802117531472, 2.4543687905029",Créteil,94028,0.2857142857142857,19
13204,Tolbiac - Boussingault,OUI,40,29,11,8,3,OUI,OUI,2025-03-13 19:02:35+00:00,"48.826177754027, 2.3420378552202",Paris,75056,0.275,19
33019,Madeleine Vionnet,OUI,28,23,5,3,2,OUI,OUI,2025-03-13 19:00:42+00:00,"48.902519074064, 2.3740895837545",Aubervilliers,93001,0.17857142857142858,19
13035,Choisy - Tolbiac,OUI,20,14,6,1,5,OUI,OUI,2025-03-13 19:01:10+00:00,"48.82591155587, 2.3602393269539",Paris,75056,0.3,19
8002,Gare Saint-Lazare - Cour du Havre,OUI,39,4,35,24,11,OUI,OUI,2025-03-13 19:02:08+00:00,"48.875674400851, 2.3265598341823",Paris,75056,0.8974358974358975,19
15056,Place Balard,OUI,22,14,8,5,3,OUI,OUI,2025-03-13 18:59:06+00:00,"48.836395736424, 2.2784192115068",Paris,75056,0.36363636363636365,19
18134,Ney - Porte de Clignancourt,OUI,24,22,2,0,2,OUI,OUI,2025-03-13 18:59:00+00:00,"48.8978867, 2.3458001",Paris,75056,0.08333333333333333,19
13203,Square de Choisy - Eastman,OUI,22,20,2,0,2,OUI,OUI,2025-03-13 19:00:11+00:00,"48.828543456283, 2.3583075090494",Paris,75056,0.09090909090909091,19
9104,Caumartin - Provence,OUI,21,17,4,2,2,OUI,OUI,2025-03-13 18:59:58+00:00,"48.874422773426545, 2.3284685611724854",Paris,75056,0.19047619047619047,19
13202,Place Farhat Hached,OUI,28,23,5,4,1,OUI,OUI,2025-03-13 18:58:54+00:00,"48.825487045602, 2.3816306985827",Paris,75056,0.17857142857142858,19
8038,François 1er - Montaigne,OUI,51,36,15,13,2,OUI,OUI,2025-03-13 19:00:12+00:00,"48.866887649978, 2.3066755757207",Paris,75056,0.29411764705882354,19
19204,Rampal - Belleville,OUI,19,14,5,1,4,OUI,OUI,2025-03-13 18:56:12+00:00,"48.873114661405, 2.3798409114805",Paris,75056,0.2631578947368421,19
5201,Saint-Jacques - Soufflot,OUI,16,15,1,0,1,OUI,OUI,2025-03-13 18:59:21+00:00,"48.846280383395, 2.3430785379567",Paris,75056,0.0625,19
18042,Place Pigalle,OUI,20,6,14,6,8,OUI,OUI,2025-03-13 19:02:03+00:00,"48.8827555, 2.3361566",Paris,75056,0.7,19
11037,Faubourg Du Temple - Republique,OUI,38,4,34,29,5,OUI,OUI,2025-03-13 19:02:26+00:00,"48.867872484749, 2.3648982158072",Paris,75056,0.8947368421052632,19
18041,Rochechouart - Martyrs,OUI,17,2,15,3,12,OUI,OUI,2025-03-13 19:01:36+00:00,"48.882193779572, 2.3405495658517",Paris,75056,0.8823529411764706,19
11020,Belfort - Voltaire,OUI,37,14,23,19,4,OUI,OUI,2025-03-13 19:01:40+00:00,"48.8563358, 2.3829901",Paris,75056,0.6216216216216216,19
18044,Clichy - Douai,OUI,32,27,5,2,3,OUI,OUI,2025-03-13 19:02:27+00:00,"48.883687771522, 2.328063700029",Paris,75056,0.15625,19
12157,Fabre d'Eglantine - Place de la Nation,OUI,66,63,3,0,3,OUI,OUI,2025-03-13 19:01:59+00:00,"48.8471116, 2.3956204",Paris,75056,0.045454545454545456,19
3004,Place de la République - Temple,OUI,15,3,12,7,5,OUI,OUI,2025-03-13 19:02:23+00:00,"48.867211201859, 2.3635464370545",Paris,75056,0.8,19
11046,Place de la République - Voltaire,OUI,16,0,16,11,5,OUI,OUI,2025-03-13 19:02:38+00:00,"48.866830968942, 2.3654810339212",Paris,75056,1.0,19
11011,Richard Lenoir - Voltaire,OUI,25,1,24,22,2,OUI,OUI,2025-03-13 19:02:38+00:00,"48.86164273878, 2.3727491497993",Paris,75056,0.96,19
11012,Montreuil - Voltaire,OUI,32,18,14,3,11,OUI,OUI,2025-03-13 19:02:05+00:00,"48.850507011842, 2.3930755582745",Paris,75056,0.4375,19
15105,Fédération - Suffren,OUI,24,11,13,11,2,OUI,OUI,2025-03-13 19:01:10+00:00,"48.852828153442, 2.2978776320815",Paris,75056,0.5416666666666666,19
8057,Hoche - Tilsitt,OUI,32,31,1,0,1,OUI,OUI,2025-03-13 18:54:43+00:00,"48.874836457837, 2.2971323132515",Paris,75056,0.03125,19
7023,Bourdonnais - Tour Eiffel,OUI,56,18,38,36,2,OUI,OUI,2025-03-13 19:01:10+00:00,"48.860897797941, 2.295599598447",Paris,75056,0.6785714285714286,19
7109,Place Joffre - Frédéric le Play,OUI,37,33,4,3,1,OUI,OUI,2025-03-13 19:02:14+00:00,"48.853754486938, 2.3044242337346",Paris,75056,0.10810810810810811,19
7025,Octave Gréard - Tour Eiffel,OUI,32,26,6,2,4,OUI,OUI,2025-03-13 19:00:31+00:00,"48.856502977696, 2.2931787543289",Paris,75056,0.1875,19
40007,Préfecture de Créteil,OUI,27,7,20,13,7,OUI,OUI,2025-03-13 19:00:42+00:00,"48.783680285918, 2.4544713672215",Créteil,94028,0.7407407407407407,19
40012,Stade de la Habette,OUI,16,14,2,0,2,OUI,OUI,2025-03-13 18:59:41+00:00,"48.774397033806, 2.4668785263921",Créteil,94028,0.125,19
40013,Hôtel de Ville de Créteil,OUI,36,17,19,13,6,OUI,OUI,2025-03-13 19:00:15+00:00,"48.77699496201, 2.4552552404284",Créteil,94028,0.5277777777777778,19
12107,Diderot - Pierre Bourdan,OUI,21,18,3,1,2,OUI,OUI,2025-03-13 19:01:22+00:00,"48.847648620797, 2.3902582749724",Paris,75056,0.14285714285714285,19
40014,Créteil Pointe du Lac,OUI,28,4,24,9,15,OUI,OUI,2025-03-13 19:01:00+00:00,"48.769807356177, 2.4623027310281",Créteil,94028,0.8571428571428571,19
23011,Bineau - Louise Michel,OUI,26,13,13,7,6,OUI,OUI,2025-03-13 19:01:53+00:00,"48.88666162207, 2.2843274474144",Levallois-Perret,92044,0.5,19
16005,Raymond Poincaré - Place Victor Hugo,OUI,21,16,5,2,3,OUI,OUI,2025-03-13 19:02:27+00:00,"48.87030612437, 2.2850745414202",Paris,75056,0.23809523809523808,19
23801,Place de la Gare,OUI,20,17,3,2,1,OUI,OUI,2025-03-13 18:58:15+00:00,"48.838513582184, 2.1866139007512",Garches,92033,0.15,19
40008,Créteil Pompadour,OUI,44,10,34,11,23,OUI,OUI,2025-03-13 19:02:28+00:00,"48.773011623355, 2.435166164893",Créteil,94028,0.7727272727272727,19
14021,Place de la Porte de Châtillon,OUI,59,56,3,1,2,OUI,OUI,2025-03-13 19:02:14+00:00,"48.8242469, 2.3186306",Paris,75056,0.05084745762711865,19
13106,Bobillot - Paulin Mery,OUI,20,9,11,4,7,OUI,OUI,2025-03-13 19:02:29+00:00,"48.829899841747, 2.3543356766749",Paris,75056,0.55,19
10031,Louis Blanc - Aqueduc,OUI,36,29,7,1,6,OUI,OUI,2025-03-13 19:02:13+00:00,"48.882030182599, 2.363561578095",Paris,75056,0.19444444444444445,19
32004,Wilson - Landy,OUI,36,28,8,7,1,OUI,OUI,2025-03-13 18:57:40+00:00,"48.91516726221354, 2.357633225619793",Saint-Denis,93066,0.2222222222222222,19
35014,Charles de Gaulle - Jean Lolive,OUI,26,24,2,1,1,OUI,OUI,2025-03-13 19:02:27+00:00,"48.8932644350857, 2.4126765131950383",Pantin,93055,0.07692307692307693,19
31708,Noisy le Sec - Jean-Baptiste Clément,OUI,20,16,4,0,4,OUI,OUI,2025-03-13 18:58:55+00:00,"48.874515389637, 2.4152836203575",Bagnolet,93006,0.2,19
10013,Alibert - Jemmapes,OUI,59,47,12,7,5,OUI,OUI,2025-03-13 19:00:13+00:00,"48.871044051984, 2.3661044619878",Paris,75056,0.2033898305084746,19
15103,Cauchy - Cévennes,OUI,50,0,50,48,2,OUI,OUI,2025-03-13 19:01:20+00:00,"48.843372571022, 2.2751328349113",Paris,75056,1.0,19
15026,Bir Hakeim,OUI,30,24,6,2,4,OUI,OUI,2025-03-13 19:00:28+00:00,"48.853844054334, 2.289705348222",Paris,75056,0.2,19
1022,Danielle Casanova - Place Vendôme,OUI,34,23,11,8,3,OUI,OUI,2025-03-13 19:00:09+00:00,"48.868266498223, 2.3304839059711",Paris,75056,0.3235294117647059,19
21404,Jean Jaurès - Gare de Clamart,OUI,20,16,4,0,4,OUI,OUI,2025-03-13 18:56:18+00:00,"48.81321981219, 2.2716768079163",Clamart,92023,0.2,19
17123,Mstislav Rostropovitch - Berthier,OUI,18,10,8,4,4,OUI,OUI,2025-03-13 19:01:56+00:00,"48.892120821173975, 2.309234105050564",Paris,75056,0.4444444444444444,19
6001,Institut de France,OUI,16,7,9,7,2,OUI,OUI,2025-03-13 18:59:49+00:00,"48.857615678565, 2.3358313530377",Paris,75056,0.5625,19
8052,Balzac - Champs Elysées,OUI,29,24,5,3,2,OUI,OUI,2025-03-13 19:02:19+00:00,"48.872699639621, 2.3001953959465",Paris,75056,0.1724137931034483,19
4104,Sebastopol - Rambuteau,OUI,14,0,14,10,4,OUI,OUI,2025-03-13 19:02:25+00:00,"48.86181809267, 2.3501381278038",Paris,75056,1.0,19
21302,Aristide Briand - Place de la Résistance,OUI,34,2,32,31,1,OUI,OUI,2025-03-13 19:02:03+00:00,"48.82124248401006, 2.2511002421379094",Issy-les-Moulineaux,92040,0.9411764705882353,19
12127,Tremblay - Lac des Minimes,OUI,48,35,13,5,8,OUI,OUI,2025-03-13 19:01:17+00:00,"48.834131261494, 2.4547516554594",Paris,75056,0.2708333333333333,19
21021,Enfants du Paradis - Peupliers,OUI,40,15,25,22,3,OUI,OUI,2025-03-13 19:00:37+00:00,"48.833122686454, 2.2571459412575",Boulogne-Billancourt,92012,0.625,19
8004,Malesherbes - Place de la Madeleine,OUI,78,53,25,13,12,OUI,OUI,2025-03-13 19:02:12+00:00,"48.870406028483, 2.323243509808",Paris,75056,0.32051282051282054,19
40001,Hôpital Mondor,OUI,28,10,18,10,8,OUI,OUI,2025-03-13 23:59:20+00:00,"48.798922410229, 2.4537451531298",Créteil,94028,0.6428571428571429,0
16107,Benjamin Godard - Victor Hugo,OUI,32,25,7,3,4,OUI,OUI,2025-03-13 23:59:07+00:00,"48.865983, 2.275725",Paris,75056,0.21875,0
44015,Rouget de L'isle - Watteau,OUI,20,8,12,2,10,OUI,OUI,2025-03-14 00:00:51+00:00,"48.778192750803, 2.3963020229163",Vitry-sur-Seine,94081,0.6,0
32017,Basilique,OUI,18,6,12,4,8,OUI,OUI,2025-03-14 00:02:37+00:00,"48.93626891059109, 2.3588666820200914",Saint-Denis,93066,0.6666666666666666,0
9020,Toudouze - Clauzel,OUI,21,18,3,1,2,OUI,OUI,2025-03-13 23:55:07+00:00,"48.87929591733507, 2.3373600840568547",Paris,75056,0.14285714285714285,0
11104,Charonne - Robert et Sonia Delaunay,OUI,20,11,9,3,6,OUI,OUI,2025-03-14 00:01:18+00:00,"48.855907555969, 2.3925706744194",Paris,75056,0.45,0
14111,Cassini - Denfert-Rochereau,OUI,23,20,3,0,3,OUI,OUI,2025-03-13 23:56:22+00:00,"48.837525839067, 2.3360354080796",Paris,75056,0.13043478260869565,0
7002,Vaneau - Sèvres,OUI,34,4,30,21,9,OUI,OUI,2025-03-14 00:00:57+00:00,"48.848563233059, 2.3204218259346",Paris,75056,0.8823529411764706,0
14014,Jourdan - Stade Charléty,OUI,57,49,8,4,4,OUI,OUI,2025-03-14 00:03:05+00:00,"48.819428333369, 2.3433353751898",Paris,75056,0.14035087719298245,0
6108,Saint-Romain - Cherche-Midi,OUI,16,1,15,13,2,OUI,OUI,2025-03-13 23:57:10+00:00,"48.84708159081946, 2.321374788880348",Paris,75056,0.9375,0
8026,Messine - Place Du Pérou,OUI,12,10,2,1,1,OUI,OUI,2025-03-13 23:58:35+00:00,"48.875448033960744, 2.315508019010038",Paris,75056,0.16666666666666666,0
33006,André Karman - République,OUI,29,24,5,1,4,OUI,OUI,2025-03-14 00:02:02+00:00,"48.91039875761846, 2.3851355910301213",Aubervilliers,93001,0.1724137931034483,0
13007,Le Brun - Gobelins,OUI,47,22,25,17,8,OUI,OUI,2025-03-14 00:02:24+00:00,"48.835092787824, 2.3534681351338",Paris,75056,0.5319148936170213,0
42016,Pierre et Marie Curie - Maurice Thorez,OUI,25,15,10,5,5,OUI,OUI,2025-03-14 00:03:15+00:00,"48.81580226360801, 2.376804985105991",Ivry-sur-Seine,94041,0.4,0
6003,Saint-Sulpice,OUI,21,18,3,2,1,OUI,OUI,2025-03-14 00:02:34+00:00,"48.85165383178419, 2.3308077827095985",Paris,75056,0.14285714285714285,0
30002,Jean Rostand - Paul Vaillant Couturier,OUI,39,31,8,6,2,OUI,OUI,2025-03-14 00:01:02+00:00,"48.908168131015, 2.4530601033354",Bobigny,93008,0.20512820512820512,0
5110,Lacépède - Monge,OUI,23,22,1,1,0,OUI,OUI,2025-03-14 00:02:26+00:00,"48.84389286531899, 2.3519663885235786",Paris,75056,0.043478260869565216,0
32304,Charcot - Benfleet,OUI,28,27,1,0,1,NON,NON,2025-03-13 23:59:50+00:00,"48.878370277021, 2.440523876268",Romainville,93063,0.03571428571428571,0
40011,Bas du Mont-Mesly,OUI,26,17,9,7,2,OUI,OUI,2025-03-14 00:02:56+00:00,"48.779035118572, 2.4609763908985",Créteil,94028,0.34615384615384615,0
7003,Square Boucicaut,OUI,57,54,3,1,2,OUI,OUI,2025-03-14 00:02:36+00:00,"48.851296433665276, 2.325061820447445",Paris,75056,0.05263157894736842,0
21010,Silly - Galliéni,OUI,25,7,18,12,6,OUI,OUI,2025-03-14 00:02:26+00:00,"48.835583838706, 2.2325500845909",Boulogne-Billancourt,92012,0.72,0
5016,Thouin - Cardinal Lemoine,OUI,15,14,1,0,1,OUI,OUI,2025-03-14 00:01:59+00:00,"48.84504716661511, 2.3494647851273465",Paris,75056,0.06666666666666667,0
25006,Place Nelson Mandela,OUI,22,22,0,0,0,OUI,OUI,2025-03-13 23:55:43+00:00,"48.862453313908, 2.1961666225454",Rueil-Malmaison,92063,0.0,0
11025,Froment - Bréguet,OUI,40,4,36,33,3,OUI,OUI,2025-03-14 00:00:28+00:00,"48.8570414504784, 2.37289470306807",Paris,75056,0.9,0
17041,Guersant - Gouvion-Saint-Cyr,OUI,32,9,23,12,11,OUI,OUI,2025-03-14 00:01:49+00:00,"48.88287775178599, 2.287667370814871",Paris,75056,0.71875,0
15047,Morillons - Dantzig,OUI,51,35,16,4,12,OUI,OUI,2025-03-14 00:02:05+00:00,"48.83310149953933, 2.299380004405976",Paris,75056,0.3137254901960784,0
17026,Jouffroy d'Abbans - Wagram,OUI,40,33,7,3,4,OUI,OUI,2025-03-13 23:59:21+00:00,"48.881973298352, 2.301132157445",Paris,75056,0.175,0
6021,Beaux-Arts - Bonaparte,OUI,19,17,2,1,1,OUI,OUI,2025-03-13 23:57:31+00:00,"48.856451985396, 2.3348518833518",Paris,75056,0.10526315789473684,0
15202,Bracion - Périphérique,OUI,30,26,4,0,4,OUI,OUI,2025-03-13 23:58:45+00:00,"48.826103771275, 2.3004549373748",Paris,75056,0.13333333333333333,0
12109,Mairie du 12ème,OUI,30,2,28,23,5,OUI,OUI,2025-03-14 00:02:50+00:00,"48.840855311763, 2.3875549435616",Paris,75056,0.9333333333333333,0
8050,Boétie - Ponthieu,OUI,41,37,4,0,4,OUI,OUI,2025-03-14 00:00:39+00:00,"48.871417284355, 2.3076787590981",Paris,75056,0.0975609756097561,0
13101,Croulebarde - Corvisart,OUI,33,20,13,12,1,OUI,OUI,2025-03-14 00:01:10+00:00,"48.830981659316855, 2.3481646925210953",Paris,75056,0.3939393939393939,0
31024,Romainville - Vaillant-Couturier,OUI,37,31,6,0,6,OUI,OUI,2025-03-14 00:02:18+00:00,"48.86785, 2.446748",Montreuil,93048,0.16216216216216217,0
14108,Le Brix et Mesmin - Jourdan,OUI,21,6,15,2,13,OUI,OUI,2025-03-14 00:02:45+00:00,"48.82234096593411, 2.327861653302471",Paris,75056,0.7142857142857143,0
2022,Saint-Fiacre - Poissonière,OUI,34,31,3,1,2,OUI,OUI,2025-03-13 23:57:48+00:00,"48.870828911558, 2.3459213599563",Paris,75056,0.08823529411764706,0
17044,Porte de Saint-Ouen - Bessières,OUI,41,35,6,3,3,OUI,OUI,2025-03-14 00:00:55+00:00,"48.89792240854517, 2.32851451022192",Paris,75056,0.14634146341463414,0
19033,Cambrai - Benjamin Constant,OUI,41,38,3,0,3,OUI,OUI,2025-03-13 23:56:04+00:00,"48.89594736851349, 2.381133802246315",Paris,75056,0.07317073170731707,0
17025,Chazelles - Courcelles,OUI,33,29,4,1,3,OUI,OUI,2025-03-13 23:58:48+00:00,"48.879406604954, 2.3034455627202988",Paris,75056,0.12121212121212122,0
20143,Ramponeau - Belleville,OUI,44,40,4,1,3,OUI,OUI,2025-03-13 23:55:00+00:00,"48.871031137596, 2.379056852114",Paris,75056,0.09090909090909091,0
21326,Moulin de Pierre - Abbé Grégoire,OUI,20,12,8,1,7,OUI,OUI,2025-03-13 23:53:14+00:00,"48.822036188382, 2.2754641655975",Issy-les-Moulineaux,92040,0.4,0
15068,Général Martial Valin - Pont du Garigliano,OUI,16,10,6,2,4,OUI,OUI,2025-03-14 00:01:12+00:00,"48.83823094269141, 2.270506024360657",Paris,75056,0.375,0
43002,Lagny - Victor Basch,OUI,26,19,7,2,5,OUI,OUI,2025-03-14 00:01:48+00:00,"48.84884147189881, 2.426325418925233",Vincennes,94080,0.2692307692307692,0
22207,Rond-point du Dr Albert Schweitzer,OUI,21,6,15,3,12,OUI,OUI,2025-03-14 00:01:15+00:00,"48.78980918988166, 2.3143940046429634",Bagneux,92007,0.7142857142857143,0
16138,Saint-Cloud - Hippodrome,OUI,30,24,6,4,2,OUI,OUI,2025-03-13 23:54:07+00:00,"48.85772148887421, 2.2549109905958176",Paris,75056,0.2,0
92002,Théâtre des Amandiers - Palais des sports,OUI,22,10,12,7,5,OUI,OUI,2025-03-13 23:59:41+00:00,"48.892648526839, 2.2136941552162",Nanterre,92050,0.5454545454545454,0
21216,Louis Lejeune - Barbès,OUI,24,21,3,2,1,OUI,OUI,2025-03-13 23:59:42+00:00,"48.81807418981508, 2.3267009854316716",Montrouge,92049,0.125,0
19027,Serrurier,OUI,18,11,7,0,7,OUI,OUI,2025-03-13 23:55:04+00:00,"48.880493403246, 2.398064173758",Paris,75056,0.3888888888888889,0
31028,Raspail Barbès,OUI,28,20,8,3,5,OUI,OUI,2025-03-13 23:58:16+00:00,"48.8529945, 2.4247387",Montreuil,93048,0.2857142857142857,0
17048,De Toqueville - Terrasse,OUI,30,26,4,2,2,OUI,OUI,2025-03-14 00:02:28+00:00,"48.882428, 2.314002",Paris,75056,0.13333333333333333,0
44017,Jules Guesde - Pont du Port à l'Anglais,OUI,26,0,26,24,2,OUI,OUI,2025-03-13 23:55:33+00:00,"48.79628807093802, 2.417212128639221",Vitry-sur-Seine,94081,1.0,0
8103,Artois - Berri,OUI,22,20,2,2,0,OUI,OUI,2025-03-13 23:55:37+00:00,"48.87393521240818, 2.3064258322119713",Paris,75056,0.09090909090909091,0
16118,Michel-Ange - Parent de Rosan,OUI,23,7,16,9,7,OUI,OUI,2025-03-14 00:03:10+00:00,"48.840579923690115, 2.2584119439125065",Paris,75056,0.6956521739130435,0
14013,Liard - Amiral Mouchez,OUI,27,15,12,8,4,OUI,OUI,2025-03-14 00:01:31+00:00,"48.8214169, 2.342167",Paris,75056,0.4444444444444444,0
2017,Caire - Dussoubs,OUI,40,20,20,20,0,OUI,OUI,2025-03-14 00:02:25+00:00,"48.86785342111862, 2.349364310503006",Paris,75056,0.5,0
15112,Vigée-Lebrun - Anselme Payen,OUI,23,13,10,4,6,OUI,OUI,2025-03-13 23:57:14+00:00,"48.838683941628375, 2.3110422492027287",Paris,75056,0.43478260869565216,0
9008,Tour d'Auvergne - Rodier,OUI,17,12,5,2,3,OUI,OUI,2025-03-13 23:57:44+00:00,"48.879161, 2.343698",Paris,75056,0.29411764705882354,0
9002,Abbeville - Faubourg Poissonnière,OUI,14,11,3,2,1,OUI,OUI,2025-03-14 00:02:57+00:00,"48.879223, 2.349147",Paris,75056,0.21428571428571427,0
8048,Marceau - Chaillot,OUI,20,18,2,1,1,OUI,OUI,2025-03-14 00:00:31+00:00,"48.868834023334, 2.2986030816809",Paris,75056,0.1,0
48003,Youri Gagarine - Karl Marx,OUI,22,14,8,1,7,OUI,OUI,2025-03-14 00:02:22+00:00,"48.78448485079149, 2.35908430069685",Villejuif,94076,0.36363636363636365,0
13118,Regnault - Patay,OUI,62,14,48,43,5,OUI,OUI,2025-03-14 00:02:30+00:00,"48.82435782216384, 2.377065159380436",Paris,75056,0.7741935483870968,0
10029,Dunkerque - Rocroy,OUI,24,22,2,1,1,OUI,OUI,2025-03-14 00:02:08+00:00,"48.880726, 2.351464",Paris,75056,0.08333333333333333,0
13030,Italie - Tolbiac,OUI,20,6,14,6,8,OUI,OUI,2025-03-13 23:59:10+00:00,"48.82557229464416, 2.3576171323657036",Paris,75056,0.7,0
41303,Gare de Nogent-le-Perreux,OUI,31,14,17,13,4,OUI,OUI,2025-03-14 00:02:06+00:00,"48.83842553348809, 2.493693307042122",Nogent-sur-Marne,94052,0.5483870967741935,0
18111,Félix Ziem - Armand Gauthier,OUI,23,9,14,1,13,OUI,OUI,2025-03-14 00:00:32+00:00,"48.88949630486821, 2.333393658804396",Paris,75056,0.6086956521739131,0
12031,Gabriel Lamé,OUI,34,20,14,9,5,OUI,OUI,2025-03-14 00:02:40+00:00,"48.8351212784276, 2.385534569621086",Paris,75056,0.4117647058823529,0
16110,Octave Feuillet - Albéric Magnard,OUI,20,18,2,0,2,OUI,OUI,2025-03-13 23:57:25+00:00,"48.86106902949534, 2.2730283066630363",Paris,75056,0.1,0
5022,Boulangers - Cardinal Lemoine,OUI,19,19,0,0,0,OUI,OUI,2025-03-14 00:00:18+00:00,"48.8462904, 2.3521495",Paris,75056,0.0,0
43009,Place Jean-Spire-Lemaître,OUI,49,30,19,11,8,OUI,OUI,2025-03-14 00:01:55+00:00,"48.8468428626593, 2.452062070369721",Vincennes,94080,0.3877551020408163,0
17040,Pereire - Ternes,OUI,48,41,7,6,1,OUI,OUI,2025-03-14 00:02:26+00:00,"48.87973954830735, 2.288012132048607",Paris,75056,0.14583333333333334,0
9001,Bellefond - Poissonnière,OUI,15,10,5,4,1,OUI,OUI,2025-03-13 23:56:22+00:00,"48.87759897050706, 2.348463758826256",Paris,75056,0.3333333333333333,0
31103,Gare Rosny-Bois-Perrier,OUI,33,14,19,1,18,OUI,OUI,2025-03-13 23:54:51+00:00,"48.88115023337061, 2.480436824262142",Rosny-sous-Bois,93064,0.5757575757575758,0
17032,Jean Oestreicher - Porte de Champerret,OUI,21,14,7,5,2,OUI,OUI,2025-03-13 23:59:01+00:00,"48.88655580065981, 2.288640439510346",Paris,75056,0.3333333333333333,0
17008,Porte Pouchet-Bessières,OUI,23,10,13,10,3,OUI,OUI,2025-03-13 23:59:15+00:00,"48.8978765, 2.3230632",Paris,75056,0.5652173913043478,0
8016,Square Louis XVI,OUI,29,23,6,5,1,OUI,OUI,2025-03-14 00:03:07+00:00,"48.87320440102894, 2.323658830743138",Paris,75056,0.20689655172413793,0
7018,Ségur - d'Estrées,OUI,18,12,6,4,2,OUI,OUI,2025-03-13 23:57:00+00:00,"48.851419978983, 2.3097044974566",Paris,75056,0.3333333333333333,0
10115,Granges aux Belles,OUI,26,20,6,1,5,OUI,OUI,2025-03-13 23:57:47+00:00,"48.8761373390584, 2.3680844979417",Paris,75056,0.23076923076923078,0
5005,Gay Lussac - Saint-Jacques,OUI,24,23,1,0,1,OUI,OUI,2025-03-14 00:02:15+00:00,"48.844730256132, 2.3419239448664",Paris,75056,0.041666666666666664,0
10161,Gare de l'Est - Faubourg-Saint-Martin,OUI,32,28,4,0,4,OUI,OUI,2025-03-14 00:03:15+00:00,"48.875642647477, 2.3594588041306",Paris,75056,0.125,0
8053,Place Georges Guillaumin,OUI,28,26,2,1,1,OUI,OUI,2025-03-14 00:01:55+00:00,"48.874750203957, 2.301771435326",Paris,75056,0.07142857142857142,0
1001,Quai de l'Horloge - Pont Neuf,OUI,16,3,13,10,3,OUI,OUI,2025-03-14 00:01:49+00:00,"48.857058739111, 2.3417982839439",Paris,75056,0.8125,0
9014,Faubourg Montmartre - La Fayette,OUI,31,25,6,5,1,OUI,OUI,2025-03-14 00:02:12+00:00,"48.875254549053, 2.3408536612988",Paris,75056,0.1935483870967742,0
21328,Verger - Colonel Guichard,OUI,29,25,4,0,4,OUI,OUI,2025-03-14 00:01:22+00:00,"48.816376985087, 2.2670380088932",Issy-les-Moulineaux,92040,0.13793103448275862,0
9106,Boudreau - Auber,OUI,27,20,7,5,2,OUI,OUI,2025-03-13 23:59:52+00:00,"48.87219, 2.329423",Paris,75056,0.25925925925925924,0
13104,Gare d'Austerlitz - Quai Saint-Bernard,OUI,26,6,20,17,3,OUI,OUI,2025-03-14 00:02:38+00:00,"48.84369030864, 2.3657163977623",Paris,75056,0.7692307692307693,0
19105,Ambroise Rendu - Porte Brunet,OUI,17,13,4,1,3,OUI,OUI,2025-03-14 00:01:57+00:00,"48.883667, 2.395733",Paris,75056,0.23529411764705882,0
9038,Douai - Bruxelles,OUI,26,24,2,0,2,OUI,OUI,2025-03-14 00:01:21+00:00,"48.88320784122797, 2.3308449949028507",Paris,75056,0.07692307692307693,0
31706,Château - République,OUI,24,23,1,0,1,OUI,OUI,2025-03-13 23:58:02+00:00,"48.862923800596, 2.4155035614967",Bagnolet,93006,0.041666666666666664,0
8009,Gare Saint-Lazare - Isly,OUI,25,23,2,0,2,OUI,OUI,2025-03-13 23:58:52+00:00,"48.874777677621296, 2.326515804784655",Paris,75056,0.08,0
22409,Henri Barbusse - Stalingrad,OUI,16,2,14,0,14,OUI,OUI,2025-03-14 00:00:21+00:00,"48.814183748660554, 2.2872862592339516",Malakoff,92046,0.875,0
18203,Lamarck - Saint-Ouen,OUI,40,40,0,0,0,NON,NON,2025-03-13 23:53:58+00:00,"48.891334555236, 2.3272445342326",Paris,75056,0.0,0
9022,Rossini - Laffitte,OUI,33,31,2,2,0,OUI,OUI,2025-03-13 23:58:10+00:00,"48.87334627510507, 2.337980867701675",Paris,75056,0.06060606060606061,0
21323,Charlot - Stade Gabriel Voisin,OUI,31,3,28,26,2,OUI,OUI,2025-03-14 00:02:22+00:00,"48.827228120536, 2.268122527474",Issy-les-Moulineaux,92040,0.9032258064516129,0
19003,Quai de la Seine,OUI,23,20,3,1,2,OUI,OUI,2025-03-13 23:55:33+00:00,"48.884492238407525, 2.3703941702842717",Paris,75056,0.13043478260869565,0
19015,Thionville - Ourcq,OUI,23,4,19,6,13,OUI,OUI,2025-03-14 00:02:56+00:00,"48.88917613743794, 2.3833653330802917",Paris,75056,0.8260869565217391,0
12151,Gare de Lyon - Place Louis Armand,OUI,56,31,25,21,4,OUI,OUI,2025-03-14 00:03:02+00:00,"48.845515089794, 2.3726498446286",Paris,75056,0.44642857142857145,0
26003,Argenteuil - Voltaire,OUI,16,1,15,6,9,OUI,OUI,2025-03-14 00:03:08+00:00,"48.91864865955558, 2.2814112156629562",Asnières-sur-Seine,92004,0.9375,0
5020,Institut du Monde Arabe - Saint-Germain,OUI,39,14,25,23,2,OUI,OUI,2025-03-14 00:02:26+00:00,"48.849063299501, 2.3558086529374",Paris,75056,0.6410256410256411,0
17004,Legendre - Clichy,OUI,38,20,18,10,8,OUI,OUI,2025-03-14 00:00:36+00:00,"48.88896161855884, 2.322528975094376",Paris,75056,0.47368421052631576,0
92007,Pesaro - Préfecture,OUI,21,20,1,1,0,OUI,OUI,2025-03-13 23:59:51+00:00,"48.89577046284005, 2.223908342421055",Nanterre,92050,0.047619047619047616,0
10107,Gare du Nord - Hôpital Lariboisière,OUI,49,18,31,10,21,OUI,OUI,2025-03-13 23:58:18+00:00,"48.881949, 2.352339",Paris,75056,0.6326530612244898,0
16026,Ranelagh - Mozart,OUI,7,2,5,2,3,OUI,OUI,2025-03-14 00:02:04+00:00,"48.8554439, 2.2704418",Paris,75056,0.7142857142857143,0
16039,Exelmans - Versailles,OUI,47,2,45,38,7,OUI,OUI,2025-03-14 00:03:06+00:00,"48.84097491091973, 2.264390252530575",Paris,75056,0.9574468085106383,0
9028,Moncey - Blanche,OUI,17,15,2,1,1,OUI,OUI,2025-03-13 23:57:37+00:00,"48.88006587474148, 2.3310810327529907",Paris,75056,0.11764705882352941,0
45003,11 Novembre 1918 - 8 Mai 1945,OUI,36,13,23,14,9,OUI,OUI,2025-03-14 00:02:04+00:00,"48.80889533774377, 2.5382421165704727",Champigny-sur-Marne,94017,0.6388888888888888,0
26002,Redoute - Les Courtilles,OUI,38,4,34,22,12,OUI,OUI,2025-03-14 00:02:37+00:00,"48.929867194519, 2.2836696356535",Asnières-sur-Seine,92004,0.8947368421052632,0
12111,Claude Decaen - Cannebière,OUI,27,19,8,1,7,OUI,OUI,2025-03-14 00:02:55+00:00,"48.83761417037952, 2.397253782195704",Paris,75056,0.2962962962962963,0
17043,Belidor - Gouvion-Saint-Cyr,OUI,38,32,6,6,0,OUI,OUI,2025-03-13 23:58:38+00:00,"48.88022154052015, 2.2854680567979813",Paris,75056,0.15789473684210525,0
11047,Amelot - Saint-Sébastien,OUI,28,4,24,23,1,OUI,OUI,2025-03-14 00:03:09+00:00,"48.861142162761, 2.3677996181077",Paris,75056,0.8571428571428571,0
19026,Place de Rhin et Danube,OUI,15,11,4,1,3,OUI,OUI,2025-03-14 00:02:26+00:00,"48.88192765861766, 2.392586767673493",Paris,75056,0.26666666666666666,0
19043,Delphine Seyrig - Général Leclerc,OUI,52,45,7,2,5,OUI,OUI,2025-03-14 00:01:49+00:00,"48.893923963057865, 2.39790290594101",Pantin,93055,0.1346153846153846,0
11023,Saint-Maur - Roquette,OUI,45,2,43,25,18,OUI,OUI,2025-03-14 00:00:18+00:00,"48.858688774062955, 2.383553994571467",Paris,75056,0.9555555555555556,0
5032,Panthéon - Valette,OUI,39,38,1,0,1,OUI,OUI,2025-03-13 23:58:59+00:00,"48.847020571652, 2.3464982619671",Paris,75056,0.02564102564102564,0
11002,Roquette - Thiéré,OUI,21,7,14,14,0,OUI,OUI,2025-03-14 00:01:24+00:00,"48.85507930579506, 2.3733686318721463",Paris,75056,0.6666666666666666,0
15067,Desaix - Edgar Faure,OUI,11,2,9,7,2,OUI,OUI,2025-03-13 23:57:29+00:00,"48.852804604940296, 2.293077029857222",Paris,75056,0.8181818181818182,0
8034,Berri - Haussmann,OUI,33,32,1,1,0,OUI,OUI,2025-03-14 00:02:45+00:00,"48.874746047357135, 2.3082953318953514",Paris,75056,0.030303030303030304,0
17030,Pereire - Rennequin,OUI,21,11,10,6,4,OUI,OUI,2025-03-14 00:02:27+00:00,"48.88364782887555, 2.2952447086572647",Paris,75056,0.47619047619047616,0
18107,Chartres - La Charbonnière,OUI,34,27,7,2,5,OUI,OUI,2025-03-13 23:57:42+00:00,"48.8847601, 2.3534657",Paris,75056,0.20588235294117646,0
11027,Saint-Ambroise - Parmentier,OUI,35,0,35,20,15,OUI,OUI,2025-03-14 00:03:07+00:00,"48.862147844548, 2.3772348091006",Paris,75056,1.0,0
20042,Pyrénées - Emmery,OUI,40,28,12,0,12,OUI,OUI,2025-03-14 00:02:11+00:00,"48.872010281270974, 2.392039597034455",Paris,75056,0.3,0
12128,Pyramide - Ecole du Breuil,OUI,33,27,6,3,3,OUI,OUI,2025-03-14 00:01:31+00:00,"48.82237977153955, 2.4586871266365056",Paris,75056,0.18181818181818182,0
6006,Notre-Dame-des-Champs - Stanislas,OUI,18,17,1,1,0,OUI,OUI,2025-03-13 23:53:31+00:00,"48.84479928858768, 2.329337755887181",Paris,75056,0.05555555555555555,0
46002,Rouget de Lisle,OUI,35,1,34,17,17,OUI,OUI,2025-03-14 00:02:00+00:00,"48.764615483395254, 2.4071189761161804",Choisy-le-Roi,94022,0.9714285714285714,0
8010,Liège - Moscou,OUI,17,16,1,0,1,OUI,OUI,2025-03-13 23:55:00+00:00,"48.8795431, 2.3264628",Paris,75056,0.058823529411764705,0
10016,Récollets - Square Villemin,OUI,17,14,3,1,2,OUI,OUI,2025-03-14 00:03:14+00:00,"48.875034655883944, 2.359801238597928",Paris,75056,0.17647058823529413,0
31022,Mairie de Montreuil,OUI,51,45,6,3,3,OUI,OUI,2025-03-13 23:56:59+00:00,"48.86131452758348, 2.440614402294159",Montreuil,93048,0.11764705882352941,0
31009,Place Du Général De Gaulle,OUI,25,17,8,1,7,OUI,OUI,2025-03-13 23:58:53+00:00,"48.8687591, 2.4329931",Montreuil,93048,0.32,0
41302,Charles de Gaulle - Beauté,OUI,48,37,11,0,11,OUI,OUI,2025-03-14 00:02:41+00:00,"48.83649602312711, 2.479562651149885",Nogent-sur-Marne,94052,0.22916666666666666,0
14020,Cimetière de Montrouge,OUI,58,51,7,1,6,OUI,OUI,2025-03-13 23:59:48+00:00,"48.821466904768, 2.3215785772007",Paris,75056,0.1206896551724138,0
33017,Anatole France - President Roosevelt,OUI,25,12,13,1,12,OUI,OUI,2025-03-14 00:02:31+00:00,"48.9155156, 2.3814103",Aubervilliers,93001,0.52,0
15042,Henry Farman,OUI,15,11,4,4,0,OUI,OUI,2025-03-14 00:00:46+00:00,"48.83372430280548, 2.2713854536414146",Paris,75056,0.26666666666666666,0
18011,Pajol - Place Herbert,OUI,38,5,33,11,22,OUI,OUI,2025-03-14 00:03:01+00:00,"48.8927825, 2.3635598",Paris,75056,0.868421052631579,0
33102,Gabriel Péri - Francisco Ferrer,OUI,18,4,14,1,13,OUI,OUI,2025-03-14 00:00:21+00:00,"48.88633710236977, 2.407338917255402",Le Pré-Saint-Gervais,93061,0.7777777777777778,0
42706,Roger Salengro - Fontainebleau,OUI,24,21,3,0,3,OUI,OUI,2025-03-14 00:02:32+00:00,"48.814548697325, 2.3611663654447",Le Kremlin-Bicêtre,94043,0.125,0
19120,Carducci - Place Hannah Arendt,OUI,27,6,21,1,20,OUI,OUI,2025-03-14 00:00:25+00:00,"48.877436681515796, 2.3860743641853337",Paris,75056,0.7777777777777778,0
21212,Marne - Germain Dardan,OUI,21,15,6,1,5,OUI,OUI,2025-03-13 23:59:28+00:00,"48.81217465201, 2.3035024699104",Montrouge,92049,0.2857142857142857,0
18003,Cimetière de Montmartre,OUI,43,42,1,0,1,OUI,OUI,2025-03-14 00:02:31+00:00,"48.886472466142, 2.3328901827335",Paris,75056,0.023255813953488372,0
44006,Concorde - Stalingrad,OUI,35,15,20,3,17,OUI,OUI,2025-03-13 23:53:26+00:00,"48.7985844, 2.3821302",Vitry-sur-Seine,94081,0.5714285714285714,0
11113,Richard Lenoir - Republique,OUI,56,17,39,35,4,OUI,OUI,2025-03-14 00:03:11+00:00,"48.8667175, 2.3692541",Paris,75056,0.6964285714285714,0
5018,Mutualité,OUI,37,18,19,16,3,OUI,OUI,2025-03-14 00:02:43+00:00,"48.848225572724, 2.3502873256803",Paris,75056,0.5135135135135135,0
15104,Hôpital Européen Georges Pompidou,OUI,62,50,12,12,0,OUI,OUI,2025-03-14 00:03:03+00:00,"48.837695319163, 2.2753742337227",Paris,75056,0.1935483870967742,0
19103,Manin - Carrières d'Amérique,OUI,16,3,13,0,13,OUI,OUI,2025-03-14 00:02:41+00:00,"48.88467214209463, 2.3919698596000676",Paris,75056,0.8125,0
14003,Schoelcher - Raspail,OUI,47,44,3,1,2,OUI,OUI,2025-03-13 23:59:57+00:00,"48.83681733526843, 2.3312794080411474",Paris,75056,0.06382978723404255,0
14138,Porte de Vanves,OUI,29,27,2,1,1,OUI,OUI,2025-03-13 23:58:29+00:00,"48.828012849445, 2.3056878894567",Paris,75056,0.06896551724137931,0
43008,Fontenay - Libération,OUI,24,14,10,7,3,OUI,OUI,2025-03-14 00:03:16+00:00,"48.847803063647, 2.4451419711113",Vincennes,94080,0.4166666666666667,0
12114,Victor Hugo - Jeanne Jugan,OUI,28,17,11,6,5,OUI,OUI,2025-03-14 00:03:01+00:00,"48.843949064031825, 2.415081394834419",Paris,75056,0.39285714285714285,0
19101,Square Simon Bolivar,OUI,21,13,8,2,6,OUI,OUI,2025-03-13 23:57:24+00:00,"48.875089888322, 2.3826304078102",Paris,75056,0.38095238095238093,0
15106,Grenelle - Violet,OUI,34,1,33,24,9,OUI,OUI,2025-03-14 00:02:02+00:00,"48.84993035512154, 2.294612042605877",Paris,75056,0.9705882352941176,0
46003,Conservatoire de Musique,OUI,24,1,23,19,4,OUI,OUI,2025-03-14 00:01:30+00:00,"48.77093586667601, 2.4034014344215398",Choisy-le-Roi,94022,0.9583333333333334,0
22406,Guy Môquet - Etienne Dolet,OUI,22,16,6,2,4,OUI,OUI,2025-03-13 23:58:57+00:00,"48.81527009991819, 2.298078276995073",Malakoff,92046,0.2727272727272727,0
41209,Cimetière de Fontenay-sous-Bois,OUI,15,12,3,0,3,OUI,OUI,2025-03-13 23:54:44+00:00,"48.84706173362218, 2.4787822365760808",Fontenay-sous-Bois,94033,0.2,0
31102,Boissière - Etienne Dolet,OUI,20,12,8,2,6,OUI,OUI,2025-03-14 00:02:17+00:00,"48.876111, 2.4677312",Montreuil,93048,0.4,0
21312,Lucie Aubrac - Fort,OUI,29,15,14,1,13,OUI,OUI,2025-03-14 00:00:43+00:00,"48.818144834008976, 2.271184623241425",Issy-les-Moulineaux,92040,0.4827586206896552,0
2111,Chabanais - Petits Champs,OUI,28,1,27,25,2,OUI,OUI,2025-03-14 00:00:48+00:00,"48.86703740186721, 2.336716018617153",Paris,75056,0.9642857142857143,0
14008,Mouton Duvernet - Général Leclerc,OUI,25,22,3,1,2,OUI,OUI,2025-03-14 00:01:13+00:00,"48.831632518293, 2.3293121159077",Paris,75056,0.12,0
18022,Marcadet - Barbès,OUI,34,24,10,2,8,OUI,OUI,2025-03-13 23:59:32+00:00,"48.890451120965, 2.3490573929687",Paris,75056,0.29411764705882354,0
13001,Port-Royal - Hôpital du Val-de-Grâce,OUI,18,7,11,4,7,OUI,OUI,2025-03-14 00:02:09+00:00,"48.837668272811, 2.3448138346607",Paris,75056,0.6111111111111112,0
10042,Enghien - Faubourg Poissonnière,OUI,32,10,22,22,0,OUI,OUI,2025-03-14 00:02:14+00:00,"48.872420063053, 2.3483952362828",Paris,75056,0.6875,0
18028,Championnet - Vauvenargues,OUI,31,1,30,9,21,OUI,OUI,2025-03-13 23:59:25+00:00,"48.89401874744574, 2.3319872841238976",Paris,75056,0.967741935483871,0
42014,Place Marcel Cachin,OUI,32,2,30,23,7,OUI,OUI,2025-03-14 00:00:50+00:00,"48.81411442356866, 2.39090770483017",Ivry-sur-Seine,94041,0.9375,0
8017,Rocher - Laborde,OUI,64,61,3,1,2,OUI,OUI,2025-03-14 00:00:35+00:00,"48.87590240712654, 2.322616316378116",Paris,75056,0.046875,0
4016,Lobau - Hôtel de Ville,OUI,58,12,46,45,1,OUI,OUI,2025-03-14 00:03:03+00:00,"48.8562118, 2.3532536",Paris,75056,0.7931034482758621,0
15054,Lecourbe - Jean Maridor,OUI,18,0,18,8,10,OUI,OUI,2025-03-13 23:58:20+00:00,"48.83796366147599, 2.2877392172813416",Paris,75056,1.0,0
15133,Saint Lambert - Blomet,OUI,27,4,23,13,10,OUI,OUI,2025-03-14 00:01:57+00:00,"48.83659148147257, 2.2930556908249855",Paris,75056,0.8518518518518519,0
5124,Erasme - Ulm,OUI,22,20,2,1,1,OUI,OUI,2025-03-14 00:02:17+00:00,"48.84264375274712, 2.3445946723222733",Paris,75056,0.09090909090909091,0
15110,Place Robert Guillemard,OUI,23,15,8,6,2,OUI,OUI,2025-03-14 00:02:57+00:00,"48.836191728066666, 2.2811267160086417",Paris,75056,0.34782608695652173,0
14106,Marc Sangnier - Porte de Vanves,OUI,20,17,3,1,2,OUI,OUI,2025-03-13 23:58:06+00:00,"48.825218683556734, 2.3107116669416428",Paris,75056,0.15,0
21006,Marcelin Berthelot,OUI,27,11,16,13,3,OUI,OUI,2025-03-14 00:02:55+00:00,"48.8415473058801, 2.233161628246308",Boulogne-Billancourt,92012,0.5925925925925926,0
18046,Etienne Jodelle - Saint Ouen,OUI,31,21,10,6,4,OUI,OUI,2025-03-14 00:02:37+00:00,"48.88794016394694, 2.326124420314341",Paris,75056,0.3225806451612903,0
8054,Bertie Albrecht - Hoche,OUI,32,30,2,0,2,OUI,OUI,2025-03-13 23:53:25+00:00,"48.87614039826388, 2.301303138307601",Paris,75056,0.0625,0
21015,Nationale - Place Jules Guesde,OUI,22,9,13,10,3,OUI,OUI,2025-03-13 23:57:35+00:00,"48.82753962462998, 2.2416052222251897",Boulogne-Billancourt,92012,0.5909090909090909,0
15109,Cevennes - Bergers,OUI,27,1,26,26,0,OUI,OUI,2025-03-14 00:03:11+00:00,"48.84240765130395, 2.281037718057633",Paris,75056,0.9629629629629629,0
44003,Gabriel Péri - Danielle Casanova,OUI,20,1,19,8,11,OUI,OUI,2025-03-13 23:59:57+00:00,"48.790114, 2.4025777",Vitry-sur-Seine,94081,0.95,0
21209,Molière - République,OUI,30,20,10,1,9,OUI,OUI,2025-03-14 00:02:48+00:00,"48.81111581390707, 2.3145738624448158",Montrouge,92049,0.3333333333333333,0
48010,Karl Marx,OUI,16,9,7,1,6,OUI,OUI,2025-03-14 00:01:00+00:00,"48.784527937293184, 2.3646667979455587",Villejuif,94076,0.4375,0
14012,Sibelle - Alésia,OUI,37,30,7,6,1,OUI,OUI,2025-03-14 00:00:39+00:00,"48.826701758539215, 2.3384983465075493",Paris,75056,0.1891891891891892,0
22203,Tertres - Fontaine,OUI,27,17,10,2,8,OUI,OUI,2025-03-14 00:00:17+00:00,"48.787553654715644, 2.306235730648041",Bagneux,92007,0.37037037037037035,0
21005,Hôtel de Ville de Boulogne Billancourt,OUI,26,8,18,13,5,OUI,OUI,2025-03-14 00:00:50+00:00,"48.83495885166784, 2.2416803240776066",Boulogne-Billancourt,92012,0.6923076923076923,0
41202,Gare Rer de Fontenay sous Bois,OUI,60,37,23,9,14,OUI,OUI,2025-03-14 00:00:46+00:00,"48.8436279, 2.4630465",Fontenay-sous-Bois,94033,0.38333333333333336,0
35010,Hoche - Jean Lolive,OUI,20,6,14,2,12,OUI,OUI,2025-03-14 00:02:35+00:00,"48.89110239200789, 2.402843534946442",Pantin,93055,0.7,0
35020,Marcelle - Thalie,OUI,20,16,4,0,4,OUI,OUI,2025-03-13 23:57:37+00:00,"48.8835462, 2.4137883",Pantin,93055,0.2,0
17203,Place de la Porte de Champeret,OUI,27,16,11,11,0,OUI,OUI,2025-03-13 23:58:52+00:00,"48.886062068226, 2.2917001576821",Paris,75056,0.4074074074074074,0
1020,Cambon - Rivoli,OUI,36,28,8,3,5,OUI,OUI,2025-03-13 23:59:07+00:00,"48.866143390992, 2.3251800647137",Paris,75056,0.2222222222222222,0
8045,Place de la Reine Astrid,OUI,55,54,1,0,1,OUI,OUI,2025-03-14 00:02:13+00:00,"48.864920982538, 2.3025491823859",Paris,75056,0.01818181818181818,0
25003,Henri Ste-Claire Déville - Paul Héroult,OUI,20,6,14,6,8,OUI,OUI,2025-03-14 00:03:08+00:00,"48.892663, 2.172411",Rueil-Malmaison,92063,0.7,0
14124,David Weill - Parc Montsouris,OUI,22,19,3,1,2,OUI,OUI,2025-03-14 00:02:58+00:00,"48.821092374256104, 2.333725690841675",Paris,75056,0.13636363636363635,0
20115,Louis Lumière - Porte de Bagnolet,OUI,20,19,1,1,0,OUI,OUI,2025-03-14 00:00:09+00:00,"48.86431136000005, 2.4105210229754443",Paris,75056,0.05,0
44013,Edouard Tremblay - Julian Grimaux,OUI,30,28,2,0,2,OUI,OUI,2025-03-14 00:01:37+00:00,"48.781383825117, 2.3723508417606",Vitry-sur-Seine,94081,0.06666666666666667,0
11030,Oberkampf - République,OUI,22,2,20,15,5,OUI,OUI,2025-03-13 23:58:22+00:00,"48.86531608707, 2.37611478491",Paris,75056,0.9090909090909091,0
20131,Repos - Cimetière du Père Lachaise,OUI,33,12,21,6,15,OUI,OUI,2025-03-14 00:00:33+00:00,"48.859358523593, 2.3896131366845",Paris,75056,0.6363636363636364,0
11039,Richard Lenoir - Jean-Pierre Timbaud,OUI,35,6,29,24,5,OUI,OUI,2025-03-14 00:03:11+00:00,"48.865804276686, 2.3693370749669",Paris,75056,0.8285714285714286,0
6025,Assas - Rennes,OUI,32,25,7,6,1,OUI,OUI,2025-03-14 00:03:13+00:00,"48.8492084999386, 2.32851454623001",Paris,75056,0.21875,0
17013,Legendre - Dulong,OUI,22,9,13,12,1,OUI,OUI,2025-03-14 00:02:35+00:00,"48.885325169402904, 2.316423766314984",Paris,75056,0.5909090909090909,0
15034,Lakanal - Commerce,OUI,45,3,42,40,2,OUI,OUI,2025-03-14 00:00:32+00:00,"48.84442462786544, 2.294059172272682",Paris,75056,0.9333333333333333,0
32604,Square du Théâtre du Garde-Chasse,OUI,50,44,6,0,6,OUI,OUI,2025-03-14 00:02:39+00:00,"48.881287375060616, 2.420119643211365",Les Lilas,93045,0.12,0
5028,Censier - Jardin des Plantes,OUI,27,3,24,17,7,OUI,OUI,2025-03-14 00:02:17+00:00,"48.84107178161383, 2.355475388467312",Paris,75056,0.8888888888888888,0
41601,Général De Gaulle - Alouette,OUI,25,3,22,5,17,OUI,OUI,2025-03-14 00:02:15+00:00,"48.839109, 2.4175664",Saint-Mandé,94067,0.88,0
42021,Raspail - Manufacture des Oeillets,OUI,31,1,30,23,7,OUI,OUI,2025-03-14 00:02:17+00:00,"48.8094458, 2.3903009",Ivry-sur-Seine,94041,0.967741935483871,0
23006,Jules Guesde - Alsace,OUI,24,10,14,6,8,OUI,OUI,2025-03-14 00:00:31+00:00,"48.890566275506, 2.2950777411461",Levallois-Perret,92044,0.5833333333333334,0
1119,Cossonnerie - Sébastopol,OUI,22,16,6,6,0,OUI,OUI,2025-03-13 23:57:15+00:00,"48.86132665908402, 2.349419631063938",Paris,75056,0.2727272727272727,0
15021,Joseph Liouville - Croix Nivert,OUI,64,10,54,41,13,OUI,OUI,2025-03-14 00:02:45+00:00,"48.844835471244416, 2.297508493065834",Paris,75056,0.84375,0
31003,Paris - Emile Zola,OUI,29,22,7,5,2,OUI,OUI,2025-03-13 23:58:27+00:00,"48.854898095789295, 2.4186685681343083",Montreuil,93048,0.2413793103448276,0
11105,Parmentier - République,OUI,21,1,20,14,6,OUI,OUI,2025-03-14 00:03:11+00:00,"48.8644954, 2.3750124",Paris,75056,0.9523809523809523,0
22402,Jean Jaurès - Salvador Allende,OUI,42,39,3,0,3,OUI,OUI,2025-03-13 23:56:53+00:00,"48.821475594736775, 2.3026576638221745",Malakoff,92046,0.07142857142857142,0
43005,Gare RER de Vincennes,OUI,49,45,4,0,4,OUI,OUI,2025-03-13 23:58:20+00:00,"48.847563015126106, 2.433383166790009",Vincennes,94080,0.08163265306122448,0
9116,Victoire - Chaussée d'Antin,OUI,23,22,1,0,1,OUI,OUI,2025-03-14 00:02:19+00:00,"48.875065791004396, 2.3316738009452824",Paris,75056,0.043478260869565216,0
19032,Villette - Belleville,OUI,38,27,11,4,7,OUI,OUI,2025-03-14 00:02:32+00:00,"48.8726877314, 2.376461327076",Paris,75056,0.2894736842105263,0
11026,Chemin Vert - Saint-Maur,OUI,44,1,43,19,24,OUI,OUI,2025-03-14 00:01:24+00:00,"48.86112461407359, 2.381299026310444",Paris,75056,0.9772727272727273,0
21701,Larmeroux - Baudelaire,OUI,28,1,27,2,25,OUI,OUI,2025-03-14 00:02:11+00:00,"48.816939911292, 2.2809894804846",Vanves,92075,0.9642857142857143,0
19024,Botzaris - Parc des Buttes Chaumont,OUI,20,12,8,2,6,OUI,OUI,2025-03-14 00:01:32+00:00,"48.877951, 2.381464",Paris,75056,0.4,0
22003,Beffroy,OUI,26,23,3,2,1,OUI,OUI,2025-03-13 23:57:54+00:00,"48.886591074488, 2.2613945603371",Neuilly-sur-Seine,92051,0.11538461538461539,0
17105,Place Madeleine Daniélou,OUI,42,30,12,12,0,OUI,OUI,2025-03-14 00:01:50+00:00,"48.883498, 2.282015",Paris,75056,0.2857142857142857,0
11024,Mairie du 11ème,OUI,50,2,48,40,8,OUI,OUI,2025-03-14 00:01:25+00:00,"48.858925, 2.3789759",Paris,75056,0.96,0
9010,Rochechouart lamartine,OUI,23,13,10,8,2,OUI,OUI,2025-03-14 00:02:46+00:00,"48.876719895109, 2.344393021854",Paris,75056,0.43478260869565216,0
13050,Quai Panhard et Levassor,OUI,56,54,2,2,0,OUI,OUI,2025-03-13 23:58:22+00:00,"48.828374828097, 2.3842737458056",Paris,75056,0.03571428571428571,0
18009,Jean-François Lépine - Stephenson,OUI,19,5,14,3,11,OUI,OUI,2025-03-14 00:02:29+00:00,"48.88611466796807, 2.356855627529275",Paris,75056,0.7368421052631579,0
16108,Sablons - Georges Mandel,OUI,38,34,4,1,3,OUI,OUI,2025-03-14 00:00:36+00:00,"48.863875, 2.28189",Paris,75056,0.10526315789473684,0
21008,Victor Hugo - Galliéni,OUI,33,1,32,20,12,OUI,OUI,2025-03-14 00:02:52+00:00,"48.838020154411, 2.2460845112801",Boulogne-Billancourt,92012,0.9696969696969697,0
17125,Marie-Georges Picquart - Pereire,OUI,32,20,12,4,8,OUI,OUI,2025-03-13 23:55:12+00:00,"48.88863669349711, 2.3111706599593163",Paris,75056,0.375,0
20134,Lieutenant Chauré - Etienne Marey,OUI,19,10,9,1,8,OUI,OUI,2025-03-14 00:01:17+00:00,"48.86746195408435, 2.405970990657807",Paris,75056,0.47368421052631576,0
16136,Théophile Gautier - François Millet,OUI,27,3,24,23,1,OUI,OUI,2025-03-14 00:03:09+00:00,"48.85034821320644, 2.273029983043671",Paris,75056,0.8888888888888888,0
24001,Arche - Léonard de Vinci,OUI,27,24,3,1,2,OUI,OUI,2025-03-13 23:56:43+00:00,"48.89790972494496, 2.2383723043644914",Courbevoie,92026,0.1111111111111111,0
19022,Marché Secrétan,OUI,25,24,1,0,1,OUI,OUI,2025-03-13 23:59:52+00:00,"48.88125496379482, 2.373463287949562",Paris,75056,0.04,0
22016,Charles de Gaulle - Sablonville,OUI,26,23,3,0,3,OUI,OUI,2025-03-14 00:01:25+00:00,"48.87991924860035, 2.2763770446181297",Neuilly-sur-Seine,92051,0.11538461538461539,0
16008,Galilée - Kléber,OUI,29,27,2,0,2,OUI,OUI,2025-03-14 00:02:37+00:00,"48.867411865714, 2.2907813801148",Paris,75056,0.06896551724137931,0
11035,Parmentier - Abel Rabaud,OUI,51,27,24,14,10,OUI,OUI,2025-03-14 00:01:29+00:00,"48.86921273836114, 2.371688821240712",Paris,75056,0.47058823529411764,0
14136,Auguste Cain - Jean Moulin,OUI,40,23,17,2,15,OUI,OUI,2025-03-14 00:02:54+00:00,"48.82577028927573, 2.3210415244102482",Paris,75056,0.425,0
42010,Mairie d'Ivry-sur-Seine,OUI,51,19,32,27,5,OUI,OUI,2025-03-13 23:58:35+00:00,"48.81057120969284, 2.3842826485633855",Ivry-sur-Seine,94041,0.6274509803921569,0
32302,Chemin Vert - Fraternité,OUI,20,12,8,0,8,OUI,OUI,2025-03-13 23:55:10+00:00,"48.877141208359035, 2.4461565166711807",Romainville,93063,0.4,0
15046,Parc Georges Brassens - Brancion,OUI,27,8,19,7,12,OUI,OUI,2025-03-13 23:59:13+00:00,"48.83227829269761, 2.3022570088505745",Paris,75056,0.7037037037037037,0
10014,Marseille - Beaurepaire,OUI,50,13,37,35,2,OUI,OUI,2025-03-13 23:59:51+00:00,"48.871624306962985, 2.3639265082738348",Paris,75056,0.74,0
46001,Place Paul Eluard,OUI,19,4,15,8,7,OUI,OUI,2025-03-13 23:55:55+00:00,"48.7672039733195, 2.4144977331161503",Choisy-le-Roi,94022,0.7894736842105263,0
16040,Exelmans - Michel-Ange,OUI,31,11,20,12,8,OUI,OUI,2025-03-14 00:01:16+00:00,"48.84309486651855, 2.2597770800669053",Paris,75056,0.6451612903225806,0
22006,Pierret - Madrid,OUI,26,23,3,2,1,OUI,OUI,2025-03-14 00:01:15+00:00,"48.882976576876565, 2.260125767248034",Neuilly-sur-Seine,92051,0.11538461538461539,0
17028,Reims - Raymond Pitet,OUI,36,8,28,18,10,OUI,OUI,2025-03-14 00:02:45+00:00,"48.8888, 2.296319",Paris,75056,0.7777777777777778,0
21301,Saint-Vincent - Verdun,OUI,33,11,22,15,7,OUI,OUI,2025-03-14 00:01:40+00:00,"48.819211549234495, 2.254007756710053",Issy-les-Moulineaux,92040,0.6666666666666666,0
42302,Aristide Briand - Gare de Bagneux,OUI,20,12,8,3,5,OUI,OUI,2025-03-13 23:54:37+00:00,"48.79387269664978, 2.321148812770844",Cachan,94016,0.4,0
19016,Hautpoul - Jean Jaurès,OUI,29,23,6,2,4,OUI,OUI,2025-03-14 00:00:49+00:00,"48.886393679436, 2.3865414544355",Paris,75056,0.20689655172413793,0
19029,Seine - Flandre,OUI,19,16,3,2,1,OUI,OUI,2025-03-13 23:58:13+00:00,"48.886785741479684, 2.3746193200349808",Paris,75056,0.15789473684210525,0
21104,Madame de Sanzillon - Mozart,OUI,22,20,2,1,1,OUI,OUI,2025-03-14 00:00:28+00:00,"48.90379820774301, 2.3187401890754704",Clichy,92024,0.09090909090909091,0
9032,Mathurins - Auber,OUI,35,31,4,4,0,OUI,OUI,2025-03-13 23:58:31+00:00,"48.872988840744, 2.3294984212276",Paris,75056,0.11428571428571428,0
11042,Grand Prieuré - Crussol,OUI,46,9,37,36,1,OUI,OUI,2025-03-14 00:00:49+00:00,"48.864660627935, 2.3692265531829",Paris,75056,0.8043478260869565,0
32003,Wilson - Métallurgie,OUI,28,3,25,8,17,OUI,OUI,2025-03-14 00:03:15+00:00,"48.909423010092326, 2.3584435880184174",Saint-Denis,93066,0.8928571428571429,0
9005,Square d'Anvers,OUI,32,30,2,1,1,OUI,OUI,2025-03-14 00:01:44+00:00,"48.882633484311, 2.3448844062122",Paris,75056,0.0625,0
32026,Leroy des Barres - Médiathèque,OUI,26,2,24,8,16,OUI,OUI,2025-03-14 00:03:08+00:00,"48.928253687082, 2.3681719727966",Saint-Denis,93066,0.9230769230769231,0
1013,Place du Palais Royal,OUI,63,47,16,16,0,OUI,OUI,2025-03-14 00:02:58+00:00,"48.862382970647, 2.3384822532535",Paris,75056,0.25396825396825395,0
8025,Miromesnil - La Boétie,OUI,32,31,1,0,1,OUI,OUI,2025-03-14 00:02:42+00:00,"48.873722412917, 2.3158480972052",Paris,75056,0.03125,0
7102,Mairie du 7ème,OUI,47,29,18,14,4,OUI,OUI,2025-03-14 00:03:14+00:00,"48.8577967, 2.3192664",Paris,75056,0.3829787234042553,0
13002,Arago - Glacière,OUI,26,6,20,10,10,OUI,OUI,2025-03-14 00:01:55+00:00,"48.83486054775774, 2.3445770524322067",Paris,75056,0.7692307692307693,0
42301,Gare Arcueil - Cachan,OUI,25,20,5,0,5,OUI,OUI,2025-03-13 23:56:06+00:00,"48.799824, 2.328171",Arcueil,94003,0.2,0
20111,Villiers de l'Isle Adam - Pyrénées,OUI,20,11,9,0,9,OUI,OUI,2025-03-14 00:00:35+00:00,"48.867362, 2.396222",Paris,75056,0.45,0
20121,Boyer - Ménilmontant,OUI,19,12,7,0,7,OUI,OUI,2025-03-14 00:02:21+00:00,"48.868895162679, 2.3919824145635",Paris,75056,0.3684210526315789,0
20043,Charonne - Avron,OUI,25,23,2,0,2,OUI,OUI,2025-03-14 00:01:29+00:00,"48.851602665222, 2.3984030470379",Paris,75056,0.08,0
19013,Laumière - Petit,OUI,32,7,25,10,15,OUI,OUI,2025-03-14 00:00:47+00:00,"48.88467368538326, 2.380039058625698",Paris,75056,0.78125,0
32016,Place de la Porte de Paris,OUI,35,22,13,5,8,OUI,OUI,2025-03-14 00:02:19+00:00,"48.93009363207303, 2.3564037680625916",Saint-Denis,93066,0.37142857142857144,0
42504,Gare RER de Gentilly,OUI,30,16,14,5,9,OUI,OUI,2025-03-13 23:58:22+00:00,"48.814280450380224, 2.3410347104072575",Gentilly,94037,0.4666666666666667,0
15201,Place Amédée Gordini - Lefebvre,OUI,36,34,2,2,0,OUI,OUI,2025-03-14 00:02:42+00:00,"48.83061737745, 2.2920634208276",Paris,75056,0.05555555555555555,0
26013,Quai du docteur Dervaux,OUI,26,8,18,13,5,OUI,OUI,2025-03-13 23:59:58+00:00,"48.910482, 2.297998",Asnières-sur-Seine,92004,0.6923076923076923,0
19008,Flandre - Alphonse Karr,OUI,26,20,6,4,2,OUI,OUI,2025-03-13 23:56:47+00:00,"48.89465, 2.381868",Paris,75056,0.23076923076923078,0
42015,Place Jean Ferrat,OUI,25,5,20,8,12,OUI,OUI,2025-03-14 00:03:02+00:00,"48.8184945213025, 2.3744174838066106",Ivry-sur-Seine,94041,0.8,0
11004,Charonne - Faubourg Saint-Antoine,OUI,32,8,24,22,2,OUI,OUI,2025-03-14 00:02:07+00:00,"48.852191909696, 2.3740932717919",Paris,75056,0.75,0
31010,Stalingrad - Désiré Chevalier,OUI,41,30,11,5,6,OUI,OUI,2025-03-14 00:01:29+00:00,"48.85670169739857, 2.445072233676911",Montreuil,93048,0.2682926829268293,0
18201,Tristan Tzara -  Tchaïkovski,OUI,33,19,14,4,10,OUI,OUI,2025-03-13 23:58:49+00:00,"48.89490221746837, 2.3648490384221077",Paris,75056,0.42424242424242425,0
92008,Hôtel de Ville de Nanterre,OUI,35,16,19,11,8,OUI,OUI,2025-03-14 00:01:17+00:00,"48.892371898250424, 2.205548956990242",Nanterre,92050,0.5428571428571428,0
12009,Charenton - Diderot,OUI,18,5,13,10,3,OUI,OUI,2025-03-14 00:02:36+00:00,"48.846171461187, 2.3793068155646",Paris,75056,0.7222222222222222,0
41402,Victor Hugo - Ecoles,OUI,23,1,22,12,10,OUI,OUI,2025-03-14 00:02:02+00:00,"48.80476007936134, 2.4180373930262093",Alfortville,94002,0.9565217391304348,0
19125,Place de l'Édit de Nantes,OUI,29,3,26,17,9,OUI,OUI,2025-03-14 00:01:33+00:00,"48.88879, 2.3785",Paris,75056,0.896551724137931,0
51004,Général Delambre - Prebuard,OUI,28,19,9,3,6,OUI,OUI,2025-03-14 00:02:52+00:00,"48.93870344444, 2.2234171606307",Argenteuil,95018,0.32142857142857145,0
14036,Boulard - Daguerre,OUI,43,37,6,2,4,OUI,OUI,2025-03-13 23:59:57+00:00,"48.83446472680611, 2.3293386027216907",Paris,75056,0.13953488372093023,0
18012,Stephenson - Doudeauville,OUI,36,13,23,9,14,OUI,OUI,2025-03-14 00:02:36+00:00,"48.888537048944826, 2.3561610281467438",Paris,75056,0.6388888888888888,0
19205,Simon Bolivar - Henri Turot,OUI,23,8,15,5,10,OUI,OUI,2025-03-14 00:02:27+00:00,"48.877475489801, 2.3739709492211",Paris,75056,0.6521739130434783,0
11036,Jules Ferry - Faubourg du Temple Paris,OUI,55,8,47,41,6,OUI,OUI,2025-03-14 00:02:46+00:00,"48.868397, 2.3678933",Paris,75056,0.8545454545454545,0
5123,Saint-Germain - Thenard,OUI,29,26,3,2,1,OUI,OUI,2025-03-14 00:00:48+00:00,"48.850571, 2.3471015",Paris,75056,0.10344827586206896,0
9021,Saint Georges - d'Aumale,OUI,23,23,0,0,0,OUI,OUI,2025-03-14 00:00:11+00:00,"48.87778639599673, 2.337429821491241",Paris,75056,0.0,0
43003,Hôpital Bégin,OUI,26,25,1,1,0,NON,NON,2025-03-13 23:54:59+00:00,"48.84571672113, 2.4272462725639",Vincennes,94080,0.038461538461538464,0
12027,Montgallet - Charenton,OUI,15,0,15,14,1,OUI,OUI,2025-03-14 00:02:26+00:00,"48.842647778701, 2.3861649278137",Paris,75056,1.0,0
23009,Anatole France - Louise Michel,OUI,47,33,14,11,3,OUI,OUI,2025-03-14 00:02:15+00:00,"48.88873214926474, 2.2881576418876652",Levallois-Perret,92044,0.2978723404255319,0
42029,Stalingrad - Germaine Tailleferre,OUI,28,15,13,4,9,OUI,OUI,2025-03-14 00:01:04+00:00,"48.80257200481316, 2.3786691203713417",Ivry-sur-Seine,94041,0.4642857142857143,0
26007,Square Gilbert Thomain,OUI,19,9,10,3,7,OUI,OUI,2025-03-14 00:01:40+00:00,"48.90717373809284, 2.2695400938391685",Asnières-sur-Seine,92004,0.5263157894736842,0
8035,Bienfaisance - Place de Narvik,OUI,35,34,1,0,1,OUI,OUI,2025-03-14 00:03:14+00:00,"48.87660163459077, 2.3129771277308464",Paris,75056,0.02857142857142857,0
16111,Faustin Hélie - Desbordes-Valmore,OUI,27,22,5,1,4,OUI,OUI,2025-03-14 00:00:29+00:00,"48.859403, 2.276522",Paris,75056,0.18518518518518517,0
21313,Guynemer - Séverine,OUI,23,7,16,16,0,OUI,OUI,2025-03-14 00:00:25+00:00,"48.83091743371036, 2.2790706530213356",Issy-les-Moulineaux,92040,0.6956521739130435,0
18110,Departement - Pajol,OUI,16,4,12,4,8,OUI,OUI,2025-03-14 00:02:45+00:00,"48.886674849730184, 2.3613611608743668",Paris,75056,0.75,0
17102,Alfred Roll - Berthier,OUI,28,16,12,5,7,OUI,OUI,2025-03-13 23:59:32+00:00,"48.887808570529, 2.3000952981763",Paris,75056,0.42857142857142855,0
19005,Flandre - Riquet,OUI,20,0,20,3,17,OUI,OUI,2025-03-13 23:58:23+00:00,"48.888013281448, 2.3737595955229",Paris,75056,1.0,0
28001,Richard Wallace - Place du 8 Mai 1945,OUI,28,0,28,17,11,OUI,OUI,2025-03-14 00:02:43+00:00,"48.87866794788021, 2.2420343756675725",Puteaux,92062,1.0,0
41606,Pasteur - Gambetta,OUI,19,15,4,3,1,OUI,OUI,2025-03-14 00:03:06+00:00,"48.84572797384512, 2.4236011505126953",Saint-Mandé,94067,0.21052631578947367,0
11007,Jean Macé - Faidherbe,OUI,58,6,52,33,19,OUI,OUI,2025-03-14 00:02:03+00:00,"48.85337548426, 2.3828620836139",Paris,75056,0.896551724137931,0
12013,Montgallet - Reuilly,OUI,14,5,9,2,7,OUI,OUI,2025-03-14 00:01:55+00:00,"48.844291, 2.3896481",Paris,75056,0.6428571428571429,0
15025,Dupleix - du Guesclin,OUI,44,6,38,33,5,OUI,OUI,2025-03-14 00:02:29+00:00,"48.85147910413369, 2.296709530055523",Paris,75056,0.8636363636363636,0
11115,Montreuil - Gonnet,OUI,24,0,24,20,4,OUI,OUI,2025-03-14 00:01:47+00:00,"48.850500564921, 2.3890856287864",Paris,75056,1.0,0
35018,Ancien Canal - Hélène Brion,OUI,23,15,8,4,4,OUI,OUI,2025-03-14 00:03:14+00:00,"48.89484799296163, 2.4188338592648506",Pantin,93055,0.34782608695652173,0
7015,Varenne,OUI,43,29,14,12,2,OUI,OUI,2025-03-14 00:00:17+00:00,"48.857202661803, 2.3152771219611",Paris,75056,0.32558139534883723,0
10113,Parmentier - Hôpital Saint-Louis,OUI,41,20,21,11,10,OUI,OUI,2025-03-14 00:02:16+00:00,"48.871379874257, 2.3698963836667",Paris,75056,0.5121951219512195,0
5021,Jussieu - Fossés Saint-Bernard,OUI,38,35,3,3,0,OUI,OUI,2025-03-14 00:01:34+00:00,"48.847185510023, 2.3534858599305",Paris,75056,0.07894736842105263,0
17011,Fragonard - Porte de Clichy,OUI,52,27,25,24,1,OUI,OUI,2025-03-14 00:02:17+00:00,"48.894155633419, 2.3143893107772",Paris,75056,0.4807692307692308,0
8033,Commandant Rivière,OUI,39,35,4,2,2,OUI,OUI,2025-03-13 23:58:40+00:00,"48.872933, 2.309796",Paris,75056,0.10256410256410256,0
17045,Place des Ternes.,OUI,46,44,2,1,1,OUI,OUI,2025-03-14 00:02:44+00:00,"48.878438631226516, 2.297727763652802",Paris,75056,0.043478260869565216,0
16121,Jardin d'Acclimatation,OUI,30,23,7,1,6,OUI,OUI,2025-03-14 00:02:08+00:00,"48.878772242510465, 2.270772233605385",Paris,75056,0.23333333333333334,0
43402,Place de Verdun,OUI,40,17,23,18,5,OUI,OUI,2025-03-14 00:01:43+00:00,"48.8202823, 2.473775",Joinville-le-Pont,94042,0.575,0
41102,Gare de Laplace,OUI,43,38,5,1,4,OUI,OUI,2025-03-14 00:01:32+00:00,"48.80893199114179, 2.3349460959434514",Arcueil,94003,0.11627906976744186,0
33018,Edouard Poisson - Victor Hugo,OUI,28,17,11,2,9,OUI,OUI,2025-03-13 23:59:09+00:00,"48.91118557052621, 2.379864752692811",Aubervilliers,93001,0.39285714285714285,0
18141,Clignancourt - Sofia,OUI,19,0,19,2,17,OUI,OUI,2025-03-13 23:59:27+00:00,"48.88511992309783, 2.34719488842051",Paris,75056,1.0,0
21305,Place Jacques Madaule,OUI,24,2,22,18,4,OUI,OUI,2025-03-13 23:55:42+00:00,"48.823933787309, 2.2606918215752",Issy-les-Moulineaux,92040,0.9166666666666666,0
33003,Bordier - Félix Faure,OUI,46,19,27,15,12,OUI,OUI,2025-03-14 00:01:47+00:00,"48.90390751882016, 2.3830059170722966",Aubervilliers,93001,0.5869565217391305,0
33009,Félix Faure - Sadi Carnot,OUI,33,27,6,5,1,OUI,OUI,2025-03-14 00:03:14+00:00,"48.90812110228388, 2.378623187541962",Aubervilliers,93001,0.18181818181818182,0
6013,Jacques Callot - Mazarine,OUI,27,1,26,25,1,OUI,OUI,2025-03-14 00:02:18+00:00,"48.855280175332, 2.3375743255019",Paris,75056,0.9629629629629629,0
5106,Cujas - Saint-Michel,OUI,19,18,1,0,1,OUI,OUI,2025-03-14 00:02:37+00:00,"48.848191348584, 2.341831654854",Paris,75056,0.05263157894736842,0
12115,Porte de Vincennes,OUI,32,24,8,4,4,OUI,OUI,2025-03-13 23:56:02+00:00,"48.846454, 2.415514",Paris,75056,0.25,0
14034,Ouest - Château,OUI,23,10,13,6,7,OUI,OUI,2025-03-14 00:03:02+00:00,"48.83617286014242, 2.319392143923804",Paris,75056,0.5652173913043478,0
23001,Paul Vaillant Couturier - Chaptal,OUI,35,31,4,3,1,OUI,OUI,2025-03-14 00:00:57+00:00,"48.893479576183, 2.2775253653526",Levallois-Perret,92044,0.11428571428571428,0
12034,Pirogues de Bercy - Libourne,OUI,48,45,3,2,1,OUI,OUI,2025-03-13 23:53:42+00:00,"48.832308, 2.38637",Paris,75056,0.0625,0
15010,Square Cambronne,OUI,58,0,58,54,4,OUI,OUI,2025-03-14 00:02:24+00:00,"48.84756654526, 2.3025691509247",Paris,75056,1.0,0
15033,Place Violet,OUI,27,3,24,17,7,OUI,OUI,2025-03-14 00:02:49+00:00,"48.84487893836502, 2.2905756533145905",Paris,75056,0.8888888888888888,0
17037,Bayen - Pereire,OUI,21,10,11,9,2,OUI,OUI,2025-03-14 00:02:49+00:00,"48.881804409079656, 2.2921088710427284",Paris,75056,0.5238095238095238,0
25008,Place du 8 Mai 1945,OUI,18,14,4,3,1,OUI,OUI,2025-03-14 00:01:12+00:00,"48.871552174017, 2.2025031970585",Rueil-Malmaison,92063,0.2222222222222222,0
16124,Route de Sèvres - Porte de Bagatelle,OUI,66,3,63,56,7,OUI,OUI,2025-03-14 00:01:35+00:00,"48.87525984132485, 2.249415814876557",Paris,75056,0.9545454545454546,0
19044,Grands Moulins de Pantin,OUI,50,47,3,0,3,OUI,OUI,2025-03-14 00:03:15+00:00,"48.89738369720229, 2.3959985375404362",Paris,75056,0.06,0
25005,18 juin 1940 - Buzenval,OUI,25,12,13,4,9,OUI,OUI,2025-03-14 00:00:48+00:00,"48.868807, 2.185428",Rueil-Malmaison,92063,0.52,0
33001,Victor Hugo - Magasins Généraux,OUI,33,32,1,0,1,OUI,OUI,2025-03-13 23:53:27+00:00,"48.903281401126755, 2.368072383105755",Aubervilliers,93001,0.030303030303030304,0
22505,Mairie de La Garenne Colombes,OUI,22,5,17,9,8,OUI,OUI,2025-03-14 00:02:43+00:00,"48.90663823468682, 2.24679596722126",La Garenne-Colombes,92035,0.7727272727272727,0
16034,Porte d'Auteuil,OUI,31,20,11,2,9,OUI,OUI,2025-03-14 00:00:27+00:00,"48.8479394142243, 2.2608396783471107",Paris,75056,0.3548387096774194,0
13045,Jean Colly - Tolbiac,OUI,36,25,11,5,6,OUI,OUI,2025-03-14 00:03:16+00:00,"48.827817291597846, 2.3705490678548813",Paris,75056,0.3055555555555556,0
41404,Carnot - Pâquerettes,OUI,24,2,22,15,7,OUI,OUI,2025-03-14 00:02:59+00:00,"48.79592939432515, 2.4261841177940373",Alfortville,94002,0.9166666666666666,0
19115,Porte de la Villette,OUI,26,12,14,6,8,OUI,OUI,2025-03-13 23:53:10+00:00,"48.89835196548483, 2.386150136590004",Paris,75056,0.5384615384615384,0
7009,Assemblée Nationale,OUI,74,58,16,14,2,OUI,OUI,2025-03-14 00:02:36+00:00,"48.861411014652, 2.3201214185208",Paris,75056,0.21621621621621623,0
32010,Place aux Étoiles,OUI,37,35,2,0,2,OUI,OUI,2025-03-13 23:55:49+00:00,"48.91835629408464, 2.3523425683379173",Saint-Denis,93066,0.05405405405405406,0
20132,Réunion - Avron,OUI,26,12,14,3,11,OUI,OUI,2025-03-14 00:02:26+00:00,"48.852566752033766, 2.403928068708116",Paris,75056,0.5384615384615384,0
16018,Flandrin - Henri Martin,OUI,17,14,3,1,2,OUI,OUI,2025-03-13 23:56:26+00:00,"48.8643275, 2.2724174",Paris,75056,0.17647058823529413,0
42707,Place Jean-Baptiste Clément,OUI,24,20,4,3,1,OUI,OUI,2025-03-13 23:59:00+00:00,"48.81240466867336, 2.3617091774940495",Le Kremlin-Bicêtre,94043,0.16666666666666666,0
24002,Gare de Courbevoie,OUI,31,22,9,2,7,OUI,OUI,2025-03-14 00:02:06+00:00,"48.8993867, 2.2506506",Courbevoie,92026,0.2903225806451613,0
92003,Chanzy - Sud-Est,OUI,25,2,23,13,10,OUI,OUI,2025-03-14 00:03:06+00:00,"48.888912037698766, 2.195632159709931",Nanterre,92050,0.92,0
5119,Jussieu - Guy de la Brosse,OUI,40,39,1,0,1,OUI,OUI,2025-03-13 23:50:48+00:00,"48.845665, 2.355653",Paris,75056,0.025,0
35009,Jean Lolive - Parc Stalingrad,OUI,21,13,8,3,5,OUI,OUI,2025-03-14 00:03:07+00:00,"48.89206174403158, 2.4091735482215886",Pantin,93055,0.38095238095238093,0
21109,Guichet - Jean Jaurès,OUI,23,2,21,15,6,OUI,OUI,2025-03-14 00:00:21+00:00,"48.905169868129036, 2.3023840785026555",Clichy,92024,0.9130434782608695,0
19019,Petit - Manin,OUI,22,22,0,0,0,NON,NON,2025-03-14 00:01:20+00:00,"48.886506875343, 2.3938155401308",Paris,75056,0.0,0
31012,Place Carnot,OUI,23,6,17,3,14,OUI,OUI,2025-03-14 00:02:16+00:00,"48.85593932186797, 2.441531717777252",Montreuil,93048,0.7391304347826086,0
8055,Courcelles - Place des Ternes,OUI,27,27,0,0,0,OUI,OUI,2025-03-14 00:00:21+00:00,"48.878199928923124, 2.2992860188665043",Paris,75056,0.0,0
20113,Piat - Parc de Belleville,OUI,20,7,13,0,13,OUI,OUI,2025-03-14 00:02:32+00:00,"48.87195626635528, 2.384981390278095",Paris,75056,0.65,0
27002,Parc Pierre Lagravère,OUI,30,11,19,8,11,OUI,OUI,2025-03-14 00:02:24+00:00,"48.92650488131725, 2.239069678491417",Colombes,92025,0.6333333333333333,0
23802,Raymond Poincaré - Allée de la Marche,OUI,22,17,5,4,1,OUI,OUI,2025-03-13 23:54:55+00:00,"48.838634069623, 2.1724102640451",Garches,92033,0.22727272727272727,0
23701,Parvis Robert Schuman - Roger Salengro,OUI,24,11,13,5,8,OUI,OUI,2025-03-14 00:00:16+00:00,"48.812657470558754, 2.1921751275658607",Chaville,92022,0.5416666666666666,0
12126,Gravelle - Route du Bac,OUI,48,29,19,10,9,OUI,OUI,2025-03-14 00:03:01+00:00,"48.824407, 2.418455",Paris,75056,0.3958333333333333,0
17007,Navier - Epinettes,OUI,36,11,25,12,13,OUI,OUI,2025-03-13 23:59:31+00:00,"48.89587780769155, 2.3226776719093327",Paris,75056,0.6944444444444444,0
18005,Tardieu - Chappe,OUI,16,5,11,1,10,OUI,OUI,2025-03-14 00:03:01+00:00,"48.884146759782, 2.341845408082",Paris,75056,0.6875,0
21502,Verdun - Place Henri IV,OUI,25,11,14,9,5,OUI,OUI,2025-03-14 00:01:58+00:00,"48.870797375639214, 2.2277003154158592",Suresnes,92073,0.56,0
92004,Nanterre - Université,OUI,19,8,11,9,2,OUI,OUI,2025-03-14 00:02:26+00:00,"48.901365, 2.212693",Nanterre,92050,0.5789473684210527,0
12024,Gare de Bercy,OUI,35,7,28,25,3,OUI,OUI,2025-03-14 00:01:35+00:00,"48.839794573906, 2.3826066032052",Paris,75056,0.8,0
5002,Sommerard - Saint-Jacques,OUI,33,31,2,2,0,OUI,OUI,2025-03-14 00:01:56+00:00,"48.850310432924466, 2.345015835298588",Paris,75056,0.06060606060606061,0
16129,Ceinture du Lac Inferieure - Saint-Cloud,OUI,40,40,0,0,0,OUI,OUI,2025-03-14 00:00:32+00:00,"48.86218070933143, 2.2617871686816216",Paris,75056,0.0,0
15028,Grenelle - Dr Finlay,OUI,69,3,66,64,2,OUI,OUI,2025-03-14 00:02:42+00:00,"48.851315406715976, 2.2919502854347233",Paris,75056,0.9565217391304348,0
35019,Anatole France - Jean Lolive,OUI,28,15,13,2,11,OUI,OUI,2025-03-13 23:55:59+00:00,"48.8949922, 2.4253764",Pantin,93055,0.4642857142857143,0
14018,Porte d'Orléans,OUI,44,41,3,1,2,OUI,OUI,2025-03-13 23:57:51+00:00,"48.8227639, 2.3249313",Paris,75056,0.06818181818181818,0
14104,Boyer-Barret - Raymond Losserand,OUI,23,16,7,2,5,OUI,OUI,2025-03-14 00:00:02+00:00,"48.83329880233322, 2.3173383995890617",Paris,75056,0.30434782608695654,0
31702,Pierre et Marie Curie - Julien Grimau,OUI,18,13,5,0,5,OUI,OUI,2025-03-14 00:01:35+00:00,"48.870714014863225, 2.424097023904324",Bagnolet,93006,0.2777777777777778,0
20119,Square des Saint-Simoniens,OUI,25,11,14,0,14,OUI,OUI,2025-03-13 23:57:34+00:00,"48.8701796, 2.3967273",Paris,75056,0.56,0
21013,Pierre Grenier - Pont de Billancourt,OUI,21,1,20,16,4,OUI,OUI,2025-03-13 23:58:22+00:00,"48.8258020742942, 2.2487989068031315",Boulogne-Billancourt,92012,0.9523809523809523,0
31705,Champeaux - Gallieni,OUI,47,44,3,3,0,OUI,OUI,2025-03-14 00:00:30+00:00,"48.864459134684644, 2.4161778017878532",Bagnolet,93006,0.06382978723404255,0
42503,Vladimir Ilitch Lénine - Andrée Chedid,OUI,31,22,9,2,7,OUI,OUI,2025-03-14 00:02:53+00:00,"48.813240124373, 2.3319716067039",Gentilly,94037,0.2903225806451613,0
6030,Assas - Vaugirard,OUI,33,29,4,2,2,OUI,OUI,2025-03-14 00:00:52+00:00,"48.848274111398, 2.3292413726449",Paris,75056,0.12121212121212122,0
21111,Professeur René Leriche - Général Leclerc,OUI,49,32,17,10,7,OUI,OUI,2025-03-14 00:01:53+00:00,"48.90782845483013, 2.307887971401215",Clichy,92024,0.3469387755102041,0
20036,Ménilmontant - Pelleport,OUI,31,26,5,0,5,OUI,OUI,2025-03-14 00:01:40+00:00,"48.870682633845, 2.3989596023316",Paris,75056,0.16129032258064516,0
11114,Ledru-Rollin - Charonne,OUI,31,18,13,10,3,OUI,OUI,2025-03-14 00:02:12+00:00,"48.85345855607243, 2.3772463581947094",Paris,75056,0.41935483870967744,0
15122,Place Charles Vallin,OUI,26,2,24,9,15,OUI,OUI,2025-03-14 00:01:05+00:00,"48.835523812041, 2.3025986552238",Paris,75056,0.9230769230769231,0
7006,Quai Voltaire,OUI,30,19,11,6,5,OUI,OUI,2025-03-14 00:01:36+00:00,"48.858942986179, 2.3314182047146",Paris,75056,0.36666666666666664,0
41604,Lagny - Joffre,OUI,30,28,2,1,1,OUI,OUI,2025-03-13 23:56:48+00:00,"48.84930687084088, 2.417949736118317",Saint-Mandé,94067,0.06666666666666667,0
17017,Gare de Pont-Cardinet,OUI,33,28,5,1,4,OUI,OUI,2025-03-13 23:56:37+00:00,"48.88713901475306, 2.314494143994255",Paris,75056,0.15151515151515152,0
15017,Place Falguière,OUI,23,18,5,1,4,OUI,OUI,2025-03-13 23:58:43+00:00,"48.83629973941847, 2.3104464635252953",Paris,75056,0.21739130434782608,0
23002,Pont de Levallois-bécon,OUI,49,44,5,2,3,OUI,OUI,2025-03-14 00:01:30+00:00,"48.8984179, 2.2791311",Levallois-Perret,92044,0.10204081632653061,0
15029,Emeriau - Place de Brazzaville,OUI,51,20,31,28,3,OUI,OUI,2025-03-14 00:02:01+00:00,"48.850785261674964, 2.2871585190296173",Paris,75056,0.6078431372549019,0
14139,Pierre Larousse - Raymond Losserand,OUI,30,20,10,4,6,OUI,OUI,2025-03-14 00:02:47+00:00,"48.83059564231877, 2.3119183257222176",Paris,75056,0.3333333333333333,0
17018,Parc Monceau,OUI,18,15,3,3,0,OUI,OUI,2025-03-14 00:02:30+00:00,"48.881077914129, 2.3095492646098",Paris,75056,0.16666666666666666,0
14130,Jonquoy - Didot,OUI,30,2,28,12,16,OUI,OUI,2025-03-14 00:00:33+00:00,"48.82890454823947, 2.31648076325655",Paris,75056,0.9333333333333333,0
10005,Petites Ecuries - Faubourg Poissonnière,OUI,17,2,15,14,1,OUI,OUI,2025-03-14 00:01:34+00:00,"48.87397217237368, 2.348388757504776",Paris,75056,0.8823529411764706,0
41207,Place du Général de Gaulle,OUI,28,26,2,0,2,OUI,OUI,2025-03-14 00:01:01+00:00,"48.8525288, 2.4877332",Fontenay-sous-Bois,94033,0.07142857142857142,0
26001,Gare d'Asnières sur Seine,OUI,21,7,14,7,7,OUI,OUI,2025-03-14 00:02:15+00:00,"48.90636459217474, 2.2835066914558415",Asnières-sur-Seine,92004,0.6666666666666666,0
12011,Charenton - Place du Col Bourgoin,OUI,35,11,24,18,6,OUI,OUI,2025-03-14 00:02:33+00:00,"48.844867319554, 2.3825789350545",Paris,75056,0.6857142857142857,0
18020,Francoeur - Marcadet,OUI,19,7,12,3,9,OUI,OUI,2025-03-14 00:00:08+00:00,"48.89104123261663, 2.340014585442034",Paris,75056,0.631578947368421,0
15038,Place Adolphe Cherioux - Vaugirard,OUI,62,18,44,25,19,OUI,OUI,2025-03-14 00:02:57+00:00,"48.83959442800459, 2.3010657727718353",Paris,75056,0.7096774193548387,0
20136,Henri Chevreau - Couronnes,OUI,27,19,8,0,8,OUI,OUI,2025-03-13 23:59:05+00:00,"48.87033205312931, 2.388777695596218",Paris,75056,0.2962962962962963,0
21032,Sèvres-Gallieni,OUI,25,18,7,4,3,OUI,OUI,2025-03-14 00:03:11+00:00,"48.837809408957, 2.2281519323587",Boulogne-Billancourt,92012,0.28,0
5026,Pascal - Claude Bernard,OUI,46,7,39,33,6,OUI,OUI,2025-03-14 00:02:53+00:00,"48.839061952159746, 2.3499782010912895",Paris,75056,0.8478260869565217,0
21019,Edouard Vaillant - Paul-Adolphe Souriau,OUI,26,1,25,22,3,OUI,OUI,2025-03-14 00:01:44+00:00,"48.834845858829, 2.2479459643364",Boulogne-Billancourt,92012,0.9615384615384616,0
43006,Vignerons - Minimes,OUI,28,15,13,6,7,OUI,OUI,2025-03-14 00:02:15+00:00,"48.841486, 2.430793",Vincennes,94080,0.4642857142857143,0
21105,Morice - Général Leclerc,OUI,25,1,24,17,7,OUI,OUI,2025-03-14 00:01:09+00:00,"48.90245471981591, 2.3128929734230046",Clichy,92024,0.96,0
8102,Lamennais - Washington,OUI,25,25,0,0,0,OUI,OUI,2025-03-13 23:56:24+00:00,"48.87352990026496, 2.303444892168045",Paris,75056,0.0,0
31019,Vincennes - Douy-Delcupe,OUI,37,28,9,1,8,OUI,OUI,2025-03-14 00:02:28+00:00,"48.85493692155721, 2.436049282550812",Montreuil,93048,0.24324324324324326,0
7004,Raspail - Varenne,OUI,16,15,1,1,0,OUI,OUI,2025-03-13 23:58:05+00:00,"48.853147816545, 2.3263905197382",Paris,75056,0.0625,0
32014,Place du Cornillon - Stade de France,OUI,34,14,20,15,5,OUI,OUI,2025-03-14 00:02:42+00:00,"48.92540695835961, 2.3644426837563515",Saint-Denis,93066,0.5882352941176471,0
2010,Uzès - Montmartre,OUI,29,27,2,1,1,OUI,OUI,2025-03-14 00:01:37+00:00,"48.870790980240706, 2.3431010171771054",Paris,75056,0.06896551724137931,0
18032,Porte de Clignancourt.,OUI,54,27,27,4,23,OUI,OUI,2025-03-14 00:02:25+00:00,"48.897488, 2.343996",Paris,75056,0.5,0
5116,Place Valhubert,OUI,51,4,47,46,1,OUI,OUI,2025-03-14 00:03:16+00:00,"48.844182577315, 2.3640366643667",Paris,75056,0.9215686274509803,0
17027,Place du Maréchal Juin - Péreire,OUI,44,26,18,12,6,OUI,OUI,2025-03-14 00:02:45+00:00,"48.885263, 2.298286",Paris,75056,0.4090909090909091,0
7014,Saint-François-Xavier,OUI,41,29,12,5,7,OUI,OUI,2025-03-14 00:01:48+00:00,"48.85154484769, 2.3146149516106",Paris,75056,0.2926829268292683,0
31016,Lucie Aubrac - Franklin,OUI,35,35,0,0,0,OUI,OUI,2025-03-14 00:01:47+00:00,"48.86223916006812, 2.4435862898826604",Montreuil,93048,0.0,0
8012,Batignolles - Place de Clichy,OUI,46,43,3,0,3,OUI,OUI,2025-03-13 23:56:47+00:00,"48.883474535757, 2.326493114233",Paris,75056,0.06521739130434782,0
8051,Batignolles - Rome,OUI,13,10,3,2,1,OUI,OUI,2025-03-14 00:02:57+00:00,"48.881823370566806, 2.3202589899301524",Paris,75056,0.23076923076923078,0
20040,Parc de Belleville - Julien Lacroix,OUI,26,16,10,2,8,OUI,OUI,2025-03-14 00:02:22+00:00,"48.8703459, 2.3842214",Paris,75056,0.38461538461538464,0
44102,Verdun - Adrien Damalix,OUI,26,10,16,8,8,OUI,OUI,2025-03-14 00:02:42+00:00,"48.8222334178559, 2.4215328320860863",Saint-Maurice,94069,0.6153846153846154,0
10023,Gare de l'Est - Verdun,OUI,13,11,2,1,1,OUI,OUI,2025-03-13 23:56:53+00:00,"48.876156054271, 2.3609149083206",Paris,75056,0.15384615384615385,0
16032,Eglise d'Auteuil,OUI,21,8,13,9,4,OUI,OUI,2025-03-14 00:00:39+00:00,"48.84749841771691, 2.26848387135299",Paris,75056,0.6190476190476191,0
34002,Capitaine Glarner - Gabriel Péri,OUI,24,11,13,4,9,OUI,OUI,2025-03-14 00:00:44+00:00,"48.902449900418745, 2.3304807533425724",Saint-Ouen-sur-Seine,93070,0.5416666666666666,0
22001,Château - Bineau,OUI,20,0,20,17,3,OUI,OUI,2025-03-13 23:59:54+00:00,"48.890404028589806, 2.270106375217438",Neuilly-sur-Seine,92051,1.0,0
13026,Place Jean Delay,OUI,33,8,25,12,13,OUI,OUI,2025-03-14 00:02:21+00:00,"48.823316, 2.354336",Paris,75056,0.7575757575757576,0
18025,Mairie du 18ème,OUI,40,34,6,1,5,OUI,OUI,2025-03-14 00:02:02+00:00,"48.892939296937605, 2.3445510864257812",Paris,75056,0.15,0
13102,Pitié-Salpêtrière,OUI,50,44,6,3,3,OUI,OUI,2025-03-13 23:58:31+00:00,"48.83748810318667, 2.365213818848133",Paris,75056,0.12,0
17122,Bridaine - Lamandé,OUI,28,8,20,6,14,OUI,OUI,2025-03-14 00:03:05+00:00,"48.8862074, 2.3206239",Paris,75056,0.7142857142857143,0
11101,Charles Delescluze,OUI,48,1,47,43,4,OUI,OUI,2025-03-14 00:02:21+00:00,"48.85242200848887, 2.380632497370243",Paris,75056,0.9791666666666666,0
20027,Porte de Ménilmontant,OUI,15,14,1,0,1,OUI,OUI,2025-03-13 23:55:10+00:00,"48.8691543609174, 2.40932246879487",Paris,75056,0.06666666666666667,0
15055,Vasco de Gama,OUI,52,17,35,32,3,OUI,OUI,2025-03-14 00:01:40+00:00,"48.83671783466264, 2.283664085650799",Paris,75056,0.6730769230769231,0
15108,Lourmel - Marie Skobtsov,OUI,22,0,22,13,9,OUI,OUI,2025-03-14 00:02:40+00:00,"48.844974, 2.287283",Paris,75056,1.0,0
10015,Lucien Sampaix - Récollets,OUI,39,31,8,5,3,OUI,OUI,2025-03-14 00:03:15+00:00,"48.874330377560476, 2.3621229082345963",Paris,75056,0.20512820512820512,0
41204,République - Danton,OUI,19,7,12,1,11,OUI,OUI,2025-03-13 23:59:15+00:00,"48.85249172181667, 2.462034523487091",Fontenay-sous-Bois,94033,0.631578947368421,0
21308,Bara - Henri Farman,OUI,56,50,6,6,0,OUI,OUI,2025-03-13 23:58:45+00:00,"48.833218027457846, 2.2677567601203923",Issy-les-Moulineaux,92040,0.10714285714285714,0
17046,Mac-Mahon - Brey,OUI,25,22,3,0,3,OUI,OUI,2025-03-14 00:01:21+00:00,"48.877532084130166, 2.294512536052928",Paris,75056,0.12,0
12032,Porte Dorée,OUI,36,15,21,11,10,OUI,OUI,2025-03-14 00:00:28+00:00,"48.8354337, 2.4077132",Paris,75056,0.5833333333333334,0
17121,Square des Epinettes,OUI,20,0,20,9,11,OUI,OUI,2025-03-14 00:01:02+00:00,"48.89383909781389, 2.325953990221024",Paris,75056,1.0,0
19037,Belleville - Porte des Lilas,OUI,27,9,18,5,13,OUI,OUI,2025-03-14 00:02:38+00:00,"48.87660391892763, 2.404769691129476",Paris,75056,0.6666666666666666,0
18109,Pajol - Riquet,OUI,43,6,37,19,18,OUI,OUI,2025-03-14 00:02:12+00:00,"48.88960028134536, 2.3628534749150276",Paris,75056,0.8604651162790697,0
6103,Mézières - Rennes,OUI,53,48,5,3,2,OUI,OUI,2025-03-14 00:03:00+00:00,"48.85023459321703, 2.3303819820284843",Paris,75056,0.09433962264150944,0
19038,Lassus - Delouvain,OUI,19,2,17,2,15,OUI,OUI,2025-03-13 23:54:27+00:00,"48.8755044846, 2.3890327325519",Paris,75056,0.8947368421052632,0
20021,Indre - Prairies,OUI,38,17,21,2,19,OUI,OUI,2025-03-13 23:59:07+00:00,"48.86254398506782, 2.403290458023548",Paris,75056,0.5526315789473685,0
16021,François Ponsard - La Muette,OUI,23,22,1,0,1,OUI,OUI,2025-03-13 23:53:45+00:00,"48.8583666, 2.2744515",Paris,75056,0.043478260869565216,0
7005,Raspail - Bac,OUI,51,46,5,3,2,OUI,OUI,2025-03-14 00:00:33+00:00,"48.855628721101, 2.3256602883339",Paris,75056,0.09803921568627451,0
9031,Provence - Chaussée d'Antin,OUI,24,17,7,6,1,OUI,OUI,2025-03-14 00:00:26+00:00,"48.87428447542072, 2.332976511564311",Paris,75056,0.2916666666666667,0
6018,Michelet - Assas,OUI,17,14,3,0,3,OUI,OUI,2025-03-14 00:02:14+00:00,"48.842741502832, 2.3350211977959",Paris,75056,0.17647058823529413,0
14002,Edgar Quinet - Raspail,OUI,44,44,0,0,0,OUI,OUI,2025-03-13 23:54:39+00:00,"48.83940266673835, 2.32971478253603",Paris,75056,0.0,0
19109,Tanger - Place du Maroc,OUI,18,7,11,2,9,OUI,OUI,2025-03-14 00:00:50+00:00,"48.8862524447104, 2.3689296841621403",Paris,75056,0.6111111111111112,0
18049,Porte d'Aubervilliers,OUI,53,52,1,0,1,OUI,OUI,2025-03-14 00:02:53+00:00,"48.89859661942376, 2.3689722642302513",Paris,75056,0.018867924528301886,0
17124,Porte de Saint-Ouen - Henri Huchard,OUI,26,19,7,7,0,OUI,OUI,2025-03-13 23:57:12+00:00,"48.898708366365064, 2.3295360803604126",Paris,75056,0.2692307692307692,0
18113,Lepic - Armée d'Orient,OUI,24,21,3,1,2,OUI,OUI,2025-03-13 23:59:57+00:00,"48.887536403814, 2.3343077301979",Paris,75056,0.125,0
44012,Génie - Mozart,OUI,18,13,5,2,3,OUI,OUI,2025-03-13 23:58:42+00:00,"48.794902381218904, 2.3734183609485626",Vitry-sur-Seine,94081,0.2777777777777778,0
31703,Sadi Carnot - François Mitterrand,OUI,26,9,17,1,16,OUI,OUI,2025-03-14 00:01:36+00:00,"48.87532687671517, 2.4241617321968083",Bagnolet,93006,0.6538461538461539,0
51003,Hôtel de Ville d'Argenteuil,OUI,29,11,18,11,7,OUI,OUI,2025-03-13 23:57:37+00:00,"48.946504, 2.2496396",Argenteuil,95018,0.6206896551724138,0
35003,Gabrielle Josserand - Edouard Vaillant,OUI,24,4,20,5,15,OUI,OUI,2025-03-14 00:02:53+00:00,"48.90271566255436, 2.3933270573616032",Pantin,93055,0.8333333333333334,0
22101,Gare Routière de Saint Cloud,OUI,29,13,16,9,7,OUI,OUI,2025-03-14 00:00:58+00:00,"48.84288183896324, 2.222245037555695",Saint-Cloud,92064,0.5517241379310345,0
11006,Ledru-Rollin - Place du Père Chaillet,OUI,37,1,36,33,3,OUI,OUI,2025-03-14 00:01:19+00:00,"48.856433706943704, 2.379020587761426",Paris,75056,0.972972972972973,0
13016,Primo Levi - Frigos,OUI,34,26,8,3,5,OUI,OUI,2025-03-13 23:59:49+00:00,"48.83094844846017, 2.37965351592796",Paris,75056,0.23529411764705882,0
19127,Aubervilliers - Curial,OUI,23,12,11,5,6,OUI,OUI,2025-03-13 23:54:30+00:00,"48.89088305227546, 2.3688579350709915",Paris,75056,0.4782608695652174,0
13043,Dunois - Clisson,OUI,49,26,23,17,6,OUI,OUI,2025-03-14 00:00:44+00:00,"48.832294, 2.3674523",Paris,75056,0.46938775510204084,0
16015,Bassano -  Iéna,OUI,14,13,1,0,1,OUI,OUI,2025-03-14 00:02:32+00:00,"48.868144510482075, 2.296149600985935",Paris,75056,0.07142857142857142,0
2009,Filles Saint-Thomas - Place de la Bourse,OUI,57,53,4,3,1,OUI,OUI,2025-03-14 00:02:08+00:00,"48.868899890853, 2.3397543845203",Paris,75056,0.07017543859649122,0
15070,Balard - Montagne de la Fage,OUI,34,3,31,27,4,OUI,OUI,2025-03-14 00:01:32+00:00,"48.83850740333351, 2.2782871127128606",Paris,75056,0.9117647058823529,0
9115,Milton - Manuel,OUI,21,12,9,5,4,OUI,OUI,2025-03-14 00:01:38+00:00,"48.878249, 2.341181",Paris,75056,0.42857142857142855,0
1120,Lavandieres Sainte Opportune - Rivoli,OUI,24,20,4,2,2,OUI,OUI,2025-03-14 00:03:12+00:00,"48.859279702476, 2.3466217517853",Paris,75056,0.16666666666666666,0
19039,Edouard Pailleron - Simon Bolivar,OUI,23,23,0,0,0,OUI,OUI,2025-03-13 23:56:26+00:00,"48.87979886049996, 2.374839261174202",Paris,75056,0.0,0
47004,Stade Auguste Delaune,OUI,21,4,17,15,2,OUI,OUI,2025-03-14 00:01:02+00:00,"48.80896378683884, 2.4345204234123234",Maisons-Alfort,94046,0.8095238095238095,0
21003,Jean Jaurès - Jean Baptiste Clément,OUI,39,13,26,21,5,OUI,OUI,2025-03-14 00:02:54+00:00,"48.84576261454011, 2.2369650006294255",Boulogne-Billancourt,92012,0.6666666666666666,0
9026,Jean-Baptiste Pigalle - La Bruyere,OUI,17,10,7,6,1,OUI,OUI,2025-03-13 23:59:57+00:00,"48.87939826447722, 2.333709173337285",Paris,75056,0.4117647058823529,0
9023,Laffitte - Italiens,OUI,31,30,1,1,0,OUI,OUI,2025-03-14 00:02:50+00:00,"48.871815737396, 2.3372015478451",Paris,75056,0.03225806451612903,0
11010,Boulets - Faubourg Saint-Antoine,OUI,42,17,25,16,9,OUI,OUI,2025-03-13 23:59:50+00:00,"48.849259262115, 2.3917546141943",Paris,75056,0.5952380952380952,0
14122,Colonel Monteil - Brune,OUI,19,16,3,2,1,OUI,OUI,2025-03-14 00:02:20+00:00,"48.82650293311, 2.3092747998272",Paris,75056,0.15789473684210525,0
16122,Route de la Muette - Porte de Neuilly,OUI,48,36,12,9,3,OUI,OUI,2025-03-14 00:02:29+00:00,"48.8798926, 2.2587671",Paris,75056,0.25,0
16123,Mahatma Gandhi,OUI,24,12,12,11,1,OUI,OUI,2025-03-14 00:00:06+00:00,"48.876356, 2.264205",Paris,75056,0.5,0
32015,Gare RER de Saint-Denis,OUI,37,17,20,8,12,OUI,OUI,2025-03-14 00:02:35+00:00,"48.93554324248177, 2.3471488058567047",Saint-Denis,93066,0.5405405405405406,0
31007,Paris - Désiré Préaux,OUI,45,37,8,3,5,OUI,OUI,2025-03-14 00:01:47+00:00,"48.85742876694898, 2.4323049187660217",Montreuil,93048,0.17777777777777778,0
16043,Place de Passy,OUI,11,10,1,1,0,OUI,OUI,2025-03-14 00:01:39+00:00,"48.85780291711202, 2.277500546942199",Paris,75056,0.09090909090909091,0
19040,Belleville - Télégraphe,OUI,40,26,14,6,8,OUI,OUI,2025-03-14 00:01:59+00:00,"48.8756045, 2.3995549",Paris,75056,0.35,0
16027,Mozart - Jasmin,OUI,62,51,11,7,4,OUI,OUI,2025-03-14 00:02:48+00:00,"48.85286124871689, 2.268483570651513",Paris,75056,0.1774193548387097,0
17047,Courcelles - Pierre Demours,OUI,24,12,12,9,3,OUI,OUI,2025-03-14 00:02:57+00:00,"48.883769733273496, 2.29858466343129",Paris,75056,0.5,0
20116,Haies - Réunion,OUI,21,12,9,2,7,OUI,OUI,2025-03-14 00:01:35+00:00,"48.85386896766491, 2.402426162238911",Paris,75056,0.42857142857142855,0
6016,Danton - Serpente,OUI,20,14,6,5,1,OUI,OUI,2025-03-14 00:00:45+00:00,"48.852297362582, 2.3414132371545",Paris,75056,0.3,0
16029,Maison de Radio - France,OUI,42,3,39,33,6,OUI,OUI,2025-03-14 00:02:54+00:00,"48.85132886434057, 2.277785539627075",Paris,75056,0.9285714285714286,0
19009,Cité des Sciences et de l'Industrie,OUI,27,19,8,2,6,OUI,OUI,2025-03-13 23:59:34+00:00,"48.89659571178903, 2.384599149227142",Paris,75056,0.2962962962962963,0
42703,Fontainebleau - Edmond Michelet,OUI,44,39,5,0,5,OUI,OUI,2025-03-14 00:01:58+00:00,"48.80956436844049, 2.3626908659935",Le Kremlin-Bicêtre,94043,0.11363636363636363,0
18029,Emile Blemont - Poteau,OUI,38,18,20,7,13,OUI,OUI,2025-03-14 00:01:51+00:00,"48.8943782, 2.3415122",Paris,75056,0.5263157894736842,0
14030,Pernety - Raymond Losserand,OUI,32,26,6,2,4,OUI,OUI,2025-03-14 00:01:09+00:00,"48.834254627953, 2.317609339387",Paris,75056,0.1875,0
21703,Square du Carrefour de l'Insurrection,OUI,19,2,17,12,5,OUI,OUI,2025-03-14 00:03:03+00:00,"48.820864559770676, 2.291113436222077",Vanves,92075,0.8947368421052632,0
20201,Eugène Reisz - Davout,OUI,20,20,0,0,0,OUI,OUI,2025-03-13 23:59:35+00:00,"48.85631874632638, 2.410396970808506",Paris,75056,0.0,0
35017,Toffier Decaux - Cartier Bresson,OUI,18,13,5,0,5,OUI,OUI,2025-03-13 23:53:36+00:00,"48.90165072551549, 2.4017545580863957",Pantin,93055,0.2777777777777778,0
13046,Eugène Oudiné - Dessous Des Berges,OUI,42,18,24,19,5,OUI,OUI,2025-03-14 00:02:54+00:00,"48.8256423, 2.3750226",Paris,75056,0.5714285714285714,0
20118,Orteaux - Mouraud,OUI,24,11,13,4,9,OUI,OUI,2025-03-14 00:00:22+00:00,"48.85558642847872, 2.408762907764669",Paris,75056,0.5416666666666666,0
22102,Mont Valérien - Michel Salles,OUI,24,7,17,13,4,OUI,OUI,2025-03-14 00:00:31+00:00,"48.8561915, 2.2152966",Saint-Cloud,92064,0.7083333333333334,0
9117,Bellefond - Maubeuge,OUI,29,7,22,8,14,OUI,OUI,2025-03-14 00:00:58+00:00,"48.878255397645, 2.3452642187476",Paris,75056,0.7586206896551724,0
17022,Pereire - Place de Wagram,OUI,45,36,9,7,2,OUI,OUI,2025-03-14 00:01:13+00:00,"48.887070607581215, 2.304111124531457",Paris,75056,0.2,0
20023,Pelleport - Belgrand,OUI,14,2,12,1,11,OUI,OUI,2025-03-14 00:01:13+00:00,"48.86500081847653, 2.403980836377493",Paris,75056,0.8571428571428571,0
7020,Champ de Mars - Cler,OUI,40,1,39,36,3,OUI,OUI,2025-03-13 23:59:18+00:00,"48.856691550115315, 2.306646779179573",Paris,75056,0.975,0
15035,Place Etienne Pernet,OUI,43,5,38,35,3,OUI,OUI,2025-03-14 00:02:45+00:00,"48.84243457133779, 2.2921819612383847",Paris,75056,0.8837209302325582,0
23304,Mairie de Sceaux,OUI,33,29,4,1,3,OUI,OUI,2025-03-13 23:56:12+00:00,"48.778916905132, 2.2887361764861",Sceaux,92071,0.12121212121212122,0
10020,Chabrol - d'Hauteville,OUI,10,3,7,1,6,OUI,OUI,2025-03-14 00:02:30+00:00,"48.877018388033, 2.3513179644942",Paris,75056,0.7,0
6017,Sénat - Condé,OUI,28,28,0,0,0,OUI,OUI,2025-03-13 23:57:44+00:00,"48.84954227788459, 2.337939441204071",Paris,75056,0.0,0
13103,Hôpital Pitié Salpêtrière,OUI,47,45,2,1,1,OUI,OUI,2025-03-14 00:00:30+00:00,"48.8377016, 2.3604946",Paris,75056,0.0425531914893617,0
11041,Square Saint-Ambroise,OUI,36,0,36,29,7,OUI,OUI,2025-03-14 00:00:31+00:00,"48.860934, 2.375841",Paris,75056,1.0,0
12161,Diderot - Reuilly,OUI,44,2,42,41,1,OUI,OUI,2025-03-14 00:02:53+00:00,"48.847208456061, 2.3861273378134",Paris,75056,0.9545454545454546,0
15031,Théâtre - Lourmel,OUI,51,1,50,47,3,OUI,OUI,2025-03-14 00:03:09+00:00,"48.8482070397636, 2.2898658737540245",Paris,75056,0.9803921568627451,0
15107,Palais des Sports,OUI,19,8,11,10,1,OUI,OUI,2025-03-14 00:02:27+00:00,"48.833468517426, 2.2858720645308",Paris,75056,0.5789473684210527,0
21014,Hameau Fleuri - Marché,OUI,20,17,3,2,1,OUI,OUI,2025-03-14 00:01:36+00:00,"48.831448892608314, 2.2412404417991643",Boulogne-Billancourt,92012,0.15,0
18017,Caulaincourt - Place Constantin Pecqueur,OUI,41,38,3,0,3,OUI,OUI,2025-03-13 23:54:38+00:00,"48.889677905028, 2.3381787144261",Paris,75056,0.07317073170731707,0
5121,Square René Viviani - Montebello,OUI,31,15,16,16,0,OUI,OUI,2025-03-14 00:03:06+00:00,"48.851904891406, 2.3478421568871",Paris,75056,0.5161290322580645,0
19041,Belleville - Pyrénées,OUI,38,36,2,1,1,OUI,OUI,2025-03-14 00:02:09+00:00,"48.8741908, 2.3860039",Paris,75056,0.05263157894736842,0
47005,Ecole Vétérinaire,OUI,34,5,29,19,10,OUI,OUI,2025-03-14 00:01:07+00:00,"48.81488859822486, 2.4224362157778994",Maisons-Alfort,94046,0.8529411764705882,0
11043,Place Pasdeloup,OUI,20,2,18,17,1,OUI,OUI,2025-03-14 00:02:48+00:00,"48.862654215631, 2.3670325062844",Paris,75056,0.9,0
14112,Méchain - Faubourg Saint-Jacques,OUI,15,14,1,1,0,OUI,OUI,2025-03-13 23:54:37+00:00,"48.83586772099485, 2.33798034198275",Paris,75056,0.06666666666666667,0
1117,Pont Neuf - Rivoli,OUI,25,22,3,3,0,OUI,OUI,2025-03-14 00:01:55+00:00,"48.860089892617, 2.344057559967",Paris,75056,0.12,0
21001,Transvaal - Charles de Gaulle,OUI,27,17,10,6,4,OUI,OUI,2025-03-14 00:01:22+00:00,"48.848280403628806, 2.2373420120857195",Boulogne-Billancourt,92012,0.37037037037037035,0
13010,Place d'Italie - Vincent Auriol,OUI,38,32,6,1,5,OUI,OUI,2025-03-13 23:55:45+00:00,"48.831481874467, 2.3567550292319",Paris,75056,0.15789473684210525,0
18033,Belliard - Damrémont,OUI,34,26,8,3,5,OUI,OUI,2025-03-13 23:59:26+00:00,"48.89669238777841, 2.338023450388167",Paris,75056,0.23529411764705882,0
32603,Calmette,OUI,31,23,8,1,7,OUI,OUI,2025-03-14 00:03:14+00:00,"48.88104925098552, 2.424993216991425",Les Lilas,93045,0.25806451612903225,0
15002,Maine - Antoine Bourdelle,OUI,17,14,3,1,2,OUI,OUI,2025-03-13 23:56:50+00:00,"48.84308531746595, 2.320263946784738",Paris,75056,0.17647058823529413,0
17201,Porte Maillot - Perreire,OUI,49,45,4,1,3,OUI,OUI,2025-03-14 00:02:25+00:00,"48.878021154637, 2.2842371277102",Paris,75056,0.08163265306122448,0
21310,Kléber - Gouverneur Général Eboué,OUI,21,6,15,11,4,OUI,OUI,2025-03-13 23:58:57+00:00,"48.826885843069796, 2.2723413258790965",Issy-les-Moulineaux,92040,0.7142857142857143,0
21311,Parvis Corentin Celton,OUI,51,5,46,45,1,OUI,OUI,2025-03-14 00:00:05+00:00,"48.82747252522725, 2.2784319519996648",Issy-les-Moulineaux,92040,0.9019607843137255,0
23007,Président Wilson - Jean Jaures,OUI,24,2,22,16,6,OUI,OUI,2025-03-14 00:02:48+00:00,"48.89034054052266, 2.2920683026313786",Levallois-Perret,92044,0.9166666666666666,0
4013,Vieille du Temple - Francs Bourgeois,OUI,28,1,27,24,3,OUI,OUI,2025-03-14 00:01:26+00:00,"48.858256413365815, 2.35821794718504",Paris,75056,0.9642857142857143,0
20016,Pyrénées - Maraîchers,OUI,33,14,19,7,12,OUI,OUI,2025-03-13 23:59:15+00:00,"48.85714001395299, 2.4043509364128113",Paris,75056,0.5757575757575758,0
45001,Hôtel de Ville de Champigny sur Marne,OUI,21,2,19,9,10,OUI,OUI,2025-03-14 00:02:46+00:00,"48.813810628405, 2.5096759200096",Champigny-sur-Marne,94017,0.9047619047619048,0
10010,Place Jacques Bonsergent,OUI,31,0,31,28,3,OUI,OUI,2025-03-14 00:02:58+00:00,"48.870948218595, 2.3612049221992",Paris,75056,1.0,0
31023,Place François Mitterand,OUI,34,29,5,1,4,OUI,OUI,2025-03-14 00:00:21+00:00,"48.86492782016328, 2.442958317697048",Montreuil,93048,0.14705882352941177,0
6107,Place Alphonse Deville,OUI,21,19,2,2,0,OUI,OUI,2025-03-14 00:00:35+00:00,"48.850188262662, 2.3275961726904",Paris,75056,0.09523809523809523,0
9118,Faubourg Poissonniere - Delta,OUI,36,32,4,1,3,OUI,OUI,2025-03-14 00:00:53+00:00,"48.882555807626765, 2.3497482016682625",Paris,75056,0.1111111111111111,0
8019,Naples - Rome,OUI,25,23,2,0,2,OUI,OUI,2025-03-13 23:54:33+00:00,"48.879960700846226, 2.321358695626259",Paris,75056,0.08,0
2001,Greneta - Sebastopol,OUI,32,6,26,24,2,OUI,OUI,2025-03-14 00:00:00+00:00,"48.865242333228, 2.3516669869423",Paris,75056,0.8125,0
9017,Lallier - Trudaine,OUI,28,28,0,0,0,OUI,OUI,2025-03-13 23:57:36+00:00,"48.88109246617963, 2.3408224806189537",Paris,75056,0.0,0
19023,Manin - Simon Bolivar,OUI,22,17,5,0,5,OUI,OUI,2025-03-14 00:01:46+00:00,"48.876499654127, 2.3794073625991",Paris,75056,0.22727272727272727,0
18008,Square Léon,OUI,33,22,11,1,10,OUI,OUI,2025-03-13 23:57:52+00:00,"48.88667396788626, 2.353205569088459",Paris,75056,0.3333333333333333,0
20019,Place du Maquis du Vercors,OUI,30,28,2,2,0,OUI,OUI,2025-03-14 00:01:23+00:00,"48.877321579493575, 2.4083782732486725",Paris,75056,0.06666666666666667,0
7008,Villersexel - Saint-Germain,OUI,16,13,3,1,2,OUI,OUI,2025-03-13 23:58:18+00:00,"48.858297001218, 2.3237934708595",Paris,75056,0.1875,0
7101,Raspail - Chomel,OUI,48,46,2,1,1,OUI,OUI,2025-03-13 23:56:12+00:00,"48.852233164303, 2.3266580700874",Paris,75056,0.041666666666666664,0
16112,Chernoviz - Raynouard,OUI,36,34,2,0,2,OUI,OUI,2025-03-14 00:02:24+00:00,"48.8569864146289, 2.282173218142987",Paris,75056,0.05555555555555555,0
8056,Beaujon - Wagram,OUI,29,29,0,0,0,OUI,OUI,2025-03-13 23:56:17+00:00,"48.875352455985, 2.2964416444302",Paris,75056,0.0,0
15003,Gare Montparnasse - Vaugirard,OUI,65,60,5,1,4,OUI,OUI,2025-03-13 23:53:49+00:00,"48.8418071798797, 2.31951002690117",Paris,75056,0.07692307692307693,0
17116,Reims - Porte d'Asnières,OUI,25,23,2,1,1,OUI,OUI,2025-03-13 23:57:52+00:00,"48.891834448210986, 2.300144659954865",Paris,75056,0.08,0
4110,Neuve Saint-Pierre - Beautreillis,OUI,19,2,17,17,0,OUI,OUI,2025-03-14 00:02:33+00:00,"48.85355351439652, 2.3639122769236565",Paris,75056,0.8947368421052632,0
18138,Station Paris Basketball - Ney - Charles Hermite,OUI,19,18,1,0,1,OUI,OUI,2025-03-13 23:55:10+00:00,"48.898748039775, 2.3645754531026",Paris,75056,0.05263157894736842,0
6032,Sabot - Rennes,OUI,25,20,5,5,0,OUI,OUI,2025-03-14 00:01:35+00:00,"48.852575112948415, 2.331552766263485",Paris,75056,0.2,0
4011,Hôtel de Ville - Pont-Marie,OUI,30,4,26,25,1,OUI,OUI,2025-03-14 00:03:02+00:00,"48.853899645527, 2.3569472506642",Paris,75056,0.8666666666666667,0
10036,Aqueduc - Villette,OUI,25,10,15,9,6,OUI,OUI,2025-03-14 00:02:03+00:00,"48.883886063895, 2.367198803315",Paris,75056,0.6,0
12041,Bois de Vincennes.,OUI,58,39,19,4,15,OUI,OUI,2025-03-14 00:01:31+00:00,"48.8338064, 2.4132221",Saint-Mandé,94067,0.3275862068965517,0
9101,Cadet - La Fayette,OUI,18,4,14,10,4,OUI,OUI,2025-03-14 00:02:28+00:00,"48.875601632672, 2.3435704037547",Paris,75056,0.7777777777777778,0
14006,Saint-Jacques - Tombe Issoire,OUI,19,12,7,5,2,OUI,OUI,2025-03-14 00:02:48+00:00,"48.833206330538864, 2.3369108140468597",Paris,75056,0.3684210526315789,0
23903,Stade Gaston Bouillant,OUI,29,18,11,5,6,OUI,OUI,2025-03-14 00:01:33+00:00,"48.939958667023, 2.3279571813836",Villeneuve-la-Garenne,92078,0.3793103448275862,0
11003,Keller - La Roquette,OUI,33,10,23,21,2,OUI,OUI,2025-03-14 00:00:01+00:00,"48.8555508, 2.3752778",Paris,75056,0.696969696969697,0
31704,Jeanne Hornet - Girardot,OUI,28,22,6,0,6,OUI,OUI,2025-03-13 23:57:15+00:00,"48.873802681432146, 2.427820265293122",Bagnolet,93006,0.21428571428571427,0
11034,Parmentier - Fontaine au Roi,OUI,46,3,43,29,14,OUI,OUI,2025-03-14 00:01:30+00:00,"48.86787670551736, 2.372705978671471",Paris,75056,0.9347826086956522,0
15059,Parc André Citroën,OUI,65,2,63,60,3,OUI,OUI,2025-03-14 00:01:32+00:00,"48.840639944296655, 2.2780618071556096",Paris,75056,0.9692307692307692,0
9012,Rougemont - Poissonnière,OUI,30,28,2,1,1,OUI,OUI,2025-03-13 23:57:38+00:00,"48.871611569354755, 2.345873080193996",Paris,75056,0.06666666666666667,0
23403,Chateau,OUI,20,10,10,2,8,OUI,OUI,2025-03-14 00:03:07+00:00,"48.774661399959, 2.3135878035462",Bourg-la-Reine,92014,0.5,0
13113,Vistule - Choisy,OUI,33,30,3,0,3,OUI,OUI,2025-03-14 00:01:09+00:00,"48.82365543660611, 2.3615723848342896",Paris,75056,0.09090909090909091,0
21024,Billancourt - Général Leclerc,OUI,22,19,3,2,1,OUI,OUI,2025-03-13 23:56:03+00:00,"48.8322649, 2.2380413",Boulogne-Billancourt,92012,0.13636363636363635,0
20017,Saint-Blaise - Mouraud,OUI,27,21,6,0,6,OUI,OUI,2025-03-13 23:57:00+00:00,"48.85696177597818, 2.40869477391243",Paris,75056,0.2222222222222222,0
10163,Gare du Nord - Demarquay,OUI,30,27,3,1,2,OUI,OUI,2025-03-13 23:58:15+00:00,"48.881154, 2.358411",Paris,75056,0.1,0
11019,Charonne - Philippe-Auguste,OUI,29,0,29,10,19,OUI,OUI,2025-03-14 00:01:33+00:00,"48.855603162026, 2.39054639062",Paris,75056,1.0,0
18137,Poissonniers - Nord,OUI,27,22,5,0,5,OUI,OUI,2025-03-14 00:02:54+00:00,"48.892511213520656, 2.3522228747606277",Paris,75056,0.18518518518518517,0
8015,Roquépine - Malesherbes,OUI,50,46,4,3,1,OUI,OUI,2025-03-13 23:55:45+00:00,"48.87345073390807, 2.320404499769211",Paris,75056,0.08,0
13041,Porte d'Ivry,OUI,50,44,6,1,5,OUI,OUI,2025-03-13 23:54:09+00:00,"48.821768747596, 2.3688706755638",Paris,75056,0.12,0
31018,Gambetta - Michelet,OUI,30,15,15,4,11,OUI,OUI,2025-03-14 00:03:09+00:00,"48.85273792380526, 2.429966032505036",Montreuil,93048,0.5,0
7016,Surcouf - Université,OUI,57,7,50,38,12,OUI,OUI,2025-03-14 00:02:59+00:00,"48.861273016278, 2.3094535509142",Paris,75056,0.8771929824561403,0
7026,Place de Finlande,OUI,24,7,17,15,2,OUI,OUI,2025-03-14 00:00:34+00:00,"48.862408335967, 2.3113624379039",Paris,75056,0.7083333333333334,0
12108,Bercy.,OUI,64,30,34,32,2,OUI,OUI,2025-03-14 00:00:32+00:00,"48.839966914994, 2.3788625746965",Paris,75056,0.53125,0
17033,Carnot - Général Lanrezac,OUI,29,29,0,0,0,OUI,OUI,2025-03-13 23:58:06+00:00,"48.875443870736, 2.2938242935036",Paris,75056,0.0,0
7013,Duroc - Place de Breteuil,OUI,44,27,17,12,5,OUI,OUI,2025-03-14 00:02:54+00:00,"48.847460641142, 2.3126140236855",Paris,75056,0.38636363636363635,0
14007,Ferrus - Saint-Jacques,OUI,33,30,3,0,3,OUI,OUI,2025-03-14 00:01:07+00:00,"48.8313878, 2.3408563",Paris,75056,0.09090909090909091,0
21114,Gustave Eiffel - Parc des Impressionnistes,OUI,30,4,26,16,10,OUI,OUI,2025-03-14 00:02:27+00:00,"48.90390619651018, 2.2946908324956894",Clichy,92024,0.8666666666666667,0
11107,Faidherbe - Dahomey,OUI,41,2,39,34,5,OUI,OUI,2025-03-14 00:03:08+00:00,"48.851358329771806, 2.383823134795429",Paris,75056,0.9512195121951219,0
31013,Centenaire - Sorins,OUI,40,30,10,6,4,OUI,OUI,2025-03-13 23:58:48+00:00,"48.85853523359734, 2.4273508787155156",Montreuil,93048,0.25,0
2014,Daunou - Louis le Grand,OUI,31,28,3,2,1,OUI,OUI,2025-03-13 23:55:59+00:00,"48.869113, 2.332515",Paris,75056,0.0967741935483871,0
32018,Franciade - Gabriel Péri,OUI,25,15,10,4,6,OUI,OUI,2025-03-14 00:02:12+00:00,"48.93261499331498, 2.355954498052597",Saint-Denis,93066,0.4,0
8105,François 1er - Lincoln,OUI,28,27,1,1,0,OUI,OUI,2025-03-13 23:55:26+00:00,"48.869517979344, 2.3024262188416",Paris,75056,0.03571428571428571,0
17016,Brochant - Square des Batignolles,OUI,31,24,7,0,7,OUI,OUI,2025-03-13 23:57:18+00:00,"48.88818698581028, 2.316861143151153",Paris,75056,0.22580645161290322,0
11048,Place Mireille Havet,OUI,40,1,39,34,5,OUI,OUI,2025-03-14 00:03:13+00:00,"48.850533, 2.383756",Paris,75056,0.975,0
20202,Dupont de l'Eure - Gambetta,OUI,31,17,14,2,12,OUI,OUI,2025-03-14 00:00:19+00:00,"48.8679385, 2.4003649",Paris,75056,0.45161290322580644,0
12154,Square Georges Melies,OUI,38,17,21,8,13,OUI,OUI,2025-03-14 00:02:55+00:00,"48.84070239213081, 2.409667745232582",Paris,75056,0.5526315789473685,0
18019,Square Raymond Souplex,OUI,51,17,34,9,25,OUI,OUI,2025-03-14 00:01:42+00:00,"48.89183721478911, 2.335426103165901",Paris,75056,0.6666666666666666,0
17104,Jardin Marguerite Long,OUI,21,14,7,6,1,OUI,OUI,2025-03-14 00:01:10+00:00,"48.8816985773914, 2.2836575657129288",Paris,75056,0.3333333333333333,0
21004,Jean Jaurès - Reine,OUI,31,0,31,30,1,OUI,OUI,2025-03-14 00:00:37+00:00,"48.84009622558849, 2.239872515201569",Boulogne-Billancourt,92012,1.0,0
15020,Mairie du 15ème,OUI,31,1,30,23,7,OUI,OUI,2025-03-14 00:02:53+00:00,"48.8417762, 2.2986539",Paris,75056,0.967741935483871,0
35008,Place de l'Eglise - Pantin,OUI,29,23,6,2,4,OUI,OUI,2025-03-14 00:00:46+00:00,"48.892809461520265, 2.4124351143836975",Pantin,93055,0.20689655172413793,0
41206,Place des Larris,OUI,34,28,6,1,5,OUI,OUI,2025-03-13 23:54:01+00:00,"48.8568363, 2.4780236",Fontenay-sous-Bois,94033,0.17647058823529413,0
13022,Butte aux Cailles - Esperance,OUI,31,15,16,2,14,OUI,OUI,2025-03-14 00:01:28+00:00,"48.82758774190948, 2.3492151126265526",Paris,75056,0.5161290322580645,0
19031,Manin - Crimée,OUI,21,2,19,7,12,OUI,OUI,2025-03-14 00:03:06+00:00,"48.8831217743719, 2.3863670602440834",Paris,75056,0.9047619047619048,0
20045,Louis Ganne - Davout,OUI,28,15,13,4,9,OUI,OUI,2025-03-14 00:03:12+00:00,"48.86338720692607, 2.409725748002529",Paris,75056,0.4642857142857143,0
13114,Nationale - Marcel Duchamp,OUI,23,9,14,7,7,OUI,OUI,2025-03-14 00:02:48+00:00,"48.82463749337136, 2.3678014799952507",Paris,75056,0.6086956521739131,0
16041,Versailles - Claude Terrasse,OUI,44,1,43,32,11,OUI,OUI,2025-03-14 00:01:17+00:00,"48.840219338074, 2.263834191153",Paris,75056,0.9772727272727273,0
15061,Square Desnouettes,OUI,22,10,12,5,7,OUI,OUI,2025-03-13 23:54:26+00:00,"48.83476837934194, 2.284142297394666",Paris,75056,0.5454545454545454,0
8029,Place du Canada,OUI,55,47,8,6,2,OUI,OUI,2025-03-14 00:00:18+00:00,"48.865346269363, 2.3101937879648",Paris,75056,0.14545454545454545,0
23008,Hôtel de Ville de Levallois Perret,OUI,25,1,24,20,4,OUI,OUI,2025-03-14 00:02:15+00:00,"48.89314451997415, 2.2888818383216862",Levallois-Perret,92044,0.96,0
16031,Vignes - Boulainvilliers,OUI,20,17,3,1,2,OUI,OUI,2025-03-14 00:00:37+00:00,"48.856399483950504, 2.275240458548069",Paris,75056,0.15,0
21108,Mairie de Clichy,OUI,44,17,27,17,10,OUI,OUI,2025-03-14 00:03:00+00:00,"48.903653634661, 2.3059353232384",Clichy,92024,0.6136363636363636,0
17005,Brochant - Clichy,OUI,51,35,16,11,5,OUI,OUI,2025-03-14 00:01:02+00:00,"48.89032998912038, 2.319730559929781",Paris,75056,0.3137254901960784,0
6014,Pont de Lodi - Dauphine,OUI,21,5,16,14,2,OUI,OUI,2025-03-14 00:01:30+00:00,"48.855296898603285, 2.339947307565249",Paris,75056,0.7619047619047619,0
14016,René Coty - Parc Montsouris,OUI,53,33,20,6,14,OUI,OUI,2025-03-14 00:02:01+00:00,"48.82479134498032, 2.336124926805496",Paris,75056,0.37735849056603776,0
14116,Romain Rolland,OUI,25,18,7,0,7,OUI,OUI,2025-03-13 23:53:38+00:00,"48.820215229662765, 2.3234144234418346",Montrouge,92049,0.28,0
12033,François Truffaut - Saint Emilion,OUI,66,41,25,25,0,OUI,OUI,2025-03-14 00:03:12+00:00,"48.83372354344807, 2.386601903271428",Paris,75056,0.3787878787878788,0
47002,Les Juilliottes,OUI,21,4,17,14,3,OUI,OUI,2025-03-13 23:58:28+00:00,"48.8043072, 2.4437362",Maisons-Alfort,94046,0.8095238095238095,0
18142,Jessaint - Marx Dormoy,OUI,30,14,16,8,8,OUI,OUI,2025-03-14 00:01:28+00:00,"48.88484543106364, 2.358930408954621",Paris,75056,0.5333333333333333,0
33005,République - Henri Barbusse,OUI,32,17,15,5,10,OUI,OUI,2025-03-14 00:00:16+00:00,"48.90661553626751, 2.389432489871979",Aubervilliers,93001,0.46875,0
18035,René Binet - Porte de Montmartre,OUI,36,28,8,2,6,OUI,OUI,2025-03-14 00:02:09+00:00,"48.89905109950848, 2.3365534096956253",Paris,75056,0.2222222222222222,0
2110,Jeûneurs - Mulhouse,OUI,28,22,6,6,0,OUI,OUI,2025-03-14 00:03:15+00:00,"48.868997, 2.346925",Paris,75056,0.21428571428571427,0
13110,Moulin de la Pointe,OUI,22,17,5,4,1,OUI,OUI,2025-03-13 23:59:57+00:00,"48.82092946051445, 2.3563179373741145",Paris,75056,0.22727272727272727,0
5019,Poissy - Saint-Germain,OUI,23,6,17,15,2,OUI,OUI,2025-03-13 23:59:35+00:00,"48.84969649427, 2.3529685288668",Paris,75056,0.7391304347826086,0
15009,Suffren - Pérignon,OUI,43,4,39,33,6,OUI,OUI,2025-03-14 00:01:41+00:00,"48.84717561492764, 2.307052147596786",Paris,75056,0.9069767441860465,0
1016,Thérèse - Opéra,OUI,24,10,14,14,0,OUI,OUI,2025-03-14 00:01:35+00:00,"48.866483514509, 2.3344334212238",Paris,75056,0.5833333333333334,0
23005,Gare de Clichy-Levallois,OUI,24,5,19,10,9,OUI,OUI,2025-03-13 23:57:14+00:00,"48.89679827481989, 2.2984680533409123",Levallois-Perret,92044,0.7916666666666666,0
10164,Claude Vellefaux - Sambre et Meuse,OUI,32,15,17,7,10,OUI,OUI,2025-03-14 00:00:49+00:00,"48.875022, 2.370478",Paris,75056,0.53125,0
21120,Docteur Calmette - Martre,OUI,30,1,29,13,16,OUI,OUI,2025-03-14 00:00:18+00:00,"48.898969358483, 2.3086513252383",Clichy,92024,0.9666666666666667,0
9113,Bleue - Trévise,OUI,23,8,15,12,3,OUI,OUI,2025-03-14 00:03:13+00:00,"48.87578906564573, 2.347289621829987",Paris,75056,0.6521739130434783,0
14125,Dareau - Broussais,OUI,22,13,9,7,2,OUI,OUI,2025-03-13 23:57:26+00:00,"48.8307758, 2.3361804",Paris,75056,0.4090909090909091,0
20103,Le Vau - Maurice Bertaux,OUI,23,21,2,0,2,OUI,OUI,2025-03-13 23:59:39+00:00,"48.86803439043193, 2.411030612453627",Paris,75056,0.08695652173913043,0
18114,Véron - Lepic,OUI,23,21,2,0,2,OUI,OUI,2025-03-13 23:57:47+00:00,"48.88526123395252, 2.334559857845307",Paris,75056,0.08695652173913043,0
4109,Mornay - Sully,OUI,12,3,9,6,3,OUI,OUI,2025-03-14 00:01:10+00:00,"48.84970399548416, 2.364460788667202",Paris,75056,0.75,0
44103,Pont De Charenton,OUI,18,0,18,16,2,OUI,OUI,2025-03-14 00:00:54+00:00,"48.8179685, 2.4199531",Saint-Maurice,94069,1.0,0
3101,Porte Saint-Martin,OUI,28,11,17,15,2,OUI,OUI,2025-03-14 00:02:02+00:00,"48.86860172112996, 2.35570102930069",Paris,75056,0.6071428571428571,0
4107,Beaumarchais - Pas de la Mule,OUI,17,9,8,5,3,OUI,OUI,2025-03-14 00:02:55+00:00,"48.855580507049, 2.3684333673431",Paris,75056,0.47058823529411764,0
2101,Bachaumont - Montmartre,OUI,31,16,15,13,2,OUI,OUI,2025-03-13 23:59:40+00:00,"48.86617395079137, 2.3449775576591496",Paris,75056,0.4838709677419355,0
42011,Quai Marcel Boyer - Victor Hugo,OUI,29,0,29,25,4,OUI,OUI,2025-03-14 00:01:46+00:00,"48.822556366667, 2.3920395970345",Ivry-sur-Seine,94041,1.0,0
8049,Georges V - François 1er,OUI,21,21,0,0,0,OUI,OUI,2025-03-14 00:03:08+00:00,"48.87034, 2.30082",Paris,75056,0.0,0
9013,Mairie du 9ème,OUI,23,19,4,3,1,OUI,OUI,2025-03-14 00:03:04+00:00,"48.873267137583, 2.3407534480528",Paris,75056,0.17391304347826086,0
22017,Charles de Gaulle - Louis Philippe,OUI,26,22,4,1,3,OUI,OUI,2025-03-14 00:02:44+00:00,"48.881742142181, 2.2710045335353",Neuilly-sur-Seine,92051,0.15384615384615385,0
21951,Place Centrale,OUI,22,20,2,1,1,OUI,OUI,2025-03-13 23:58:27+00:00,"48.78740167690531, 2.2278830409049992",Meudon,92048,0.09090909090909091,0
19021,Mairie du 19ème,OUI,24,5,19,3,16,OUI,OUI,2025-03-14 00:00:12+00:00,"48.88256264247959, 2.3812624812126164",Paris,75056,0.7916666666666666,0
19113,Pré Saint-Gervais - Lilas,OUI,27,25,2,0,2,OUI,OUI,2025-03-14 00:02:35+00:00,"48.877870626988, 2.3959073424339",Paris,75056,0.07407407407407407,0
19030,Melun - Jean Jaurès,OUI,27,7,20,5,15,OUI,OUI,2025-03-13 23:59:24+00:00,"48.8837796723475, 2.376477420330048",Paris,75056,0.7407407407407407,0
14128,Gergovie - Vercingétorix,OUI,29,20,9,3,6,OUI,OUI,2025-03-13 23:57:04+00:00,"48.83453413883994, 2.313154547426182",Paris,75056,0.3103448275862069,0
22002,Argenson - Château,OUI,24,10,14,12,2,OUI,OUI,2025-03-13 23:59:48+00:00,"48.888559314669514, 2.2642001509666447",Neuilly-sur-Seine,92051,0.5833333333333334,0
19036,Hôpital Robert Debré,OUI,33,18,15,1,14,OUI,OUI,2025-03-14 00:02:41+00:00,"48.88005222200894, 2.4008650346327003",Paris,75056,0.45454545454545453,0
13019,Fernand Braudel - Vincent Auriol,OUI,35,24,11,9,2,OUI,OUI,2025-03-14 00:01:48+00:00,"48.83637852318147, 2.3723404482007027",Paris,75056,0.3142857142857143,0
31101,Jules Guesde - Laennec,OUI,19,14,5,0,5,OUI,OUI,2025-03-14 00:01:00+00:00,"48.87628983900398, 2.5006942078471184",Rosny-sous-Bois,93064,0.2631578947368421,0
11044,Square du Bataclan,OUI,17,0,17,13,4,OUI,OUI,2025-03-14 00:02:34+00:00,"48.8633762, 2.3711327",Paris,75056,1.0,0
31026,Demi-Lune - Aristide Briand,OUI,20,13,7,0,7,OUI,OUI,2025-03-13 23:55:50+00:00,"48.87626381919953, 2.4562818557024",Montreuil,93048,0.35,0
5030,Sorbonne - Ecoles,OUI,47,45,2,0,2,OUI,OUI,2025-03-14 00:02:29+00:00,"48.849686566191, 2.3434996604919",Paris,75056,0.0425531914893617,0
17001,Guy Môquet - Saint-Ouen,OUI,46,29,17,6,11,OUI,OUI,2025-03-13 23:59:11+00:00,"48.892777719023975, 2.3270335793495183",Paris,75056,0.3695652173913043,0
21952,Place Tony de Graaff,OUI,42,2,40,29,11,OUI,OUI,2025-03-14 00:03:15+00:00,"48.8181645, 2.2458109",Meudon,92048,0.9523809523809523,0
35004,Place du Président Salvador Allende,OUI,59,56,3,0,3,OUI,OUI,2025-03-13 23:58:17+00:00,"48.897307310356055, 2.40079153681279",Pantin,93055,0.05084745762711865,0
9015,Lamartine - Faubourg Montmartre,OUI,29,25,4,3,1,OUI,OUI,2025-03-13 23:57:11+00:00,"48.876613982891, 2.3397656902671",Paris,75056,0.13793103448275862,0
31707,Edouard Vaillant - Galliéni,OUI,48,39,9,1,8,OUI,OUI,2025-03-14 00:00:31+00:00,"48.858462881661, 2.4147954583168",Bagnolet,93006,0.1875,0
11110,Roquette - Folie Regnault,OUI,50,21,29,14,15,OUI,OUI,2025-03-13 23:54:43+00:00,"48.859246959155485, 2.386553623578705",Paris,75056,0.58,0
8011,Clapeyron - Moscou,OUI,15,12,3,1,2,OUI,OUI,2025-03-13 23:56:35+00:00,"48.88078819514121, 2.324815057218075",Paris,75056,0.2,0
12153,Terroirs de France - Lheureux,OUI,54,50,4,3,1,OUI,OUI,2025-03-14 00:02:25+00:00,"48.83212027074841, 2.388618104159832",Paris,75056,0.07407407407407407,0
13020,Paul Klee - Place Augusta Holmes,OUI,43,40,3,3,0,OUI,OUI,2025-03-13 23:55:02+00:00,"48.838946417408025, 2.3704235663952966",Paris,75056,0.06976744186046512,0
21017,Place Marcel Sembat,OUI,53,22,31,30,1,OUI,OUI,2025-03-14 00:02:24+00:00,"48.83328865030686, 2.2441747784614567",Boulogne-Billancourt,92012,0.5849056603773585,0
14113,Santé - Arago,OUI,37,27,10,6,4,OUI,OUI,2025-03-14 00:02:02+00:00,"48.83507657562064, 2.3415737262044938",Paris,75056,0.2702702702702703,0
14127,Odessa - Départ,OUI,39,37,2,0,2,OUI,OUI,2025-03-13 23:57:49+00:00,"48.842885590081, 2.3244281485677",Paris,75056,0.05128205128205128,0
15019,Paul Barruel - Vaugirard,OUI,36,21,15,13,2,OUI,OUI,2025-03-14 00:02:57+00:00,"48.84014918546239, 2.3044332861900334",Paris,75056,0.4166666666666667,0
12120,Lac Daumesnil - Saint-Maurice,OUI,49,41,8,5,3,OUI,OUI,2025-03-14 00:01:02+00:00,"48.82774555743318, 2.4183654785156246",Paris,75056,0.16326530612244897,0
20203,Evariste Galois,OUI,20,16,4,0,4,OUI,OUI,2025-03-13 23:57:38+00:00,"48.873341356228, 2.4133544409574",Paris,75056,0.2,0
22012,Madeleine Michelis - Roule,OUI,23,17,6,5,1,OUI,OUI,2025-03-13 23:59:35+00:00,"48.88260431301364, 2.2773634269833565",Neuilly-sur-Seine,92051,0.2608695652173913,0
12150,Bastille - Quai de la Rapée,OUI,26,1,25,22,3,OUI,OUI,2025-03-14 00:01:18+00:00,"48.84682410855, 2.3669364675879",Paris,75056,0.9615384615384616,0
23105,Sèvres Rive Gauche,OUI,33,25,8,8,0,OUI,OUI,2025-03-14 00:00:33+00:00,"48.821443218278, 2.2150785306885",Sèvres,92072,0.24242424242424243,0
11031,Jacquard - Ternaux,OUI,39,0,39,33,6,OUI,OUI,2025-03-14 00:02:42+00:00,"48.8646605, 2.373162",Paris,75056,1.0,0
20117,Saint-Fargeau - Mortier,OUI,31,26,5,0,5,OUI,OUI,2025-03-14 00:00:28+00:00,"48.87266656122256, 2.407912909984589",Paris,75056,0.16129032258064516,0
12125,Pyramide - Parc Floral,OUI,50,47,3,1,2,OUI,OUI,2025-03-13 23:56:45+00:00,"48.837442, 2.440452",Paris,75056,0.06,0
48009,République - Auguste Perret,OUI,30,22,8,2,6,OUI,OUI,2025-03-14 00:02:41+00:00,"48.78695280952244, 2.3518594354391094",Villejuif,94076,0.26666666666666666,0
9016,Choron - Martyrs,OUI,17,2,15,13,2,OUI,OUI,2025-03-14 00:01:02+00:00,"48.877851443503, 2.3396701365709",Paris,75056,0.8823529411764706,0
21009,Le Corbusier - Jean Jaurès,OUI,44,30,14,13,1,OUI,OUI,2025-03-14 00:01:38+00:00,"48.83780830557548, 2.2408381104469304",Boulogne-Billancourt,92012,0.3181818181818182,0
10037,Quai de Valmy,OUI,24,21,3,0,3,OUI,OUI,2025-03-14 00:00:32+00:00,"48.88126951579429, 2.368186041712761",Paris,75056,0.125,0
31017,Jean Moulin - Paul Doumer,OUI,17,2,15,1,14,OUI,OUI,2025-03-14 00:01:55+00:00,"48.8622179854695, 2.45533436536789",Montreuil,93048,0.8823529411764706,0
15125,Parc Suzanne Lenglen,OUI,50,49,1,0,1,OUI,OUI,2025-03-14 00:01:33+00:00,"48.833250690537874, 2.2765403240919113",Paris,75056,0.02,0
13047,Boutroux - Porte de Vitry,OUI,48,19,29,26,3,OUI,OUI,2025-03-14 00:01:56+00:00,"48.822632, 2.377738",Paris,75056,0.6041666666666666,0
13117,Stade Georges Carpentier,OUI,40,38,2,0,2,OUI,OUI,2025-03-14 00:02:30+00:00,"48.820482438381, 2.3668321967125",Paris,75056,0.05,0
22403,Pierre Brossolette - Adolphe Pinard,OUI,23,14,9,3,6,OUI,OUI,2025-03-14 00:01:31+00:00,"48.821772279548, 2.3131558299065",Malakoff,92046,0.391304347826087,0
17029,Pierre Demours - Laugier,OUI,36,26,10,6,4,OUI,OUI,2025-03-14 00:02:29+00:00,"48.8813072, 2.294846",Paris,75056,0.2777777777777778,0
20047,Cours de Vincennes - Davout,OUI,48,45,3,0,3,OUI,OUI,2025-03-14 00:03:14+00:00,"48.847238029966, 2.4107042336225",Paris,75056,0.0625,0
10004,Metz - Faubourg Saint-Denis,OUI,44,21,23,23,0,OUI,OUI,2025-03-14 00:03:08+00:00,"48.870893, 2.353521",Paris,75056,0.5227272727272727,0
42004,Westermeyer - Paul Vaillant-Couturier,OUI,26,6,20,13,7,OUI,OUI,2025-03-14 00:01:30+00:00,"48.819116181578764, 2.3966637253761296",Ivry-sur-Seine,94041,0.7692307692307693,0
20039,Belleville - Couronnes,OUI,48,11,37,13,24,OUI,OUI,2025-03-14 00:02:00+00:00,"48.868831082877, 2.3809862136841",Paris,75056,0.7708333333333334,0
92005,Gare de Nanterre Ville,OUI,42,30,12,10,2,OUI,OUI,2025-03-13 23:58:54+00:00,"48.8950295, 2.1957932",Nanterre,92050,0.2857142857142857,0
22013,Mairie de Neuilly sur Seine,OUI,31,8,23,17,6,OUI,OUI,2025-03-13 23:57:04+00:00,"48.88494728765838, 2.2677031159400944",Neuilly-sur-Seine,92051,0.7419354838709677,0
22103,Senard - Charles Blum,OUI,24,17,7,5,2,OUI,OUI,2025-03-14 00:00:53+00:00,"48.857315824799, 2.221091687679291",Saint-Cloud,92064,0.2916666666666667,0
21316,Cimetière d'Issy-les-Moulineaux,OUI,24,14,10,0,10,OUI,OUI,2025-03-14 00:03:06+00:00,"48.817699773925, 2.2609312087297",Issy-les-Moulineaux,92040,0.4166666666666667,0
10039,Sambre et Meuse - Villette,OUI,24,7,17,4,13,OUI,OUI,2025-03-14 00:01:30+00:00,"48.874405666217, 2.3738072379951",Paris,75056,0.7083333333333334,0
16009,Saint-Didier - Raymond Poincaré,OUI,17,15,2,1,1,OUI,OUI,2025-03-13 23:57:55+00:00,"48.86642312020962, 2.285863497192411",Paris,75056,0.11764705882352941,0
12129,Bois de Vincennes - Porte Jaune,OUI,35,30,5,4,1,OUI,OUI,2025-03-14 00:00:12+00:00,"48.838751246689455, 2.4605489149689674",Paris,75056,0.14285714285714285,0
16003,André Maurois - Joseph et Marie Hackin,OUI,27,13,14,13,1,OUI,OUI,2025-03-14 00:02:07+00:00,"48.8778983, 2.2789591",Paris,75056,0.5185185185185185,0
19124,Alexander Fleming - Belvédère,OUI,31,21,10,0,10,OUI,OUI,2025-03-13 23:58:51+00:00,"48.88179064200294, 2.4030599377642674",Paris,75056,0.3225806451612903,0
16014,Eylau - Trocadéro,OUI,22,22,0,0,0,OUI,OUI,2025-03-14 00:02:11+00:00,"48.863354122371, 2.2864209115505",Paris,75056,0.0,0
7010,Constantine - Université,OUI,59,48,11,9,2,OUI,OUI,2025-03-13 23:59:52+00:00,"48.860680473738, 2.3148481955842",Paris,75056,0.1864406779661017,0
16007,Longchamp - Place d'Iéna,OUI,22,21,1,0,1,OUI,OUI,2025-03-13 23:56:36+00:00,"48.864917233434, 2.2926748171449",Paris,75056,0.045454545454545456,0
35015,Averroès - Aimé Césaire,OUI,18,4,14,2,12,OUI,OUI,2025-03-14 00:02:53+00:00,"48.91405323432864, 2.412636950612068",Pantin,93055,0.7777777777777778,0
10110,Louis Blanc - Jemmapes,OUI,31,12,19,4,15,OUI,OUI,2025-03-14 00:01:53+00:00,"48.879330755297, 2.3684485629201",Paris,75056,0.6129032258064516,0
32021,Place du Front Populaire - George Sand,OUI,64,63,1,1,0,OUI,OUI,2025-03-13 23:58:06+00:00,"48.90680713698062, 2.364541214992642",Saint-Denis,93066,0.015625,0
21702,Gare SNCF Vanves-Malakoff,OUI,49,34,15,10,5,OUI,OUI,2025-03-14 00:02:49+00:00,"48.819002163836444, 2.292150005103606",Vanves,92075,0.30612244897959184,0
7024,Rapp - Place du Général Gouraud,OUI,30,18,12,9,3,OUI,OUI,2025-03-14 00:01:57+00:00,"48.858102885107, 2.3004072904587",Paris,75056,0.4,0
15052,Convention - Vaugirard,OUI,43,2,41,35,6,OUI,OUI,2025-03-14 00:02:47+00:00,"48.83767682233156, 2.295586926020252",Paris,75056,0.9534883720930233,0
20004,Commandant l'Herminier - Gallieni,OUI,17,14,3,1,2,OUI,OUI,2025-03-14 00:00:10+00:00,"48.847040552603, 2.4160453677177",Paris,75056,0.17647058823529413,0
31021,Résistance - Hoche,OUI,28,15,13,0,13,OUI,OUI,2025-03-13 23:59:42+00:00,"48.864273423741956, 2.435784414410591",Montreuil,93048,0.4642857142857143,0
13515,Auguste Blanqui - Glacière,OUI,59,42,17,6,11,OUI,OUI,2025-03-14 00:03:05+00:00,"48.831151602964, 2.343822196126",Paris,75056,0.288135593220339,0
15123,Commerce - Letellier,OUI,42,13,29,21,8,OUI,OUI,2025-03-14 00:02:44+00:00,"48.84797660373612, 2.2966245196598805",Paris,75056,0.6904761904761905,0
10152,Gare du Nord - Place de Valenciennes,OUI,25,22,3,1,2,OUI,OUI,2025-03-13 23:56:24+00:00,"48.879089, 2.354235",Paris,75056,0.12,0
21030,Fessart - Château,OUI,20,2,18,14,4,OUI,OUI,2025-03-14 00:03:15+00:00,"48.84245, 2.23989",Boulogne-Billancourt,92012,0.9,0
15131,Charles Lecocq - Lecourbe,OUI,28,2,26,20,6,OUI,OUI,2025-03-14 00:03:03+00:00,"48.84044, 2.294867",Paris,75056,0.9285714285714286,0
17039,Place Saint-Ferdinand,OUI,38,34,4,1,3,OUI,OUI,2025-03-14 00:01:22+00:00,"48.87815529789739, 2.288518047864942",Paris,75056,0.10526315789473684,0
9036,Athènes - Clichy,OUI,18,14,4,2,2,OUI,OUI,2025-03-13 23:59:12+00:00,"48.878113787876, 2.32956021945824",Paris,75056,0.2222222222222222,0
22604,Hôtel de Ville de Fontenay-aux-Roses,OUI,32,28,4,0,4,OUI,OUI,2025-03-14 00:00:30+00:00,"48.790844603480856, 2.2871455930319455",Fontenay-aux-Roses,92032,0.125,0
13027,Mazagran - Pierre de Coubertin,OUI,15,6,9,5,4,OUI,OUI,2025-03-14 00:02:41+00:00,"48.816218640260445, 2.344226874411106",Paris,75056,0.6,0
20009,Docteurs Déjérine - Pte de Montreuil,OUI,20,18,2,0,2,OUI,OUI,2025-03-14 00:02:45+00:00,"48.85398448133697, 2.41208288897222",Paris,75056,0.1,0
21118,Neuilly - Petit,OUI,14,4,10,5,5,OUI,OUI,2025-03-14 00:00:34+00:00,"48.898965361341254, 2.29627937078476",Clichy,92024,0.7142857142857143,0
42305,Vanne - Saussaies,OUI,19,11,8,1,7,OUI,OUI,2025-03-14 00:01:49+00:00,"48.786404, 2.338848",Cachan,94016,0.42105263157894735,0
11103,Pelée - Alphonse Baudin,OUI,37,5,32,23,9,OUI,OUI,2025-03-14 00:01:41+00:00,"48.8600265, 2.3710541",Paris,75056,0.8648648648648649,0
11032,Jean-Pierre Timbaud - Vaucouleurs,OUI,45,10,35,16,19,OUI,OUI,2025-03-14 00:02:38+00:00,"48.867937, 2.377885",Paris,75056,0.7777777777777778,0
21203,Place Jules Ferry,OUI,28,25,3,2,1,OUI,OUI,2025-03-14 00:02:20+00:00,"48.812107928414775, 2.325837314128876",Montrouge,92049,0.10714285714285714,0
8001,Petit Palais,OUI,45,32,13,11,2,OUI,OUI,2025-03-14 00:01:18+00:00,"48.8667692, 2.3157655",Paris,75056,0.28888888888888886,0
5034,Censier - Santeuil,OUI,65,35,30,29,1,OUI,OUI,2025-03-14 00:03:02+00:00,"48.840658921385234, 2.3537524044513702",Paris,75056,0.46153846153846156,0
13121,Bruneseau - Quai d'Ivry,OUI,46,4,42,41,1,OUI,OUI,2025-03-14 00:03:12+00:00,"48.824945637583, 2.3885661363602",Ivry-sur-Seine,94041,0.9130434782608695,0
10017,Gare de l'Est - Fidélité,OUI,13,11,2,1,1,OUI,OUI,2025-03-13 23:56:12+00:00,"48.874575, 2.356796",Paris,75056,0.15384615384615385,0
10012,Vinaigriers - Magenta,OUI,24,6,18,17,1,OUI,OUI,2025-03-13 23:59:05+00:00,"48.8731167, 2.3593052",Paris,75056,0.75,0
19025,Botzaris - Crimée,OUI,20,14,6,0,6,OUI,OUI,2025-03-14 00:01:47+00:00,"48.87959698690176, 2.3887913337477067",Paris,75056,0.3,0
21028,Pierre Lefaucheux - Traversière,OUI,32,15,17,15,2,OUI,OUI,2025-03-14 00:01:52+00:00,"48.82435208303827, 2.2417913004755974",Boulogne-Billancourt,92012,0.53125,0
21029,Cours de l'Ile Seguin - Parc Billancourt,OUI,26,23,3,0,3,OUI,OUI,2025-03-14 00:00:06+00:00,"48.82714055843935, 2.234234511852265",Boulogne-Billancourt,92012,0.11538461538461539,0
4003,Quai aux Fleurs - Pont Saint-Louis,OUI,21,3,18,14,4,OUI,OUI,2025-03-14 00:01:48+00:00,"48.852915956209, 2.3521957173944",Paris,75056,0.8571428571428571,0
10153,Gare du Nord - Denain,OUI,20,15,5,2,3,OUI,OUI,2025-03-13 23:56:43+00:00,"48.879595787608, 2.3544725775719",Paris,75056,0.25,0
8549,George V - Christophe Colomb,OUI,22,21,1,0,1,OUI,OUI,2025-03-14 00:03:08+00:00,"48.87046, 2.30104",Paris,75056,0.045454545454545456,0
15072,Place Fernand Forest,OUI,27,12,15,13,2,OUI,OUI,2025-03-14 00:02:21+00:00,"48.849269143836, 2.281863167882",Paris,75056,0.5555555555555556,0
23902,Gallieni - Lycée Charles Petitet,OUI,43,20,23,17,6,OUI,OUI,2025-03-14 00:02:04+00:00,"48.927640283627, 2.3308986340524",Villeneuve-la-Garenne,92078,0.5348837209302325,0
12006,Gare de Lyon - Van Gogh,OUI,41,33,8,6,2,OUI,OUI,2025-03-14 00:00:33+00:00,"48.843839785643, 2.3704450240357",Paris,75056,0.1951219512195122,0
20007,Buzenval - Avron,OUI,49,38,11,5,6,OUI,OUI,2025-03-14 00:02:20+00:00,"48.851617204999, 2.4015135973077",Paris,75056,0.22448979591836735,0
21115,Chancé Milly - Cimetière Communal Sud,OUI,32,2,30,26,4,OUI,OUI,2025-03-14 00:02:59+00:00,"48.89687189382465, 2.303922325372696",Clichy,92024,0.9375,0
20122,Vitruve - Davout,OUI,23,17,6,0,6,OUI,OUI,2025-03-14 00:02:37+00:00,"48.86053161154489, 2.4091592812626543",Paris,75056,0.2608695652173913,0
21708,Marcel Yol - Jullien,OUI,28,23,5,0,5,OUI,OUI,2025-03-14 00:02:47+00:00,"48.82537611802588, 2.287235018058929",Vanves,92075,0.17857142857142858,0
14101,Gare Montparnasse - Edgar Quinet,OUI,31,31,0,0,0,OUI,OUI,2025-03-13 23:50:12+00:00,"48.841487851079, 2.3233232282801",Paris,75056,0.0,0
13048,Wurtz - Tolbiac,OUI,28,28,0,0,0,NON,NON,2025-03-13 23:57:15+00:00,"48.82631195621, 2.344585955143",Paris,75056,0.0,0
22501,Théâtre de La Garenne,OUI,20,11,9,1,8,OUI,OUI,2025-03-14 00:02:41+00:00,"48.905658361454, 2.2345951981176",La Garenne-Colombes,92035,0.45,0
41210,Hôtel de ville de Fontenay-sous-Bois,OUI,19,16,3,0,3,OUI,OUI,2025-03-14 00:02:47+00:00,"48.84949749106274, 2.4750164151191716",Fontenay-sous-Bois,94033,0.15789473684210525,0
4001,Arcole - Notre-Dame,OUI,28,17,11,9,2,OUI,OUI,2025-03-14 00:02:18+00:00,"48.853883541328, 2.3493797332048",Paris,75056,0.39285714285714285,0
42304,Marc Sangnier - Division Leclerc,OUI,21,0,21,13,8,OUI,OUI,2025-03-14 00:03:08+00:00,"48.78599652305309, 2.329955510795116",Cachan,94016,1.0,0
40009,Lycée Saint Exupéry - Juliette Savar,OUI,29,17,12,8,4,OUI,OUI,2025-03-13 23:56:34+00:00,"48.783021513972, 2.4637357216879",Créteil,94028,0.41379310344827586,0
11109,Pierre Levée - Fontaine Timbaud,OUI,22,4,18,12,6,OUI,OUI,2025-03-14 00:01:22+00:00,"48.86632723374305, 2.3711163550615306",Paris,75056,0.8181818181818182,0
44002,Paul Vaillant-Couturier - Gare RER,OUI,26,17,9,5,4,OUI,OUI,2025-03-13 23:57:04+00:00,"48.80108159069614, 2.402097210288048",Vitry-sur-Seine,94081,0.34615384615384615,0
4010,Saint-Antoine Sévigné,OUI,26,15,11,11,0,OUI,OUI,2025-03-14 00:01:39+00:00,"48.8550222, 2.3612322",Paris,75056,0.4230769230769231,0
16115,Raffet - Montmorency,OUI,40,33,7,4,3,OUI,OUI,2025-03-14 00:00:46+00:00,"48.85258670812, 2.2629252456151954",Paris,75056,0.175,0
14131,Jourdan - Monticelli,OUI,30,25,5,1,4,OUI,OUI,2025-03-13 23:55:54+00:00,"48.822032, 2.329095",Paris,75056,0.16666666666666666,0
13039,Ivry - Simone Weil,OUI,18,12,6,2,4,OUI,OUI,2025-03-13 23:55:04+00:00,"48.823283932030755, 2.3659095168113713",Paris,75056,0.3333333333333333,0
17023,Porte d'Asnières,OUI,33,24,9,3,6,OUI,OUI,2025-03-14 00:02:27+00:00,"48.89035817610495, 2.3036286234855656",Paris,75056,0.2727272727272727,0
21031,Cimetière de Boulogne-Billancourt,OUI,38,1,37,31,6,OUI,OUI,2025-03-14 00:03:04+00:00,"48.830764, 2.252024",Boulogne-Billancourt,92012,0.9736842105263158,0
19108,Gaston Tessier - Rosa Parks RER,OUI,37,25,12,2,10,OUI,OUI,2025-03-14 00:01:30+00:00,"48.8963765, 2.3743692",Paris,75056,0.32432432432432434,0
16024,Ranelagh - Maison de la Radio,OUI,21,10,11,9,2,OUI,OUI,2025-03-14 00:03:13+00:00,"48.85293603169479, 2.280449643731117",Paris,75056,0.5238095238095238,0
10105,Mazagran - Bonne Nouvelle,OUI,25,18,7,6,1,OUI,OUI,2025-03-14 00:02:42+00:00,"48.870047123655, 2.3511248454452",Paris,75056,0.28,0
15043,Brancion - Lefebvre,OUI,9,4,5,0,5,OUI,OUI,2025-03-14 00:03:11+00:00,"48.82900222785569, 2.301431038163409",Paris,75056,0.5555555555555556,0
17003,Jacques Kellner - Saint-Ouen,OUI,43,20,23,16,7,OUI,OUI,2025-03-13 23:59:26+00:00,"48.895809485802886, 2.327897409164145",Paris,75056,0.5348837209302325,0
21955,Vaugirard - Verrerie,OUI,24,3,21,21,0,OUI,OUI,2025-03-14 00:00:57+00:00,"48.820881336842, 2.2367222622987",Meudon,92048,0.875,0
6008,Assas - Luxembourg,OUI,33,32,1,1,0,OUI,OUI,2025-03-14 00:02:19+00:00,"48.843734468779, 2.3334283818759",Paris,75056,0.030303030303030304,0
16101,Malakoff - Place de la Porte Maillot,OUI,25,24,1,0,1,OUI,OUI,2025-03-14 00:00:16+00:00,"48.876733496638, 2.2834577411413",Paris,75056,0.04,0
13109,Brillat-Savarin - Küss,OUI,21,1,20,12,8,OUI,OUI,2025-03-14 00:02:56+00:00,"48.822203, 2.350422",Paris,75056,0.9523809523809523,0
21307,Victor Cresson - Telles de la Poterie,OUI,29,2,27,23,4,OUI,OUI,2025-03-13 23:58:59+00:00,"48.822698842979, 2.2686498274964",Issy-les-Moulineaux,92040,0.9310344827586207,0
21204,Estienne d'Orves - Henri Ginoux,OUI,30,19,11,1,10,OUI,OUI,2025-03-14 00:02:18+00:00,"48.815388220397274, 2.320886790760933",Montrouge,92049,0.36666666666666664,0
10018,Square Alban Satragne,OUI,28,23,5,1,4,OUI,OUI,2025-03-14 00:03:14+00:00,"48.875388227727, 2.3559567333359",Paris,75056,0.17857142857142858,0
43001,Paris - Laitières,OUI,22,21,1,0,1,OUI,OUI,2025-03-14 00:01:35+00:00,"48.84630274151258, 2.4207553267478947",Vincennes,94080,0.045454545454545456,0
32301,Mairie de Romainville,OUI,17,14,3,0,3,OUI,OUI,2025-03-14 00:00:31+00:00,"48.885109, 2.435679",Romainville,93063,0.17647058823529413,0
11021,Charonne - Pierre Bayle,OUI,23,12,11,4,7,OUI,OUI,2025-03-14 00:02:35+00:00,"48.858445054262, 2.3903981223891",Paris,75056,0.4782608695652174,0
20108,Jardin de l'Hospice Debrousse,OUI,23,18,5,2,3,OUI,OUI,2025-03-13 23:58:49+00:00,"48.861451061938, 2.40568600595",Paris,75056,0.21739130434782608,0
15030,Emeriau - Beaugrenelle,OUI,69,21,48,44,4,OUI,OUI,2025-03-14 00:02:17+00:00,"48.84791249714942, 2.2843059897422795",Paris,75056,0.6956521739130435,0
21219,Amaury Duval - Gabriel Péri,OUI,36,27,9,6,3,OUI,OUI,2025-03-14 00:03:12+00:00,"48.81718759671675, 2.323841750621796",Montrouge,92049,0.25,0
16011,Victor Hugo - La Pompe,OUI,39,38,1,0,1,OUI,OUI,2025-03-13 23:59:28+00:00,"48.86795222470859, 2.28146318346262",Paris,75056,0.02564102564102564,0
13011,Hôpital - Campo-Formio,OUI,11,8,3,1,2,OUI,OUI,2025-03-13 23:56:24+00:00,"48.835405, 2.358218",Paris,75056,0.2727272727272727,0
10165,Gare de l'Est - Place du 11 Novembre 1918,OUI,39,31,8,7,1,OUI,OUI,2025-03-13 23:58:09+00:00,"48.876327, 2.3585464",Paris,75056,0.20512820512820512,0
31025,Paul Signac - Aristide Briand,OUI,33,24,9,0,9,OUI,OUI,2025-03-14 00:01:27+00:00,"48.86950262156371, 2.4502260982990265",Montreuil,93048,0.2727272727272727,0
14010,Jean Moulin - Place Victor et Hélène Basch,OUI,39,37,2,0,2,OUI,OUI,2025-03-13 23:56:14+00:00,"48.82764910241, 2.3261967301369",Paris,75056,0.05128205128205128,0
5014,Jean Calvin - Tournefort,OUI,28,18,10,4,6,OUI,OUI,2025-03-14 00:02:56+00:00,"48.84158856925782, 2.348489575088024",Paris,75056,0.35714285714285715,0
22303,Lucien Lanternier - Le Luth,OUI,25,8,17,12,5,OUI,OUI,2025-03-14 00:02:03+00:00,"48.93159430558871, 2.2889783978462224",Gennevilliers,92036,0.68,0
13033,Porte d'Italie,OUI,13,13,0,0,0,OUI,OUI,2025-03-13 23:58:05+00:00,"48.817161987718954, 2.360236309468746",Paris,75056,0.0,0
92001,Mairie de quartier du Plateau - Mont-Valérien,OUI,20,9,11,4,7,OUI,OUI,2025-03-14 00:01:24+00:00,"48.8799933, 2.2072437",Nanterre,92050,0.55,0
42701,Charles Gide - Fort de Bicêtre,OUI,29,25,4,0,4,OUI,OUI,2025-03-14 00:00:21+00:00,"48.8071937956922, 2.353984415531159",Le Kremlin-Bicêtre,94043,0.13793103448275862,0
43010,La Jarry - Place Diderot,OUI,25,5,20,9,11,OUI,OUI,2025-03-14 00:02:57+00:00,"48.849726940367326, 2.452013790607453",Vincennes,94080,0.8,0
16020,Place de la Porte de Passy,OUI,34,29,5,4,1,OUI,OUI,2025-03-14 00:03:01+00:00,"48.857341095470794, 2.2644165538827115",Paris,75056,0.14705882352941177,0
15004,Vaugirard - Pasteur,OUI,21,20,1,0,1,OUI,OUI,2025-03-13 23:57:44+00:00,"48.84040868803496, 2.3154367133975033",Paris,75056,0.047619047619047616,0
13126,Place Nationale - Château-des-Rentiers,OUI,18,11,7,3,4,OUI,OUI,2025-03-14 00:01:14+00:00,"48.829268, 2.365212",Paris,75056,0.3888888888888889,0
6027,Blaise-Desgoffe - Vaugirard,OUI,31,29,2,0,2,OUI,OUI,2025-03-13 23:53:17+00:00,"48.846128877747, 2.3242672160268",Paris,75056,0.06451612903225806,0
8020,Batignolles - Beudant,OUI,43,35,8,5,3,OUI,OUI,2025-03-14 00:02:59+00:00,"48.88216401466375, 2.319852970540523",Paris,75056,0.18604651162790697,0
18007,Goutte d'or - Barbès,OUI,20,2,18,4,14,OUI,OUI,2025-03-14 00:00:10+00:00,"48.885124323627, 2.3496962338686",Paris,75056,0.9,0
17015,Place de Lévis,OUI,48,46,2,0,2,OUI,OUI,2025-03-14 00:01:36+00:00,"48.883546851533254, 2.3131933808326726",Paris,75056,0.041666666666666664,0
18006,Square Louise Michel,OUI,36,31,5,1,4,OUI,OUI,2025-03-14 00:03:02+00:00,"48.884687354509, 2.3441386967897",Paris,75056,0.1388888888888889,0
15023,La Motte-Picquet - Grenelle,OUI,34,16,18,17,1,OUI,OUI,2025-03-13 23:58:33+00:00,"48.84858321339195, 2.299347817897797",Paris,75056,0.5294117647058824,0
17108,Bessières - Porte de Clichy,OUI,32,19,13,9,4,OUI,OUI,2025-03-14 00:02:57+00:00,"48.89611762451474, 2.31790903955698",Paris,75056,0.40625,0
42003,Place de l'Insurrection d'Août 1944,OUI,29,13,16,12,4,OUI,OUI,2025-03-14 00:00:27+00:00,"48.81477852751594, 2.398074567317963",Ivry-sur-Seine,94041,0.5517241379310345,0
4020,Place Edmond Michelet,OUI,23,11,12,9,3,OUI,OUI,2025-03-13 23:56:20+00:00,"48.860134890542, 2.3500636965036",Paris,75056,0.5217391304347826,0
12043,Daumesnil - Hébrard,OUI,39,2,37,35,2,OUI,OUI,2025-03-14 00:03:15+00:00,"48.8429, 2.38474",Paris,75056,0.9487179487179487,0
22408,Place du 14 Juillet,OUI,21,12,9,3,6,OUI,OUI,2025-03-14 00:01:18+00:00,"48.819266959525, 2.3011998832226",Malakoff,92046,0.42857142857142855,0
23003,Président Wilson - Baudin,OUI,27,13,14,10,4,OUI,OUI,2025-03-13 23:58:54+00:00,"48.89826887103676, 2.2849336266517644",Levallois-Perret,92044,0.5185185185185185,0
21306,Place Lafayette,OUI,60,34,26,25,1,OUI,OUI,2025-03-14 00:00:36+00:00,"48.829654975522, 2.2638675570488",Issy-les-Moulineaux,92040,0.43333333333333335,0
44007,Camille Groult - Guy Môquet,OUI,22,2,20,13,7,OUI,OUI,2025-03-14 00:00:21+00:00,"48.787482746521306, 2.3976725712418556",Vitry-sur-Seine,94081,0.9090909090909091,0
1021,Halles - Bourdonnais,OUI,17,14,3,3,0,OUI,OUI,2025-03-13 23:55:37+00:00,"48.860448992575, 2.3460162431002",Paris,75056,0.17647058823529413,0
4002,Marché aux fleurs,OUI,20,13,7,7,0,OUI,OUI,2025-03-14 00:02:43+00:00,"48.855258115391, 2.3473754525185",Paris,75056,0.35,0
7017,La Motte-Picquet - La Tour Maubourg,OUI,40,13,27,12,15,OUI,OUI,2025-03-14 00:02:45+00:00,"48.856926701847, 2.3096215831203",Paris,75056,0.675,0
42501,Raspail - Albert Schweitzer,OUI,27,7,20,17,3,OUI,OUI,2025-03-14 00:02:03+00:00,"48.81031545, 2.34395871",Gentilly,94037,0.7407407407407407,0
22015,Île de la Jatte,OUI,21,4,17,10,7,OUI,OUI,2025-03-14 00:02:24+00:00,"48.894036161302104, 2.2666339203715324",Neuilly-sur-Seine,92051,0.8095238095238095,0
42209,Place de l'Europe - Quai de Bercy,OUI,15,0,15,11,4,OUI,OUI,2025-03-14 00:03:06+00:00,"48.82529858840266, 2.3945679143071175",Charenton-le-Pont,94018,1.0,0
12018,Saint-Mandé - Fabre d'Eglantine,OUI,34,24,10,1,9,OUI,OUI,2025-03-14 00:02:56+00:00,"48.8453579, 2.3965022",Paris,75056,0.29411764705882354,0
22206,Louis Pasteur - Albert Petit,OUI,30,18,12,2,10,OUI,OUI,2025-03-14 00:02:45+00:00,"48.796261, 2.317289",Bagneux,92007,0.4,0
17119,Toqueville - Cardinet,OUI,29,19,10,3,7,OUI,OUI,2025-03-14 00:00:03+00:00,"48.88490187110713, 2.3109393194317818",Paris,75056,0.3448275862068966,0
21217,Louis Rolland - République,OUI,26,26,0,0,0,OUI,OUI,2025-03-13 23:53:51+00:00,"48.81710889740748, 2.3193106434955717",Montrouge,92049,0.0,0
32601,Porte des Lilas - Faidherbe,OUI,39,36,3,1,2,OUI,OUI,2025-03-14 00:00:54+00:00,"48.87861855668978, 2.4120327830314636",Les Lilas,93045,0.07692307692307693,0
9114,Faubourg Poissonnière - Dunkerque,OUI,29,21,8,5,3,OUI,OUI,2025-03-14 00:01:45+00:00,"48.880883445404436, 2.349934279918671",Paris,75056,0.27586206896551724,0
15058,Place du Moulin de Javel,OUI,46,36,10,10,0,OUI,OUI,2025-03-13 23:56:56+00:00,"48.84021670922, 2.2716060653329",Paris,75056,0.21739130434782608,0
12007,Gare de Lyon - Chalon,OUI,45,14,31,23,8,OUI,OUI,2025-03-14 00:03:13+00:00,"48.845666194202, 2.3741452395916",Paris,75056,0.6888888888888889,0
12026,Place Ginette Hamelin,OUI,48,17,31,24,7,OUI,OUI,2025-03-14 00:02:35+00:00,"48.837853, 2.382064",Paris,75056,0.6458333333333334,0
25001,Colmar - Victor Hugo,OUI,32,25,7,5,2,OUI,OUI,2025-03-13 23:59:42+00:00,"48.88652251096166, 2.173960916697979",Rueil-Malmaison,92063,0.21875,0
10162,Alexandre Parodi - Quai de Valmy,OUI,23,14,9,3,6,OUI,OUI,2025-03-14 00:00:10+00:00,"48.879359419425, 2.3665961623192",Paris,75056,0.391304347826087,0
35007,Benjamin Delessert - Jean Lolive,OUI,21,16,5,2,3,OUI,OUI,2025-03-13 23:56:05+00:00,"48.89392043619345, 2.417981922626496",Pantin,93055,0.23809523809523808,0
13009,Auguste Blanqui - Corvisart,OUI,24,22,2,2,0,OUI,OUI,2025-03-14 00:02:01+00:00,"48.8300989, 2.3502726",Paris,75056,0.08333333333333333,0
47001,Place de la Gare,OUI,46,1,45,41,4,OUI,OUI,2025-03-14 00:02:35+00:00,"48.80253358011283, 2.4275037646293645",Maisons-Alfort,94046,0.9782608695652174,0
9024,Taitbout - La Fayette,OUI,52,50,2,1,1,OUI,OUI,2025-03-14 00:01:41+00:00,"48.8733298892, 2.3352625966072",Paris,75056,0.038461538461538464,0
44101,Place Mongolfier,OUI,38,17,21,12,9,OUI,OUI,2025-03-14 00:02:00+00:00,"48.815160030060376, 2.4592879414558415",Saint-Maurice,94069,0.5526315789473685,0
17111,Lemercier - Cardinet,OUI,24,14,10,7,3,OUI,OUI,2025-03-14 00:02:49+00:00,"48.890097168851746, 2.317377626895905",Paris,75056,0.4166666666666667,0
13032,Italie - Jardin Joan Miro,OUI,26,22,4,1,3,OUI,OUI,2025-03-14 00:00:30+00:00,"48.81990914045756, 2.3592948541045193",Paris,75056,0.15384615384615385,0
21319,Esplanade du Foncet - Camille Desmoulins,OUI,26,1,25,21,4,OUI,OUI,2025-03-14 00:02:20+00:00,"48.827090233494964, 2.2606857866048813",Issy-les-Moulineaux,92040,0.9615384615384616,0
15064,Javel - André Citroën,OUI,42,15,27,25,2,OUI,OUI,2025-03-14 00:02:09+00:00,"48.846276485475, 2.2786368057132",Paris,75056,0.6428571428571429,0
8116,Champs-Elysees - Bassano,OUI,25,25,0,0,0,NON,NON,2021-02-21 19:09:18+00:00,"48.871811807816, 2.300238981843",Paris,75056,0.0,19
13128,Quai de la Gare - Pont de Bercy,OUI,29,7,22,22,0,OUI,OUI,2025-03-14 00:03:15+00:00,"48.83730787972, 2.3740861260598",Paris,75056,0.7586206896551724,0
92006,Place Nelson Mandela,OUI,30,25,5,1,4,OUI,OUI,2025-03-13 23:54:32+00:00,"48.897874318180556, 2.2182820737361912",Nanterre,92050,0.16666666666666666,0
17107,Berthier - Place Stuart Merril,OUI,34,19,15,9,6,OUI,OUI,2025-03-13 23:58:35+00:00,"48.885927922355044, 2.2933450341224675",Paris,75056,0.4411764705882353,0
21314,Chemin de Bretagne,OUI,28,0,28,27,1,OUI,OUI,2025-03-13 23:58:49+00:00,"48.824753068884, 2.2588385956052",Issy-les-Moulineaux,92040,1.0,0
15057,Lucien Bossoutrot - Général Martial Vallin,OUI,36,34,2,2,0,OUI,OUI,2025-03-13 23:55:10+00:00,"48.836956046311, 2.2741072252393",Paris,75056,0.05555555555555555,0
12038,Picpus - Louis Braille,OUI,43,23,20,10,10,OUI,OUI,2025-03-14 00:02:14+00:00,"48.839988788912, 2.4005256685521",Paris,75056,0.46511627906976744,0
16002,Pergolèse - Malakoff,OUI,36,32,4,1,3,OUI,OUI,2025-03-14 00:01:45+00:00,"48.87521088779225, 2.2842781618237495",Paris,75056,0.1111111111111111,0
12005,Crozatier - Faubourg Saint-Antoine,OUI,41,3,38,32,6,OUI,OUI,2025-03-14 00:01:29+00:00,"48.850440013405, 2.378901366211",Paris,75056,0.926829268292683,0
23010,Voltaire - Anatole France,OUI,25,3,22,20,2,OUI,OUI,2025-03-14 00:02:46+00:00,"48.891999360256904, 2.284262739121914",Levallois-Perret,92044,0.88,0
13516,Glacière - Soeur Catherine Marie,OUI,40,35,5,2,3,OUI,OUI,2025-03-14 00:03:04+00:00,"48.829522989420596, 2.343570403754711",Paris,75056,0.125,0
19128,Quai de l'Oise - Aisne,OUI,28,1,27,8,19,OUI,OUI,2025-03-14 00:01:57+00:00,"48.8906231, 2.3833701",Paris,75056,0.9642857142857143,0
12155,Rottembourg - Général Michel Bizot,OUI,41,10,31,22,9,OUI,OUI,2025-03-14 00:03:01+00:00,"48.83787825992554, 2.4044052511453633",Paris,75056,0.7560975609756098,0
15005,Place Jacques et Thérèse Tréfouël,OUI,43,40,3,2,1,OUI,OUI,2025-03-13 23:58:04+00:00,"48.842726498317, 2.3125657439232",Paris,75056,0.06976744186046512,0
12028,Vivaldi - Antoine-Julien Hénard,OUI,27,15,12,4,8,OUI,OUI,2025-03-13 23:58:38+00:00,"48.841923663276546, 2.389728979467376",Paris,75056,0.4444444444444444,0
21401,Mairie de Clamart,OUI,31,23,8,1,7,OUI,OUI,2025-03-14 00:01:57+00:00,"48.800612, 2.262151",Clamart,92023,0.25806451612903225,0
9034,Godot de Mauroy - Madeleine,OUI,22,18,4,3,1,OUI,OUI,2025-03-13 23:59:08+00:00,"48.869789, 2.326347",Paris,75056,0.18181818181818182,0
13044,Place Jeanne d'Arc,OUI,34,20,14,8,6,OUI,OUI,2025-03-13 23:59:31+00:00,"48.829575, 2.369126",Paris,75056,0.4117647058823529,0
12035,Madagascar - Meuniers,OUI,32,0,32,17,15,OUI,OUI,2025-03-14 00:00:33+00:00,"48.83460464474706, 2.3970650508999825",Paris,75056,1.0,0
9027,Douai - Pierre Fontaine,OUI,22,21,1,0,1,OUI,OUI,2025-03-14 00:01:32+00:00,"48.88229101148092, 2.33324121683836",Paris,75056,0.045454545454545456,0
10021,Marché Saint-Quentin,OUI,12,9,3,3,0,OUI,OUI,2025-03-13 23:59:44+00:00,"48.877356057652, 2.3545114456374",Paris,75056,0.25,0
41211,Louis Xavier de Ricard - Ancienne Mairie,OUI,34,23,11,3,8,OUI,OUI,2025-03-13 23:58:55+00:00,"48.84629899065091, 2.472420372068882",Fontenay-sous-Bois,94033,0.3235294117647059,0
15022,Emile Zola - Fondary,OUI,41,2,39,36,3,OUI,OUI,2025-03-14 00:02:20+00:00,"48.847051143113745, 2.2953405976295476",Paris,75056,0.9512195121951219,0
44011,Lebrun - Colonel Fabien,OUI,27,15,12,1,11,OUI,OUI,2025-03-14 00:01:12+00:00,"48.78266870733145, 2.381317801773548",Vitry-sur-Seine,94081,0.4444444444444444,0
23004,Paul Vaillant-Couturier - Victor Hugo,OUI,34,8,26,20,6,OUI,OUI,2025-03-14 00:00:35+00:00,"48.89819702263572, 2.293848017974069",Levallois-Perret,92044,0.7647058823529411,0
2108,Vivienne - Montmartre,OUI,36,34,2,0,2,OUI,OUI,2025-03-13 23:56:55+00:00,"48.871347597383, 2.3414588347077",Paris,75056,0.05555555555555555,0
5012,Estrapade - Ulm,OUI,16,16,0,0,0,OUI,OUI,2025-03-13 23:56:29+00:00,"48.84512772828, 2.3454568170362",Paris,75056,0.0,0
21707,Square Etienne Jarousse,OUI,22,11,11,1,10,OUI,OUI,2025-03-14 00:02:25+00:00,"48.82485182597129, 2.2925933450460434",Vanves,92075,0.5,0
8037,Monceau - Malesherbes,OUI,37,36,1,0,1,OUI,OUI,2025-03-13 23:57:24+00:00,"48.8795079, 2.3145456",Paris,75056,0.02702702702702703,0
5001,Harpe - Saint-Germain,OUI,40,35,5,4,1,OUI,OUI,2025-03-14 00:01:54+00:00,"48.851518815017, 2.3436703160405",Paris,75056,0.125,0
11017,Charonne - Bureau,OUI,47,25,22,9,13,OUI,OUI,2025-03-14 00:03:01+00:00,"48.854176, 2.396093",Paris,75056,0.46808510638297873,0
15129,Hôpital Necker,OUI,35,24,11,6,5,OUI,OUI,2025-03-14 00:03:08+00:00,"48.846043490118454, 2.313245013356209",Paris,75056,0.3142857142857143,0
33015,Charles Tillon - Cimetière Communal,OUI,27,4,23,7,16,OUI,OUI,2025-03-14 00:02:16+00:00,"48.91844023641836, 2.3935630917549138",Aubervilliers,93001,0.8518518518518519,0
51001,Gare d'Argenteuil,OUI,37,16,21,4,17,OUI,OUI,2025-03-13 23:59:17+00:00,"48.947022436806705, 2.256898172199726",Argenteuil,95018,0.5675675675675675,0
15311,Quai du Président Roosevelt - Pont Aval,OUI,30,12,18,18,0,OUI,OUI,2025-03-13 23:59:45+00:00,"48.8343883676388, 2.2656820714473724",Paris,75056,0.6,0
21303,Jean Monnet - Iles,OUI,31,1,30,27,3,OUI,OUI,2025-03-14 00:02:35+00:00,"48.823393984057304, 2.2497073194874866",Issy-les-Moulineaux,92040,0.967741935483871,0
35006,Delizy - Louis Nadot,OUI,20,15,5,2,3,OUI,OUI,2025-03-14 00:00:29+00:00,"48.896212845581346, 2.4094578623771667",Pantin,93055,0.25,0
33014,Parc Eli Lotar,OUI,19,7,12,5,7,OUI,OUI,2025-03-14 00:02:31+00:00,"48.91844993053703, 2.3727085813879967",Aubervilliers,93001,0.631578947368421,0
41205,Maréchal Joffre - Verdun,OUI,20,15,5,0,5,OUI,OUI,2025-03-13 23:57:25+00:00,"48.85385, 2.470307",Fontenay-sous-Bois,94033,0.25,0
9007,Condorcet - Turgot,OUI,19,15,4,2,2,OUI,OUI,2025-03-13 23:57:06+00:00,"48.87985155789093, 2.345232367515564",Paris,75056,0.21052631578947367,0
44016,Balzac - Olympes de Gouges,OUI,28,3,25,9,16,OUI,OUI,2025-03-14 00:00:57+00:00,"48.77850332486751, 2.4006786569952965",Vitry-sur-Seine,94081,0.8928571428571429,0
20105,Benoît Frachon - République,OUI,29,25,4,3,1,OUI,OUI,2025-03-13 23:55:31+00:00,"48.85230729014318, 2.415605485439301",Paris,75056,0.13793103448275862,0
44005,Place Saint-Just,OUI,22,9,13,4,9,OUI,OUI,2025-03-14 00:01:52+00:00,"48.790379518724265, 2.3895226791501045",Vitry-sur-Seine,94081,0.5909090909090909,0
33103,Jean Jaurès - Jules Jacquemin,OUI,22,6,16,2,14,OUI,OUI,2025-03-14 00:01:33+00:00,"48.88433053604843, 2.4082902455152104",Le Pré-Saint-Gervais,93061,0.7272727272727273,0
15011,Cambronne - Villa Croix Nivert,OUI,59,19,40,29,11,OUI,OUI,2025-03-14 00:02:15+00:00,"48.845847561366, 2.3017574474216",Paris,75056,0.6779661016949152,0
14032,Mairie du 14ème,OUI,31,20,11,0,11,OUI,OUI,2025-03-14 00:02:13+00:00,"48.83254578123, 2.3254923149943",Paris,75056,0.3548387096774194,0
9004,Gérando - Rochechouart,OUI,20,19,1,0,1,OUI,OUI,2025-03-13 23:59:27+00:00,"48.88294340845, 2.3464846238494",Paris,75056,0.05,0
6002,Saint-Benoît - Jacob,OUI,20,18,2,2,0,OUI,OUI,2025-03-13 23:55:31+00:00,"48.85545136013941, 2.3334722220897675",Paris,75056,0.1,0
51002,Placette Grégoire Collas,OUI,25,14,11,3,8,OUI,OUI,2025-03-14 00:00:34+00:00,"48.94342014002797, 2.2487476095557213",Argenteuil,95018,0.44,0
14031,Didot - Place de Moro-Giafferi,OUI,21,2,19,7,12,OUI,OUI,2025-03-14 00:02:56+00:00,"48.8337, 2.3215",Paris,75056,0.9047619047619048,0
33016,Fort d'Aubervilliers,OUI,22,6,16,7,9,OUI,OUI,2025-03-14 00:02:08+00:00,"48.91502382370325, 2.4035281687974925",Aubervilliers,93001,0.7272727272727273,0
10019,Paradis - Hauteville,OUI,31,16,15,12,3,OUI,OUI,2025-03-14 00:02:22+00:00,"48.874999954666755, 2.3522757401923404",Paris,75056,0.4838709677419355,0
6012,Saint-Germain - Ciseaux,OUI,18,18,0,0,0,OUI,OUI,2025-03-13 23:54:43+00:00,"48.853305277595, 2.3344654618827",Paris,75056,0.0,0
11033,Bréguet - Sabin,OUI,31,10,21,18,3,OUI,OUI,2025-03-13 23:59:38+00:00,"48.856931678257, 2.3706749462105",Paris,75056,0.6774193548387096,0
27005,Gare du Stade,OUI,18,16,2,1,1,OUI,OUI,2025-03-14 00:00:29+00:00,"48.9312676, 2.2603778",Colombes,92025,0.1111111111111111,0
15071,Suffren - Champ de Mars,OUI,23,11,12,11,1,OUI,OUI,2025-03-14 00:00:27+00:00,"48.8547194, 2.2952168",Paris,75056,0.5217391304347826,0
20022,Porte de Bagnolet,OUI,33,25,8,1,7,OUI,OUI,2025-03-13 23:55:30+00:00,"48.864707139122984, 2.408344637349607",Paris,75056,0.24242424242424243,0
8201,Arsène Houssaye - Friedland,OUI,29,29,0,0,0,OUI,OUI,2025-03-14 00:01:37+00:00,"48.874510616163, 2.2994716674148",Paris,75056,0.0,0
12036,Reuilly - Place Felix Eboue,OUI,41,8,33,13,20,OUI,OUI,2025-03-14 00:03:15+00:00,"48.84030274499962, 2.394630398715453",Paris,75056,0.8048780487804879,0
9102,Londres - Place d'Estienne d'Orves,OUI,23,23,0,0,0,OUI,OUI,2025-03-13 23:58:08+00:00,"48.876693805756986, 2.3305362090468407",Paris,75056,0.0,0
14026,Plantes - Moulin Vert,OUI,45,37,8,5,3,OUI,OUI,2025-03-14 00:01:55+00:00,"48.83005755305626, 2.3232302069664006",Paris,75056,0.17777777777777778,0
9006,Dunkerque - Trudaine,OUI,16,13,3,0,3,OUI,OUI,2025-03-14 00:02:08+00:00,"48.88215166773376, 2.3463253676891327",Paris,75056,0.1875,0
10008,Cité Riverin - Château d'Eau,OUI,17,0,17,16,1,OUI,OUI,2025-03-13 23:57:13+00:00,"48.870702423554306, 2.358739863900845",Paris,75056,1.0,0
18030,Joseph Dijon - Ornano,OUI,36,25,11,2,9,OUI,OUI,2025-03-14 00:01:54+00:00,"48.89374453351521, 2.3476678133010864",Paris,75056,0.3055555555555556,0
16012,Flandrin - Longchamp,OUI,38,33,5,1,4,OUI,OUI,2025-03-13 23:59:24+00:00,"48.86877849178477, 2.274354539176829",Paris,75056,0.13157894736842105,0
5024,Place Monge,OUI,21,14,7,4,3,OUI,OUI,2025-03-14 00:03:07+00:00,"48.842761803051, 2.3524079471827",Paris,75056,0.3333333333333333,0
16036,Porte Molitor,OUI,57,20,37,23,14,OUI,OUI,2025-03-14 00:02:26+00:00,"48.84524763511433, 2.2569015249609947",Paris,75056,0.6491228070175439,0
31005,Square Denise Buisson,OUI,45,37,8,3,5,OUI,OUI,2025-03-13 23:57:23+00:00,"48.8562322730982, 2.426436245441437",Montreuil,93048,0.17777777777777778,0
42505,Charles Frérot - Albert Guilpin,OUI,27,12,15,8,7,OUI,OUI,2025-03-14 00:02:16+00:00,"48.8155839183714, 2.3505029082298283",Gentilly,94037,0.5555555555555556,0
9011,Geoffroy - Marie,OUI,18,10,8,7,1,OUI,OUI,2025-03-13 23:59:53+00:00,"48.873781940593325, 2.344513876337893",Paris,75056,0.4444444444444444,0
8117,Place de la Madeleine - Royale,OUI,41,32,9,4,5,OUI,OUI,2025-03-14 00:01:17+00:00,"48.869228052648, 2.324421107769",Paris,75056,0.21951219512195122,0
5115,Buffon - Jardin des Plantes,OUI,28,8,20,19,1,OUI,OUI,2025-03-14 00:01:47+00:00,"48.842668466104875, 2.3618587106466293",Paris,75056,0.7142857142857143,0
12015,Place de la Nation - Picpus,OUI,36,25,11,5,6,OUI,OUI,2025-03-13 23:55:24+00:00,"48.846821681548, 2.4001130461693",Paris,75056,0.3055555555555556,0
12101,Charenton - Prague,OUI,28,7,21,17,4,OUI,OUI,2025-03-14 00:01:55+00:00,"48.848175129981, 2.3763584494312",Paris,75056,0.75,0
48004,Maxime Gorki - Louis Aragon,OUI,20,20,0,0,0,OUI,OUI,2025-03-14 00:03:04+00:00,"48.78909814728443, 2.368387877941132",Villejuif,94076,0.0,0
4019,Cloître Saint-Merri - Renard,OUI,29,10,19,18,1,OUI,OUI,2025-03-14 00:01:10+00:00,"48.858835448898, 2.3518279194832",Paris,75056,0.6551724137931034,0
26004,Gare RER les Grésillons,OUI,21,4,17,4,13,OUI,OUI,2025-03-14 00:00:08+00:00,"48.919898633572764, 2.31458459136273",Asnières-sur-Seine,92004,0.8095238095238095,0
8027,Mairie du 8ème,OUI,14,13,1,0,1,OUI,OUI,2025-03-13 23:58:06+00:00,"48.877932, 2.318264",Paris,75056,0.07142857142857142,0
18139,Poissonniers - Championnet,OUI,28,19,9,0,9,OUI,OUI,2025-03-13 23:58:29+00:00,"48.89543299733937, 2.3530178144574165",Paris,75056,0.32142857142857145,0
15039,Abbé Groult - Convention,OUI,12,3,9,3,6,OUI,OUI,2025-03-14 00:01:05+00:00,"48.83596927866069, 2.302064039509349",Paris,75056,0.75,0
16042,Murat - Porte de Saint-Cloud,OUI,37,3,34,31,3,OUI,OUI,2025-03-14 00:03:03+00:00,"48.83750862621299, 2.2577651962637906",Paris,75056,0.918918918918919,0
21315,Jules Guesdes - Général de Gaulle,OUI,24,2,22,8,14,OUI,OUI,2025-03-13 23:55:26+00:00,"48.81930581291959, 2.278934195637703",Issy-les-Moulineaux,92040,0.9166666666666666,0
15001,Gare Montparnasse - Arrivée,OUI,41,37,4,0,4,OUI,OUI,2025-03-14 00:02:55+00:00,"48.843827994315, 2.3225811123848",Paris,75056,0.0975609756097561,0
23102,Hôtel de Ville de Sèvres,OUI,31,14,17,16,1,OUI,OUI,2025-03-13 23:56:35+00:00,"48.824363561289, 2.2131047397852",Sèvres,92072,0.5483870967741935,0
19110,Square Claude Bernard,OUI,27,21,6,3,3,OUI,OUI,2025-03-14 00:00:50+00:00,"48.89876016219984, 2.375325746834278",Paris,75056,0.2222222222222222,0
15036,Croix Nivert - Square Saint-Lambert,OUI,47,47,0,0,0,NON,NON,2025-03-03 09:03:43+00:00,"48.843051521591, 2.2952004522085",Paris,75056,0.0,9
11112,Jules Vallès - Charonne,OUI,23,1,22,16,6,OUI,OUI,2025-03-14 00:01:48+00:00,"48.854284379935, 2.3847674578428",Paris,75056,0.9565217391304348,0
6022,Marché Saint-Germain,OUI,19,19,0,0,0,OUI,OUI,2025-03-14 00:02:27+00:00,"48.85165625855281, 2.335500307381153",Paris,75056,0.0,0
18202,Diane Arbus,OUI,37,29,8,5,3,OUI,OUI,2025-03-14 00:01:06+00:00,"48.898800717199, 2.3524022474885",Paris,75056,0.21621621621621623,0
15006,Cherche-Midi - Hôpital Necker,OUI,37,24,13,8,5,OUI,OUI,2025-03-14 00:01:54+00:00,"48.84461063309956, 2.317914068698883",Paris,75056,0.35135135135135137,0
3008,Perle - Vieille du Temple,OUI,34,11,23,22,1,OUI,OUI,2025-03-14 00:01:20+00:00,"48.8601346, 2.3611206",Paris,75056,0.6764705882352942,0
21402,Place Aimé Césaire,OUI,27,23,4,0,4,OUI,OUI,2025-03-13 23:59:10+00:00,"48.783194713067815, 2.2429127991199493",Clamart,92023,0.14814814814814814,0
1007,Turbigo - Française,OUI,16,12,4,3,1,OUI,OUI,2025-03-14 00:01:43+00:00,"48.86358858111446, 2.3477794602513313",Paris,75056,0.25,0
41403,Gare RER - Malleret-Joinville,OUI,19,0,19,14,5,OUI,OUI,2025-03-14 00:02:23+00:00,"48.802936, 2.42531",Alfortville,94002,1.0,0
47003,Charentonneau - Maisons Alfort,OUI,20,0,20,9,11,OUI,OUI,2025-03-13 23:59:08+00:00,"48.809932980484355, 2.443288456496946",Maisons-Alfort,94046,1.0,0
13018,Bruant - Vincent Auriol,OUI,24,18,6,2,4,OUI,OUI,2025-03-14 00:02:23+00:00,"48.834848452929, 2.3668264996271",Paris,75056,0.25,0
18004,Place des Abbesses,OUI,11,8,3,1,2,OUI,OUI,2025-03-14 00:01:07+00:00,"48.884542726149725, 2.3386867716908455",Paris,75056,0.2727272727272727,0
13052,Leredde - Tolbiac,OUI,40,23,17,16,1,OUI,OUI,2025-03-13 23:58:44+00:00,"48.82887629664, 2.3744382709265",Paris,75056,0.425,0
16013,Mairie du 16ème,OUI,35,32,3,1,2,OUI,OUI,2025-03-14 00:01:55+00:00,"48.863936848471994, 2.2765953093767166",Paris,75056,0.08571428571428572,0
17024,Villiers - Batignolles,OUI,23,19,4,3,1,OUI,OUI,2025-03-14 00:00:17+00:00,"48.88125253846116, 2.31653843075037",Paris,75056,0.17391304347826086,0
7012,Cité Vaneau,OUI,24,12,12,10,2,OUI,OUI,2025-03-13 23:59:14+00:00,"48.8542210666207, 2.319614924490452",Paris,75056,0.5,0
15127,Place Charles Michels,OUI,35,0,35,28,7,OUI,OUI,2025-03-14 00:02:35+00:00,"48.846401, 2.28502",Paris,75056,1.0,0
20008,Pyrénées - Avron,OUI,32,28,4,3,1,OUI,OUI,2025-03-13 23:53:53+00:00,"48.853246898211985, 2.405871044529538",Paris,75056,0.125,0
14011,Place des Droits de l'Enfant,OUI,38,20,18,4,14,OUI,OUI,2025-03-14 00:02:02+00:00,"48.8274804, 2.3319217",Paris,75056,0.47368421052631576,0
20104,Louis Lumière.,OUI,22,21,1,0,1,OUI,OUI,2025-03-14 00:02:43+00:00,"48.86216198070008, 2.41112578185621",Paris,75056,0.045454545454545456,0
41401,Marne - Charles de Gaulle,OUI,25,2,23,15,8,OUI,OUI,2025-03-14 00:02:31+00:00,"48.815071719544434, 2.4121668934822087",Alfortville,94002,0.92,0
8110,Gare Saint-Lazare - Stockholm,OUI,31,30,1,1,0,OUI,OUI,2025-03-13 23:59:53+00:00,"48.877127316667654, 2.322417162358761",Paris,75056,0.03225806451612903,0
20044,Davout - Volga,OUI,27,24,3,1,2,OUI,OUI,2025-03-14 00:01:05+00:00,"48.852919679957296, 2.410522909779111",Paris,75056,0.1111111111111111,0
12156,Niger - Soult,OUI,23,11,12,3,9,OUI,OUI,2025-03-14 00:02:50+00:00,"48.84369906369085, 2.410361237220498",Paris,75056,0.5217391304347826,0
16019,Porte de la Muette,OUI,34,34,0,0,0,OUI,OUI,2025-03-13 23:59:10+00:00,"48.86302317841182, 2.2687188170157406",Paris,75056,0.0,0
18140,Porte de Clignancourt - Ney,OUI,39,28,11,4,7,OUI,OUI,2025-03-13 23:57:46+00:00,"48.899641123987095, 2.344321422278881",Paris,75056,0.28205128205128205,0
33012,Landy - Heurtault,OUI,28,15,13,5,8,OUI,OUI,2025-03-13 23:58:05+00:00,"48.915096534520316, 2.375951372087002",Aubervilliers,93001,0.4642857142857143,0
2013,Favart - Italiens,OUI,17,16,1,1,0,OUI,OUI,2025-03-13 23:57:03+00:00,"48.871446353921, 2.3382901058508",Paris,75056,0.058823529411764705,0
9009,Square Montholon,OUI,17,6,11,10,1,OUI,OUI,2025-03-14 00:02:49+00:00,"48.876620377545024, 2.3457641154527664",Paris,75056,0.6470588235294118,0
3102,Bourg l'Abbé - Saint-Martin,OUI,36,11,25,22,3,OUI,OUI,2025-03-14 00:03:10+00:00,"48.86393331949257, 2.352406270802021",Paris,75056,0.6944444444444444,0
4021,Centre Georges Pompidou,OUI,24,18,6,2,4,OUI,OUI,2025-03-14 00:03:07+00:00,"48.861419, 2.352581",Paris,75056,0.25,0
41203,Stalingrad - Rigollots,OUI,51,32,19,3,16,OUI,OUI,2025-03-13 23:53:32+00:00,"48.84997403844251, 2.45557576417923",Fontenay-sous-Bois,94033,0.37254901960784315,0
19010,Emile Reynaud - Porte de la Villette,OUI,22,4,18,5,13,OUI,OUI,2025-03-14 00:03:16+00:00,"48.90098953630053, 2.3887022584676743",Paris,75056,0.8181818181818182,0
10033,Gare du Nord - Saint-Vincent de Paul,OUI,24,21,3,0,3,OUI,OUI,2025-03-14 00:02:26+00:00,"48.880955741648, 2.3524305148385",Paris,75056,0.125,0
22301,Chausson - Gabriel Péri,OUI,21,4,17,12,5,OUI,OUI,2025-03-14 00:01:31+00:00,"48.921891003481115, 2.2952306270599365",Gennevilliers,92036,0.8095238095238095,0
18039,Jardins d'Eole,OUI,19,10,9,3,6,OUI,OUI,2025-03-14 00:02:46+00:00,"48.8869703, 2.3668488",Paris,75056,0.47368421052631576,0
15132,Bargue -  Dutot,OUI,21,12,9,3,6,OUI,OUI,2025-03-13 23:54:39+00:00,"48.837884, 2.308876",Paris,75056,0.42857142857142855,0
8028,Arsène Houssaye - Champs-Elysées,OUI,28,27,1,0,1,OUI,OUI,2025-03-13 23:56:06+00:00,"48.873409276267, 2.2977904602885",Paris,75056,0.03571428571428571,0
10032,Claude Vellefaux - Hôpital Saint-Louis,OUI,32,24,8,6,2,OUI,OUI,2025-03-14 00:01:47+00:00,"48.872859139003, 2.3700717069851",Paris,75056,0.25,0
10011,Bourse du Travail,OUI,17,2,15,11,4,OUI,OUI,2025-03-14 00:02:50+00:00,"48.868976638826, 2.3623438552022",Paris,75056,0.8823529411764706,0
14001,Edgar Quinet - Gaité,OUI,27,27,0,0,0,OUI,OUI,2025-03-14 00:02:09+00:00,"48.841160928966, 2.324595451355",Paris,75056,0.0,0
21953,Gare de Bellevue,OUI,20,18,2,0,2,OUI,OUI,2025-03-14 00:02:31+00:00,"48.8192404685572, 2.2295309230685234",Meudon,92048,0.1,0
1006,Grande Truanderie - Saint-Denis,OUI,28,8,20,19,1,OUI,OUI,2025-03-13 23:58:05+00:00,"48.8626302, 2.3498075",Paris,75056,0.7142857142857143,0
14019,Sarrette - Général Leclerc,OUI,22,19,3,0,3,OUI,OUI,2025-03-14 00:02:46+00:00,"48.825030852925, 2.3264128693982",Paris,75056,0.13636363636363635,0
15008,Sèvres - Lecourbe,OUI,60,52,8,4,4,OUI,OUI,2025-03-14 00:01:36+00:00,"48.8447677, 2.3110086",Paris,75056,0.13333333333333333,0
12002,Lacuée - Lyon,OUI,15,2,13,11,2,OUI,OUI,2025-03-13 23:57:57+00:00,"48.849268481958, 2.3704585433006",Paris,75056,0.8666666666666667,0
22201,Henri Ravera - Gabriel Péri,OUI,28,7,21,1,20,OUI,OUI,2025-03-14 00:02:32+00:00,"48.79722273833844, 2.302115857601166",Bagneux,92007,0.75,0
21506,Maurice Payret-Dortail,OUI,22,16,6,0,6,OUI,OUI,2025-03-14 00:01:56+00:00,"48.87811957063342, 2.2233625128865246",Suresnes,92073,0.2727272727272727,0
5007,Ecoles - Carmes,OUI,33,22,11,10,1,OUI,OUI,2025-03-14 00:02:52+00:00,"48.848904447989405, 2.3473486304283147",Paris,75056,0.3333333333333333,0
4103,Archives - Rivoli,OUI,21,14,7,4,3,OUI,OUI,2025-03-14 00:03:01+00:00,"48.857346707443, 2.3539767041802",Paris,75056,0.3333333333333333,0
16105,Crevaux - Bugeaud,OUI,31,26,5,2,3,OUI,OUI,2025-03-14 00:01:49+00:00,"48.87080942867, 2.2811490076919",Paris,75056,0.16129032258064516,0
9037,Parme - Clichy,OUI,23,20,3,2,1,OUI,OUI,2025-03-13 23:57:57+00:00,"48.881266424227, 2.3281970934506",Paris,75056,0.13043478260869565,0
4006,Bourdon - Pont Morland,OUI,48,3,45,41,4,OUI,OUI,2025-03-14 00:02:37+00:00,"48.8478103, 2.3659356",Paris,75056,0.9375,0
32013,Saint-Denis - Université,OUI,18,12,6,0,6,OUI,OUI,2025-03-13 23:58:59+00:00,"48.94563430946964, 2.3638297989964485",Saint-Denis,93066,0.3333333333333333,0
6010,Chevreuse - Montparnasse,OUI,14,13,1,0,1,OUI,OUI,2025-03-13 23:56:47+00:00,"48.841739161231, 2.3315522167367",Paris,75056,0.07142857142857142,0
2003,Saint-Denis - Réaumur,OUI,31,13,18,16,2,OUI,OUI,2025-03-13 23:57:47+00:00,"48.8661116315789, 2.3507790675507594",Paris,75056,0.5806451612903226,0
5015,Epée de Bois - Mouffetard,OUI,62,48,14,12,2,OUI,OUI,2025-03-14 00:03:00+00:00,"48.841508690388835, 2.350066713988781",Paris,75056,0.22580645161290322,0
22503,Joffre - Aigle,OUI,19,9,10,6,4,OUI,OUI,2025-03-13 23:57:03+00:00,"48.904033, 2.245096",La Garenne-Colombes,92035,0.5263157894736842,0
45002,Roger Salengro - Général de Gaulle,OUI,27,11,16,5,11,OUI,OUI,2025-03-14 00:02:56+00:00,"48.820029010376956, 2.4846760556101803",Champigny-sur-Marne,94017,0.5925925925925926,0
1102,Française - Etienne Marcel,OUI,35,28,7,7,0,OUI,OUI,2025-03-14 00:01:42+00:00,"48.864053304653766, 2.347587011754513",Paris,75056,0.2,0
15128,Cadix - Hameau,OUI,36,3,33,23,10,OUI,OUI,2025-03-14 00:01:34+00:00,"48.8340107632249, 2.289516180753708",Paris,75056,0.9166666666666666,0
15111,Olivier de Serres - Leriche,OUI,24,13,11,4,7,OUI,OUI,2025-03-14 00:00:24+00:00,"48.83460221715206, 2.2957482933998112",Paris,75056,0.4583333333333333,0
44014,Camille Risch - Paul Armangot,OUI,25,21,4,3,1,OUI,OUI,2025-03-13 23:59:12+00:00,"48.774703, 2.373685",Vitry-sur-Seine,94081,0.16,0
2021,Cléry - Montmartre,OUI,57,49,8,7,1,OUI,OUI,2025-03-13 23:55:41+00:00,"48.867458, 2.3445211",Paris,75056,0.14035087719298245,0
12037,Reuilly - Daumesnil,OUI,36,19,17,9,8,OUI,OUI,2025-03-14 00:02:55+00:00,"48.8395385, 2.3972516",Paris,75056,0.4722222222222222,0
24006,Adolphe Lalyre - Armand Silvestre,OUI,38,22,16,5,11,OUI,OUI,2025-03-14 00:02:29+00:00,"48.90406266961591, 2.273416221141815",Courbevoie,92026,0.42105263157894735,0
20001,Place de la Nation - Charonne,OUI,35,14,21,15,6,OUI,OUI,2025-03-14 00:02:58+00:00,"48.848364667777, 2.3997623859813",Paris,75056,0.6,0
3009,Temple - Haudriettes,OUI,19,4,15,14,1,OUI,OUI,2025-03-14 00:01:18+00:00,"48.861636880212, 2.3566960206458",Paris,75056,0.7894736842105263,0
18034,Leibniz - Jean Dollfus,OUI,32,26,6,2,4,OUI,OUI,2025-03-14 00:00:47+00:00,"48.896328348515986, 2.333390423834684",Paris,75056,0.1875,0
14132,Bézout - Général Leclerc,OUI,29,21,8,3,5,OUI,OUI,2025-03-13 23:54:56+00:00,"48.82884804502439, 2.3285973072052",Paris,75056,0.27586206896551724,0
12019,Gare de Reuilly - Picpus,OUI,26,9,17,9,8,OUI,OUI,2025-03-14 00:02:12+00:00,"48.84267354116789, 2.3972943797707558",Paris,75056,0.6538461538461539,0
4014,Blancs-Manteaux - Archives,OUI,28,3,25,22,3,OUI,OUI,2025-03-14 00:01:48+00:00,"48.85941800703, 2.3559471219778",Paris,75056,0.8928571428571429,0
14135,Jourdan - Cité Universitaire,OUI,39,34,5,4,1,OUI,OUI,2025-03-14 00:01:17+00:00,"48.819897343156676, 2.3397007964124366",Paris,75056,0.1282051282051282,0
3012,Square Emile - Chautemps,OUI,23,5,18,15,3,OUI,OUI,2025-03-14 00:00:44+00:00,"48.867433724231, 2.3536357283592",Paris,75056,0.782608695652174,0
20024,Gambetta - Père Lachaise,OUI,26,15,11,1,10,OUI,OUI,2025-03-14 00:01:05+00:00,"48.864295696165875, 2.398228667282044",Paris,75056,0.4230769230769231,0
14022,Didot - Mariniers,OUI,34,30,4,3,1,OUI,OUI,2025-03-14 00:00:41+00:00,"48.82650543613106, 2.313136198271666",Paris,75056,0.11764705882352941,0
3010,Beaubourg - Michel-le-Comte,OUI,14,6,8,5,3,OUI,OUI,2025-03-14 00:03:08+00:00,"48.862534941806, 2.3543103039265",Paris,75056,0.5714285714285714,0
19012,Lally-Tollendal - Armand Carrel,OUI,26,13,13,7,6,OUI,OUI,2025-03-13 23:56:38+00:00,"48.88270066221072, 2.374717555940151",Paris,75056,0.5,0
10034,Louis Blanc - La Chapelle,OUI,21,12,9,4,5,OUI,OUI,2025-03-14 00:01:57+00:00,"48.884008964514, 2.3599335551262",Paris,75056,0.42857142857142855,0
31001,Lagny - Auguste Blanqui,OUI,26,24,2,0,2,OUI,OUI,2025-03-14 00:01:32+00:00,"48.84922568052601, 2.4218603968620305",Montreuil,93048,0.07692307692307693,0
6104,Herschel - Observatoire,OUI,36,31,5,4,1,OUI,OUI,2025-03-13 23:59:52+00:00,"48.84342376221923, 2.3376645147800446",Paris,75056,0.1388888888888889,0
14023,Adolphe Pinard - Victor Hugo,OUI,50,40,10,5,5,OUI,OUI,2025-03-13 23:59:15+00:00,"48.8236825874564, 2.3077843710780144",Malakoff,92046,0.2,0
21309,Mairie d'Issy,OUI,39,23,16,16,0,OUI,OUI,2025-03-13 23:58:58+00:00,"48.823767792468, 2.2723111510277",Issy-les-Moulineaux,92040,0.41025641025641024,0
19111,Cesaria Evora - Rosa Parks,OUI,35,27,8,2,6,OUI,OUI,2025-03-14 00:03:04+00:00,"48.89717672825043, 2.3745173960924144",Paris,75056,0.22857142857142856,0
16102,Pergolèse - Marbeau,OUI,25,17,8,6,2,OUI,OUI,2025-03-14 00:00:12+00:00,"48.873568706869, 2.2815125225299",Paris,75056,0.32,0
8036,Lisbonne - Monceau,OUI,46,44,2,1,1,OUI,OUI,2025-03-14 00:02:32+00:00,"48.877455676814, 2.3096942214195",Paris,75056,0.043478260869565216,0
20034,Sorbier - Ménilmontant,OUI,24,19,5,0,5,OUI,OUI,2025-03-13 23:58:19+00:00,"48.868542395661, 2.3897721245885",Paris,75056,0.20833333333333334,0
14133,Froidevaux - Boulard,OUI,32,28,4,0,4,OUI,OUI,2025-03-14 00:00:30+00:00,"48.835147319625, 2.3294411972165",Paris,75056,0.125,0
13005,Cordelières - Arago,OUI,44,0,44,39,5,OUI,OUI,2025-03-14 00:03:02+00:00,"48.83548071896613, 2.348572461702221",Paris,75056,1.0,0
21215,Verdier - Jean Jaurès,OUI,33,24,9,1,8,OUI,OUI,2025-03-14 00:01:34+00:00,"48.81614048711214, 2.3123561963438988",Montrouge,92049,0.2727272727272727,0
19002,Centquatre,OUI,36,16,20,11,9,NON,NON,2025-03-14 00:02:05+00:00,"48.889333538455, 2.3707854375243",Paris,75056,0.5555555555555556,0
41208,Alouettes - Maréchal de Lattre de Tassigny,OUI,21,19,2,1,1,OUI,OUI,2025-03-13 23:56:40+00:00,"48.85511009293948, 2.4930700287222862",Fontenay-sous-Bois,94033,0.09523809523809523,0
17019,Phalsbourg - Villiers,OUI,19,17,2,1,1,OUI,OUI,2025-03-14 00:00:10+00:00,"48.88242307900951, 2.3090453445911407",Paris,75056,0.10526315789473684,0
42704,Mairie du Kremlin-Bicêtre,OUI,25,12,13,6,7,OUI,OUI,2025-03-14 00:02:30+00:00,"48.81191981537702, 2.3570189997553825",Le Kremlin-Bicêtre,94043,0.52,0
19201,Petit - Georges Thill,OUI,23,9,14,2,12,OUI,OUI,2025-03-13 23:58:05+00:00,"48.88603131999171, 2.3895753175020222",Paris,75056,0.6086956521739131,0
21706,Jean Bleuzen - Square du 11 Novembre,OUI,45,43,2,0,2,OUI,OUI,2025-03-13 23:58:34+00:00,"48.8232579, 2.2965213",Vanves,92075,0.044444444444444446,0
10009,Mairie du 10ème,OUI,17,2,15,14,1,OUI,OUI,2025-03-14 00:01:34+00:00,"48.872089449907, 2.3575825989246",Paris,75056,0.8823529411764706,0
2012,Choiseul - Quatre Septembre,OUI,42,42,0,0,0,OUI,OUI,2025-03-14 00:02:44+00:00,"48.8699355331869, 2.3359975218772893",Paris,75056,0.0,0
41405,Place de l'Europe - Alfortville,OUI,24,1,23,18,5,OUI,OUI,2025-03-13 23:59:53+00:00,"48.78913702405837, 2.4284800887107854",Alfortville,94002,0.9583333333333334,0
12163,Hippodrome Paris-Vincennes,OUI,42,42,0,0,0,OUI,OUI,2025-03-14 00:02:17+00:00,"48.82048387758518, 2.446271181106568",Paris,75056,0.0,0
20006,Pyrénées - Plaine,OUI,12,6,6,2,4,OUI,OUI,2025-03-13 23:57:55+00:00,"48.85026702458, 2.4062821269035",Paris,75056,0.5,0
21509,Gardenat Lapostol - Franklin Roosevelt,OUI,24,23,1,0,1,OUI,OUI,2025-03-14 00:02:28+00:00,"48.871839, 2.222505",Suresnes,92073,0.041666666666666664,0
14137,Maurice d'Ocagne - General Maudhuy,OUI,29,13,16,3,13,OUI,OUI,2025-03-14 00:00:33+00:00,"48.82414282524159, 2.3158789426088333",Paris,75056,0.5517241379310345,0
2004,Square Pierre Lazareff,OUI,17,12,5,2,3,OUI,OUI,2025-03-14 00:02:27+00:00,"48.867141720746, 2.3483933508396",Paris,75056,0.29411764705882354,0
3011,Turbigo - Réaumur,OUI,29,12,17,16,1,OUI,OUI,2025-03-14 00:02:40+00:00,"48.865574047531, 2.3564198613167",Paris,75056,0.5862068965517241,0
2016,Aboukir - Alexandrie,OUI,21,7,14,10,4,OUI,OUI,2025-03-14 00:03:13+00:00,"48.86868344444473, 2.3502043269474897",Paris,75056,0.6666666666666666,0
31709,Place de la Fraternité,OUI,22,10,12,2,10,OUI,OUI,2025-03-14 00:02:44+00:00,"48.85716405838368, 2.422847449779511",Montreuil,93048,0.5454545454545454,0
4018,Saint-Bon - Rivoli,OUI,14,3,11,10,1,OUI,OUI,2025-03-14 00:03:08+00:00,"48.857999643315, 2.3502172809763",Paris,75056,0.7857142857142857,0
10027,Dunkerque - Alsace,OUI,19,17,2,1,1,OUI,OUI,2025-03-13 23:59:06+00:00,"48.879355, 2.358379",Paris,75056,0.10526315789473684,0
44001,Quai Jules Guesde - Saint-Simon,OUI,30,16,14,12,2,OUI,OUI,2025-03-13 23:53:28+00:00,"48.80391487219, 2.4089661620274",Vitry-sur-Seine,94081,0.4666666666666667,0
10006,Petites Ecuries - Faubourg Saint-Denis,OUI,28,25,3,1,2,OUI,OUI,2025-03-14 00:01:42+00:00,"48.87287120589831, 2.3542150855064397",Paris,75056,0.10714285714285714,0
4007,Place de la Bastille - Bourdon,OUI,30,12,18,16,2,OUI,OUI,2025-03-14 00:02:24+00:00,"48.852364355271, 2.3681089282036",Paris,75056,0.6,0
22401,Charles de Gaulle - Plateau de Vanves,OUI,33,32,1,0,1,OUI,OUI,2025-03-13 23:57:20+00:00,"48.82233088973263, 2.298571803412886",Malakoff,92046,0.030303030303030304,0
5004,Saint-Jacques - Val de Grâce,OUI,18,16,2,0,2,OUI,OUI,2025-03-14 00:01:10+00:00,"48.8417514, 2.3413893",Paris,75056,0.1111111111111111,0
14103,Maine - Liancourt,OUI,25,18,7,2,5,OUI,OUI,2025-03-14 00:03:16+00:00,"48.835064363954, 2.323731449974",Paris,75056,0.28,0
4009,Village Saint-Paul,OUI,27,3,24,22,2,OUI,OUI,2025-03-14 00:01:24+00:00,"48.852639866625, 2.3607301712036",Paris,75056,0.8888888888888888,0
3001,Beaumarchais - Saint-Gilles,OUI,47,32,15,14,1,OUI,OUI,2025-03-14 00:03:08+00:00,"48.8580378, 2.3679352",Paris,75056,0.3191489361702128,0
33020,Waldeck Rochet - Germaine Tillon,OUI,30,20,10,4,6,OUI,OUI,2025-03-14 00:00:57+00:00,"48.91105960199651, 2.3676301538944244",Aubervilliers,93001,0.3333333333333333,0
7021,Bosquet - Saint-Dominique,OUI,26,9,17,11,6,OUI,OUI,2025-03-14 00:00:41+00:00,"48.858651709526, 2.3037165802346",Paris,75056,0.6538461538461539,0
32019,Place du 8 mai 1945.,OUI,28,10,18,6,12,OUI,OUI,2025-03-14 00:02:52+00:00,"48.938882272105, 2.3566243797541",Saint-Denis,93066,0.6428571428571429,0
2015,Louis le Grand - Italiens,OUI,33,30,3,0,3,OUI,OUI,2025-03-13 23:56:07+00:00,"48.870508937204, 2.3340544619393",Paris,75056,0.09090909090909091,0
9039,Chaussée d'Antin - Haussmann,OUI,23,19,4,3,1,OUI,OUI,2025-03-14 00:00:36+00:00,"48.87243, 2.33359",Paris,75056,0.17391304347826086,0
21026,Sèvres - Général Leclerc,OUI,29,19,10,8,2,OUI,OUI,2025-03-14 00:03:05+00:00,"48.830121559055, 2.2314262390137",Boulogne-Billancourt,92012,0.3448275862068966,0
1025,Oratoire - Rivoli,OUI,16,7,9,7,2,OUI,OUI,2025-03-14 00:00:32+00:00,"48.861342760889, 2.3400047421455",Paris,75056,0.5625,0
19129,Solitaires - Place des Fêtes,OUI,29,29,0,0,0,NON,NON,2025-02-23 09:26:05+00:00,"48.876601, 2.391769",Paris,75056,0.0,9
2008,Mairie du 2ème,OUI,28,24,4,2,2,OUI,OUI,2025-03-14 00:03:13+00:00,"48.8672190355135, 2.3404625437747044",Paris,75056,0.14285714285714285,0
20029,Frères Flavien - Porte des Lilas,OUI,23,7,16,5,11,OUI,OUI,2025-03-14 00:00:49+00:00,"48.8780992764359, 2.41104629853209",Paris,75056,0.6956521739130435,0
18015,Custine - Ramey,OUI,41,16,25,5,20,OUI,OUI,2025-03-14 00:00:36+00:00,"48.888735896947, 2.3469526693225",Paris,75056,0.6097560975609756,0
13017,Nationale - Vincent Auriol,OUI,32,26,6,0,6,OUI,OUI,2025-03-14 00:01:22+00:00,"48.83252708397293, 2.362354410392119",Paris,75056,0.1875,0
32024,Port - Confluence,OUI,23,9,14,7,7,OUI,OUI,2025-03-14 00:03:10+00:00,"48.936093926526, 2.3436167797955",Saint-Denis,93066,0.6086956521739131,0
12020,Cours de Vincennes - Soult,OUI,44,18,26,25,1,OUI,OUI,2025-03-13 23:59:29+00:00,"48.846918761569, 2.4105220288038",Paris,75056,0.5909090909090909,0
6026,Saint-Placide - Cherche Midi,OUI,65,59,6,2,4,OUI,OUI,2025-03-14 00:00:31+00:00,"48.8490535919234, 2.325317971408367",Paris,75056,0.09230769230769231,0
2005,Montmartre - Etienne Marcel,OUI,16,7,9,7,2,OUI,OUI,2025-03-14 00:00:43+00:00,"48.86502194581, 2.3450684401448",Paris,75056,0.5625,0
42018,Amédée Huon - Fort d'Ivry,OUI,29,24,5,3,2,OUI,OUI,2025-03-13 23:58:18+00:00,"48.805131376899986, 2.388489693403244",Ivry-sur-Seine,94041,0.1724137931034483,0
23702,Hôtel de Ville de Chaville,OUI,20,18,2,0,2,OUI,OUI,2025-03-13 23:53:18+00:00,"48.80887149094033, 2.188134044408798",Chaville,92022,0.1,0
12164,Stade Pershing,OUI,26,26,0,0,0,NON,NON,2025-02-26 05:58:32+00:00,"48.829107826857, 2.4583535268903",Paris,75056,0.0,6
2002,Etienne Marcel - Montorgueil,OUI,27,10,17,17,0,OUI,OUI,2025-03-13 23:55:32+00:00,"48.86450567259199, 2.3461959511041637",Paris,75056,0.6296296296296297,0
1023,Saint-Honoré - Musée du Louvre,OUI,22,15,7,7,0,OUI,OUI,2025-03-14 00:00:52+00:00,"48.863443132848, 2.3348781846405",Paris,75056,0.3181818181818182,0
21507,Gardenat-Lapostol - Velettes,OUI,20,16,4,0,4,OUI,OUI,2025-03-14 00:00:18+00:00,"48.87387, 2.224185",Suresnes,92073,0.2,0
19202,Marseillaise - Grenade,OUI,44,28,16,5,11,OUI,OUI,2025-03-14 00:02:57+00:00,"48.889371092747, 2.3979396821544",Paris,75056,0.36363636363636365,0
22306,Place du 17 Octobre,OUI,15,7,8,4,4,OUI,OUI,2025-03-13 23:59:04+00:00,"48.91962690034779, 2.2978286134199792",Gennevilliers,92036,0.5333333333333333,0
14201,Decrès - Alésia,OUI,30,20,10,2,8,OUI,OUI,2025-03-14 00:01:59+00:00,"48.832200060759, 2.3139070151575",Paris,75056,0.3333333333333333,0
22502,Kléber - National,OUI,19,18,1,0,1,OUI,OUI,2025-03-13 23:53:48+00:00,"48.906333898712234, 2.2393910586833954",La Garenne-Colombes,92035,0.05263157894736842,0
5003,Le Goff - Gay-Lussac,OUI,34,33,1,1,0,OUI,OUI,2025-03-14 00:02:41+00:00,"48.846102400979, 2.3412207886577",Paris,75056,0.029411764705882353,0
3006,Mairie du 3ème,OUI,24,3,21,16,5,OUI,OUI,2025-03-14 00:02:32+00:00,"48.86446178139141, 2.361762821674347",Paris,75056,0.875,0
31020,Résistance - Parmentier,OUI,33,26,7,0,7,OUI,OUI,2025-03-14 00:01:53+00:00,"48.85965138131299, 2.436705082654953",Montreuil,93048,0.21212121212121213,0
18112,Arthur Ranc - Hôpital Bichat,OUI,24,17,7,1,6,OUI,OUI,2025-03-14 00:01:15+00:00,"48.8978712500682, 2.333521842956543",Paris,75056,0.2916666666666667,0
4015,Mairie du 4ème,OUI,40,11,29,27,2,OUI,OUI,2025-03-14 00:03:03+00:00,"48.855949910497, 2.3563823103905",Paris,75056,0.725,0
6007,Bréa - Raspail,OUI,24,22,2,0,2,OUI,OUI,2025-03-13 23:54:39+00:00,"48.842738478258, 2.3297942217634",Paris,75056,0.08333333333333333,0
3003,Fille du Calvaire - Turenne,OUI,25,6,19,18,1,OUI,OUI,2025-03-14 00:02:56+00:00,"48.86210505412563, 2.3649600148200993",Paris,75056,0.76,0
21119,Belfort - Victor Hugo,OUI,21,2,19,12,7,OUI,OUI,2025-03-14 00:02:31+00:00,"48.9018492, 2.3172724",Clichy,92024,0.9047619047619048,0
9111,Victoire - Laffitte,OUI,19,15,4,3,1,OUI,OUI,2025-03-14 00:00:52+00:00,"48.87514373494672, 2.338118505144376",Paris,75056,0.21052631578947367,0
16201,Porte Dauphine,OUI,59,57,2,1,1,OUI,OUI,2025-03-14 00:02:37+00:00,"48.871139344351, 2.2749781616017",Paris,75056,0.03389830508474576,0
5122,Saint-Michel - Luxembourg,OUI,27,23,4,3,1,OUI,OUI,2025-03-14 00:00:49+00:00,"48.84501507626, 2.3394941166043",Paris,75056,0.14814814814814814,0
23042,André Theuriet - Blagis,OUI,30,29,1,0,1,OUI,OUI,2025-03-13 23:53:24+00:00,"48.77977325745441, 2.3130525648593903",Bourg-la-Reine,92014,0.03333333333333333,0
13125,Gare d'Austerlitz - Pont Charles de Gaulle,OUI,52,41,11,10,1,OUI,OUI,2025-03-14 00:02:06+00:00,"48.842319830109, 2.3670300096273",Paris,75056,0.21153846153846154,0
42019,Lampes,OUI,43,0,43,36,7,OUI,OUI,2025-03-14 00:01:53+00:00,"48.81152481985875, 2.4017931148409843",Ivry-sur-Seine,94041,1.0,0
21110,Parc Roger Salengro,OUI,31,2,29,21,8,OUI,OUI,2025-03-14 00:01:08+00:00,"48.905303858642, 2.31055945158",Clichy,92024,0.9354838709677419,0
10201,Magenta - Chabrol,OUI,23,11,12,8,4,OUI,OUI,2025-03-14 00:01:31+00:00,"48.876495350882, 2.3560990020633",Paris,75056,0.5217391304347826,0
6031,Pierre Sarrazin - Saint-Michel,OUI,29,24,5,4,1,OUI,OUI,2025-03-14 00:02:14+00:00,"48.850908146398, 2.342130728066",Paris,75056,0.1724137931034483,0
42210,Victor Hugo - Paul Eluard,OUI,31,10,21,14,7,OUI,OUI,2025-03-14 00:00:47+00:00,"48.819602554907, 2.4114319673051",Charenton-le-Pont,94018,0.6774193548387096,0
48005,Eugène Varlin - Place de la Paix,OUI,23,15,8,1,7,OUI,OUI,2025-03-14 00:00:10+00:00,"48.792862, 2.363093",Villejuif,94076,0.34782608695652173,0
44008,Youri Gagarine - Commune de Paris,OUI,32,5,27,10,17,OUI,OUI,2025-03-13 23:54:07+00:00,"48.782427463041, 2.3939734697342",Vitry-sur-Seine,94081,0.84375,0
4012,Tiron - Rivoli,OUI,27,0,27,24,3,OUI,OUI,2025-03-14 00:03:03+00:00,"48.855692253233, 2.3579058051109",Paris,75056,1.0,0
21011,Silly - Louis Blériot,OUI,22,19,3,3,0,OUI,OUI,2025-03-13 23:53:18+00:00,"48.83219045374266, 2.2340199351310734",Boulogne-Billancourt,92012,0.13636363636363635,0
1014,Rivoli - Musée du Louvre,OUI,18,11,7,3,4,OUI,OUI,2025-03-14 00:02:10+00:00,"48.86364636851945, 2.33409583568573",Paris,75056,0.3888888888888889,0
20010,Sorbier - Gasnier-Guy,OUI,34,29,5,0,5,OUI,OUI,2025-03-13 23:53:47+00:00,"48.865217631011, 2.3936596512794",Paris,75056,0.14705882352941177,0
4017,Place de l'Hôtel de Ville,OUI,13,3,10,10,0,OUI,OUI,2025-03-14 00:03:08+00:00,"48.8573314, 2.351458",Paris,75056,0.7692307692307693,0
42022,Gare RER - Maurice Grandcoing,OUI,37,17,20,19,1,OUI,OUI,2025-03-14 00:01:24+00:00,"48.813881, 2.392429",Ivry-sur-Seine,94041,0.5405405405405406,0
26006,Bas - Gabriel Péri,OUI,30,11,19,15,4,OUI,OUI,2025-03-14 00:01:41+00:00,"48.91585580539625, 2.2948095202445984",Asnières-sur-Seine,92004,0.6333333333333333,0
17202,Mariotte - Batignolles,OUI,19,14,5,2,3,OUI,OUI,2025-03-14 00:00:55+00:00,"48.884571659595, 2.321469503475",Paris,75056,0.2631578947368421,0
42211,Séminaire de Conflans - Liberté,OUI,24,21,3,3,0,OUI,OUI,2025-03-13 23:58:24+00:00,"48.823194, 2.404179",Charenton-le-Pont,94018,0.125,0
17020,Jouffroy d'Abbans - Malesherbes,OUI,26,12,14,9,5,OUI,OUI,2025-03-14 00:02:32+00:00,"48.8850134, 2.3070717",Paris,75056,0.5384615384615384,0
42026,Barbès - Monique Maunoury,OUI,40,37,3,2,1,OUI,OUI,2025-03-13 23:57:55+00:00,"48.81552718820216, 2.3687169334905405",Ivry-sur-Seine,94041,0.075,0
12202,Charenton - Wattignies,OUI,40,3,37,31,6,OUI,OUI,2025-03-14 00:02:51+00:00,"48.836919119234, 2.3916775206425",Paris,75056,0.925,0
3002,Saint-Gilles - Turenne,OUI,15,5,10,6,4,OUI,OUI,2025-03-14 00:00:43+00:00,"48.858158956779, 2.3647149920992",Paris,75056,0.6666666666666666,0
23206,Béranger - Félix Faure,OUI,25,21,4,2,2,OUI,OUI,2025-03-14 00:01:40+00:00,"48.80404828621485, 2.2848263373723436",Châtillon,92020,0.16,0
13054,Pau Casals - Neuve Tolbiac,OUI,53,52,1,0,1,OUI,OUI,2025-03-13 23:57:58+00:00,"48.8311602, 2.3774395",Paris,75056,0.018867924528301886,0
20142,Mûriers - Père Lachaise,OUI,20,15,5,1,4,OUI,OUI,2025-03-14 00:00:57+00:00,"48.864130509668044, 2.39164982067019",Paris,75056,0.25,0
1012,Jean-Jacques Rousseau - Deux Ecus,OUI,19,11,8,7,1,OUI,OUI,2025-03-14 00:03:08+00:00,"48.86297805972131, 2.3414635285735126",Paris,75056,0.42105263157894735,0
19130,Place Paul Delouvrier,OUI,26,5,21,2,19,OUI,OUI,2025-03-14 00:01:32+00:00,"48.89197621431365, 2.3851288855075836",Paris,75056,0.8076923076923077,0
51008,Martyrs de Châteaubriant - Jean Grandel,OUI,38,31,7,1,6,OUI,OUI,2025-03-13 23:56:29+00:00,"48.951432, 2.211214",Argenteuil,95018,0.18421052631578946,0
35012,Candale - Mehul,OUI,25,8,17,3,14,OUI,OUI,2025-03-13 23:58:33+00:00,"48.8893935006175, 2.414379715919495",Pantin,93055,0.68,0
21329,Gare - Aristide Briand,OUI,28,0,28,22,6,OUI,OUI,2025-03-14 00:02:45+00:00,"48.821410564722, 2.2555950104387",Issy-les-Moulineaux,92040,1.0,0
21505,Édouard Vaillant - Place Jean Jaurès,OUI,21,9,12,3,9,OUI,OUI,2025-03-14 00:02:33+00:00,"48.86265537999924, 2.2089037319128613",Suresnes,92073,0.5714285714285714,0
13015,Chevaleret - Louise Weiss,OUI,35,33,2,1,1,OUI,OUI,2025-03-14 00:01:56+00:00,"48.832586513351, 2.37121138812",Paris,75056,0.05714285714285714,0
16044,Porte de Saint Cloud - Parc des Princes,OUI,31,10,21,19,2,OUI,OUI,2025-03-14 00:03:05+00:00,"48.838662757066, 2.2525164484978",Paris,75056,0.6774193548387096,0
23041,Général Leclerc - Bièvre,OUI,24,19,5,4,1,OUI,OUI,2025-03-14 00:02:27+00:00,"48.782414428747316, 2.3166695237159733",Bourg-la-Reine,92014,0.20833333333333334,0
10041,Gare du Nord - La Chapelle,OUI,17,9,8,3,5,OUI,OUI,2025-03-13 23:58:29+00:00,"48.884178287286, 2.3561057075858",Paris,75056,0.47058823529411764,0
31104,Mairie de Rosny-sous-Bois,OUI,27,13,14,6,8,OUI,OUI,2025-03-14 00:01:31+00:00,"48.871256519012, 2.4865807592869",Rosny-sous-Bois,93064,0.5185185185185185,0
4101,Bastille - Beaumarchais,OUI,20,4,16,15,1,OUI,OUI,2025-03-14 00:02:01+00:00,"48.853833463852, 2.3685702681541",Paris,75056,0.8,0
42024,Danielle Casanova - Ledru-Rollin,OUI,28,0,28,25,3,OUI,OUI,2025-03-14 00:03:02+00:00,"48.815783497876815, 2.383259721100331",Ivry-sur-Seine,94041,1.0,0
22506,Gare des Vallées,OUI,20,4,16,4,12,OUI,OUI,2025-03-14 00:00:41+00:00,"48.913179, 2.257726",La Garenne-Colombes,92035,0.8,0
15203,Porte de Versailles,OUI,27,20,7,5,2,OUI,OUI,2025-03-14 00:01:05+00:00,"48.832324016657, 2.2875617349045",Paris,75056,0.25925925925925924,0
1018,Alger - Rivoli,OUI,17,8,9,7,2,OUI,OUI,2025-03-14 00:02:16+00:00,"48.864773553495, 2.3294493936128",Paris,75056,0.5294117647058824,0
13116,Place du Docteur Yersin,OUI,50,43,7,3,4,OUI,OUI,2025-03-13 23:56:33+00:00,"48.82010494991975, 2.3725583776831627",Paris,75056,0.14,0
1026,Place du Lieutenant Henri Karcher,OUI,28,4,24,21,3,OUI,OUI,2025-03-14 00:03:08+00:00,"48.863490871724466, 2.3400671035051346",Paris,75056,0.8571428571428571,0
11111,Léon Frot - Charonne,OUI,19,0,19,19,0,OUI,OUI,2025-03-14 00:01:35+00:00,"48.854963800335234, 2.387217085372007",Paris,75056,1.0,0
23101,Grande Rue - Europe,OUI,25,3,22,10,12,OUI,OUI,2025-03-14 00:01:04+00:00,"48.8218104687602, 2.205879874527455",Sèvres,92072,0.88,0
15012,Cambronne - Mademoiselle,OUI,67,3,64,51,13,OUI,OUI,2025-03-14 00:01:28+00:00,"48.843277330035214, 2.30230766886348",Paris,75056,0.9552238805970149,0
17106,Berthier - Porte de Clichy,OUI,24,21,3,3,0,OUI,OUI,2025-03-13 23:55:21+00:00,"48.894222687781, 2.3125872006816",Paris,75056,0.125,0
18016,Francoeur - Caulaincourt,OUI,33,17,16,3,13,OUI,OUI,2025-03-14 00:03:13+00:00,"48.8899944409612, 2.342529706656933",Paris,75056,0.48484848484848486,0
1116,Ventadour - Opéra,OUI,26,20,6,3,3,OUI,OUI,2025-03-14 00:01:34+00:00,"48.866810653323, 2.3343884482519",Paris,75056,0.23076923076923078,0
15053,Lecourbe - Convention,OUI,43,4,39,30,9,OUI,OUI,2025-03-14 00:01:58+00:00,"48.83923319241899, 2.2915197908878326",Paris,75056,0.9069767441860465,0
1017,Saint-Honoré - 29 juillet,OUI,19,12,7,5,2,OUI,OUI,2025-03-14 00:02:12+00:00,"48.86557114282421, 2.330567417577153",Paris,75056,0.3684210526315789,0
21022,Dôme - République,OUI,24,1,23,19,4,OUI,OUI,2025-03-14 00:03:14+00:00,"48.832681, 2.250257",Boulogne-Billancourt,92012,0.9583333333333334,0
15040,Saint-Amand - Labrouste,OUI,34,18,16,9,7,OUI,OUI,2025-03-14 00:03:16+00:00,"48.834097274832295, 2.3087677359581",Paris,75056,0.47058823529411764,0
15041,Franquet - Labrouste,OUI,37,21,16,5,11,OUI,OUI,2025-03-13 23:55:31+00:00,"48.83287705011431, 2.306762784719467",Paris,75056,0.43243243243243246,0
23107,Gare de Sèvres - Ville d'Avray,OUI,22,22,0,0,0,OUI,OUI,2025-03-14 00:00:05+00:00,"48.826262366227, 2.2001516849313",Sèvres,92072,0.0,0
10003,Hauteville - Bonne Nouvelle,OUI,17,5,12,8,4,OUI,OUI,2025-03-13 23:33:44+00:00,"48.87077436024, 2.3496496368327",Paris,75056,0.7058823529411765,0
6201,Saint Pères - Saint Germain,OUI,19,18,1,1,0,OUI,OUI,2025-03-13 23:53:21+00:00,"48.853729675265, 2.3300181032703",Paris,75056,0.05263157894736842,0
41103,Place de la vache noire,OUI,23,21,2,2,0,OUI,OUI,2025-03-13 23:56:35+00:00,"48.81040517059777, 2.327060401439667",Arcueil,94003,0.08695652173913043,0
22601,Marx Dormoy - Château Sainte-Barbe,OUI,20,11,9,1,8,OUI,OUI,2025-03-14 00:00:33+00:00,"48.791782341055324, 2.297856844961643",Fontenay-aux-Roses,92032,0.45,0
13028,Gouthière - Poterne des Peupliers,OUI,32,22,10,5,5,OUI,OUI,2025-03-14 00:03:15+00:00,"48.820507, 2.351342",Paris,75056,0.3125,0
48008,Guy Môquet - Parvis Georges Marchais,OUI,30,29,1,0,1,OUI,OUI,2025-03-13 23:55:49+00:00,"48.79518840095975, 2.35943466424942",Villejuif,94076,0.03333333333333333,0
20012,Buzenval - Vignoles,OUI,17,3,14,7,7,OUI,OUI,2025-03-14 00:03:10+00:00,"48.853858171688, 2.4000040814281",Paris,75056,0.8235294117647058,0
27001,Square Victor Basch,OUI,18,3,15,10,5,OUI,OUI,2025-03-14 00:00:44+00:00,"48.914304862261, 2.2289156913757",Colombes,92025,0.8333333333333334,0
42303,Place Eustache Deschamps,OUI,20,6,14,8,6,OUI,OUI,2025-03-14 00:03:10+00:00,"48.793855, 2.336637",Cachan,94016,0.7,0
17021,Jouffroy d'Abbans - Villiers,OUI,31,20,11,7,4,OUI,OUI,2025-03-14 00:03:06+00:00,"48.884215547037, 2.3056533560157",Paris,75056,0.3548387096774194,0
48002,LCL Campus - Place Oscar Niemeyer,OUI,37,25,12,4,8,OUI,OUI,2025-03-14 00:02:02+00:00,"48.805342480621576, 2.363983690738678",Villejuif,94076,0.32432432432432434,0
41605,Général De Gaulle - Vivien,OUI,21,5,16,2,14,OUI,OUI,2025-03-14 00:02:01+00:00,"48.83607420090204, 2.4189166724681854",Saint-Mandé,94067,0.7619047619047619,0
3007,Archives - Pastourelle,OUI,26,14,12,9,3,OUI,OUI,2025-03-14 00:02:43+00:00,"48.8623615, 2.3595041",Paris,75056,0.46153846153846156,0
12008,Hector Malot - Daumesnil,OUI,52,4,48,46,2,OUI,OUI,2025-03-14 00:03:11+00:00,"48.84693552991762, 2.3770876228809357",Paris,75056,0.9230769230769231,0
28005,Jean Jaurès - Paul Lafargue,OUI,27,20,7,0,7,OUI,OUI,2025-03-14 00:02:12+00:00,"48.884933177666, 2.2484488785267",Puteaux,92062,0.25925925925925924,0
13120,Pierre Joseph Desault,OUI,17,0,17,16,1,OUI,OUI,2025-03-14 00:01:42+00:00,"48.82110230800372, 2.378775402903557",Paris,75056,1.0,0
35005,Quai de l'Aisne - Général Leclerc,OUI,26,19,7,0,7,OUI,OUI,2025-03-13 23:57:16+00:00,"48.895713, 2.400571",Pantin,93055,0.2692307692307692,0
16025,Jean de la Fontaine - Boulainvilliers,OUI,64,17,47,43,4,OUI,OUI,2025-03-14 00:02:47+00:00,"48.85264791461651, 2.2758664190769196",Paris,75056,0.734375,0
16139,Suresnes - Muette à Neuilly,OUI,29,25,4,2,2,OUI,OUI,2025-03-13 23:55:30+00:00,"48.868570404348, 2.266000919044",Paris,75056,0.13793103448275862,0
13036,Olympiades,OUI,36,11,25,4,21,OUI,OUI,2025-03-13 23:55:30+00:00,"48.826764665199, 2.3650860786438",Paris,75056,0.6944444444444444,0
42028,Verdun - Carnot,OUI,29,10,19,2,17,OUI,OUI,2025-03-14 00:01:20+00:00,"48.808439376064946, 2.373795211315155",Ivry-sur-Seine,94041,0.6551724137931034,0
16017,Siam - La Pompe,OUI,16,14,2,1,1,OUI,OUI,2025-03-14 00:02:51+00:00,"48.861720329027264, 2.275346568555312",Paris,75056,0.125,0
12166,Parc Floral du Bel Air,OUI,22,17,5,2,3,OUI,OUI,2025-03-14 00:01:45+00:00,"48.839285711865735, 2.438560165464878",Paris,75056,0.22727272727272727,0
16116,George Sand - Jean de La Fontaine,OUI,28,2,26,18,8,OUI,OUI,2025-03-14 00:00:39+00:00,"48.84986918764119, 2.268257387525699",Paris,75056,0.9285714285714286,0
22603,Place de la Division Leclerc,OUI,33,32,1,0,1,OUI,OUI,2025-03-13 23:55:57+00:00,"48.793824988636516, 2.2731140430551027",Fontenay-aux-Roses,92032,0.030303030303030304,0
20013,Alexandre Dumas - Place de la Réunion,OUI,45,5,40,1,39,OUI,OUI,2025-03-14 00:02:34+00:00,"48.85533710742046, 2.3997703687646292",Paris,75056,0.8888888888888888,0
12113,Cardinal Lavigerie,OUI,46,6,40,33,7,OUI,OUI,2025-03-14 00:03:12+00:00,"48.832934193699835, 2.402636749399156",Paris,75056,0.8695652173913043,0
31105,Lavoisier - Missak Manouchian,OUI,18,5,13,4,9,OUI,OUI,2025-03-14 00:03:03+00:00,"48.86286468896063, 2.495676465332508",Rosny-sous-Bois,93064,0.7222222222222222,0
16010,Belles Feuilles - Place de Mexico,OUI,21,20,1,0,1,OUI,OUI,2025-03-13 23:57:08+00:00,"48.865804746474, 2.2829206287861",Paris,75056,0.047619047619047616,0
42205,Place Aristide Briand,OUI,35,1,34,19,15,OUI,OUI,2025-03-14 00:02:27+00:00,"48.82189236575831, 2.413003742694855",Charenton-le-Pont,94018,0.9714285714285714,0
31701,Mairie de Bagnolet,OUI,26,10,16,1,15,OUI,OUI,2025-03-14 00:00:27+00:00,"48.868421318555, 2.4179587885737",Bagnolet,93006,0.6153846153846154,0
32020,Jules Guesdes - Carnot,OUI,15,12,3,1,2,OUI,OUI,2025-03-14 00:00:16+00:00,"48.93828169931872, 2.3508992046117783",Saint-Denis,93066,0.2,0
22404,Pierre Brossolette - 12 Février 1934,OUI,24,4,20,6,14,OUI,OUI,2025-03-14 00:02:24+00:00,"48.8176962416867, 2.3076123744249344",Malakoff,92046,0.8333333333333334,0
27006,Victor Hugo - Gare,OUI,19,2,17,12,5,OUI,OUI,2025-03-14 00:00:44+00:00,"48.923133952658, 2.2600970417261",Colombes,92025,0.8947368421052632,0
20032,Square des Amandiers,OUI,26,17,9,1,8,OUI,OUI,2025-03-14 00:01:18+00:00,"48.86615630668046, 2.3891324177384377",Paris,75056,0.34615384615384615,0
1015,Place André Malraux,OUI,15,9,6,5,1,OUI,OUI,2025-03-14 00:00:53+00:00,"48.863925158727, 2.3356226831675",Paris,75056,0.4,0
30004,Jean Jaurès - Place de la Libération,OUI,28,3,25,9,16,OUI,OUI,2025-03-14 00:01:01+00:00,"48.90617751921, 2.4391458057475",Bobigny,93008,0.8928571428571429,0
1008,Les Halles - Saint-Eustache,OUI,32,29,3,2,1,OUI,OUI,2025-03-13 23:59:11+00:00,"48.86362695901683, 2.342623919248581",Paris,75056,0.09375,0
14005,René Coty - Place Denfert-Rochereau,OUI,36,33,3,1,2,OUI,OUI,2025-03-14 00:03:15+00:00,"48.833056477316, 2.3329411447048",Paris,75056,0.08333333333333333,0
2006,Place des Victoires,OUI,24,20,4,4,0,OUI,OUI,2025-03-13 23:56:03+00:00,"48.8660354, 2.3420333",Paris,75056,0.16666666666666666,0
17006,Guy Môquet - Compoint,OUI,34,14,20,14,6,OUI,OUI,2025-03-14 00:02:54+00:00,"48.89213559044868, 2.32321947813034",Paris,75056,0.5882352941176471,0
9019,Victor Massé - Jean-Baptiste Pigalle,OUI,18,15,3,2,1,OUI,OUI,2025-03-13 23:59:20+00:00,"48.8811043724, 2.3366955667734",Paris,75056,0.16666666666666666,0
18101,Championnet.,OUI,20,6,14,4,10,OUI,OUI,2025-03-13 23:57:17+00:00,"48.8953643, 2.3498166",Paris,75056,0.7,0
44004,Place de l'Eglise - Vitry-sur-Seine,OUI,28,1,27,25,2,OUI,OUI,2025-03-13 23:59:43+00:00,"48.791922819921815, 2.395057752728462",Vitry-sur-Seine,94081,0.9642857142857143,0
6028,Quatre Vents - Carrefour de l'Odéon,OUI,34,28,6,6,0,OUI,OUI,2025-03-14 00:02:49+00:00,"48.851751374458864, 2.338161695134053",Paris,75056,0.17647058823529413,0
1024,Coquillière - Louvre,OUI,19,15,4,4,0,OUI,OUI,2025-03-14 00:00:00+00:00,"48.863795909662, 2.3425736278296",Paris,75056,0.21052631578947367,0
20005,Reynaldo Hahn - Lagny,OUI,19,15,4,3,1,OUI,OUI,2025-03-14 00:03:02+00:00,"48.849266043601794, 2.412330328844772",Paris,75056,0.21052631578947367,0
19046,Porte de Pantin.,OUI,32,26,6,2,4,OUI,OUI,2025-03-14 00:00:55+00:00,"48.889199725577, 2.3950181901455",Paris,75056,0.1875,0
12122,Bois de Vincennes - Polygone,OUI,51,48,3,0,3,OUI,OUI,2025-03-13 23:53:46+00:00,"48.83544491617421, 2.431421081436563",Paris,75056,0.058823529411764705,0
2102,Saint-Marc - Feydeau,OUI,36,34,2,2,0,OUI,OUI,2025-03-14 00:01:41+00:00,"48.870326843044, 2.3418715826353",Paris,75056,0.05555555555555555,0
15120,Colonel Pierre Avia,OUI,28,13,15,12,3,OUI,OUI,2025-03-14 00:02:40+00:00,"48.8296843300915, 2.275342586850291",Paris,75056,0.5357142857142857,0
2020,Danielle Casanova - Opéra,OUI,20,16,4,3,1,OUI,OUI,2025-03-14 00:03:00+00:00,"48.867643242297, 2.3333894088864",Paris,75056,0.2,0
24007,Jean-Baptiste Charcot - Sainte-Geneviève,OUI,21,12,9,6,3,OUI,OUI,2025-03-13 23:56:20+00:00,"48.90310883721567, 2.278892956674099",Courbevoie,92026,0.42857142857142855,0
15114,Pasteur - Cotentin,OUI,10,6,4,1,3,OUI,OUI,2025-03-13 23:56:13+00:00,"48.8389284, 2.316356",Paris,75056,0.4,0
6029,Vaugirard - Monsieur le Prince,OUI,24,22,2,1,1,OUI,OUI,2025-03-13 23:56:34+00:00,"48.848951441614, 2.3411329463124",Paris,75056,0.08333333333333333,0
11029,Ménilmontant - Oberkampf,OUI,38,24,14,3,11,OUI,OUI,2025-03-14 00:00:10+00:00,"48.866617658681, 2.3830134404158",Paris,75056,0.3684210526315789,0
12016,Saint-Mande - Picpus,OUI,32,20,12,11,1,OUI,OUI,2025-03-13 23:59:11+00:00,"48.845127728278, 2.4015686296482",Paris,75056,0.375,0
11028,Guillaume Bertrand - République,OUI,38,14,24,9,15,OUI,OUI,2025-03-14 00:03:02+00:00,"48.863825174341, 2.380906377155",Paris,75056,0.631578947368421,0
23301,Les Blagis,OUI,24,5,19,12,7,OUI,OUI,2025-03-14 00:02:53+00:00,"48.785205, 2.302526",Sceaux,92071,0.7916666666666666,0
13055,M.- A. Lagroua Weill-Hallé -  F. Dolto,OUI,60,55,5,3,2,OUI,OUI,2025-03-13 23:53:57+00:00,"48.828595283857425, 2.380220606266108",Paris,75056,0.08333333333333333,0
34013,Blanqui - Docteur Bauer,OUI,19,6,13,8,5,OUI,OUI,2025-03-13 23:57:23+00:00,"48.907735489085, 2.3407192814591",Saint-Ouen-sur-Seine,93070,0.6842105263157895,0
21027,Fief - République,OUI,24,21,3,2,1,OUI,OUI,2025-03-13 23:57:29+00:00,"48.83170888166024, 2.255771979689598",Boulogne-Billancourt,92012,0.125,0
23104,Quai de Sèvres - Manufacture Nationale,OUI,27,19,8,5,3,OUI,OUI,2025-03-14 00:02:31+00:00,"48.828688, 2.22499",Sèvres,92072,0.2962962962962963,0
25002,Hôtel de Ville de Rueil-Malmaison,OUI,19,3,16,10,6,OUI,OUI,2025-03-14 00:03:02+00:00,"48.878194, 2.181724",Rueil-Malmaison,92063,0.8421052631578947,0
20140,Paganini - Davout,OUI,22,19,3,1,2,OUI,OUI,2025-03-14 00:01:06+00:00,"48.85135, 2.412021",Paris,75056,0.13636363636363635,0
6005,Montparnasse -  Square Ozanam,OUI,49,47,2,0,2,OUI,OUI,2025-03-14 00:02:48+00:00,"48.843310567822, 2.3265242949128",Paris,75056,0.04081632653061224,0
48012,Stalingrad - Henri Luisette,OUI,25,23,2,0,2,OUI,OUI,2025-03-13 23:59:25+00:00,"48.78363092456589, 2.366935946761926",Villejuif,94076,0.08,0
16022,Jean Bologne - Passy,OUI,19,17,2,2,0,OUI,OUI,2025-03-13 23:58:42+00:00,"48.857566889784465, 2.280027395306772",Paris,75056,0.10526315789473684,0
23303,Gare de Robinson,OUI,29,25,4,2,2,OUI,OUI,2025-03-14 00:02:46+00:00,"48.7799259211605, 2.281828634440899",Sceaux,92071,0.13793103448275862,0
20011,Pyrénées - Dagorno,OUI,20,13,7,1,6,OUI,OUI,2025-03-14 00:01:28+00:00,"48.855425770695085, 2.4051643162965775",Paris,75056,0.35,0
15018,Dutot - Place Alleray,OUI,54,26,28,10,18,OUI,OUI,2025-03-14 00:03:08+00:00,"48.836826091766, 2.3071701095578",Paris,75056,0.5185185185185185,0
20106,Mairie du 20ème,OUI,27,21,6,1,5,OUI,OUI,2025-03-14 00:01:59+00:00,"48.865302324275, 2.3990669846535",Paris,75056,0.2222222222222222,0
26012,Jardin Modèle - Pierre Boudou,OUI,14,4,10,4,6,OUI,OUI,2025-03-14 00:00:27+00:00,"48.914866710946, 2.3057010525935",Asnières-sur-Seine,92004,0.7142857142857143,0
21007,Rond-Point Rhin et Danube,OUI,52,44,8,5,3,OUI,OUI,2025-03-14 00:00:08+00:00,"48.840452820991764, 2.2280225157737736",Boulogne-Billancourt,92012,0.15384615384615385,0
20048,Bagnolet - Place Saint-Blaise,OUI,24,20,4,0,4,OUI,OUI,2025-03-13 23:59:36+00:00,"48.85973, 2.40334",Paris,75056,0.16666666666666666,0
13037,Ivry - Baudricourt,OUI,20,10,10,2,8,OUI,OUI,2025-03-14 00:01:49+00:00,"48.824695995415006, 2.363106073577468",Paris,75056,0.5,0
10166,Strasbourg - Saint-Denis,OUI,16,11,5,4,1,OUI,OUI,2025-03-14 00:01:08+00:00,"48.869601642433, 2.3542908579111",Paris,75056,0.3125,0
45004,République - Louis Loucheur,OUI,37,3,34,5,29,OUI,OUI,2025-03-14 00:03:06+00:00,"48.823549261189, 2.5101865455508",Champigny-sur-Marne,94017,0.918918918918919,0
17050,Batignolles - Abel Truchet,OUI,25,22,3,1,2,OUI,OUI,2025-03-14 00:00:16+00:00,"48.883103904582, 2.3238347490884",Paris,75056,0.12,0
23202,Henri Barbusse - Gabriel Péri,OUI,16,12,4,1,3,OUI,OUI,2025-03-13 23:57:23+00:00,"48.801773795836, 2.2874166362216",Châtillon,92020,0.25,0
13013,Saint-Marcel - Hôpital,OUI,18,8,10,7,3,OUI,OUI,2025-03-14 00:02:55+00:00,"48.839504424583, 2.3609894170229",Paris,75056,0.5555555555555556,0
13049,Vincent Auriol - Louise Weiss,OUI,22,21,1,1,0,OUI,OUI,2025-03-14 00:00:59+00:00,"48.834001935501, 2.3703888058662",Paris,75056,0.045454545454545456,0
8044,Alfred de Vigny - Place du Général Brocard,OUI,32,28,4,1,3,OUI,OUI,2025-03-14 00:02:33+00:00,"48.87836138361425, 2.305254448220567",Paris,75056,0.125,0
6015,André Mazet - Saint-André des Arts,OUI,54,2,52,46,6,OUI,OUI,2025-03-14 00:02:48+00:00,"48.85375581057431, 2.3390958085656166",Paris,75056,0.9629629629629629,0
21510,Fontaine du Tertre - Calvaire,OUI,23,22,1,0,1,OUI,OUI,2025-03-14 00:00:14+00:00,"48.8702539, 2.2187778",Suresnes,92073,0.043478260869565216,0
32605,Mairie,OUI,20,15,5,0,5,OUI,OUI,2025-03-14 00:02:16+00:00,"48.87914304162, 2.4163350908311",Les Lilas,93045,0.25,0
51007,Résistance - Romain Rolland,OUI,28,19,9,0,9,OUI,OUI,2025-03-14 00:03:08+00:00,"48.950873482371, 2.2310190077797",Argenteuil,95018,0.32142857142857145,0
8202,Londres - Europe,OUI,27,26,1,0,1,OUI,OUI,2025-03-13 23:59:57+00:00,"48.878618556803, 2.3248164693922",Paris,75056,0.037037037037037035,0
11040,Temple - Jean-Pierre Timbaud,OUI,30,2,28,26,2,OUI,OUI,2025-03-14 00:01:59+00:00,"48.86446597201, 2.3660597205162",Paris,75056,0.9333333333333333,0
32011,Stade de France - Francis de Pressensé,OUI,43,40,3,0,3,OUI,OUI,2025-03-13 23:56:38+00:00,"48.919141953558, 2.3620655760169",Saint-Denis,93066,0.06976744186046512,0
13008,Place d'Italie - Soeur Rosalie,OUI,50,50,0,0,0,OUI,OUI,2025-03-14 00:03:05+00:00,"48.831908520394, 2.3546943448098",Paris,75056,0.0,0
8040,Pierre Charron - Champs-Elysées,OUI,29,28,1,1,0,OUI,OUI,2025-03-14 00:03:06+00:00,"48.870103359864, 2.3043501377106",Paris,75056,0.034482758620689655,0
11038,Temple - Charlot,OUI,43,14,29,29,0,OUI,OUI,2025-03-14 00:01:59+00:00,"48.865709343796, 2.3652737250724",Paris,75056,0.6744186046511628,0
10202,Bichat - Grange aux Belles,OUI,29,22,7,5,2,OUI,OUI,2025-03-13 23:59:50+00:00,"48.873688, 2.365015",Paris,75056,0.2413793103448276,0
21511,Marcel Monge - Marcel Dassault,OUI,46,20,26,26,0,OUI,OUI,2025-03-14 00:02:57+00:00,"48.86096384533371, 2.2246733296048142",Suresnes,92073,0.5652173913043478,0
42030,Stéphanie Bouvard - Gambetta,OUI,30,0,30,15,15,OUI,OUI,2025-03-14 00:02:12+00:00,"48.814548138856, 2.4024386957288",Ivry-sur-Seine,94041,1.0,0
21033,Sèvres - Maréchal Juin,OUI,17,1,16,16,0,OUI,OUI,2025-03-14 00:02:19+00:00,"48.8324305, 2.2292812",Boulogne-Billancourt,92012,0.9411764705882353,0
8018,Saint-Augustin,OUI,30,30,0,0,0,OUI,OUI,2025-03-14 00:02:34+00:00,"48.8762009747008, 2.319786250591278",Paris,75056,0.0,0
8003,Galilée - Vernet,OUI,47,46,1,0,1,OUI,OUI,2025-03-13 23:56:45+00:00,"48.871715878697, 2.2985444962978",Paris,75056,0.02127659574468085,0
24010,Charles de Gaulle - Rue de l'Alma,OUI,26,22,4,3,1,OUI,OUI,2025-03-13 23:58:00+00:00,"48.896620592993, 2.252313240191",Courbevoie,92026,0.15384615384615385,0
48001,Chastenet de Géry - Marcel Paul,OUI,25,17,8,0,8,OUI,OUI,2025-03-14 00:02:55+00:00,"48.800123, 2.3567359",Villejuif,94076,0.32,0
41101,Paul Doumer - Stalingrad,OUI,24,11,13,6,7,OUI,OUI,2025-03-14 00:03:14+00:00,"48.806518992199, 2.3368880152702",Arcueil,94003,0.5416666666666666,0
18135,Ney - Porte de Montmartre,OUI,21,18,3,0,3,OUI,OUI,2025-03-13 23:57:36+00:00,"48.897918, 2.3364872",Paris,75056,0.14285714285714285,0
20030,Ménilmontant - Père Lachaise,OUI,38,17,21,8,13,OUI,OUI,2025-03-14 00:02:47+00:00,"48.863287291502, 2.3869940266013",Paris,75056,0.5526315789473685,0
24101,Place Charles de Gaulle,OUI,23,14,9,0,9,OUI,OUI,2025-03-14 00:02:38+00:00,"48.826073335699, 2.1894485725692",Ville-d'Avray,92077,0.391304347826087,0
20035,Pyrénées - Ménilmontant,OUI,26,12,14,0,14,OUI,OUI,2025-03-14 00:02:22+00:00,"48.8693268535238, 2.395084574818611",Paris,75056,0.5384615384615384,0
34011,Clef des Champs - Albert Dhalenne,OUI,26,19,7,3,4,OUI,OUI,2025-03-13 23:56:55+00:00,"48.914938, 2.330665",Saint-Ouen-sur-Seine,93070,0.2692307692307692,0
21508,Georges Pompidou - Verdun,OUI,24,1,23,14,9,OUI,OUI,2025-03-13 23:59:55+00:00,"48.875481, 2.232443",Suresnes,92073,0.9583333333333334,0
21704,Place du Maréchal de Lattre de Tassigny,OUI,26,0,26,15,11,OUI,OUI,2025-03-14 00:02:10+00:00,"48.821707715257055, 2.2853431485432423",Vanves,92075,1.0,0
15032,Félix Faure - Lourmel,OUI,55,27,28,25,3,OUI,OUI,2025-03-14 00:03:00+00:00,"48.83868901709515, 2.2818081825971603",Paris,75056,0.509090909090909,0
19121,Belleville -  Pré Saint-Gervais,OUI,21,1,20,0,20,OUI,OUI,2025-03-14 00:03:14+00:00,"48.875565910073, 2.3930460959673",Paris,75056,0.9523809523809523,0
13053,Chevaleret - Tolbiac,OUI,21,15,6,2,4,OUI,OUI,2025-03-14 00:00:47+00:00,"48.82941, 2.375934",Paris,75056,0.2857142857142857,0
25007,Bons Raisins - Voltaire,OUI,24,23,1,1,0,OUI,OUI,2025-03-13 23:56:46+00:00,"48.87282451461399, 2.1947155570850896",Rueil-Malmaison,92063,0.041666666666666664,0
48011,Epi d'Or - Chevilly,OUI,20,17,3,0,3,OUI,OUI,2025-03-13 23:59:52+00:00,"48.781109786782, 2.3549050362061",Villejuif,94076,0.15,0
19114,Manin - Secrétan,OUI,19,12,7,0,7,OUI,OUI,2025-03-13 23:59:19+00:00,"48.8791665, 2.3787959",Paris,75056,0.3684210526315789,0
12123,Château de Vincennes,OUI,49,43,6,5,1,OUI,OUI,2025-03-13 23:59:49+00:00,"48.84423193255657, 2.439209537709179",Paris,75056,0.12244897959183673,0
34009,Dora Maar - Nadia Guendouz,OUI,28,25,3,0,3,OUI,OUI,2025-03-13 23:56:48+00:00,"48.905452421305, 2.3220406472683",Saint-Ouen-sur-Seine,93070,0.10714285714285714,0
21002,Place Denfert-Rochereau,OUI,20,1,19,13,6,OUI,OUI,2025-03-14 00:02:40+00:00,"48.843252536286684, 2.245987951755524",Boulogne-Billancourt,92012,0.95,0
41304,Port - Maurice Chevalier,OUI,30,2,28,25,3,OUI,OUI,2025-03-13 23:59:56+00:00,"48.832474421632, 2.490257616467",Nogent-sur-Marne,94052,0.9333333333333333,0
13024,Bobillot - Tolbiac,OUI,33,16,17,7,10,OUI,OUI,2025-03-14 00:02:48+00:00,"48.8255961335041, 2.350204177200794",Paris,75056,0.5151515151515151,0
8031,Jean Mermoz - Champs-Elysées,OUI,45,40,5,2,3,OUI,OUI,2025-03-13 23:55:55+00:00,"48.869689856852, 2.3107324540615",Paris,75056,0.1111111111111111,0
24004,Paix - Verdun,OUI,32,18,14,6,8,OUI,OUI,2025-03-13 23:59:24+00:00,"48.900504, 2.261173",Courbevoie,92026,0.4375,0
26011,Ménil - Argenteuil,OUI,18,2,16,7,9,OUI,OUI,2025-03-14 00:02:24+00:00,"48.925901818305, 2.2741496502338",Asnières-sur-Seine,92004,0.8888888888888888,0
24005,Edith Cavell - Volta,OUI,32,27,5,2,3,OUI,OUI,2025-03-13 23:58:14+00:00,"48.901616564286975, 2.269354350864887",Courbevoie,92026,0.15625,0
35021,Cartier Bresson - Denis Papin,OUI,30,16,14,0,14,OUI,OUI,2025-03-14 00:01:56+00:00,"48.902616, 2.397814",Pantin,93055,0.4666666666666667,0
5027,Gobelins - Port-Royal,OUI,37,2,35,31,4,OUI,OUI,2025-03-14 00:00:53+00:00,"48.837135900263, 2.3515201359987",Paris,75056,0.9459459459459459,0
18045,Pierre Ginier - Clichy,OUI,15,11,4,2,2,OUI,OUI,2025-03-13 23:54:58+00:00,"48.8867667, 2.326228",Paris,75056,0.26666666666666666,0
48006,Maxime Gorki - Paul Vaillant-Couturier,OUI,19,19,0,0,0,OUI,OUI,2025-03-13 23:57:03+00:00,"48.79673508795443, 2.3683342337608337",Villejuif,94076,0.0,0
18018,Carpeaux - Place Jacques Froment,OUI,19,2,17,4,13,OUI,OUI,2025-03-14 00:01:26+00:00,"48.8906542, 2.3309428",Paris,75056,0.8947368421052632,0
19117,Euryale Dehaynin - Loire,OUI,30,14,16,2,14,OUI,OUI,2025-03-14 00:03:11+00:00,"48.886248917304805, 2.3774591088294987",Paris,75056,0.5333333333333333,0
21954,Val-Fleury,OUI,23,17,6,1,5,OUI,OUI,2025-03-13 23:59:04+00:00,"48.807671407991, 2.2407217696309",Meudon,92048,0.2608695652173913,0
20003,Pyrénées - Cours de Vincennes,OUI,19,12,7,2,5,OUI,OUI,2025-03-14 00:02:07+00:00,"48.847796779935, 2.4061721563339",Paris,75056,0.3684210526315789,0
22507,Châteaudun - Place de la Liberté,OUI,25,14,11,4,7,OUI,OUI,2025-03-14 00:01:03+00:00,"48.90970830301211, 2.2454486480600626",La Garenne-Colombes,92035,0.44,0
11022,Roquette - Auguste Laurent,OUI,16,0,16,14,2,OUI,OUI,2025-03-14 00:03:06+00:00,"48.858001906023354, 2.381797702650783",Paris,75056,1.0,0
11201,Faubourg St-Antoine - Place de la Nation,OUI,16,13,3,1,2,OUI,OUI,2025-03-14 00:01:31+00:00,"48.8487726, 2.393606",Paris,75056,0.1875,0
41602,Place Charles Digeon,OUI,31,25,6,3,3,OUI,OUI,2025-03-14 00:00:02+00:00,"48.84354203133597, 2.418427169322968",Saint-Mandé,94067,0.1935483870967742,0
22602,Place Henri Dunant - Gare RER,OUI,31,26,5,0,5,OUI,OUI,2025-03-13 23:54:34+00:00,"48.788093281931, 2.2909234046643",Fontenay-aux-Roses,92032,0.16129032258064516,0
15069,Félix Faure - Convention,OUI,44,2,42,35,7,OUI,OUI,2025-03-14 00:03:00+00:00,"48.841249336041, 2.2883866008495",Paris,75056,0.9545454545454546,0
12106,Gare de Lyon - Roland Barthes,OUI,67,9,58,52,6,OUI,OUI,2025-03-14 00:02:24+00:00,"48.84395729494058, 2.3790882155299187",Paris,75056,0.8656716417910447,0
14004,Port Royal - Hôpital Cochin,OUI,22,16,6,5,1,OUI,OUI,2025-03-13 23:54:09+00:00,"48.838608030238, 2.3406994164846",Paris,75056,0.2727272727272727,0
32023,Guy Môquet - Jean Moulin,OUI,25,10,15,8,7,OUI,OUI,2025-03-14 00:03:13+00:00,"48.940931521020836, 2.363948999931771",Saint-Denis,93066,0.6,0
14027,Gergovie - Alésia,OUI,54,30,24,8,16,OUI,OUI,2025-03-14 00:00:10+00:00,"48.83088717455243, 2.318882101207347",Paris,75056,0.4444444444444444,0
25010,Maréchal Leclerc de Hauteclocque - Marché Buzenval,OUI,29,25,4,3,1,OUI,OUI,2025-03-14 00:00:27+00:00,"48.858446, 2.192077",Rueil-Malmaison,92063,0.13793103448275862,0
30003,Moscou - Edouard Vaillant,OUI,29,20,9,4,5,OUI,OUI,2025-03-14 00:02:17+00:00,"48.90755810177, 2.4689837335263",Bobigny,93008,0.3103448275862069,0
12165,Champs de Manoeuvre - Cartoucherie,OUI,31,30,1,0,1,OUI,OUI,2025-03-13 23:55:37+00:00,"48.835261, 2.447974",Paris,75056,0.03225806451612903,0
35013,Guillaume Tell - Parc Henri Barbusse,OUI,19,6,13,1,12,OUI,OUI,2025-03-14 00:02:43+00:00,"48.88958925894009, 2.4198862910270695",Pantin,93055,0.6842105263157895,0
12001,Bastille - Biscornet,OUI,57,10,47,44,3,OUI,OUI,2025-03-14 00:02:01+00:00,"48.851355779579, 2.369220033288",Paris,75056,0.8245614035087719,0
20020,Pyrénées - Charles Renouvier,OUI,29,18,11,0,11,OUI,OUI,2025-03-13 23:56:17+00:00,"48.86095933229224, 2.400421852042113",Paris,75056,0.3793103448275862,0
22018,Charles de Gaulle - Les Sablons,OUI,35,32,3,0,3,OUI,OUI,2025-03-13 23:55:25+00:00,"48.880987514929, 2.2715748726513",Neuilly-sur-Seine,92051,0.08571428571428572,0
12102,Bercy - Traversiére,OUI,30,2,28,25,3,OUI,OUI,2025-03-14 00:01:11+00:00,"48.846192642574, 2.3703800886869",Paris,75056,0.9333333333333333,0
11001,Richard Lenoir - Place de la Bastille,OUI,48,28,20,16,4,OUI,OUI,2025-03-14 00:02:04+00:00,"48.8538327, 2.3697222",Paris,75056,0.4166666666666667,0
15024,Suffren - La Motte-Piquet,OUI,21,6,15,13,2,OUI,OUI,2025-03-14 00:02:25+00:00,"48.850881230919, 2.3012199997902",Paris,75056,0.7142857142857143,0
23203,Division Leclerc - Kléber,OUI,25,20,5,0,5,OUI,OUI,2025-03-13 23:55:33+00:00,"48.798666226364, 2.2833752789972",Châtillon,92020,0.2,0
12119,Dom-Pérignon - Gravelle,OUI,46,14,32,13,19,OUI,OUI,2025-03-14 00:03:16+00:00,"48.825481574435, 2.409880310297",Paris,75056,0.6956521739130435,0
9035,Gare Saint-Lazare - Place de Budapest,OUI,43,41,2,2,0,OUI,OUI,2025-03-13 23:58:24+00:00,"48.877753, 2.327339",Paris,75056,0.046511627906976744,0
13006,Duméril - Jeanne d'Arc,OUI,40,11,29,19,10,OUI,OUI,2025-03-14 00:02:57+00:00,"48.838151608087, 2.3571084495564",Paris,75056,0.725,0
26009,Marceau Delorme - Pierre Brossolette,OUI,26,1,25,12,13,OUI,OUI,2025-03-14 00:03:13+00:00,"48.91206062860357, 2.295897423568745",Asnières-sur-Seine,92004,0.9615384615384616,0
43007,Hôtel de Ville de Vincennes,OUI,26,26,0,0,0,OUI,OUI,2025-03-14 00:00:18+00:00,"48.84827609706963, 2.4398955702781677",Vincennes,94080,0.0,0
34012,Bateliers - Quai de Seine,OUI,22,14,8,2,6,OUI,OUI,2025-03-14 00:03:05+00:00,"48.915817585516, 2.3239533298594",Saint-Ouen-sur-Seine,93070,0.36363636363636365,0
15050,Dominique Pado - Croix Nivert,OUI,21,1,20,16,4,OUI,OUI,2025-03-14 00:02:13+00:00,"48.83648798164934, 2.2897250577807426",Paris,75056,0.9523809523809523,0
23204,Roland Garros - Jean Bouin,OUI,28,17,11,3,8,OUI,OUI,2025-03-14 00:02:11+00:00,"48.809460857173, 2.2853198638301",Châtillon,92020,0.39285714285714285,0
43004,Montreuil - République,OUI,23,18,5,4,1,OUI,OUI,2025-03-13 23:57:41+00:00,"48.85026349463687, 2.4345204234123234",Vincennes,94080,0.21739130434782608,0
31303,Simone Signoret - Paris,OUI,26,11,15,7,8,OUI,OUI,2025-03-14 00:01:24+00:00,"48.903600624712865, 2.465406596265139",Noisy-le-Sec,93053,0.5769230769230769,0
14009,Tombe Issoire - René Coty,OUI,35,21,14,9,5,OUI,OUI,2025-03-14 00:02:27+00:00,"48.830512876709, 2.3343613743782",Paris,75056,0.4,0
5107,Pontoise - La Tournelle,OUI,21,7,14,11,3,OUI,OUI,2025-03-14 00:01:45+00:00,"48.850458009188, 2.3524542754922",Paris,75056,0.6666666666666666,0
17117,Pereire - Saussure,OUI,30,24,6,4,2,OUI,OUI,2025-03-14 00:01:05+00:00,"48.888229075478, 2.3101296275854",Paris,75056,0.2,0
18023,Ordener - Poissonniers,OUI,34,27,7,3,4,OUI,OUI,2025-03-14 00:02:23+00:00,"48.891213890844654, 2.351288666219873",Paris,75056,0.20588235294117646,0
18021,Marcadet - Ramey,OUI,21,14,7,2,5,OUI,OUI,2025-03-14 00:00:54+00:00,"48.890875, 2.3449019",Paris,75056,0.3333333333333333,0
18026,Ruisseau - Ordener,OUI,34,21,13,7,6,OUI,OUI,2025-03-14 00:01:19+00:00,"48.89299462568024, 2.340144887566567",Paris,75056,0.38235294117647056,0
5033,Saint-Séverin - Saint-Michel,OUI,30,24,6,5,1,OUI,OUI,2025-03-14 00:01:52+00:00,"48.852731305488, 2.3440927639604",Paris,75056,0.2,0
16006,Lauriston - Copernic,OUI,18,17,1,1,0,OUI,OUI,2025-03-13 23:56:01+00:00,"48.86926, 2.289918",Paris,75056,0.05555555555555555,0
15045,Porte de la Plaine,OUI,35,31,4,2,2,OUI,OUI,2025-03-13 23:53:33+00:00,"48.82805169605981, 2.2924277186393742",Paris,75056,0.11428571428571428,0
8008,Joseph Sansboeuf - Saint Lazare,OUI,30,24,6,6,0,OUI,OUI,2025-03-13 23:57:36+00:00,"48.875315630653, 2.3229019716382",Paris,75056,0.2,0
25004,Marcel Pourtout - Édouard Manet,OUI,24,6,18,17,1,OUI,OUI,2025-03-14 00:01:06+00:00,"48.87555620763429, 2.1655967831611638",Rueil-Malmaison,92063,0.75,0
13205,Choisy - Pointe d'Ivry,OUI,24,22,2,0,2,OUI,OUI,2025-03-13 23:56:13+00:00,"48.822154170359, 2.3633708034878",Paris,75056,0.08333333333333333,0
12022,Sahel - Général Michel Bizot,OUI,31,12,19,18,1,OUI,OUI,2025-03-14 00:02:38+00:00,"48.840872964793355, 2.4044444784522057",Paris,75056,0.6129032258064516,0
31202,Gabriel Péri - Jules Ferry,OUI,27,7,20,14,6,OUI,OUI,2025-03-14 00:02:55+00:00,"48.926182814311, 2.3912295762525",La Courneuve,93027,0.7407407407407407,0
15027,Duhamel - André Gide,OUI,20,12,8,0,8,OUI,OUI,2025-03-13 23:59:56+00:00,"48.8365662244334, 2.312707121097412",Paris,75056,0.4,0
15013,Volontaires - Lecourbe,OUI,30,1,29,23,6,OUI,OUI,2025-03-14 00:02:02+00:00,"48.84351378799, 2.3065522313118",Paris,75056,0.9666666666666667,0
21023,Ancienne Mairie - André Morizet,OUI,24,5,19,13,6,OUI,OUI,2025-03-14 00:02:08+00:00,"48.838311, 2.234077",Boulogne-Billancourt,92012,0.7916666666666666,0
22701,Général Leclerc - République,OUI,28,0,28,21,7,OUI,OUI,2025-03-14 00:01:40+00:00,"48.915885074177, 2.2682306702811",Bois-Colombes,92009,1.0,0
47007,Liberté - Vert-de-Maisons,OUI,20,0,20,14,6,OUI,OUI,2025-03-14 00:02:01+00:00,"48.790147809608, 2.4328628182411",Maisons-Alfort,94046,1.0,0
17110,Legendre - Nollet,OUI,29,25,4,0,4,OUI,OUI,2025-03-14 00:01:11+00:00,"48.887742186754224, 2.320293079881375",Paris,75056,0.13793103448275862,0
18042,Place Pigalle,OUI,20,19,1,0,1,OUI,OUI,2025-03-14 00:03:07+00:00,"48.8827555, 2.3361566",Paris,75056,0.05,0
20014,Charonne - Alexandre Dumas,OUI,34,13,21,5,16,OUI,OUI,2025-03-14 00:01:39+00:00,"48.856077415056, 2.3948693275452",Paris,75056,0.6176470588235294,0
18041,Rochechouart - Martyrs,OUI,17,16,1,0,1,OUI,OUI,2025-03-13 23:57:23+00:00,"48.882193779572, 2.3405495658517",Paris,75056,0.058823529411764705,0
14035,Maine - Jean Zay,OUI,46,43,3,0,3,OUI,OUI,2025-03-13 23:55:19+00:00,"48.837925263898, 2.3225428909063",Paris,75056,0.06521739130434782,0
11014,Place de la Nation - Taillebourg,OUI,45,45,0,0,0,OUI,OUI,2025-03-14 00:00:53+00:00,"48.8488408, 2.3973043",Paris,75056,0.0,0
8046,Marceau - Président Wilson,OUI,31,28,3,1,2,OUI,OUI,2025-03-13 23:56:37+00:00,"48.8652359, 2.3002513",Paris,75056,0.0967741935483871,0
8039,Colisée - Champs-Elysées,OUI,16,13,3,1,2,OUI,OUI,2025-03-13 23:58:42+00:00,"48.870475399387, 2.3076190799475",Paris,75056,0.1875,0
20110,Gambetta - Tourelles,OUI,20,2,18,15,3,OUI,OUI,2025-03-13 23:59:28+00:00,"48.875337902264, 2.4059921130538",Paris,75056,0.9,0
11102,Alexandre Dumas - Voltaire,OUI,59,11,48,25,23,OUI,OUI,2025-03-14 00:01:35+00:00,"48.852888670365, 2.3891476408096",Paris,75056,0.8135593220338984,0
8007,Rome - Provence,OUI,27,20,7,7,0,OUI,OUI,2025-03-14 00:00:00+00:00,"48.874230055580306, 2.325570111724113",Paris,75056,0.25925925925925924,0
12157,Fabre d'Eglantine - Place de la Nation,OUI,67,34,33,21,12,OUI,OUI,2025-03-13 23:58:57+00:00,"48.8471116, 2.3956204",Paris,75056,0.4925373134328358,0
21218,Gabriel Péri - Place de la Libération,OUI,17,14,3,1,2,OUI,OUI,2025-03-14 00:02:12+00:00,"48.819828421929, 2.3117361743705",Montrouge,92049,0.17647058823529413,0
16103,Traktir - Foch,OUI,18,18,0,0,0,OUI,OUI,2025-03-14 00:01:58+00:00,"48.872755334614, 2.2915497802487",Paris,75056,0.0,0
21207,Verdier - République,OUI,29,24,5,2,3,OUI,OUI,2025-03-13 23:54:45+00:00,"48.815403766277, 2.31739372015",Montrouge,92049,0.1724137931034483,0
11046,Place de la République - Voltaire,OUI,17,9,8,8,0,OUI,OUI,2025-03-14 00:02:45+00:00,"48.866830968942, 2.3654810339212",Paris,75056,0.47058823529411764,0
11016,Philippe-Auguste,OUI,47,29,18,2,16,OUI,OUI,2025-03-13 23:55:38+00:00,"48.851853488265, 2.3932945355773",Paris,75056,0.3829787234042553,0
35001,Jean Jaurès - Ouvrières Pivéreuses,OUI,21,10,11,4,7,OUI,OUI,2025-03-14 00:02:10+00:00,"48.910423437526, 2.3995766043663",Pantin,93055,0.5238095238095238,0
16033,Marché d'Auteuil,OUI,31,18,13,12,1,OUI,OUI,2025-03-14 00:02:48+00:00,"48.84842761367387, 2.265253821160005",Paris,75056,0.41935483870967744,0
11011,Richard Lenoir - Voltaire,OUI,25,0,25,25,0,OUI,OUI,2025-03-14 00:01:04+00:00,"48.86164273878, 2.3727491497993",Paris,75056,1.0,0
21205,Arthur Auger - Jean Jaurès,OUI,24,21,3,1,2,OUI,OUI,2025-03-13 23:57:35+00:00,"48.813736445585235, 2.3069277405738835",Montrouge,92049,0.125,0
8057,Hoche - Tilsitt,OUI,32,31,1,0,1,OUI,OUI,2025-03-13 23:57:32+00:00,"48.874836457837, 2.2971323132515",Paris,75056,0.03125,0
16023,Passy - Place du Costa Rica,OUI,30,27,3,1,2,OUI,OUI,2025-03-14 00:00:16+00:00,"48.8584893, 2.2839655",Paris,75056,0.1,0
9025,Taitbout - Châteaudun,OUI,53,31,22,21,1,OUI,OUI,2025-03-14 00:01:45+00:00,"48.876383969379, 2.3353566779335",Paris,75056,0.41509433962264153,0
6004,Regard - Rennes,OUI,46,42,4,1,3,OUI,OUI,2025-03-13 23:56:55+00:00,"48.847385404956, 2.3268555477262",Paris,75056,0.08695652173913043,0
7025,Octave Gréard - Tour Eiffel,OUI,32,32,0,0,0,OUI,OUI,2025-03-13 23:54:55+00:00,"48.856502977696, 2.2931787543289",Paris,75056,0.0,0
19014,Lorraine - Jean Jaurès,OUI,19,14,5,3,2,OUI,OUI,2025-03-14 00:02:12+00:00,"48.8863865, 2.3825772",Paris,75056,0.2631578947368421,0
40007,Préfecture de Créteil,OUI,27,7,20,13,7,OUI,OUI,2025-03-14 00:01:31+00:00,"48.783680285918, 2.4544713672215",Créteil,94028,0.7407407407407407,0
15014,Volontaires - Vaugirard,OUI,32,14,18,11,7,OUI,OUI,2025-03-13 23:55:34+00:00,"48.84132050184004, 2.30808901725357",Paris,75056,0.5625,0
40010,Haut du Mont-Mesly,OUI,21,19,2,1,1,OUI,OUI,2025-03-14 00:02:33+00:00,"48.780191921646, 2.4685737495183",Créteil,94028,0.09523809523809523,0
22014,Victor Hugo - Bineau,OUI,24,20,4,1,3,OUI,OUI,2025-03-13 23:59:07+00:00,"48.88758225888669, 2.2783890366554265",Neuilly-sur-Seine,92051,0.16666666666666666,0
40013,Hôtel de Ville de Créteil,OUI,36,18,18,13,5,OUI,OUI,2025-03-14 00:01:36+00:00,"48.77699496201, 2.4552552404284",Créteil,94028,0.5,0
15044,Dantzig - Lefebvre,OUI,33,27,6,1,5,OUI,OUI,2025-03-14 00:03:13+00:00,"48.83013921586756, 2.295934036374092",Paris,75056,0.18181818181818182,0
12107,Diderot - Pierre Bourdan,OUI,20,7,13,10,3,OUI,OUI,2025-03-14 00:01:50+00:00,"48.847648620797, 2.3902582749724",Paris,75056,0.65,0
15113,Arsonval - Falguière,OUI,24,15,9,5,4,OUI,OUI,2025-03-14 00:02:52+00:00,"48.84040040365445, 2.313117867297474",Paris,75056,0.375,0
23011,Bineau - Louise Michel,OUI,26,16,10,2,8,OUI,OUI,2025-03-14 00:00:42+00:00,"48.88666162207, 2.2843274474144",Levallois-Perret,92044,0.38461538461538464,0
19001,Crimée - Ourcq,OUI,56,29,27,2,25,OUI,OUI,2025-03-14 00:01:36+00:00,"48.894104140316, 2.3729460884673",Paris,75056,0.48214285714285715,0
12105,Bercy - Villot,OUI,32,29,3,3,0,OUI,OUI,2025-03-14 00:01:53+00:00,"48.841795009027, 2.3767850184816",Paris,75056,0.09375,0
26005,Hôtel de Ville d'Asnières sur Seine,OUI,27,8,19,11,8,OUI,OUI,2025-03-14 00:01:36+00:00,"48.90999330025577, 2.288238108158112",Asnières-sur-Seine,92004,0.7037037037037037,0
13023,Bobillot - Moulin des Prés,OUI,28,26,2,0,2,OUI,OUI,2025-03-14 00:01:22+00:00,"48.828657346203, 2.353020646317",Paris,75056,0.07142857142857142,0
23801,Place de la Gare,OUI,20,14,6,3,3,OUI,OUI,2025-03-14 00:00:37+00:00,"48.838513582184, 2.1866139007512",Garches,92033,0.3,0
12040,Porte de Charenton,OUI,64,40,24,8,16,OUI,OUI,2025-03-14 00:02:18+00:00,"48.831240105856, 2.3989107459784",Paris,75056,0.375,0
40004,Créteil Village,OUI,25,1,24,7,17,OUI,OUI,2025-03-14 00:03:04+00:00,"48.79122395576, 2.4642198533952",Créteil,94028,0.96,0
6020,Place Saint-André des Arts,OUI,31,17,14,12,2,OUI,OUI,2025-03-14 00:02:30+00:00,"48.852886173881, 2.3426544293761",Paris,75056,0.45161290322580644,0
23703,Gare de Chaville Rive Gauche,OUI,18,18,0,0,0,OUI,OUI,2025-03-14 00:01:24+00:00,"48.805160304345, 2.188277207315",Chaville,92022,0.0,0
19007,Flandre - Ourcq,OUI,30,2,28,13,15,OUI,OUI,2025-03-14 00:01:21+00:00,"48.89260159189023, 2.3790915682911873",Paris,75056,0.9333333333333333,0
40008,Créteil Pompadour,OUI,44,10,34,11,23,OUI,OUI,2025-03-14 00:02:44+00:00,"48.773011623355, 2.435166164893",Créteil,94028,0.7727272727272727,0
21016,Point du Jour - Jean Jaurès,OUI,39,0,39,32,7,OUI,OUI,2025-03-14 00:03:04+00:00,"48.828753141436465, 2.245911467014621",Boulogne-Billancourt,92012,1.0,0
14021,Place de la Porte de Châtillon,OUI,59,51,8,4,4,OUI,OUI,2025-03-13 23:59:30+00:00,"48.8242469, 2.3186306",Paris,75056,0.13559322033898305,0
5105,Geoffroy-Saint-Hilaire - Saint-Marcel,OUI,17,1,16,10,6,OUI,OUI,2025-03-14 00:02:57+00:00,"48.83907826424974, 2.356877340669728",Paris,75056,0.9411764705882353,0
40015,Iles de Loisirs de Créteil,OUI,24,3,21,12,9,OUI,OUI,2025-03-14 00:02:50+00:00,"48.780258200618, 2.4455094301232",Créteil,94028,0.875,0
11018,Saint-Maur - République,OUI,35,9,26,14,12,OUI,OUI,2025-03-14 00:02:28+00:00,"48.864185861455, 2.3783174157143",Paris,75056,0.7428571428571429,0
51005,Yves Farges - Route d'Enghien,OUI,33,16,17,6,11,OUI,OUI,2025-03-14 00:01:20+00:00,"48.95756799268, 2.2834496977978",Argenteuil,95018,0.5151515151515151,0
19123,Metz - Marne,OUI,29,27,2,0,2,OUI,OUI,2025-03-14 00:01:13+00:00,"48.891163, 2.3865705",Paris,75056,0.06896551724137931,0
32004,Wilson - Landy,OUI,37,18,19,10,9,OUI,OUI,2025-03-14 00:02:48+00:00,"48.91516726221354, 2.357633225619793",Saint-Denis,93066,0.5135135135135135,0
21107,Bertrand Sincholle - Henri Barbusse,OUI,16,2,14,12,2,OUI,OUI,2025-03-14 00:02:32+00:00,"48.89925982394349, 2.3042294383049016",Clichy,92024,0.875,0
22007,Commandant Charcot - Bretteville,OUI,30,0,30,20,10,OUI,OUI,2025-03-14 00:02:38+00:00,"48.87530570765423, 2.2558460757136345",Neuilly-sur-Seine,92051,1.0,0
20137,Borrégo - Gambetta,OUI,25,17,8,0,8,OUI,OUI,2025-03-14 00:00:04+00:00,"48.87330497045532, 2.4014145880937576",Paris,75056,0.32,0
12039,Général Michel Bizot - Claude Decaen,OUI,38,1,37,19,18,OUI,OUI,2025-03-14 00:02:02+00:00,"48.83481262982544, 2.400927788127704",Paris,75056,0.9736842105263158,0
35014,Charles de Gaulle - Jean Lolive,OUI,26,22,4,1,3,OUI,OUI,2025-03-13 23:57:25+00:00,"48.8932644350857, 2.4126765131950383",Pantin,93055,0.15384615384615385,0
5031,Lacépède - Linné,OUI,48,42,6,3,3,OUI,OUI,2025-03-14 00:00:32+00:00,"48.8437035476636, 2.354651279747486",Paris,75056,0.125,0
31708,Noisy le Sec - Jean-Baptiste Clément,OUI,20,8,12,1,11,OUI,OUI,2025-03-14 00:03:08+00:00,"48.874515389637, 2.4152836203575",Bagnolet,93006,0.6,0
12017,Saint-Mandé - Docteur Arnold Netter,OUI,35,18,17,10,7,OUI,OUI,2025-03-14 00:02:20+00:00,"48.84462585769668, 2.404946386814118",Paris,75056,0.4857142857142857,0
10013,Alibert - Jemmapes,OUI,59,27,32,24,8,OUI,OUI,2025-03-14 00:01:33+00:00,"48.871044051984, 2.3661044619878",Paris,75056,0.5423728813559322,0
14025,Jacquier - Didot,OUI,30,16,14,5,9,OUI,OUI,2025-03-14 00:02:06+00:00,"48.82953336292279, 2.318179272115231",Paris,75056,0.4666666666666667,0
15103,Cauchy - Cévennes,OUI,50,2,48,47,1,OUI,OUI,2025-03-14 00:02:03+00:00,"48.843372571022, 2.2751328349113",Paris,75056,0.96,0
6009,Guynemer - Jardin du Luxembourg,OUI,33,28,5,3,2,OUI,OUI,2025-03-14 00:02:19+00:00,"48.8466127, 2.3325478",Paris,75056,0.15151515151515152,0
1003,Saint-Denis - Rivoli,OUI,43,36,7,7,0,OUI,OUI,2025-03-14 00:03:15+00:00,"48.859059340842, 2.3476943001151",Paris,75056,0.16279069767441862,0
42027,Verdun - Pierre et Marie Curie,OUI,26,19,7,3,4,OUI,OUI,2025-03-13 23:56:46+00:00,"48.812822398263286, 2.3707106709480286",Ivry-sur-Seine,94041,0.2692307692307692,0
34014,Michelet - Dr Bauer,OUI,30,9,21,7,14,OUI,OUI,2025-03-14 00:00:48+00:00,"48.906125424194, 2.3440374449846",Saint-Ouen-sur-Seine,93070,0.7,0
16104,Paul Valery - Victor Hugo,OUI,33,26,7,3,4,OUI,OUI,2025-03-13 23:59:31+00:00,"48.87137406080164, 2.2887128591537476",Paris,75056,0.21212121212121213,0
21404,Jean Jaurès - Gare de Clamart,OUI,20,12,8,1,7,OUI,OUI,2025-03-14 00:01:34+00:00,"48.81321981219, 2.2716768079163",Clamart,92023,0.4,0
20033,Etienne Dolet - Place Maurice Chevalier,OUI,46,14,32,15,17,OUI,OUI,2025-03-14 00:01:58+00:00,"48.86798303359366, 2.3851405311143026",Paris,75056,0.6956521739130435,0
17123,Mstislav Rostropovitch - Berthier,OUI,18,17,1,1,0,OUI,OUI,2025-03-13 23:54:36+00:00,"48.892120821173975, 2.309234105050564",Paris,75056,0.05555555555555555,0
30005,Convention - Campus de Bobigny,OUI,29,23,6,1,5,OUI,OUI,2025-03-13 23:54:50+00:00,"48.914920058264, 2.4172238067445",Bobigny,93008,0.20689655172413793,0
17038,Grande Armée - Brunel,OUI,60,58,2,1,1,OUI,OUI,2025-03-14 00:03:06+00:00,"48.876116, 2.288124",Paris,75056,0.03333333333333333,0
1201,Perrault - Place du Louvre,OUI,27,8,19,19,0,OUI,OUI,2025-03-14 00:00:03+00:00,"48.860273568996, 2.3412468419093",Paris,75056,0.7037037037037037,0
13123,BNF - Bibliothèque Nationale de France,OUI,42,20,22,22,0,OUI,OUI,2025-03-14 00:00:14+00:00,"48.8350268238, 2.3760157451034",Paris,75056,0.5238095238095238,0
17036,Place Tristan Bernard,OUI,27,10,17,14,3,OUI,OUI,2025-03-14 00:02:59+00:00,"48.8794936, 2.2915423",Paris,75056,0.6296296296296297,0
8052,Balzac - Champs Elysées,OUI,28,27,1,1,0,OUI,OUI,2025-03-13 23:57:02+00:00,"48.872699639621, 2.3001953959465",Paris,75056,0.03571428571428571,0
21112,Claude Debussy - Marc Bloch,OUI,50,44,6,2,4,OUI,OUI,2025-03-14 00:00:10+00:00,"48.910388180512, 2.3117771744728",Clichy,92024,0.12,0
12010,Daumesnil - Picpus,OUI,21,1,20,16,4,OUI,OUI,2025-03-14 00:00:45+00:00,"48.8374688, 2.401765",Paris,75056,0.9523809523809523,0
22703,Place Jean Mermoz,OUI,29,1,28,7,21,OUI,OUI,2025-03-14 00:02:54+00:00,"48.9220937, 2.2718348",Bois-Colombes,92009,0.9655172413793104,0
4104,Sebastopol - Rambuteau,OUI,14,8,6,6,0,OUI,OUI,2025-03-13 23:54:33+00:00,"48.86181809267, 2.3501381278038",Paris,75056,0.42857142857142855,0
25009,Place des Arts - Jean Mermoz,OUI,20,0,20,18,2,OUI,OUI,2025-03-14 00:01:47+00:00,"48.880391139734, 2.1832160452221",Rueil-Malmaison,92063,1.0,0
32001,Proudhon - Président Wilson,OUI,30,17,13,4,9,OUI,OUI,2025-03-14 00:02:26+00:00,"48.906442763495, 2.3584905266762",Saint-Denis,93066,0.43333333333333335,0
26010,Louis Armand - Bernard Palissy,OUI,16,0,16,13,3,OUI,OUI,2025-03-13 23:57:58+00:00,"48.916974, 2.313384",Asnières-sur-Seine,92004,1.0,0
33019,Madeleine Vionnet,OUI,36,27,9,3,6,OUI,OUI,2025-03-14 00:02:49+00:00,"48.902519074064, 2.3740895837545",Aubervilliers,93001,0.25,0
16140,Hippodrome de Longchamp,OUI,24,8,16,15,1,OUI,OUI,2025-03-13 23:59:23+00:00,"48.86413226532, 2.239905372262",Paris,75056,0.6666666666666666,0
12127,Tremblay - Lac des Minimes,OUI,47,47,0,0,0,OUI,OUI,2025-03-14 00:02:05+00:00,"48.834131261494, 2.4547516554594",Paris,75056,0.0,0
3201,Payenne - Square George Caïn,OUI,22,17,5,3,2,OUI,OUI,2025-03-14 00:02:39+00:00,"48.8578329, 2.3622643",Paris,75056,0.22727272727272727,0
21021,Enfants du Paradis - Peupliers,OUI,40,27,13,13,0,OUI,OUI,2025-03-14 00:02:49+00:00,"48.833122686454, 2.2571459412575",Boulogne-Billancourt,92012,0.325,0
23106,Pavé des Gardes - Charles Vaillant,OUI,20,20,0,0,0,OUI,OUI,2025-03-13 23:59:46+00:00,"48.81168551728, 2.2111820107205",Sèvres,92072,0.0,0
8002,Gare Saint-Lazare - Cour du Havre,OUI,40,8,32,26,6,OUI,OUI,2025-03-14 00:02:24+00:00,"48.875674400851, 2.3265598341823",Paris,75056,0.8,0
20037,Gambetta - Saint Fargeau,OUI,24,18,6,1,5,OUI,OUI,2025-03-14 00:02:12+00:00,"48.871244610447015, 2.4039056897163396",Paris,75056,0.25,0
9104,Caumartin - Provence,OUI,22,17,5,3,2,OUI,OUI,2025-03-14 00:01:11+00:00,"48.874422773426545, 2.3284685611724854",Paris,75056,0.22727272727272727,0
19045,Macdonald - Césaria Evora,OUI,65,56,9,4,5,OUI,OUI,2025-03-14 00:02:00+00:00,"48.89883, 2.37933",Paris,75056,0.13846153846153847,0
22302,Gare RER - Général de Gaulle,OUI,38,28,10,9,1,OUI,OUI,2025-03-14 00:02:07+00:00,"48.933548439566, 2.3064726536317",Gennevilliers,92036,0.2631578947368421,0
9029,Saint-Lazare - Place d'Estienne d'Orves,OUI,38,32,6,5,1,OUI,OUI,2025-03-13 23:57:53+00:00,"48.8768345, 2.3329067",Paris,75056,0.15789473684210525,0
41212,Nungesser - Santé,OUI,22,14,8,0,8,OUI,OUI,2025-03-14 00:00:51+00:00,"48.852335, 2.448967",Fontenay-sous-Bois,94033,0.36363636363636365,0
10151,Gare du Nord - Faubourg Saint-Denis,OUI,28,27,1,0,1,OUI,OUI,2025-03-13 23:59:05+00:00,"48.879612765504, 2.3568402975798",Paris,75056,0.03571428571428571,0
7007,Musée d'Orsay,OUI,63,36,27,23,4,OUI,OUI,2025-03-13 23:58:40+00:00,"48.859726157909, 2.3258604481816",Paris,75056,0.42857142857142855,0
22208,Stalingrad - Barbara,OUI,19,18,1,0,1,OUI,OUI,2025-03-13 23:58:44+00:00,"48.809223658808, 2.3175904558822",Bagneux,92007,0.05263157894736842,0
22209,Verdun - Henri Barbusse,OUI,23,22,1,1,0,OUI,OUI,2025-03-14 00:02:58+00:00,"48.802056061754, 2.3159965061736",Bagneux,92007,0.043478260869565216,0
45005,Stalingrad - Général de Gaulle,OUI,26,9,17,4,13,OUI,OUI,2025-03-14 00:03:09+00:00,"48.823450589614, 2.4965062363218",Champigny-sur-Marne,94017,0.6538461538461539,0
14110,Abbé Carton - Plantes,OUI,25,20,5,3,2,OUI,OUI,2025-03-13 23:56:10+00:00,"48.827673823166, 2.3209181427956",Paris,75056,0.2,0
10025,Jemmapes - Ecluses Saint-Martin,OUI,14,8,6,4,2,OUI,OUI,2025-03-14 00:02:52+00:00,"48.87748519186726, 2.3660067468881607",Paris,75056,0.42857142857142855,0
32305,Saint-Germain - Verdun,OUI,29,20,9,2,7,OUI,OUI,2025-03-14 00:00:48+00:00,"48.882877330093, 2.4331868384644",Romainville,93063,0.3103448275862069,0
22305,Jean Jaurès - Place du Dr Roux,OUI,34,25,9,7,2,OUI,OUI,2025-03-14 00:02:33+00:00,"48.927567032796, 2.2947337017374",Gennevilliers,92036,0.2647058823529412,0
23205,Parc des Pierrettes,OUI,22,16,6,0,6,OUI,OUI,2025-03-13 23:56:34+00:00,"48.7973062, 2.2909969",Châtillon,92020,0.2727272727272727,0
23201,Avenir,OUI,42,42,0,0,0,OUI,OUI,2025-03-14 00:00:25+00:00,"48.8103438, 2.3003776",Châtillon,92020,0.0,0
21320,Président Roosevelt - Rouget de Lisle,OUI,38,35,3,1,2,OUI,OUI,2025-03-13 23:59:55+00:00,"48.83047518749, 2.2616135525345",Issy-les-Moulineaux,92040,0.07894736842105263,0
21327,Jean Bouin - Gouverneur Général Eboué,OUI,31,6,25,23,2,OUI,OUI,2025-03-14 00:01:08+00:00,"48.824792734266, 2.2651904328524",Issy-les-Moulineaux,92040,0.8064516129032258,0
17126,Hélène et François Missoffe - Emile Borel,OUI,29,22,7,5,2,OUI,OUI,2025-03-13 23:59:32+00:00,"48.89990653843488, 2.321543991674844",Paris,75056,0.2413793103448276,0
34005,Adrien Lesesne - Docteur Bauer,OUI,29,3,26,6,20,OUI,OUI,2025-03-13 23:57:38+00:00,"48.90263867304635, 2.348248063431511",Saint-Ouen-sur-Seine,93070,0.896551724137931,0
17127,Porte de Clichy - Place des Nations Unies,OUI,37,14,23,18,5,OUI,OUI,2025-03-14 00:02:56+00:00,"48.896737263309504, 2.310542999196392",Paris,75056,0.6216216216216216,0
26008,Henri Barbusse - Bourguignons,OUI,33,3,30,7,23,OUI,OUI,2025-03-14 00:03:14+00:00,"48.91301722799713, 2.2734212270774417",Asnières-sur-Seine,92004,0.9090909090909091,0
34008,Garibaldi - Gabriel Péri,OUI,28,2,26,10,16,OUI,OUI,2025-03-13 23:58:59+00:00,"48.905741911394, 2.3316044208059",Saint-Ouen-sur-Seine,93070,0.9285714285714286,0
31301,Gare RER,OUI,28,20,8,1,7,OUI,OUI,2025-03-13 23:56:07+00:00,"48.896280181078, 2.4581568985227",Noisy-le-Sec,93053,0.2857142857142857,0
21514,Place de la Paix - Abbé Saint-Pierre,OUI,24,17,7,0,7,OUI,OUI,2025-03-13 23:58:32+00:00,"48.86462724459225, 2.2047570338469806",Suresnes,92073,0.2916666666666667,0
19018,Cité de la Musique,OUI,54,42,12,6,6,OUI,OUI,2025-03-14 00:03:01+00:00,"48.888796556487, 2.3925811931922",Paris,75056,0.2222222222222222,0
10026,Gare de l'Est - Chateau Landon,OUI,56,27,29,19,10,OUI,OUI,2025-03-14 00:02:22+00:00,"48.879305, 2.362424",Paris,75056,0.5178571428571429,0
17010,Jonquière - Docteur Paul Brousse,OUI,39,0,39,24,15,OUI,OUI,2025-03-14 00:03:08+00:00,"48.894799816683985, 2.318705212173216",Paris,75056,1.0,0
18024,Clignancourt - Ordener,OUI,35,19,16,4,12,OUI,OUI,2025-03-14 00:03:01+00:00,"48.891457726153774, 2.348636478060487",Paris,75056,0.45714285714285713,0
7201,Place De Fontenoy - Saxe,OUI,18,14,4,2,2,OUI,OUI,2025-03-13 23:59:30+00:00,"48.850270554523, 2.3069813815839",Paris,75056,0.2222222222222222,0
31201,Suzanne Masson,OUI,33,6,27,13,14,OUI,OUI,2025-03-14 00:02:38+00:00,"48.923306888013, 2.3847292397611",La Courneuve,93027,0.8181818181818182,0
13204,Tolbiac - Boussingault,OUI,41,1,40,24,16,OUI,OUI,2025-03-14 00:03:10+00:00,"48.826177754027, 2.3420378552202",Paris,75056,0.975609756097561,0
13035,Choisy - Tolbiac,OUI,20,14,6,0,6,OUI,OUI,2025-03-13 23:58:15+00:00,"48.82591155587, 2.3602393269539",Paris,75056,0.3,0
15062,Convention - Lourmel,OUI,32,4,28,24,4,OUI,OUI,2025-03-14 00:02:47+00:00,"48.842055041656, 2.2859910875559",Paris,75056,0.875,0
10114,Granges aux Belles - Hôpital Saint-Louis,OUI,59,45,14,9,5,OUI,OUI,2025-03-14 00:02:42+00:00,"48.874794994841, 2.366669436985",Paris,75056,0.23728813559322035,0
18134,Ney - Porte de Clignancourt,OUI,25,12,13,5,8,OUI,OUI,2025-03-14 00:01:25+00:00,"48.8978867, 2.3458001",Paris,75056,0.52,0
13203,Square de Choisy - Eastman,OUI,23,17,6,1,5,OUI,OUI,2025-03-13 23:58:28+00:00,"48.828543456283, 2.3583075090494",Paris,75056,0.2608695652173913,0
13202,Place Farhat Hached,OUI,28,19,9,8,1,OUI,OUI,2025-03-14 00:00:55+00:00,"48.825487045602, 2.3816306985827",Paris,75056,0.32142857142857145,0
13051,Halle Freyssinet - Parvis Alan Turing,OUI,23,23,0,0,0,OUI,OUI,2025-03-14 00:02:14+00:00,"48.832846814471, 2.3711421713233",Paris,75056,0.0,0
8038,François 1er - Montaigne,OUI,50,46,4,3,1,OUI,OUI,2025-03-14 00:01:55+00:00,"48.866887649978, 2.3066755757207",Paris,75056,0.08,0
21501,Pont de Suresnes,OUI,16,6,10,9,1,OUI,OUI,2025-03-14 00:01:52+00:00,"48.867415092322, 2.2258946679617",Suresnes,92073,0.625,0
19204,Rampal - Belleville,OUI,18,11,7,2,5,OUI,OUI,2025-03-14 00:02:51+00:00,"48.873114661405, 2.3798409114805",Paris,75056,0.3888888888888889,0
5201,Saint-Jacques - Soufflot,OUI,16,16,0,0,0,OUI,OUI,2025-03-14 00:00:59+00:00,"48.846280383395, 2.3430785379567",Paris,75056,0.0,0
11037,Faubourg Du Temple - Republique,OUI,38,9,29,28,1,OUI,OUI,2025-03-14 00:02:53+00:00,"48.867872484749, 2.3648982158072",Paris,75056,0.7631578947368421,0
35002,Jean Jaurès - Presles,OUI,31,22,9,3,6,OUI,OUI,2025-03-14 00:03:07+00:00,"48.907134414988, 2.3960057280531",Pantin,93055,0.2903225806451613,0
11020,Belfort - Voltaire,OUI,38,1,37,31,6,OUI,OUI,2025-03-14 00:01:34+00:00,"48.8563358, 2.3829901",Paris,75056,0.9736842105263158,0
18044,Clichy - Douai,OUI,31,28,3,1,2,OUI,OUI,2025-03-14 00:01:16+00:00,"48.883687771522, 2.328063700029",Paris,75056,0.0967741935483871,0
21213,Vanne - Général de Gaulle,OUI,24,18,6,1,5,OUI,OUI,2025-03-14 00:01:34+00:00,"48.815007, 2.328318",Montrouge,92049,0.25,0
3004,Place de la République - Temple,OUI,17,7,10,6,4,OUI,OUI,2025-03-14 00:02:47+00:00,"48.867211201859, 2.3635464370545",Paris,75056,0.5882352941176471,0
11009,Boulets - Voltaire,OUI,24,1,23,14,9,OUI,OUI,2025-03-14 00:01:50+00:00,"48.85218705621, 2.3890301585197",Paris,75056,0.9583333333333334,0
15060,Place de la Montagne du Goulet,OUI,21,3,18,17,1,OUI,OUI,2025-03-13 23:57:33+00:00,"48.8443415, 2.2773844",Paris,75056,0.8571428571428571,0
7111,Ecole Militaire - Place Joffre,OUI,25,7,18,17,1,OUI,OUI,2025-03-14 00:02:25+00:00,"48.852060203583, 2.3017993569374",Paris,75056,0.72,0
11012,Montreuil - Voltaire,OUI,32,21,11,5,6,OUI,OUI,2025-03-14 00:01:43+00:00,"48.850507011842, 2.3930755582745",Paris,75056,0.34375,0
15105,Fédération - Suffren,OUI,24,6,18,16,2,OUI,OUI,2025-03-14 00:01:25+00:00,"48.852828153442, 2.2978776320815",Paris,75056,0.75,0
18205,Mauroy - Cheminots,OUI,28,13,15,5,10,OUI,OUI,2025-03-14 00:03:14+00:00,"48.897715198403, 2.357895075822",Paris,75056,0.5357142857142857,0
7023,Bourdonnais - Tour Eiffel,OUI,58,25,33,26,7,OUI,OUI,2025-03-14 00:02:49+00:00,"48.860897797941, 2.295599598447",Paris,75056,0.5689655172413793,0
7109,Place Joffre - Frédéric le Play,OUI,37,30,7,5,2,OUI,OUI,2025-03-14 00:02:10+00:00,"48.853754486938, 2.3044242337346",Paris,75056,0.1891891891891892,0
4108,Quai de Béthune - Pont de la Tournelle,OUI,25,0,25,21,4,OUI,OUI,2025-03-14 00:01:41+00:00,"48.85097433194, 2.3563072085381",Paris,75056,1.0,0
40012,Stade de la Habette,OUI,16,13,3,0,3,OUI,OUI,2025-03-14 00:00:29+00:00,"48.774397033806, 2.4668785263921",Créteil,94028,0.1875,0
40014,Créteil Pointe du Lac,OUI,28,4,24,9,15,OUI,OUI,2025-03-14 00:03:12+00:00,"48.769807356177, 2.4623027310281",Créteil,94028,0.8571428571428571,0
16005,Raymond Poincaré - Place Victor Hugo,OUI,21,21,0,0,0,OUI,OUI,2025-03-13 23:57:57+00:00,"48.87030612437, 2.2850745414202",Paris,75056,0.0,0
12201,Dugommier,OUI,53,2,51,39,12,OUI,OUI,2025-03-14 00:00:32+00:00,"48.838811048815, 2.3896577954292",Paris,75056,0.9622641509433962,0
40003,Centre Hospitalier Intercommunal de Créteil,OUI,17,15,2,1,1,OUI,OUI,2025-03-13 23:55:38+00:00,"48.797078298909, 2.463801423807",Créteil,94028,0.11764705882352941,0
13106,Bobillot - Paulin Mery,OUI,21,20,1,0,1,OUI,OUI,2025-03-14 00:02:56+00:00,"48.829899841747, 2.3543356766749",Paris,75056,0.047619047619047616,0
10031,Louis Blanc - Aqueduc,OUI,35,12,23,9,14,OUI,OUI,2025-03-14 00:03:10+00:00,"48.882030182599, 2.363561578095",Paris,75056,0.6571428571428571,0
15026,Bir Hakeim,OUI,30,15,15,10,5,OUI,OUI,2025-03-14 00:01:55+00:00,"48.853844054334, 2.289705348222",Paris,75056,0.5,0
1022,Danielle Casanova - Place Vendôme,OUI,35,31,4,2,2,OUI,OUI,2025-03-13 23:55:42+00:00,"48.868266498223, 2.3304839059711",Paris,75056,0.11428571428571428,0
41301,Bois de Vincennes - Gare,OUI,49,48,1,0,1,OUI,OUI,2025-03-13 23:54:27+00:00,"48.836022242887, 2.470833995083",Nogent-sur-Marne,94052,0.02040816326530612,0
18043,Clichy - Place Blanche,OUI,18,16,2,1,1,OUI,OUI,2025-03-13 23:56:46+00:00,"48.883601088297, 2.3332237824798",Paris,75056,0.1111111111111111,0
19203,Pailleron - Bouret,OUI,27,23,4,1,3,OUI,OUI,2025-03-14 00:00:03+00:00,"48.880516995482, 2.3763902374411",Paris,75056,0.14814814814814814,0
27004,Gare de la Garenne-Colombes,OUI,26,17,9,4,5,OUI,OUI,2025-03-13 23:57:02+00:00,"48.909752, 2.239145",Colombes,92025,0.34615384615384615,0
32012,Carrefour Pleyel,OUI,65,54,11,2,9,OUI,OUI,2025-03-14 00:02:46+00:00,"48.92034156960326, 2.3438543826341625",Saint-Denis,93066,0.16923076923076924,0
6001,Institut de France,OUI,17,5,12,12,0,OUI,OUI,2025-03-14 00:01:33+00:00,"48.857615678565, 2.3358313530377",Paris,75056,0.7058823529411765,0
1002,Victoria - Place du Chatelet,OUI,18,14,4,3,1,OUI,OUI,2025-03-14 00:00:29+00:00,"48.857992591527, 2.3469167947769",Paris,75056,0.2222222222222222,0
40002,Bleuets - Bordières,OUI,21,14,7,4,3,OUI,OUI,2025-03-14 00:00:20+00:00,"48.802117531472, 2.4543687905029",Créteil,94028,0.3333333333333333,0
21302,Aristide Briand - Place de la Résistance,OUI,44,0,44,36,8,OUI,OUI,2025-03-14 00:01:56+00:00,"48.82124248401006, 2.2511002421379094",Issy-les-Moulineaux,92040,1.0,0
15056,Place Balard,OUI,22,21,1,1,0,OUI,OUI,2025-03-13 23:56:44+00:00,"48.836395736424, 2.2784192115068",Paris,75056,0.045454545454545456,0
8004,Malesherbes - Place de la Madeleine,OUI,77,61,16,8,8,OUI,OUI,2025-03-14 00:00:07+00:00,"48.870406028483, 2.323243509808",Paris,75056,0.2077922077922078,0
